,room,timestamp,Zone Temperature,Zone Temperature Error,Actual Supply Flow,Actual Supply Flow Error,Average Supply Flow,Supply Vel Press,total
23725,RM-1208,6/29/2014,1458,3444,0,1722,0,0,6624
23578,RM-1208,2/2/2014,1572,3456,0,0,0,1572,6600
30425,RM-1229,2/2/2014,0,0,1572,3456,0,1572,6600
23579,RM-1208,2/3/2014,1563,3456,0,0,0,1563,6582
30426,RM-1229,2/3/2014,0,0,1563,3456,0,1563,6582
30427,RM-1229,2/4/2014,0,0,1542,3456,0,1542,6540
23580,RM-1208,2/4/2014,1539,3456,0,0,0,1542,6537
18899,RM-1155,2/2/2014,1572,0,1572,1728,0,1572,6444
23581,RM-1208,2/5/2014,1485,3456,0,0,0,1482,6423
30428,RM-1229,2/5/2014,0,0,1485,3456,0,1482,6423
18900,RM-1155,2/3/2014,1563,0,1563,1728,0,1563,6417
18901,RM-1155,2/4/2014,1539,0,1542,1728,0,1542,6351
23586,RM-1208,2/10/2014,1440,3456,0,0,0,1440,6336
30433,RM-1229,2/10/2014,0,0,1440,3456,0,1440,6336
23582,RM-1208,2/6/2014,1416,3456,0,0,0,1416,6288
30429,RM-1229,2/6/2014,0,0,1413,3456,0,1416,6285
23617,RM-1208,3/13/2014,1392,3456,0,0,0,1395,6243
18902,RM-1155,2/5/2014,1485,0,1485,1728,0,1482,6180
30432,RM-1229,2/9/2014,0,0,1308,3456,0,1305,6069
23585,RM-1208,2/9/2014,1305,3456,0,0,0,1305,6066
30430,RM-1229,2/7/2014,0,0,1311,3444,0,1308,6063
23583,RM-1208,2/7/2014,1308,3444,0,0,0,1308,6060
18907,RM-1155,2/10/2014,1440,0,1440,1728,0,1440,6048
23726,RM-1208,6/30/2014,852,3456,0,1728,0,0,6036
35121,RM-B103A,3/15/2014,1290,0,0,3456,0,1290,6036
23619,RM-1208,3/15/2014,1287,3456,0,0,0,1290,6033
23584,RM-1208,2/8/2014,1284,3456,0,0,0,1284,6024
30431,RM-1229,2/8/2014,0,0,1281,3456,0,1284,6021
23701,RM-1208,6/5/2014,834,3456,0,1728,0,0,6018
23589,RM-1208,2/13/2014,1275,3432,0,0,0,1275,5982
23596,RM-1208,2/20/2014,1260,3456,0,0,0,1263,5979
30436,RM-1229,2/13/2014,0,0,1272,3432,0,1275,5979
18903,RM-1155,2/6/2014,1416,0,1413,1728,0,1416,5973
23620,RM-1208,3/16/2014,1257,3456,0,0,0,1257,5970
35122,RM-B103A,3/16/2014,1257,0,0,3456,0,1257,5970
23702,RM-1208,6/6/2014,783,3456,0,1728,0,0,5967
23700,RM-1208,6/4/2014,1044,3456,0,1458,0,0,5958
30435,RM-1229,2/12/2014,0,0,1260,3444,0,1254,5958
23588,RM-1208,2/12/2014,1254,3444,0,0,0,1254,5952
23590,RM-1208,2/14/2014,1230,3456,0,0,0,1230,5916
23618,RM-1208,3/14/2014,1221,3456,0,0,0,1218,5895
23621,RM-1208,3/17/2014,1212,3456,0,0,0,1209,5877
35123,RM-B103A,3/17/2014,1209,0,0,3456,0,1209,5874
23627,RM-1208,3/23/2014,1203,3456,0,0,0,1203,5862
35129,RM-B103A,3/23/2014,1203,0,0,3456,0,1203,5862
23591,RM-1208,2/15/2014,1197,3456,0,0,0,1200,5853
23705,RM-1208,6/9/2014,654,3456,0,1728,0,0,5838
23597,RM-1208,2/21/2014,1176,3456,0,0,0,1176,5808
23703,RM-1208,6/7/2014,600,3456,0,1728,0,0,5784
23628,RM-1208,3/24/2014,1161,3456,0,0,0,1158,5775
23706,RM-1208,6/10/2014,588,3456,0,1728,0,0,5772
35128,RM-B103A,3/22/2014,1158,0,0,3456,0,1158,5772
35130,RM-B103A,3/24/2014,1158,0,0,3456,0,1158,5772
23592,RM-1208,2/16/2014,1158,3456,0,0,0,1155,5769
23626,RM-1208,3/22/2014,1155,3456,0,0,0,1158,5769
23598,RM-1208,2/22/2014,1149,3456,0,0,0,1149,5754
23622,RM-1208,3/18/2014,1146,3456,0,0,0,1146,5748
35124,RM-B103A,3/18/2014,1146,0,0,3456,0,1146,5748
23599,RM-1208,2/23/2014,1131,3456,0,0,0,1131,5718
23704,RM-1208,6/8/2014,525,3456,0,1728,0,0,5709
23593,RM-1208,2/17/2014,1107,3456,0,0,0,1107,5670
23707,RM-1208,6/11/2014,495,3444,0,1722,0,0,5661
18904,RM-1155,2/7/2014,1308,0,1311,1722,0,1308,5649
18906,RM-1155,2/9/2014,1305,0,1308,1728,0,1305,5646
23708,RM-1208,6/12/2014,456,3456,0,1728,0,0,5640
35132,RM-B103A,3/26/2014,1092,0,0,3456,0,1092,5640
23630,RM-1208,3/26/2014,1092,3456,0,0,0,1089,5637
23600,RM-1208,2/24/2014,1077,3456,0,0,0,1074,5607
30434,RM-1229,2/11/2014,0,0,1083,3456,0,1065,5604
23594,RM-1208,2/18/2014,1068,3456,0,0,0,1068,5592
23606,RM-1208,3/2/2014,1071,3444,0,0,0,1071,5586
18905,RM-1155,2/8/2014,1284,0,1281,1728,0,1284,5577
23616,RM-1208,3/12/2014,1059,3456,0,0,0,1059,5574
23587,RM-1208,2/11/2014,1047,3456,0,0,0,1065,5568
23631,RM-1208,3/27/2014,1080,3408,0,0,0,1080,5568
23710,RM-1208,6/14/2014,384,3456,0,1728,0,0,5568
35133,RM-B103A,3/27/2014,1080,0,0,3408,0,1077,5565
23605,RM-1208,3/1/2014,1050,3456,0,0,0,1050,5556
18910,RM-1155,2/13/2014,1275,0,1272,1716,0,1275,5538
23711,RM-1208,6/15/2014,354,3456,0,1728,0,0,5538
23601,RM-1208,2/25/2014,1035,3456,0,0,0,1035,5526
23629,RM-1208,3/25/2014,1029,3456,0,0,0,1032,5517
35131,RM-B103A,3/25/2014,1029,0,0,3456,0,1032,5517
23602,RM-1208,2/26/2014,1029,3456,0,0,0,1029,5514
23609,RM-1208,3/5/2014,1029,3456,0,0,0,1029,5514
23714,RM-1208,6/18/2014,330,3456,0,1728,0,0,5514
23625,RM-1208,3/21/2014,1029,3456,0,0,0,1026,5511
23709,RM-1208,6/13/2014,327,3456,0,1728,0,0,5511
23712,RM-1208,6/16/2014,324,3456,0,1728,0,0,5508
35127,RM-B103A,3/21/2014,1026,0,0,3456,0,1026,5508
23713,RM-1208,6/17/2014,321,3456,0,1728,0,0,5505
23607,RM-1208,3/3/2014,1035,3432,0,0,0,1035,5502
23595,RM-1208,2/19/2014,1020,3456,0,0,0,1020,5496
23715,RM-1208,6/19/2014,309,3456,0,1728,0,0,5493
18909,RM-1155,2/12/2014,1254,0,1260,1722,0,1254,5490
23716,RM-1208,6/20/2014,303,3456,0,1728,0,0,5487
23717,RM-1208,6/21/2014,279,3456,0,1728,0,0,5463
23718,RM-1208,6/22/2014,273,3456,0,1728,0,0,5457
23720,RM-1208,6/24/2014,273,3456,0,1728,0,0,5457
23721,RM-1208,6/25/2014,273,3456,0,1728,0,0,5457
23719,RM-1208,6/23/2014,267,3456,0,1728,0,0,5451
23608,RM-1208,3/4/2014,984,3456,0,0,0,984,5424
18911,RM-1155,2/14/2014,1230,0,1233,1728,0,1230,5421
23603,RM-1208,2/27/2014,978,3456,0,0,0,978,5412
23722,RM-1208,6/26/2014,228,3456,0,1728,0,0,5412
23727,RM-1208,7/1/2014,222,3456,0,1728,0,0,5406
23724,RM-1208,6/28/2014,210,3456,0,1728,0,0,5394
23723,RM-1208,6/27/2014,189,3456,0,1728,0,0,5373
23611,RM-1208,3/7/2014,951,3456,0,0,0,951,5358
30286,RM-1229,9/13/2013,1776,0,1779,0,0,1776,5331
18912,RM-1155,2/15/2014,1197,0,1197,1728,0,1200,5322
23623,RM-1208,3/19/2014,927,3456,0,0,0,927,5310
35125,RM-B103A,3/19/2014,927,0,0,3456,0,927,5310
30287,RM-1229,9/14/2013,1767,0,1764,0,0,1767,5298
23612,RM-1208,3/8/2014,954,3372,0,0,0,954,5280
23613,RM-1208,3/9/2014,933,3396,0,0,0,933,5262
18913,RM-1155,2/16/2014,1158,0,1158,1728,0,1155,5199
23615,RM-1208,3/11/2014,861,3456,0,0,0,861,5178
30437,RM-1229,2/14/2014,0,0,1233,3456,0,462,5151
23573,RM-1208,1/28/2014,858,3432,0,0,0,858,5148
23574,RM-1208,1/29/2014,837,3456,0,0,0,837,5130
23610,RM-1208,3/6/2014,834,3456,0,0,0,837,5127
30288,RM-1229,9/15/2013,1707,0,1707,0,0,1707,5121
23604,RM-1208,2/28/2014,816,3456,0,0,0,819,5091
23614,RM-1208,3/10/2014,819,3432,0,0,0,819,5070
21626,RM-1200C,3/23/2014,0,1728,0,3318,0,0,5046
7483,RM-1116,7/13/2013,0,0,2517,0,0,2517,5034
8171,RM-1117,7/13/2013,2517,0,0,0,0,2517,5034
18708,RM-1155,7/13/2013,2517,0,2517,0,0,0,5034
32261,RM-1236,7/13/2013,2517,0,2517,0,0,0,5034
36806,RM-B200C,7/13/2013,0,0,2517,0,0,2517,5034
38182,RM-B215,7/13/2013,2517,0,0,0,0,2517,5034
40243,RM-B224,7/13/2013,0,0,2517,0,0,2517,5034
44162,RM-B250,7/13/2013,2517,0,0,0,0,2517,5034
36316,RM-B200B,2/2/2014,0,3456,0,0,0,1572,5028
36317,RM-B200B,2/3/2014,0,3456,0,0,0,1563,5019
36318,RM-B200B,2/4/2014,0,3456,0,0,0,1542,4998
8172,RM-1117,7/14/2013,2490,0,0,0,0,2490,4980
38183,RM-B215,7/14/2013,2490,0,0,0,0,2490,4980
44163,RM-B250,7/14/2013,2490,0,0,0,0,2490,4980
7484,RM-1116,7/14/2013,0,0,2487,0,0,2490,4977
18709,RM-1155,7/14/2013,2490,0,2487,0,0,0,4977
32262,RM-1236,7/14/2013,2490,0,2487,0,0,0,4977
36807,RM-B200C,7/14/2013,0,0,2487,0,0,2490,4977
40244,RM-B224,7/14/2013,0,0,2487,0,0,2490,4977
30289,RM-1229,9/16/2013,1647,0,1647,0,0,1647,4941
36319,RM-B200B,2/5/2014,0,3456,0,0,0,1482,4938
18908,RM-1155,2/11/2014,1047,0,1083,1728,0,1065,4923
44500,RM-B250,6/29/2014,0,1722,1467,1722,0,0,4911
13169,RM-1132,6/29/2014,0,0,1458,3444,0,0,4902
17673,RM-1151,6/29/2014,1458,0,0,3444,0,0,4902
23577,RM-1208,2/1/2014,747,3396,0,0,0,747,4890
30424,RM-1229,2/1/2014,0,0,747,3396,0,747,4890
35080,RM-B103A,2/2/2014,1572,0,0,1728,0,1572,4872
36320,RM-B200B,2/6/2014,0,3456,0,0,0,1416,4872
35081,RM-B103A,2/3/2014,1563,0,0,1728,0,1563,4854
18914,RM-1155,2/17/2014,1107,0,909,1728,0,1107,4851
23632,RM-1208,3/28/2014,693,3456,0,0,0,702,4851
35134,RM-B103A,3/28/2014,693,0,0,3456,0,702,4851
30291,RM-1229,9/18/2013,1617,0,1617,0,0,1614,4848
30464,RM-1229,3/13/2014,0,0,1392,3456,0,0,4848
7482,RM-1116,7/12/2013,0,0,2421,0,0,2421,4842
8170,RM-1117,7/12/2013,2421,0,0,0,0,2421,4842
18707,RM-1155,7/12/2013,2421,0,2421,0,0,0,4842
32260,RM-1236,7/12/2013,2421,0,2421,0,0,0,4842
36805,RM-B200C,7/12/2013,0,0,2421,0,0,2421,4842
40242,RM-B224,7/12/2013,0,0,2421,0,0,2421,4842
44161,RM-B250,7/12/2013,2421,0,0,0,0,2421,4842
35082,RM-B103A,2/4/2014,1542,0,0,1728,0,1542,4812
7480,RM-1116,7/10/2013,0,0,2403,0,0,2406,4809
8168,RM-1117,7/10/2013,2403,0,0,0,0,2406,4809
13024,RM-1132,2/4/2014,0,0,1539,1728,0,1542,4809
36803,RM-B200C,7/10/2013,0,0,2403,0,0,2406,4809
40240,RM-B224,7/10/2013,0,0,2403,0,0,2406,4809
18705,RM-1155,7/10/2013,2403,0,2403,0,0,0,4806
32258,RM-1236,7/10/2013,2403,0,2403,0,0,0,4806
17631,RM-1151,5/18/2014,1338,0,0,3456,0,0,4794
23683,RM-1208,5/18/2014,1338,3456,0,0,0,0,4794
44458,RM-B250,5/18/2014,0,1728,1338,1728,0,0,4794
17633,RM-1151,5/20/2014,1335,0,0,3456,0,0,4791
23685,RM-1208,5/20/2014,1335,3456,0,0,0,0,4791
44460,RM-B250,5/20/2014,0,1728,1335,1728,0,0,4791
23575,RM-1208,1/30/2014,663,3444,0,0,0,666,4773
30422,RM-1229,1/30/2014,0,0,663,3444,0,666,4773
7487,RM-1116,7/18/2013,0,0,2385,0,0,2382,4767
18712,RM-1155,7/18/2013,2382,0,2385,0,0,0,4767
32265,RM-1236,7/18/2013,2382,0,2385,0,0,0,4767
36810,RM-B200C,7/18/2013,0,0,2385,0,0,2382,4767
40247,RM-B224,7/18/2013,0,0,2385,0,0,2382,4767
8175,RM-1117,7/18/2013,2382,0,0,0,0,2382,4764
38186,RM-B215,7/18/2013,2382,0,0,0,0,2382,4764
44166,RM-B250,7/18/2013,2382,0,0,0,0,2382,4764
36321,RM-B200B,2/7/2014,0,3444,0,0,0,1308,4752
17635,RM-1151,5/22/2014,1293,0,0,3456,0,0,4749
23687,RM-1208,5/22/2014,1293,3456,0,0,0,0,4749
44462,RM-B250,5/22/2014,0,1728,1293,1728,0,0,4749
7485,RM-1116,7/15/2013,0,0,2373,0,0,2373,4746
36808,RM-B200C,7/15/2013,0,0,2373,0,0,2373,4746
40245,RM-B224,7/15/2013,0,0,2373,0,0,2373,4746
8173,RM-1117,7/15/2013,2370,0,0,0,0,2373,4743
18710,RM-1155,7/15/2013,2370,0,2373,0,0,0,4743
30466,RM-1229,3/15/2014,0,0,1287,3456,0,0,4743
32263,RM-1236,7/15/2013,2370,0,2373,0,0,0,4743
38184,RM-B215,7/15/2013,2370,0,0,0,0,2373,4743
44164,RM-B250,7/15/2013,2370,0,0,0,0,2373,4743
36322,RM-B200B,2/8/2014,0,3456,0,0,0,1284,4740
44464,RM-B250,5/24/2014,0,1728,1281,1728,0,0,4737
17637,RM-1151,5/24/2014,1278,0,0,3456,0,0,4734
23689,RM-1208,5/24/2014,1278,3456,0,0,0,0,4734
44459,RM-B250,5/19/2014,0,1728,1275,1728,0,0,4731
17634,RM-1151,5/21/2014,1272,0,0,3456,0,0,4728
23686,RM-1208,5/21/2014,1272,3456,0,0,0,0,4728
44461,RM-B250,5/21/2014,0,1728,1272,1728,0,0,4728
17632,RM-1151,5/19/2014,1269,0,0,3456,0,0,4725
23684,RM-1208,5/19/2014,1269,3456,0,0,0,0,4725
7489,RM-1116,7/20/2013,0,0,2361,0,0,2358,4719
18714,RM-1155,7/20/2013,2358,0,2361,0,0,0,4719
32267,RM-1236,7/20/2013,2358,0,2361,0,0,0,4719
36812,RM-B200C,7/20/2013,0,0,2361,0,0,2358,4719
40249,RM-B224,7/20/2013,0,0,2361,0,0,2358,4719
8177,RM-1117,7/20/2013,2358,0,0,0,0,2358,4716
8380,RM-1117,2/20/2014,0,1728,1260,1728,0,0,4716
30443,RM-1229,2/20/2014,0,0,1260,3456,0,0,4716
38188,RM-B215,7/20/2013,2358,0,0,0,0,2358,4716
44168,RM-B250,7/20/2013,2358,0,0,0,0,2358,4716
30467,RM-1229,3/16/2014,0,0,1257,3456,0,0,4713
17609,RM-1151,4/26/2014,1254,0,0,3456,0,0,4710
23661,RM-1208,4/26/2014,1254,3456,0,0,0,0,4710
30508,RM-1229,4/26/2014,0,0,1254,3456,0,0,4710
44436,RM-B250,4/26/2014,0,1728,1254,1728,0,0,4710
8401,RM-1117,3/13/2014,0,1728,1392,1578,0,0,4698
13025,RM-1132,2/5/2014,0,0,1485,1728,0,1482,4695
35083,RM-B103A,2/5/2014,1482,0,0,1728,0,1482,4692
8374,RM-1117,2/14/2014,0,1728,1233,1728,0,0,4689
17638,RM-1151,5/25/2014,1233,0,0,3456,0,0,4689
23690,RM-1208,5/25/2014,1233,3456,0,0,0,0,4689
44465,RM-B250,5/25/2014,0,1728,1233,1728,0,0,4689
30465,RM-1229,3/14/2014,0,0,1230,3456,0,0,4686
35140,RM-B103A,4/3/2014,1221,0,0,3456,0,0,4677
23638,RM-1208,4/3/2014,1218,3456,0,0,0,0,4674
30485,RM-1229,4/3/2014,0,0,1218,3456,0,0,4674
44463,RM-B250,5/23/2014,0,1728,1218,1728,0,0,4674
30468,RM-1229,3/17/2014,0,0,1212,3456,0,0,4668
18706,RM-1155,7/11/2013,2331,0,2331,0,0,0,4662
32259,RM-1236,7/11/2013,2331,0,2331,0,0,0,4662
7481,RM-1116,7/11/2013,0,0,2331,0,0,2328,4659
8169,RM-1117,7/11/2013,2331,0,0,0,0,2328,4659
30474,RM-1229,3/23/2014,0,0,1203,3456,0,0,4659
36804,RM-B200C,7/11/2013,0,0,2331,0,0,2328,4659
40241,RM-B224,7/11/2013,0,0,2331,0,0,2328,4659
44160,RM-B250,7/11/2013,2331,0,0,0,0,2328,4659
17610,RM-1151,4/27/2014,1200,0,0,3456,0,0,4656
23662,RM-1208,4/27/2014,1200,3456,0,0,0,0,4656
30509,RM-1229,4/27/2014,0,0,1200,3456,0,0,4656
44437,RM-B250,4/27/2014,0,1728,1200,1728,0,0,4656
8375,RM-1117,2/15/2014,0,1728,1197,1728,0,0,4653
30438,RM-1229,2/15/2014,0,0,1197,3456,0,0,4653
17636,RM-1151,5/23/2014,1191,0,0,3456,0,0,4647
24413,RM-1208B,6/29/2014,1458,0,1467,1722,0,0,4647
23688,RM-1208,5/23/2014,1188,3456,0,0,0,0,4644
8381,RM-1117,2/21/2014,0,1728,1176,1728,0,0,4632
30444,RM-1229,2/21/2014,0,0,1176,3456,0,0,4632
23639,RM-1208,4/4/2014,1170,3456,0,0,0,0,4626
30486,RM-1229,4/4/2014,0,0,1170,3456,0,0,4626
44414,RM-B250,4/4/2014,0,1728,1170,1728,0,0,4626
35141,RM-B103A,4/4/2014,1167,0,0,3456,0,0,4623
30475,RM-1229,3/24/2014,0,0,1161,3456,0,0,4617
8376,RM-1117,2/16/2014,0,1728,1158,1728,0,0,4614
17611,RM-1151,4/28/2014,1158,0,0,3456,0,0,4614
30439,RM-1229,2/16/2014,0,0,1158,3456,0,0,4614
23663,RM-1208,4/28/2014,1155,3456,0,0,0,0,4611
30473,RM-1229,3/22/2014,0,0,1155,3456,0,0,4611
30510,RM-1229,4/28/2014,0,0,1155,3456,0,0,4611
44438,RM-B250,4/28/2014,0,1728,1155,1728,0,0,4611
13030,RM-1132,2/10/2014,0,0,1440,1728,0,1440,4608
35088,RM-B103A,2/10/2014,1440,0,0,1728,0,1440,4608
8382,RM-1117,2/22/2014,0,1728,1149,1728,0,0,4605
17642,RM-1151,5/29/2014,1149,0,0,3456,0,0,4605
23694,RM-1208,5/29/2014,1149,3456,0,0,0,0,4605
30445,RM-1229,2/22/2014,0,0,1149,3456,0,0,4605
44469,RM-B250,5/29/2014,0,1728,1149,1728,0,0,4605
7490,RM-1116,7/21/2013,0,0,2301,0,0,2301,4602
8178,RM-1117,7/21/2013,2301,0,0,0,0,2301,4602
17639,RM-1151,5/26/2014,1146,0,0,3456,0,0,4602
17643,RM-1151,5/30/2014,1146,0,0,3456,0,0,4602
18715,RM-1155,7/21/2013,2301,0,2301,0,0,0,4602
23640,RM-1208,4/5/2014,1146,3456,0,0,0,0,4602
23691,RM-1208,5/26/2014,1146,3456,0,0,0,0,4602
23695,RM-1208,5/30/2014,1146,3456,0,0,0,0,4602
30469,RM-1229,3/18/2014,0,0,1146,3456,0,0,4602
32268,RM-1236,7/21/2013,2301,0,2301,0,0,0,4602
35142,RM-B103A,4/5/2014,1146,0,0,3456,0,0,4602
36813,RM-B200C,7/21/2013,0,0,2301,0,0,2301,4602
38189,RM-B215,7/21/2013,2301,0,0,0,0,2301,4602
40250,RM-B224,7/21/2013,0,0,2301,0,0,2301,4602
44169,RM-B250,7/21/2013,2301,0,0,0,0,2301,4602
44466,RM-B250,5/26/2014,0,1728,1146,1728,0,0,4602
44470,RM-B250,5/30/2014,0,1728,1146,1728,0,0,4602
30487,RM-1229,4/5/2014,0,0,1143,3456,0,0,4599
44415,RM-B250,4/5/2014,0,1728,1143,1728,0,0,4599
8383,RM-1117,2/23/2014,0,1728,1131,1728,0,0,4587
30446,RM-1229,2/23/2014,0,0,1131,3456,0,0,4587
17640,RM-1151,5/27/2014,1128,0,0,3456,0,0,4584
44467,RM-B250,5/27/2014,0,1728,1128,1728,0,0,4584
17644,RM-1151,5/31/2014,1125,0,0,3456,0,0,4581
23696,RM-1208,5/31/2014,1125,3456,0,0,0,0,4581
17613,RM-1151,4/30/2014,1122,0,0,3456,0,0,4578
17647,RM-1151,6/3/2014,1122,0,0,3456,0,0,4578
23665,RM-1208,4/30/2014,1122,3456,0,0,0,0,4578
23692,RM-1208,5/27/2014,1122,3456,0,0,0,0,4578
23699,RM-1208,6/3/2014,1122,3456,0,0,0,0,4578
44440,RM-B250,4/30/2014,0,1728,1122,1728,0,0,4578
44471,RM-B250,5/31/2014,0,1728,1122,1728,0,0,4578
44474,RM-B250,6/3/2014,0,1728,1122,1728,0,0,4578
23634,RM-1208,3/30/2014,1116,3456,0,0,0,0,4572
35136,RM-B103A,3/30/2014,1116,0,0,3456,0,0,4572
30481,RM-1229,3/30/2014,0,0,1113,3456,0,0,4569
8377,RM-1117,2/17/2014,0,1728,1107,1728,0,0,4563
30440,RM-1229,2/17/2014,0,0,1107,3456,0,0,4563
13026,RM-1132,2/6/2014,0,0,1416,1728,0,1416,4560
35084,RM-B103A,2/6/2014,1416,0,0,1728,0,1416,4560
17614,RM-1151,5/1/2014,1095,0,0,3456,0,0,4551
23666,RM-1208,5/1/2014,1095,3456,0,0,0,0,4551
44441,RM-B250,5/1/2014,0,1728,1095,1728,0,0,4551
30477,RM-1229,3/26/2014,0,0,1092,3456,0,0,4548
30488,RM-1229,4/6/2014,0,0,1089,3456,0,0,4545
44416,RM-B250,4/6/2014,0,1728,1089,1728,0,0,4545
23641,RM-1208,4/6/2014,1086,3456,0,0,0,0,4542
35143,RM-B103A,4/6/2014,1086,0,0,3456,0,0,4542
17645,RM-1151,6/1/2014,1083,0,0,3456,0,0,4539
23697,RM-1208,6/1/2014,1083,3456,0,0,0,0,4539
44472,RM-B250,6/1/2014,0,1728,1083,1728,0,0,4539
44473,RM-B250,6/2/2014,0,1728,1083,1728,0,0,4539
17646,RM-1151,6/2/2014,1080,0,0,3456,0,0,4536
23698,RM-1208,6/2/2014,1080,3456,0,0,0,0,4536
8384,RM-1117,2/24/2014,0,1728,1077,1728,0,0,4533
30447,RM-1229,2/24/2014,0,0,1077,3456,0,0,4533
8378,RM-1117,2/18/2014,0,1728,1068,1728,0,0,4524
30441,RM-1229,2/18/2014,0,0,1068,3456,0,0,4524
8400,RM-1117,3/12/2014,0,1728,1062,1728,0,0,4518
30463,RM-1229,3/12/2014,0,0,1062,3456,0,0,4518
8390,RM-1117,3/2/2014,0,1722,1071,1722,0,0,4515
17615,RM-1151,5/2/2014,1059,0,0,3456,0,0,4515
23642,RM-1208,4/7/2014,1059,3456,0,0,0,0,4515
23667,RM-1208,5/2/2014,1059,3456,0,0,0,0,4515
30453,RM-1229,3/2/2014,0,0,1071,3444,0,0,4515
35119,RM-B103A,3/13/2014,1395,0,0,1728,0,1392,4515
35144,RM-B103A,4/7/2014,1059,0,0,3456,0,0,4515
41846,RM-B230,3/13/2014,1395,1728,1392,0,0,0,4515
44442,RM-B250,5/2/2014,0,1728,1059,1728,0,0,4515
7584,RM-1116,11/1/2013,1503,0,1506,0,0,1503,4512
13061,RM-1132,3/13/2014,0,0,1392,1728,0,1392,4512
30489,RM-1229,4/7/2014,0,0,1056,3456,0,0,4512
36907,RM-B200C,11/1/2013,1503,0,1506,0,0,1503,4512
44417,RM-B250,4/7/2014,0,1728,1056,1728,0,0,4512
8389,RM-1117,3/1/2014,0,1728,1050,1728,0,0,4506
30452,RM-1229,3/1/2014,0,0,1050,3456,0,0,4506
30490,RM-1229,4/8/2014,0,0,1050,3456,0,0,4506
44418,RM-B250,4/8/2014,0,1728,1050,1728,0,0,4506
17641,RM-1151,5/28/2014,1047,0,0,3456,0,0,4503
23643,RM-1208,4/8/2014,1047,3456,0,0,0,0,4503
23693,RM-1208,5/28/2014,1047,3456,0,0,0,0,4503
30496,RM-1229,4/14/2014,0,0,1047,3456,0,0,4503
35145,RM-B103A,4/8/2014,1047,0,0,3456,0,0,4503
35151,RM-B103A,4/14/2014,1047,0,0,3456,0,0,4503
35152,RM-B103A,4/15/2014,1047,0,0,3456,0,0,4503
44424,RM-B250,4/14/2014,0,1728,1047,1728,0,0,4503
44468,RM-B250,5/28/2014,0,1728,1047,1728,0,0,4503
17648,RM-1151,6/4/2014,1044,0,0,3456,0,0,4500
23649,RM-1208,4/14/2014,1044,3456,0,0,0,0,4500
23650,RM-1208,4/15/2014,1044,3456,0,0,0,0,4500
30497,RM-1229,4/15/2014,0,0,1044,3456,0,0,4500
44425,RM-B250,4/15/2014,0,1728,1044,1728,0,0,4500
44475,RM-B250,6/4/2014,0,1728,1041,1728,0,0,4497
8385,RM-1117,2/25/2014,0,1728,1035,1728,0,0,4491
30448,RM-1229,2/25/2014,0,0,1035,3456,0,0,4491
30476,RM-1229,3/25/2014,0,0,1032,3456,0,0,4488
30478,RM-1229,3/27/2014,0,0,1080,3408,0,0,4488
8386,RM-1117,2/26/2014,0,1728,1029,1728,0,0,4485
8393,RM-1117,3/5/2014,0,1728,1029,1728,0,0,4485
30449,RM-1229,2/26/2014,0,0,1029,3456,0,0,4485
30456,RM-1229,3/5/2014,0,0,1029,3456,0,0,4485
30472,RM-1229,3/21/2014,0,0,1029,3456,0,0,4485
17616,RM-1151,5/3/2014,1026,0,0,3456,0,0,4482
23668,RM-1208,5/3/2014,1026,3456,0,0,0,0,4482
44443,RM-B250,5/3/2014,0,1728,1026,1728,0,0,4482
8379,RM-1117,2/19/2014,0,1728,1023,1728,0,0,4479
30442,RM-1229,2/19/2014,0,0,1023,3456,0,0,4479
23651,RM-1208,4/16/2014,1020,3456,0,0,0,0,4476
30498,RM-1229,4/16/2014,0,0,1020,3456,0,0,4476
35153,RM-B103A,4/16/2014,1020,0,0,3456,0,0,4476
44426,RM-B250,4/16/2014,0,1728,1020,1728,0,0,4476
8391,RM-1117,3/3/2014,0,1716,1035,1716,0,0,4467
23644,RM-1208,4/9/2014,1011,3456,0,0,0,0,4467
30454,RM-1229,3/3/2014,0,0,1035,3432,0,0,4467
30491,RM-1229,4/9/2014,0,0,1011,3456,0,0,4467
35146,RM-B103A,4/9/2014,1011,0,0,3456,0,0,4467
44419,RM-B250,4/9/2014,0,1728,1011,1728,0,0,4467
21627,RM-1200C,3/24/2014,0,1728,0,2736,0,0,4464
17617,RM-1151,5/4/2014,996,0,0,3456,0,0,4452
17630,RM-1151,5/17/2014,1164,0,0,3288,0,0,4452
23652,RM-1208,4/17/2014,996,3456,0,0,0,0,4452
23669,RM-1208,5/4/2014,996,3456,0,0,0,0,4452
30499,RM-1229,4/17/2014,0,0,996,3456,0,0,4452
44427,RM-B250,4/17/2014,0,1728,996,1728,0,0,4452
44444,RM-B250,5/4/2014,0,1728,996,1728,0,0,4452
8387,RM-1117,2/27/2014,0,1728,993,1728,0,0,4449
30450,RM-1229,2/27/2014,0,0,993,3456,0,0,4449
35154,RM-B103A,4/17/2014,993,0,0,3456,0,0,4449
17608,RM-1151,4/25/2014,990,0,0,3456,0,0,4446
23660,RM-1208,4/25/2014,990,3456,0,0,0,0,4446
23664,RM-1208,4/29/2014,990,3456,0,0,0,0,4446
30507,RM-1229,4/25/2014,0,0,990,3456,0,0,4446
30511,RM-1229,4/29/2014,0,0,990,3456,0,0,4446
44435,RM-B250,4/25/2014,0,1728,990,1728,0,0,4446
44439,RM-B250,4/29/2014,0,1728,990,1728,0,0,4446
17612,RM-1151,4/29/2014,987,0,0,3456,0,0,4443
44457,RM-B250,5/17/2014,0,1632,1185,1626,0,0,4443
8392,RM-1117,3/4/2014,0,1728,984,1728,0,0,4440
23682,RM-1208,5/17/2014,1164,3276,0,0,0,0,4440
30455,RM-1229,3/4/2014,0,0,984,3456,0,0,4440
30512,RM-1229,4/30/2014,0,0,1122,3300,0,0,4422
23653,RM-1208,4/18/2014,963,3456,0,0,0,0,4419
35155,RM-B103A,4/18/2014,963,0,0,3456,0,0,4419
30500,RM-1229,4/18/2014,0,0,960,3456,0,0,4416
44428,RM-B250,4/18/2014,0,1728,960,1728,0,0,4416
23645,RM-1208,4/10/2014,957,3456,0,0,0,0,4413
35147,RM-B103A,4/10/2014,957,0,0,3456,0,0,4413
30492,RM-1229,4/10/2014,0,0,954,3456,0,0,4410
44420,RM-B250,4/10/2014,0,1728,954,1728,0,0,4410
8395,RM-1117,3/7/2014,0,1728,951,1728,0,0,4407
30458,RM-1229,3/7/2014,0,0,951,3456,0,0,4407
24371,RM-1208B,5/18/2014,1338,0,1338,1728,0,0,4404
24373,RM-1208B,5/20/2014,1335,0,1335,1728,0,0,4398
30493,RM-1229,4/11/2014,0,0,942,3456,0,0,4398
35148,RM-B103A,4/11/2014,942,0,0,3456,0,0,4398
44421,RM-B250,4/11/2014,0,1728,942,1728,0,0,4398
23646,RM-1208,4/11/2014,939,3456,0,0,0,0,4395
30495,RM-1229,4/13/2014,0,0,933,3456,0,0,4389
44423,RM-B250,4/13/2014,0,1728,933,1728,0,0,4389
23648,RM-1208,4/13/2014,930,3456,0,0,0,0,4386
30470,RM-1229,3/19/2014,0,0,930,3456,0,0,4386
35150,RM-B103A,4/13/2014,930,0,0,3456,0,0,4386
30290,RM-1229,9/17/2013,1452,0,1473,0,0,1458,4383
23654,RM-1208,4/19/2014,918,3456,0,0,0,0,4374
30501,RM-1229,4/19/2014,0,0,918,3456,0,0,4374
35156,RM-B103A,4/19/2014,918,0,0,3456,0,0,4374
44429,RM-B250,4/19/2014,0,1728,918,1728,0,0,4374
7583,RM-1116,10/31/2013,1458,0,1455,0,0,1455,4368
36906,RM-B200C,10/31/2013,1455,0,1455,0,0,1455,4365
23647,RM-1208,4/12/2014,903,3456,0,0,0,0,4359
30494,RM-1229,4/12/2014,0,0,900,3456,0,0,4356
35149,RM-B103A,4/12/2014,900,0,0,3456,0,0,4356
44422,RM-B250,4/12/2014,0,1728,900,1728,0,0,4356
30502,RM-1229,4/20/2014,0,0,894,3456,0,0,4350
44430,RM-B250,4/20/2014,0,1728,894,1728,0,0,4350
23655,RM-1208,4/20/2014,891,3456,0,0,0,0,4347
13027,RM-1132,2/7/2014,0,0,1308,1722,0,1308,4338
13029,RM-1132,2/9/2014,0,0,1305,1728,0,1305,4338
35085,RM-B103A,2/7/2014,1308,0,0,1722,0,1308,4338
35087,RM-B103A,2/9/2014,1305,0,0,1728,0,1305,4338
8397,RM-1117,3/9/2014,0,1698,933,1698,0,0,4329
30460,RM-1229,3/9/2014,0,0,933,3396,0,0,4329
8396,RM-1117,3/8/2014,0,1686,954,1686,0,0,4326
30459,RM-1229,3/8/2014,0,0,954,3372,0,0,4326
23656,RM-1208,4/21/2014,867,3456,0,0,0,0,4323
30503,RM-1229,4/21/2014,0,0,867,3456,0,0,4323
44431,RM-B250,4/21/2014,0,1728,867,1728,0,0,4323
23657,RM-1208,4/22/2014,864,3456,0,0,0,0,4320
30504,RM-1229,4/22/2014,0,0,864,3456,0,0,4320
44432,RM-B250,4/22/2014,0,1728,864,1728,0,0,4320
8399,RM-1117,3/11/2014,0,1728,861,1728,0,0,4317
30462,RM-1229,3/11/2014,0,0,861,3456,0,0,4317
44501,RM-B250,6/30/2014,0,1728,861,1728,0,0,4317
24375,RM-1208B,5/22/2014,1293,0,1293,1728,0,0,4314
29721,RM-1224,1/17/2014,0,864,0,3450,0,0,4314
13170,RM-1132,6/30/2014,0,0,855,3456,0,0,4311
17674,RM-1151,6/30/2014,855,0,0,3456,0,0,4311
35120,RM-B103A,3/14/2014,1218,0,0,1872,0,1218,4308
13063,RM-1132,3/15/2014,0,0,1287,1728,0,1290,4305
41848,RM-B230,3/15/2014,1290,1728,1287,0,0,0,4305
17606,RM-1151,4/23/2014,843,0,0,3456,0,0,4299
23658,RM-1208,4/23/2014,843,3456,0,0,0,0,4299
30505,RM-1229,4/23/2014,0,0,843,3456,0,0,4299
44433,RM-B250,4/23/2014,0,1728,843,1728,0,0,4299
8394,RM-1117,3/6/2014,0,1728,840,1728,0,0,4296
13028,RM-1132,2/8/2014,0,0,1284,1728,0,1284,4296
30457,RM-1229,3/6/2014,0,0,840,3456,0,0,4296
35086,RM-B103A,2/8/2014,1284,0,0,1728,0,1284,4296
8357,RM-1117,1/28/2014,0,1716,861,1716,0,0,4293
36312,RM-B200B,1/29/2014,0,3456,0,0,0,837,4293
17649,RM-1151,6/5/2014,834,0,0,3456,0,0,4290
36311,RM-B200B,1/28/2014,0,3432,0,0,0,858,4290
24377,RM-1208B,5/24/2014,1278,0,1281,1728,0,0,4287
44476,RM-B250,6/5/2014,0,1728,837,1722,0,0,4287
23637,RM-1208,4/2/2014,1062,3216,0,0,0,0,4278
30483,RM-1229,4/1/2014,0,0,822,3456,0,0,4278
30484,RM-1229,4/2/2014,0,0,1062,3216,0,0,4278
35139,RM-B103A,4/2/2014,1062,0,0,3216,0,0,4278
8388,RM-1117,2/28/2014,0,1728,819,1728,0,0,4275
30451,RM-1229,2/28/2014,0,0,819,3456,0,0,4275
23636,RM-1208,4/1/2014,816,3456,0,0,0,0,4272
24372,RM-1208B,5/19/2014,1269,0,1275,1728,0,0,4272
24374,RM-1208B,5/21/2014,1272,0,1272,1728,0,0,4272
35138,RM-B103A,4/1/2014,816,0,0,3456,0,0,4272
13033,RM-1132,2/13/2014,0,0,1275,1716,0,1275,4266
35091,RM-B103A,2/13/2014,1275,0,0,1716,0,1275,4266
17605,RM-1151,4/22/2014,864,0,0,3390,0,0,4254
8398,RM-1117,3/10/2014,0,1716,819,1716,0,0,4251
13040,RM-1132,2/20/2014,0,0,1260,1728,0,1263,4251
18917,RM-1155,2/20/2014,1260,0,0,1728,0,1263,4251
30461,RM-1229,3/10/2014,0,0,819,3432,0,0,4251
35098,RM-B103A,2/20/2014,1260,0,0,1728,0,1263,4251
41825,RM-B230,2/20/2014,1260,1728,1260,0,0,0,4248
13064,RM-1132,3/16/2014,0,0,1257,1728,0,1257,4242
41849,RM-B230,3/16/2014,1257,1728,1257,0,0,0,4242
17650,RM-1151,6/6/2014,783,0,0,3456,0,0,4239
17607,RM-1151,4/24/2014,780,0,0,3456,0,0,4236
23659,RM-1208,4/24/2014,780,3456,0,0,0,0,4236
24349,RM-1208B,4/26/2014,1254,0,1254,1728,0,0,4236
30506,RM-1229,4/24/2014,0,0,780,3456,0,0,4236
44434,RM-B250,4/24/2014,0,1728,780,1728,0,0,4236
44477,RM-B250,6/6/2014,0,1728,780,1728,0,0,4236
13032,RM-1132,2/12/2014,0,0,1254,1722,0,1254,4230
35090,RM-B103A,2/12/2014,1254,0,0,1722,0,1254,4230
30294,RM-1229,9/21/2013,1404,0,1404,0,0,1404,4212
30482,RM-1229,3/31/2014,0,0,750,3456,0,0,4206
23635,RM-1208,3/31/2014,747,3456,0,0,0,0,4203
35137,RM-B103A,3/31/2014,747,0,0,3456,0,0,4203
24378,RM-1208B,5/25/2014,1233,0,1233,1728,0,0,4194
13034,RM-1132,2/14/2014,0,0,1230,1728,0,1230,4188
35092,RM-B103A,2/14/2014,1230,0,0,1728,0,1230,4188
41847,RM-B230,3/14/2014,1218,1728,1230,0,0,0,4176
13062,RM-1132,3/14/2014,0,0,1221,1728,0,1218,4167
24326,RM-1208B,4/3/2014,1221,0,1218,1728,0,0,4167
30479,RM-1229,3/28/2014,0,0,711,3456,0,0,4167
13065,RM-1132,3/17/2014,0,0,1212,1728,0,1209,4149
41850,RM-B230,3/17/2014,1209,1728,1212,0,0,0,4149
30293,RM-1229,9/20/2013,1383,0,1383,0,0,1380,4146
30285,RM-1229,9/12/2013,1380,0,1383,0,0,1380,4143
36315,RM-B200B,2/1/2014,0,3396,0,0,0,747,4143
24376,RM-1208B,5/23/2014,1191,0,1218,1728,0,0,4137
13071,RM-1132,3/23/2014,0,0,1203,1728,0,1203,4134
30295,RM-1229,9/22/2013,1377,0,1377,0,0,1380,4134
41856,RM-B230,3/23/2014,1203,1728,1203,0,0,0,4134
24350,RM-1208B,4/27/2014,1200,0,1200,1728,0,0,4128
13035,RM-1132,2/15/2014,0,0,1197,1728,0,1200,4125
35093,RM-B103A,2/15/2014,1197,0,0,1728,0,1200,4125
8373,RM-1117,2/13/2014,0,1134,1272,1716,0,0,4122
35157,RM-B103A,4/20/2014,891,0,0,3228,0,0,4119
17653,RM-1151,6/9/2014,654,0,0,3456,0,0,4110
44480,RM-B250,6/9/2014,0,1728,654,1728,0,0,4110
36313,RM-B200B,1/30/2014,0,3432,0,0,0,666,4098
18918,RM-1155,2/21/2014,1179,0,0,1728,0,1176,4083
35099,RM-B103A,2/21/2014,1179,0,0,1728,0,1176,4083
41826,RM-B230,2/21/2014,1179,1728,1176,0,0,0,4083
13041,RM-1132,2/21/2014,0,0,1176,1728,0,1176,4080
44478,RM-B250,6/7/2014,0,1728,615,1728,0,0,4071
24327,RM-1208B,4/4/2014,1167,0,1170,1728,0,0,4065
17651,RM-1151,6/7/2014,600,0,0,3456,0,0,4056
44481,RM-B250,6/10/2014,0,1728,594,1728,0,0,4050
7576,RM-1116,10/24/2013,1347,0,1350,0,0,1350,4047
13072,RM-1132,3/24/2014,0,0,1161,1728,0,1158,4047
30327,RM-1229,10/24/2013,1347,0,1350,0,0,1350,4047
36899,RM-B200C,10/24/2013,1347,0,1350,0,0,1350,4047
41857,RM-B230,3/24/2014,1158,1728,1161,0,0,0,4047
17654,RM-1151,6/10/2014,588,0,0,3456,0,0,4044
13036,RM-1132,2/16/2014,0,0,1158,1728,0,1155,4041
13070,RM-1132,3/22/2014,0,0,1155,1728,0,1158,4041
17618,RM-1151,5/5/2014,885,0,0,3156,0,0,4041
23670,RM-1208,5/5/2014,885,3156,0,0,0,0,4041
24351,RM-1208B,4/28/2014,1158,0,1155,1728,0,0,4041
35094,RM-B103A,2/16/2014,1158,0,0,1728,0,1155,4041
41855,RM-B230,3/22/2014,1158,1728,1155,0,0,0,4041
44445,RM-B250,5/5/2014,0,1572,885,1572,0,0,4029
13042,RM-1132,2/22/2014,0,0,1149,1728,0,1149,4026
24382,RM-1208B,5/29/2014,1149,0,1149,1728,0,0,4026
18919,RM-1155,2/22/2014,1146,0,0,1728,0,1149,4023
35100,RM-B103A,2/22/2014,1146,0,0,1728,0,1149,4023
41827,RM-B230,2/22/2014,1146,1728,1149,0,0,0,4023
13066,RM-1132,3/18/2014,0,0,1146,1728,0,1146,4020
23562,RM-1208,1/17/2014,285,3450,0,0,0,285,4020
24379,RM-1208B,5/26/2014,1146,0,1146,1728,0,0,4020
24383,RM-1208B,5/30/2014,1146,0,1146,1728,0,0,4020
30296,RM-1229,9/23/2013,1341,0,1341,0,0,1338,4020
41851,RM-B230,3/18/2014,1146,1728,1146,0,0,0,4020
24328,RM-1208B,4/5/2014,1146,0,1143,1728,0,0,4017
13023,RM-1132,2/3/2014,0,0,1563,1728,0,717,4008
35126,RM-B103A,3/20/2014,273,0,0,3456,0,273,4002
23624,RM-1208,3/20/2014,270,3456,0,0,0,273,3999
24316,RM-1208B,3/24/2014,1110,0,1161,1728,0,0,3999
13043,RM-1132,2/23/2014,0,0,1134,1728,0,1131,3993
23563,RM-1208,1/18/2014,285,3420,0,0,0,288,3993
35101,RM-B103A,2/23/2014,1134,0,0,1728,0,1131,3993
41828,RM-B230,2/23/2014,1134,1728,1131,0,0,0,3993
23564,RM-1208,1/19/2014,267,3456,0,0,0,264,3987
44479,RM-B250,6/8/2014,0,1728,531,1728,0,0,3987
24380,RM-1208B,5/27/2014,1128,0,1128,1728,0,0,3984
17652,RM-1151,6/8/2014,525,0,0,3456,0,0,3981
24370,RM-1208B,5/17/2014,1167,0,1185,1626,0,0,3978
24384,RM-1208B,5/31/2014,1125,0,1122,1728,0,0,3975
24353,RM-1208B,4/30/2014,1122,0,1122,1728,0,0,3972
24387,RM-1208B,6/3/2014,1122,0,1122,1728,0,0,3972
30421,RM-1229,1/29/2014,0,0,837,2292,0,837,3966
7574,RM-1116,10/22/2013,1320,0,1320,0,0,1320,3960
30325,RM-1229,10/22/2013,1320,0,1320,0,0,1320,3960
36897,RM-B200C,10/22/2013,1320,0,1320,0,0,1320,3960
24322,RM-1208B,3/30/2014,1116,0,1113,1728,0,0,3957
44482,RM-B250,6/11/2014,0,1722,504,1722,0,0,3948
13037,RM-1132,2/17/2014,0,0,1107,1728,0,1107,3942
17655,RM-1151,6/11/2014,498,0,0,3444,0,0,3942
23565,RM-1208,1/20/2014,249,3444,0,0,0,249,3942
35095,RM-B103A,2/17/2014,1107,0,0,1728,0,1107,3942
41822,RM-B230,2/17/2014,1107,1728,1107,0,0,0,3942
18898,RM-1155,2/1/2014,747,0,747,1698,0,747,3939
23568,RM-1208,1/23/2014,240,3456,0,0,0,243,3939
24354,RM-1208B,5/1/2014,1095,0,1095,1728,0,0,3918
44483,RM-B250,6/12/2014,0,1728,459,1728,0,0,3915
17656,RM-1151,6/12/2014,456,0,0,3456,0,0,3912
24318,RM-1208B,3/26/2014,1092,0,1092,1728,0,0,3912
41859,RM-B230,3/26/2014,1092,1728,1092,0,0,0,3912
13074,RM-1132,3/26/2014,0,0,1092,1728,0,1089,3909
30297,RM-1229,9/24/2013,1302,0,1302,0,0,1302,3906
24329,RM-1208B,4/6/2014,1086,0,1089,1728,0,0,3903
7510,RM-1116,8/10/2013,0,0,1950,0,0,1950,3900
8198,RM-1117,8/10/2013,1950,0,0,0,0,1950,3900
18735,RM-1155,8/10/2013,1950,0,1950,0,0,0,3900
30261,RM-1229,8/10/2013,1950,0,1950,0,0,0,3900
32288,RM-1236,8/10/2013,1950,0,1950,0,0,0,3900
36833,RM-B200C,8/10/2013,0,0,1950,0,0,1950,3900
38209,RM-B215,8/10/2013,1950,0,0,0,0,1950,3900
39582,RM-B222,8/10/2013,1950,0,1950,0,0,0,3900
40270,RM-B224,8/10/2013,0,0,1950,0,0,1950,3900
44189,RM-B250,8/10/2013,1950,0,0,0,0,1950,3900
23414,RM-1208,8/10/2013,1950,0,0,0,0,1947,3897
23569,RM-1208,1/24/2014,219,3456,0,0,0,219,3894
24385,RM-1208B,6/1/2014,1083,0,1083,1728,0,0,3894
24386,RM-1208B,6/2/2014,1080,0,1083,1728,0,0,3891
41829,RM-B230,2/24/2014,1074,1728,1077,0,0,0,3879
13044,RM-1132,2/24/2014,0,0,1074,1728,0,1074,3876
35102,RM-B103A,2/24/2014,1074,0,0,1728,0,1074,3876
13038,RM-1132,2/18/2014,0,0,1068,1728,0,1068,3864
13050,RM-1132,3/2/2014,0,0,1071,1722,0,1071,3864
13075,RM-1132,3/27/2014,0,0,1080,1704,0,1080,3864
18915,RM-1155,2/18/2014,1068,0,0,1728,0,1068,3864
24319,RM-1208B,3/27/2014,1080,0,1080,1704,0,0,3864
35096,RM-B103A,2/18/2014,1068,0,0,1728,0,1068,3864
35108,RM-B103A,3/2/2014,1071,0,0,1722,0,1071,3864
41823,RM-B230,2/18/2014,1068,1728,1068,0,0,0,3864
41835,RM-B230,3/2/2014,1071,1722,1071,0,0,0,3864
41860,RM-B230,3/27/2014,1080,1704,1080,0,0,0,3864
23570,RM-1208,1/25/2014,213,3432,0,0,0,210,3855
8240,RM-1117,9/30/2013,1284,0,1281,0,0,1284,3849
13060,RM-1132,3/12/2014,0,0,1059,1728,0,1062,3849
30303,RM-1229,9/30/2013,1284,0,1281,0,0,1284,3849
35118,RM-B103A,3/12/2014,1059,0,0,1728,0,1062,3849
41845,RM-B230,3/12/2014,1059,1728,1062,0,0,0,3849
24355,RM-1208B,5/2/2014,1059,0,1059,1728,0,0,3846
24330,RM-1208B,4/7/2014,1059,0,1056,1728,0,0,3843
13031,RM-1132,2/11/2014,0,0,1047,1728,0,1065,3840
17658,RM-1151,6/14/2014,384,0,0,3456,0,0,3840
35089,RM-B103A,2/11/2014,1047,0,0,1728,0,1065,3840
44485,RM-B250,6/14/2014,0,1728,384,1728,0,0,3840
44486,RM-B250,6/15/2014,0,1728,378,1728,0,0,3834
7577,RM-1116,10/25/2013,1278,0,1278,0,0,1275,3831
30328,RM-1229,10/25/2013,1278,0,1278,0,0,1275,3831
36900,RM-B200C,10/25/2013,1278,0,1278,0,0,1275,3831
13049,RM-1132,3/1/2014,0,0,1050,1728,0,1050,3828
35107,RM-B103A,3/1/2014,1050,0,0,1728,0,1050,3828
41834,RM-B230,3/1/2014,1050,1728,1050,0,0,0,3828
24331,RM-1208B,4/8/2014,1047,0,1050,1728,0,0,3825
44484,RM-B250,6/13/2014,0,1728,369,1728,0,0,3825
24337,RM-1208B,4/14/2014,1047,0,1047,1728,0,0,3822
24381,RM-1208B,5/28/2014,1047,0,1047,1728,0,0,3822
23567,RM-1208,1/22/2014,219,3384,0,0,0,216,3819
24338,RM-1208B,4/15/2014,1047,0,1044,1728,0,0,3819
7585,RM-1116,11/2/2013,1272,0,1269,0,0,1272,3813
24388,RM-1208B,6/4/2014,1044,0,1041,1728,0,0,3813
36908,RM-B200C,11/2/2013,1272,0,1269,0,0,1272,3813
17659,RM-1151,6/15/2014,354,0,0,3456,0,0,3810
8235,RM-1117,9/25/2013,1269,0,1269,0,0,1269,3807
30298,RM-1229,9/25/2013,1269,0,1269,0,0,1269,3807
30292,RM-1229,9/19/2013,1266,0,1269,0,0,1269,3804
44487,RM-B250,6/16/2014,0,1728,348,1728,0,0,3804
44488,RM-B250,6/17/2014,0,1728,345,1728,0,0,3801
13045,RM-1132,2/25/2014,0,0,1035,1728,0,1035,3798
35103,RM-B103A,2/25/2014,1035,0,0,1728,0,1035,3798
41830,RM-B230,2/25/2014,1035,1728,1035,0,0,0,3798
13073,RM-1132,3/25/2014,0,0,1029,1728,0,1032,3789
24317,RM-1208B,3/25/2014,1029,0,1032,1728,0,0,3789
41858,RM-B230,3/25/2014,1029,1728,1032,0,0,0,3789
44489,RM-B250,6/18/2014,0,1728,333,1728,0,0,3789
13046,RM-1132,2/26/2014,0,0,1029,1728,0,1029,3786
13051,RM-1132,3/3/2014,0,0,1035,1716,0,1035,3786
13053,RM-1132,3/5/2014,0,0,1029,1728,0,1029,3786
17662,RM-1151,6/18/2014,330,0,0,3456,0,0,3786
35104,RM-B103A,2/26/2014,1029,0,0,1728,0,1029,3786
35109,RM-B103A,3/3/2014,1035,0,0,1716,0,1035,3786
35111,RM-B103A,3/5/2014,1029,0,0,1728,0,1029,3786
41831,RM-B230,2/26/2014,1029,1728,1029,0,0,0,3786
41836,RM-B230,3/3/2014,1035,1716,1035,0,0,0,3786
41838,RM-B230,3/5/2014,1029,1728,1029,0,0,0,3786
13069,RM-1132,3/21/2014,0,0,1029,1728,0,1026,3783
17660,RM-1151,6/16/2014,327,0,0,3456,0,0,3783
41854,RM-B230,3/21/2014,1026,1728,1029,0,0,0,3783
17657,RM-1151,6/13/2014,324,0,0,3456,0,0,3780
24356,RM-1208B,5/3/2014,1026,0,1026,1728,0,0,3780
17661,RM-1151,6/17/2014,321,0,0,3456,0,0,3777
23566,RM-1208,1/21/2014,177,3420,0,0,0,180,3777
8241,RM-1117,10/1/2013,1257,0,1260,0,0,1257,3774
18736,RM-1155,8/11/2013,1887,0,1887,0,0,0,3774
23415,RM-1208,8/11/2013,1887,0,0,0,0,1887,3774
30262,RM-1229,8/11/2013,1887,0,1887,0,0,0,3774
30304,RM-1229,10/1/2013,1257,0,1260,0,0,1257,3774
32289,RM-1236,8/11/2013,1887,0,1887,0,0,0,3774
39583,RM-B222,8/11/2013,1887,0,1887,0,0,0,3774
7511,RM-1116,8/11/2013,0,0,1887,0,0,1884,3771
8199,RM-1117,8/11/2013,1887,0,0,0,0,1884,3771
36834,RM-B200C,8/11/2013,0,0,1887,0,0,1884,3771
38210,RM-B215,8/11/2013,1887,0,0,0,0,1884,3771
40271,RM-B224,8/11/2013,0,0,1887,0,0,1884,3771
41824,RM-B230,2/19/2014,1020,1728,1023,0,0,0,3771
44190,RM-B250,8/11/2013,1887,0,0,0,0,1884,3771
13039,RM-1132,2/19/2014,0,0,1020,1728,0,1020,3768
18719,RM-1155,7/25/2013,1884,0,1884,0,0,0,3768
18916,RM-1155,2/19/2014,1020,0,0,1728,0,1020,3768
24339,RM-1208B,4/16/2014,1020,0,1020,1728,0,0,3768
30245,RM-1229,7/25/2013,1884,0,1884,0,0,0,3768
32272,RM-1236,7/25/2013,1884,0,1884,0,0,0,3768
35097,RM-B103A,2/19/2014,1020,0,0,1728,0,1020,3768
39566,RM-B222,7/25/2013,1884,0,1884,0,0,0,3768
7494,RM-1116,7/25/2013,0,0,1884,0,0,1881,3765
7578,RM-1116,10/26/2013,1254,0,1254,0,0,1257,3765
8182,RM-1117,7/25/2013,1884,0,0,0,0,1881,3765
17663,RM-1151,6/19/2014,309,0,0,3456,0,0,3765
30329,RM-1229,10/26/2013,1254,0,1254,0,0,1257,3765
36817,RM-B200C,7/25/2013,0,0,1884,0,0,1881,3765
36901,RM-B200C,10/26/2013,1254,0,1254,0,0,1257,3765
38193,RM-B215,7/25/2013,1884,0,0,0,0,1881,3765
40254,RM-B224,7/25/2013,0,0,1884,0,0,1881,3765
44173,RM-B250,7/25/2013,1884,0,0,0,0,1881,3765
44490,RM-B250,6/19/2014,0,1728,309,1728,0,0,3765
17664,RM-1151,6/20/2014,303,0,0,3456,0,0,3759
36943,RM-B200C,12/10/2013,1248,0,1257,0,0,1251,3756
38319,RM-B215,12/10/2013,1248,0,1257,0,0,1251,3756
44491,RM-B250,6/20/2014,0,1728,300,1728,0,0,3756
24332,RM-1208B,4/9/2014,1011,0,1011,1728,0,0,3750
13160,RM-1132,6/20/2014,0,0,303,3444,0,0,3747
44496,RM-B250,6/25/2014,0,1728,285,1728,0,0,3741
8346,RM-1117,1/17/2014,0,1722,288,1728,0,0,3738
44492,RM-B250,6/21/2014,0,1728,282,1728,0,0,3738
44495,RM-B250,6/24/2014,0,1728,282,1728,0,0,3738
8236,RM-1117,9/26/2013,1245,0,1245,0,0,1245,3735
13161,RM-1132,6/21/2014,0,0,279,3456,0,0,3735
17665,RM-1151,6/21/2014,279,0,0,3456,0,0,3735
30299,RM-1229,9/26/2013,1245,0,1245,0,0,1245,3735
36300,RM-B200B,1/17/2014,0,3450,0,0,0,285,3735
24325,RM-1208B,4/2/2014,1062,0,1062,1608,0,0,3732
13162,RM-1132,6/22/2014,0,0,273,3456,0,0,3729
13164,RM-1132,6/24/2014,0,0,273,3456,0,0,3729
13165,RM-1132,6/25/2014,0,0,273,3456,0,0,3729
17666,RM-1151,6/22/2014,273,0,0,3456,0,0,3729
17668,RM-1151,6/24/2014,273,0,0,3456,0,0,3729
17669,RM-1151,6/25/2014,273,0,0,3456,0,0,3729
30471,RM-1229,3/20/2014,0,0,273,3456,0,0,3729
44493,RM-B250,6/22/2014,0,1728,273,1728,0,0,3729
8348,RM-1117,1/19/2014,0,1728,267,1728,0,0,3723
13163,RM-1132,6/23/2014,0,0,267,3456,0,0,3723
17667,RM-1151,6/23/2014,267,0,0,3456,0,0,3723
36905,RM-B200C,10/30/2013,1242,0,1239,0,0,1242,3723
44494,RM-B250,6/23/2014,0,1728,267,1728,0,0,3723
7582,RM-1116,10/30/2013,1239,0,1239,0,0,1242,3720
24357,RM-1208B,5/4/2014,996,0,996,1728,0,0,3720
36302,RM-B200B,1/19/2014,0,3456,0,0,0,264,3720
8239,RM-1117,9/29/2013,1239,0,1239,0,0,1239,3717
24340,RM-1208B,4/17/2014,993,0,996,1728,0,0,3717
30302,RM-1229,9/29/2013,1239,0,1239,0,0,1239,3717
23571,RM-1208,1/26/2014,135,3444,0,0,0,135,3714
44497,RM-B250,6/26/2014,0,1728,258,1728,0,0,3714
24348,RM-1208B,4/25/2014,990,0,990,1728,0,0,3708
36301,RM-B200B,1/18/2014,0,3420,0,0,0,288,3708
38321,RM-B215,12/12/2013,1236,0,1236,0,0,1236,3708
8347,RM-1117,1/18/2014,0,1710,285,1710,0,0,3705
24352,RM-1208B,4/29/2014,987,0,990,1728,0,0,3705
8237,RM-1117,9/27/2013,1233,0,1233,0,0,1233,3699
30300,RM-1229,9/27/2013,1233,0,1233,0,0,1233,3699
36306,RM-B200B,1/23/2014,0,3456,0,0,0,243,3699
41832,RM-B230,2/27/2014,978,1728,993,0,0,0,3699
8352,RM-1117,1/23/2014,0,1728,240,1728,0,0,3696
13052,RM-1132,3/4/2014,0,0,984,1728,0,984,3696
35110,RM-B103A,3/4/2014,984,0,0,1728,0,984,3696
41837,RM-B230,3/4/2014,984,1728,984,0,0,0,3696
7579,RM-1116,10/27/2013,1233,0,1230,0,0,1230,3693
8349,RM-1117,1/20/2014,0,1722,249,1722,0,0,3693
36303,RM-B200B,1/20/2014,0,3444,0,0,0,249,3693
36902,RM-B200C,10/27/2013,1233,0,1230,0,0,1230,3693
30280,RM-1229,9/6/2013,1230,0,1230,0,0,1230,3690
17670,RM-1151,6/26/2014,231,0,0,3456,0,0,3687
13047,RM-1132,2/27/2014,0,0,978,1728,0,978,3684
13166,RM-1132,6/26/2014,0,0,228,3456,0,0,3684
35105,RM-B103A,2/27/2014,978,0,0,1728,0,978,3684
13171,RM-1132,7/1/2014,0,0,222,3456,0,0,3678
17675,RM-1151,7/1/2014,222,0,0,3456,0,0,3678
8353,RM-1117,1/24/2014,0,1728,219,1728,0,0,3675
36307,RM-B200B,1/24/2014,0,3456,0,0,0,219,3675
36944,RM-B200C,12/11/2013,1224,0,1224,0,0,1224,3672
38320,RM-B215,12/11/2013,1224,0,1224,0,0,1224,3672
44502,RM-B250,7/1/2014,0,1722,225,1722,0,0,3669
7586,RM-1116,11/3/2013,1221,0,1224,0,0,1221,3666
13168,RM-1132,6/28/2014,0,0,210,3456,0,0,3666
17672,RM-1151,6/28/2014,210,0,0,3456,0,0,3666
36909,RM-B200C,11/3/2013,1221,0,1224,0,0,1221,3666
7503,RM-1116,8/3/2013,0,0,1830,0,0,1827,3657
18728,RM-1155,8/3/2013,1827,0,1830,0,0,0,3657
23407,RM-1208,8/3/2013,1830,0,0,0,0,1827,3657
30254,RM-1229,8/3/2013,1827,0,1830,0,0,0,3657
32281,RM-1236,8/3/2013,1827,0,1830,0,0,0,3657
36826,RM-B200C,8/3/2013,0,0,1830,0,0,1827,3657
39575,RM-B222,8/3/2013,1827,0,1830,0,0,0,3657
40263,RM-B224,8/3/2013,0,0,1830,0,0,1827,3657
44499,RM-B250,6/28/2014,0,1722,213,1722,0,0,3657
8191,RM-1117,8/3/2013,1827,0,0,0,0,1827,3654
38202,RM-B215,8/3/2013,1827,0,0,0,0,1827,3654
44182,RM-B250,8/3/2013,1827,0,0,0,0,1827,3654
7587,RM-1116,11/4/2013,1218,0,1215,0,0,1218,3651
24341,RM-1208B,4/18/2014,963,0,960,1728,0,0,3651
36910,RM-B200C,11/4/2013,1218,0,1215,0,0,1218,3651
8354,RM-1117,1/25/2014,0,1716,213,1716,0,0,3645
13167,RM-1132,6/27/2014,0,0,189,3456,0,0,3645
17671,RM-1151,6/27/2014,189,0,0,3456,0,0,3645
44498,RM-B250,6/27/2014,0,1728,189,1728,0,0,3645
24333,RM-1208B,4/10/2014,957,0,954,1728,0,0,3639
23572,RM-1208,1/27/2014,135,3360,0,0,0,138,3633
13055,RM-1132,3/7/2014,0,0,951,1728,0,951,3630
35113,RM-B103A,3/7/2014,951,0,0,1728,0,951,3630
36308,RM-B200B,1/25/2014,0,3420,0,0,0,210,3630
41840,RM-B230,3/7/2014,951,1728,951,0,0,0,3630
7555,RM-1116,10/3/2013,1209,0,1206,0,0,1209,3624
8243,RM-1117,10/3/2013,1209,0,1206,0,0,1209,3624
30306,RM-1229,10/3/2013,1209,0,1206,0,0,1209,3624
41821,RM-B230,2/16/2014,735,1728,1158,0,0,0,3621
8238,RM-1117,9/28/2013,1206,0,1206,0,0,1206,3618
30301,RM-1229,9/28/2013,1206,0,1206,0,0,1206,3618
38329,RM-B215,12/20/2013,1206,0,1206,0,0,1206,3618
24334,RM-1208B,4/11/2014,942,0,942,1728,0,0,3612
8351,RM-1117,1/22/2014,0,1692,219,1692,0,0,3603
36304,RM-B200B,1/21/2014,0,3420,0,0,0,180,3600
8350,RM-1117,1/21/2014,0,1710,177,1710,0,0,3597
13056,RM-1132,3/8/2014,0,0,954,1686,0,954,3594
35114,RM-B103A,3/8/2014,954,0,0,1686,0,954,3594
41841,RM-B230,3/8/2014,954,1686,954,0,0,0,3594
24336,RM-1208B,4/13/2014,930,0,933,1728,0,0,3591
7588,RM-1116,11/5/2013,1194,0,1197,0,0,1194,3585
36911,RM-B200C,11/5/2013,1194,0,1197,0,0,1194,3585
41852,RM-B230,3/19/2014,927,1728,930,0,0,0,3585
2740,RM-1106,8/12/2013,1791,0,0,0,0,1791,3582
7581,RM-1116,10/29/2013,1194,0,1194,0,0,1194,3582
8200,RM-1117,8/12/2013,1791,0,0,0,0,1791,3582
8355,RM-1117,1/26/2014,0,1722,138,1722,0,0,3582
13067,RM-1132,3/19/2014,0,0,927,1728,0,927,3582
23416,RM-1208,8/12/2013,1791,0,0,0,0,1791,3582
36904,RM-B200C,10/29/2013,1194,0,1194,0,0,1194,3582
38211,RM-B215,8/12/2013,1791,0,0,0,0,1791,3582
39584,RM-B222,8/12/2013,1791,0,1791,0,0,0,3582
7512,RM-1116,8/12/2013,0,0,1788,0,0,1791,3579
18737,RM-1155,8/12/2013,1791,0,1788,0,0,0,3579
30263,RM-1229,8/12/2013,1791,0,1788,0,0,0,3579
32290,RM-1236,8/12/2013,1791,0,1788,0,0,0,3579
36835,RM-B200C,8/12/2013,0,0,1788,0,0,1791,3579
40272,RM-B224,8/12/2013,0,0,1788,0,0,1791,3579
47598,RM-B275,8/12/2013,0,0,1788,0,0,1791,3579
7580,RM-1116,10/28/2013,1191,0,1194,0,0,1191,3576
7595,RM-1116,11/12/2013,1191,0,1194,0,0,1191,3576
36305,RM-B200B,1/22/2014,0,3360,0,0,0,216,3576
36903,RM-B200C,10/28/2013,1191,0,1194,0,0,1191,3576
36918,RM-B200C,11/12/2013,1191,0,1194,0,0,1191,3576
38294,RM-B215,11/12/2013,1191,0,1194,0,0,1191,3576
8242,RM-1117,10/2/2013,1191,0,1191,0,0,1191,3573
30305,RM-1229,10/2/2013,1191,0,1191,0,0,1191,3573
36309,RM-B200B,1/26/2014,0,3432,0,0,0,135,3567
13057,RM-1132,3/9/2014,0,0,933,1698,0,933,3564
24342,RM-1208B,4/19/2014,918,0,918,1728,0,0,3564
35115,RM-B103A,3/9/2014,933,0,0,1698,0,933,3564
38330,RM-B215,12/21/2013,1188,0,1188,0,0,1188,3564
41842,RM-B230,3/9/2014,933,1698,933,0,0,0,3564
7535,RM-1116,9/13/2013,0,0,1779,0,0,1776,3555
18760,RM-1155,9/13/2013,1776,0,1779,0,0,0,3555
32313,RM-1236,9/13/2013,1776,0,1779,0,0,0,3555
36858,RM-B200C,9/13/2013,0,0,1779,0,0,1776,3555
47621,RM-B275,9/13/2013,0,0,1779,0,0,1776,3555
2763,RM-1106,9/13/2013,1776,0,0,0,0,1776,3552
7562,RM-1116,10/10/2013,1185,0,1182,0,0,1185,3552
8192,RM-1117,8/4/2013,1776,0,0,0,0,1776,3552
8223,RM-1117,9/13/2013,1776,0,0,0,0,1776,3552
8250,RM-1117,10/10/2013,1185,0,1182,0,0,1185,3552
23439,RM-1208,9/13/2013,1776,0,0,0,0,1776,3552
30313,RM-1229,10/10/2013,1185,0,1182,0,0,1185,3552
36885,RM-B200C,10/10/2013,1185,0,1182,0,0,1185,3552
38203,RM-B215,8/4/2013,1776,0,0,0,0,1776,3552
38234,RM-B215,9/13/2013,1776,0,0,0,0,1776,3552
39607,RM-B222,9/13/2013,1776,0,1776,0,0,0,3552
44183,RM-B250,8/4/2013,1776,0,0,0,0,1776,3552
7504,RM-1116,8/4/2013,0,0,1773,0,0,1776,3549
18729,RM-1155,8/4/2013,1776,0,1773,0,0,0,3549
23408,RM-1208,8/4/2013,1773,0,0,0,0,1776,3549
30255,RM-1229,8/4/2013,1776,0,1773,0,0,0,3549
32282,RM-1236,8/4/2013,1776,0,1773,0,0,0,3549
36827,RM-B200C,8/4/2013,0,0,1773,0,0,1776,3549
39576,RM-B222,8/4/2013,1776,0,1773,0,0,0,3549
40264,RM-B224,8/4/2013,0,0,1773,0,0,1776,3549
7594,RM-1116,11/11/2013,1179,0,1179,0,0,1179,3537
36917,RM-B200C,11/11/2013,1179,0,1179,0,0,1179,3537
38293,RM-B215,11/11/2013,1179,0,1179,0,0,1179,3537
7596,RM-1116,11/13/2013,1179,0,1176,0,0,1179,3534
8224,RM-1117,9/14/2013,1767,0,0,0,0,1767,3534
36919,RM-B200C,11/13/2013,1179,0,1176,0,0,1179,3534
38235,RM-B215,9/14/2013,1767,0,0,0,0,1767,3534
38295,RM-B215,11/13/2013,1179,0,1176,0,0,1179,3534
7536,RM-1116,9/14/2013,0,0,1764,0,0,1767,3531
7556,RM-1116,10/4/2013,1176,0,1179,0,0,1176,3531
8244,RM-1117,10/4/2013,1176,0,1179,0,0,1176,3531
18761,RM-1155,9/14/2013,1767,0,1764,0,0,0,3531
23440,RM-1208,9/14/2013,1764,0,0,0,0,1767,3531
30307,RM-1229,10/4/2013,1176,0,1179,0,0,1176,3531
32314,RM-1236,9/14/2013,1767,0,1764,0,0,0,3531
36859,RM-B200C,9/14/2013,0,0,1764,0,0,1767,3531
39608,RM-B222,9/14/2013,1767,0,1764,0,0,0,3531
47622,RM-B275,9/14/2013,0,0,1764,0,0,1767,3531
24335,RM-1208B,4/12/2014,900,0,900,1728,0,0,3528
7589,RM-1116,11/6/2013,1176,0,1173,0,0,1176,3525
36912,RM-B200C,11/6/2013,1176,0,1173,0,0,1176,3525
24343,RM-1208B,4/20/2014,891,0,894,1728,0,0,3513
38331,RM-B215,12/22/2013,1170,0,1167,0,0,1170,3507
8234,RM-1117,9/24/2013,1302,0,897,0,0,1302,3501
8356,RM-1117,1/27/2014,0,1680,138,1680,0,0,3498
36323,RM-B200B,2/9/2014,0,2178,0,0,0,1305,3483
38322,RM-B215,12/13/2013,1161,0,1158,0,0,1161,3480
7575,RM-1116,10/23/2013,1158,0,1161,0,0,1158,3477
30326,RM-1229,10/23/2013,1158,0,1161,0,0,1158,3477
36898,RM-B200C,10/23/2013,1158,0,1161,0,0,1158,3477
7597,RM-1116,11/14/2013,1158,0,1158,0,0,1158,3474
30284,RM-1229,9/11/2013,1158,0,1158,0,0,1158,3474
36310,RM-B200B,1/27/2014,0,3336,0,0,0,138,3474
36920,RM-B200C,11/14/2013,1158,0,1158,0,0,1158,3474
38296,RM-B215,11/14/2013,1158,0,1158,0,0,1158,3474
38323,RM-B215,12/14/2013,1158,0,1158,0,0,1158,3474
7557,RM-1116,10/5/2013,1158,0,1155,0,0,1158,3471
8245,RM-1117,10/5/2013,1155,0,1155,0,0,1158,3468
30308,RM-1229,10/5/2013,1155,0,1155,0,0,1158,3468
24344,RM-1208B,4/21/2014,867,0,867,1728,0,0,3462
30480,RM-1229,3/29/2014,0,0,6,3456,0,0,3462
35135,RM-B103A,3/29/2014,3,0,0,3456,0,0,3459
9799,RM-1123,4/10/2014,0,3456,0,0,0,0,3456
9800,RM-1123,4/11/2014,0,3456,0,0,0,0,3456
9801,RM-1123,4/12/2014,0,3456,0,0,0,0,3456
9802,RM-1123,4/13/2014,0,3456,0,0,0,0,3456
9803,RM-1123,4/14/2014,0,3456,0,0,0,0,3456
9804,RM-1123,4/15/2014,0,3456,0,0,0,0,3456
9805,RM-1123,4/16/2014,0,3456,0,0,0,0,3456
9806,RM-1123,4/17/2014,0,3456,0,0,0,0,3456
9807,RM-1123,4/18/2014,0,3456,0,0,0,0,3456
9808,RM-1123,4/19/2014,0,3456,0,0,0,0,3456
9809,RM-1123,4/20/2014,0,3456,0,0,0,0,3456
9810,RM-1123,4/21/2014,0,3456,0,0,0,0,3456
9811,RM-1123,4/22/2014,0,3456,0,0,0,0,3456
9812,RM-1123,4/23/2014,0,3456,0,0,0,0,3456
9813,RM-1123,4/24/2014,0,3456,0,0,0,0,3456
9814,RM-1123,4/25/2014,0,3456,0,0,0,0,3456
9815,RM-1123,4/26/2014,0,3456,0,0,0,0,3456
9816,RM-1123,4/27/2014,0,3456,0,0,0,0,3456
9817,RM-1123,4/28/2014,0,3456,0,0,0,0,3456
9818,RM-1123,4/29/2014,0,3456,0,0,0,0,3456
9819,RM-1123,4/30/2014,0,3456,0,0,0,0,3456
9820,RM-1123,5/1/2014,0,3456,0,0,0,0,3456
9821,RM-1123,5/2/2014,0,3456,0,0,0,0,3456
9822,RM-1123,5/3/2014,0,3456,0,0,0,0,3456
9823,RM-1123,5/4/2014,0,3456,0,0,0,0,3456
9837,RM-1123,5/18/2014,0,3456,0,0,0,0,3456
9838,RM-1123,5/19/2014,0,3456,0,0,0,0,3456
9839,RM-1123,5/20/2014,0,3456,0,0,0,0,3456
9840,RM-1123,5/21/2014,0,3456,0,0,0,0,3456
9841,RM-1123,5/22/2014,0,3456,0,0,0,0,3456
9842,RM-1123,5/23/2014,0,3456,0,0,0,0,3456
9843,RM-1123,5/24/2014,0,3456,0,0,0,0,3456
9844,RM-1123,5/25/2014,0,3456,0,0,0,0,3456
9845,RM-1123,5/26/2014,0,3456,0,0,0,0,3456
9846,RM-1123,5/27/2014,0,3456,0,0,0,0,3456
9847,RM-1123,5/28/2014,0,3456,0,0,0,0,3456
9848,RM-1123,5/29/2014,0,3456,0,0,0,0,3456
9849,RM-1123,5/30/2014,0,3456,0,0,0,0,3456
9850,RM-1123,5/31/2014,0,3456,0,0,0,0,3456
9851,RM-1123,6/1/2014,0,3456,0,0,0,0,3456
9852,RM-1123,6/2/2014,0,3456,0,0,0,0,3456
9853,RM-1123,6/3/2014,0,3456,0,0,0,0,3456
9854,RM-1123,6/4/2014,0,3456,0,0,0,0,3456
9855,RM-1123,6/5/2014,0,3456,0,0,0,0,3456
9856,RM-1123,6/6/2014,0,3456,0,0,0,0,3456
9857,RM-1123,6/7/2014,0,3456,0,0,0,0,3456
9858,RM-1123,6/8/2014,0,3456,0,0,0,0,3456
9859,RM-1123,6/9/2014,0,3456,0,0,0,0,3456
9860,RM-1123,6/10/2014,0,3456,0,0,0,0,3456
9862,RM-1123,6/12/2014,0,3456,0,0,0,0,3456
9863,RM-1123,6/13/2014,0,3456,0,0,0,0,3456
9864,RM-1123,6/14/2014,0,3456,0,0,0,0,3456
9865,RM-1123,6/15/2014,0,3456,0,0,0,0,3456
9866,RM-1123,6/16/2014,0,3456,0,0,0,0,3456
9867,RM-1123,6/17/2014,0,3456,0,0,0,0,3456
9868,RM-1123,6/18/2014,0,3456,0,0,0,0,3456
9869,RM-1123,6/19/2014,0,3456,0,0,0,0,3456
9870,RM-1123,6/20/2014,0,3456,0,0,0,0,3456
9871,RM-1123,6/21/2014,0,3456,0,0,0,0,3456
9872,RM-1123,6/22/2014,0,3456,0,0,0,0,3456
9873,RM-1123,6/23/2014,0,3456,0,0,0,0,3456
9874,RM-1123,6/24/2014,0,3456,0,0,0,0,3456
9875,RM-1123,6/25/2014,0,3456,0,0,0,0,3456
9876,RM-1123,6/26/2014,0,3456,0,0,0,0,3456
9877,RM-1123,6/27/2014,0,3456,0,0,0,0,3456
9878,RM-1123,6/28/2014,0,3456,0,0,0,0,3456
9880,RM-1123,6/30/2014,0,3456,0,0,0,0,3456
9881,RM-1123,7/1/2014,0,3456,0,0,0,0,3456
20367,RM-1200A,6/20/2014,0,0,0,3456,0,0,3456
20368,RM-1200A,6/21/2014,0,0,0,3456,0,0,3456
20369,RM-1200A,6/22/2014,0,0,0,3456,0,0,3456
20370,RM-1200A,6/23/2014,0,0,0,3456,0,0,3456
20371,RM-1200A,6/24/2014,0,0,0,3456,0,0,3456
20372,RM-1200A,6/25/2014,0,0,0,3456,0,0,3456
20373,RM-1200A,6/26/2014,0,0,0,3456,0,0,3456
20374,RM-1200A,6/27/2014,0,0,0,3456,0,0,3456
20377,RM-1200A,6/30/2014,0,0,0,3456,0,0,3456
20876,RM-1200B,1/17/2014,0,1728,0,1728,0,0,3456
20878,RM-1200B,1/19/2014,0,1728,0,1728,0,0,3456
20882,RM-1200B,1/23/2014,0,1728,0,1728,0,0,3456
20883,RM-1200B,1/24/2014,0,1728,0,1728,0,0,3456
20888,RM-1200B,1/29/2014,0,1728,0,1728,0,0,3456
20892,RM-1200B,2/2/2014,0,1728,0,1728,0,0,3456
21563,RM-1200C,1/19/2014,0,1728,0,1728,0,0,3456
21567,RM-1200C,1/23/2014,0,1728,0,1728,0,0,3456
21568,RM-1200C,1/24/2014,0,1728,0,1728,0,0,3456
21573,RM-1200C,1/29/2014,0,1728,0,1728,0,0,3456
21577,RM-1200C,2/2/2014,0,1728,0,1728,0,0,3456
21578,RM-1200C,2/3/2014,0,1728,0,1728,0,0,3456
21579,RM-1200C,2/4/2014,0,1728,0,1728,0,0,3456
21580,RM-1200C,2/5/2014,0,1728,0,1728,0,0,3456
21581,RM-1200C,2/6/2014,0,1728,0,1728,0,0,3456
21583,RM-1200C,2/8/2014,0,1728,0,1728,0,0,3456
21584,RM-1200C,2/9/2014,0,1728,0,1728,0,0,3456
21585,RM-1200C,2/10/2014,0,1728,0,1728,0,0,3456
21586,RM-1200C,2/11/2014,0,1728,0,1728,0,0,3456
21589,RM-1200C,2/14/2014,0,1728,0,1728,0,0,3456
21590,RM-1200C,2/15/2014,0,1728,0,1728,0,0,3456
21591,RM-1200C,2/16/2014,0,1728,0,1728,0,0,3456
21592,RM-1200C,2/17/2014,0,1728,0,1728,0,0,3456
21593,RM-1200C,2/18/2014,0,1728,0,1728,0,0,3456
21594,RM-1200C,2/19/2014,0,1728,0,1728,0,0,3456
21595,RM-1200C,2/20/2014,0,1728,0,1728,0,0,3456
21596,RM-1200C,2/21/2014,0,1728,0,1728,0,0,3456
21597,RM-1200C,2/22/2014,0,1728,0,1728,0,0,3456
21598,RM-1200C,2/23/2014,0,1728,0,1728,0,0,3456
21599,RM-1200C,2/24/2014,0,1728,0,1728,0,0,3456
21600,RM-1200C,2/25/2014,0,1728,0,1728,0,0,3456
21601,RM-1200C,2/26/2014,0,1728,0,1728,0,0,3456
21602,RM-1200C,2/27/2014,0,1728,0,1728,0,0,3456
21603,RM-1200C,2/28/2014,0,1728,0,1728,0,0,3456
21604,RM-1200C,3/1/2014,0,1728,0,1728,0,0,3456
21607,RM-1200C,3/4/2014,0,1728,0,1728,0,0,3456
21608,RM-1200C,3/5/2014,0,1728,0,1728,0,0,3456
21609,RM-1200C,3/6/2014,0,1728,0,1728,0,0,3456
21610,RM-1200C,3/7/2014,0,1728,0,1728,0,0,3456
21614,RM-1200C,3/11/2014,0,1728,0,1728,0,0,3456
21615,RM-1200C,3/12/2014,0,1728,0,1728,0,0,3456
21616,RM-1200C,3/13/2014,0,1728,0,1728,0,0,3456
21617,RM-1200C,3/14/2014,0,1728,0,1728,0,0,3456
21618,RM-1200C,3/15/2014,0,1728,0,1728,0,0,3456
21619,RM-1200C,3/16/2014,0,1728,0,1728,0,0,3456
21620,RM-1200C,3/17/2014,0,1728,0,1728,0,0,3456
21621,RM-1200C,3/18/2014,0,1728,0,1728,0,0,3456
21622,RM-1200C,3/19/2014,0,1728,0,1728,0,0,3456
21623,RM-1200C,3/20/2014,0,1728,0,1728,0,0,3456
21624,RM-1200C,3/21/2014,0,1728,0,1728,0,0,3456
21625,RM-1200C,3/22/2014,0,1728,0,1728,0,0,3456
21628,RM-1200C,3/25/2014,0,1728,0,1728,0,0,3456
21629,RM-1200C,3/26/2014,0,1728,0,1728,0,0,3456
21631,RM-1200C,3/28/2014,0,1728,0,1728,0,0,3456
21632,RM-1200C,3/29/2014,0,1728,0,1728,0,0,3456
21633,RM-1200C,3/30/2014,0,1728,0,1728,0,0,3456
21634,RM-1200C,3/31/2014,0,1728,0,1728,0,0,3456
21635,RM-1200C,4/1/2014,0,1728,0,1728,0,0,3456
21637,RM-1200C,4/3/2014,0,1728,0,1728,0,0,3456
21638,RM-1200C,4/4/2014,0,1728,0,1728,0,0,3456
21639,RM-1200C,4/5/2014,0,1728,0,1728,0,0,3456
21640,RM-1200C,4/6/2014,0,1728,0,1728,0,0,3456
21641,RM-1200C,4/7/2014,0,1728,0,1728,0,0,3456
21642,RM-1200C,4/8/2014,0,1728,0,1728,0,0,3456
21643,RM-1200C,4/9/2014,0,1728,0,1728,0,0,3456
21644,RM-1200C,4/10/2014,0,1728,0,1728,0,0,3456
21645,RM-1200C,4/11/2014,0,1728,0,1728,0,0,3456
21646,RM-1200C,4/12/2014,0,1728,0,1728,0,0,3456
21647,RM-1200C,4/13/2014,0,1728,0,1728,0,0,3456
21648,RM-1200C,4/14/2014,0,1728,0,1728,0,0,3456
21649,RM-1200C,4/15/2014,0,1728,0,1728,0,0,3456
21650,RM-1200C,4/16/2014,0,1728,0,1728,0,0,3456
21651,RM-1200C,4/17/2014,0,1728,0,1728,0,0,3456
21652,RM-1200C,4/18/2014,0,1728,0,1728,0,0,3456
21653,RM-1200C,4/19/2014,0,1728,0,1728,0,0,3456
21654,RM-1200C,4/20/2014,0,1728,0,1728,0,0,3456
21655,RM-1200C,4/21/2014,0,1728,0,1728,0,0,3456
21656,RM-1200C,4/22/2014,0,1728,0,1728,0,0,3456
21657,RM-1200C,4/23/2014,0,1728,0,1728,0,0,3456
21658,RM-1200C,4/24/2014,0,1728,0,1728,0,0,3456
21659,RM-1200C,4/25/2014,0,1728,0,1728,0,0,3456
21660,RM-1200C,4/26/2014,0,1728,0,1728,0,0,3456
21661,RM-1200C,4/27/2014,0,1728,0,1728,0,0,3456
21662,RM-1200C,4/28/2014,0,1728,0,1728,0,0,3456
21663,RM-1200C,4/29/2014,0,1728,0,1728,0,0,3456
21664,RM-1200C,4/30/2014,0,1728,0,1728,0,0,3456
21665,RM-1200C,5/1/2014,0,1728,0,1728,0,0,3456
21666,RM-1200C,5/2/2014,0,1728,0,1728,0,0,3456
21667,RM-1200C,5/3/2014,0,1728,0,1728,0,0,3456
21668,RM-1200C,5/4/2014,0,1728,0,1728,0,0,3456
21682,RM-1200C,5/18/2014,0,1728,0,1728,0,0,3456
21683,RM-1200C,5/19/2014,0,1728,0,1728,0,0,3456
21684,RM-1200C,5/20/2014,0,1728,0,1728,0,0,3456
21685,RM-1200C,5/21/2014,0,1728,0,1728,0,0,3456
21686,RM-1200C,5/22/2014,0,1728,0,1728,0,0,3456
21687,RM-1200C,5/23/2014,0,1728,0,1728,0,0,3456
21688,RM-1200C,5/24/2014,0,1728,0,1728,0,0,3456
21689,RM-1200C,5/25/2014,0,1728,0,1728,0,0,3456
21690,RM-1200C,5/26/2014,0,1728,0,1728,0,0,3456
21691,RM-1200C,5/27/2014,0,1728,0,1728,0,0,3456
21692,RM-1200C,5/28/2014,0,1728,0,1728,0,0,3456
21693,RM-1200C,5/29/2014,0,1728,0,1728,0,0,3456
21694,RM-1200C,5/30/2014,0,1728,0,1728,0,0,3456
21695,RM-1200C,5/31/2014,0,1728,0,1728,0,0,3456
21696,RM-1200C,6/1/2014,0,1728,0,1728,0,0,3456
21697,RM-1200C,6/2/2014,0,1728,0,1728,0,0,3456
21698,RM-1200C,6/3/2014,0,1728,0,1728,0,0,3456
21699,RM-1200C,6/4/2014,0,1728,0,1728,0,0,3456
21701,RM-1200C,6/6/2014,0,1728,0,1728,0,0,3456
21702,RM-1200C,6/7/2014,0,1728,0,1728,0,0,3456
21703,RM-1200C,6/8/2014,0,1728,0,1728,0,0,3456
21704,RM-1200C,6/9/2014,0,1728,0,1728,0,0,3456
21705,RM-1200C,6/10/2014,0,1728,0,1728,0,0,3456
21707,RM-1200C,6/12/2014,0,1728,0,1728,0,0,3456
23633,RM-1208,3/29/2014,0,3456,0,0,0,0,3456
24345,RM-1208B,4/22/2014,864,0,864,1728,0,0,3456
29723,RM-1224,1/19/2014,0,0,0,3456,0,0,3456
29727,RM-1224,1/23/2014,0,0,0,3456,0,0,3456
29728,RM-1224,1/24/2014,0,0,0,3456,0,0,3456
29733,RM-1224,1/29/2014,0,0,0,3456,0,0,3456
29737,RM-1224,2/2/2014,0,0,0,3456,0,0,3456
29738,RM-1224,2/3/2014,0,0,0,3456,0,0,3456
29739,RM-1224,2/4/2014,0,0,0,3456,0,0,3456
29740,RM-1224,2/5/2014,0,0,0,3456,0,0,3456
29741,RM-1224,2/6/2014,0,0,0,3456,0,0,3456
29743,RM-1224,2/8/2014,0,0,0,3456,0,0,3456
29744,RM-1224,2/9/2014,0,0,0,3456,0,0,3456
29745,RM-1224,2/10/2014,0,0,0,3456,0,0,3456
29746,RM-1224,2/11/2014,0,0,0,3456,0,0,3456
29749,RM-1224,2/14/2014,0,0,0,3456,0,0,3456
29750,RM-1224,2/15/2014,0,0,0,3456,0,0,3456
29751,RM-1224,2/16/2014,0,0,0,3456,0,0,3456
29752,RM-1224,2/17/2014,0,0,0,3456,0,0,3456
29753,RM-1224,2/18/2014,0,0,0,3456,0,0,3456
29754,RM-1224,2/19/2014,0,0,0,3456,0,0,3456
29755,RM-1224,2/20/2014,0,0,0,3456,0,0,3456
29756,RM-1224,2/21/2014,0,0,0,3456,0,0,3456
29757,RM-1224,2/22/2014,0,0,0,3456,0,0,3456
29758,RM-1224,2/23/2014,0,0,0,3456,0,0,3456
29759,RM-1224,2/24/2014,0,0,0,3456,0,0,3456
29760,RM-1224,2/25/2014,0,0,0,3456,0,0,3456
29761,RM-1224,2/26/2014,0,0,0,3456,0,0,3456
29762,RM-1224,2/27/2014,0,0,0,3456,0,0,3456
29763,RM-1224,2/28/2014,0,0,0,3456,0,0,3456
29764,RM-1224,3/1/2014,0,0,0,3456,0,0,3456
29767,RM-1224,3/4/2014,0,0,0,3456,0,0,3456
29768,RM-1224,3/5/2014,0,0,0,3456,0,0,3456
29769,RM-1224,3/6/2014,0,0,0,3456,0,0,3456
29770,RM-1224,3/7/2014,0,0,0,3456,0,0,3456
29774,RM-1224,3/11/2014,0,0,0,3456,0,0,3456
29775,RM-1224,3/12/2014,0,0,0,3456,0,0,3456
29776,RM-1224,3/13/2014,0,0,0,3456,0,0,3456
29777,RM-1224,3/14/2014,0,0,0,3456,0,0,3456
29778,RM-1224,3/15/2014,0,0,0,3456,0,0,3456
29779,RM-1224,3/16/2014,0,0,0,3456,0,0,3456
29780,RM-1224,3/17/2014,0,0,0,3456,0,0,3456
29781,RM-1224,3/18/2014,0,0,0,3456,0,0,3456
29782,RM-1224,3/19/2014,0,0,0,3456,0,0,3456
29783,RM-1224,3/20/2014,0,0,0,3456,0,0,3456
29784,RM-1224,3/21/2014,0,0,0,3456,0,0,3456
29785,RM-1224,3/22/2014,0,0,0,3456,0,0,3456
29786,RM-1224,3/23/2014,0,0,0,3456,0,0,3456
29787,RM-1224,3/24/2014,0,0,0,3456,0,0,3456
29788,RM-1224,3/25/2014,0,0,0,3456,0,0,3456
29789,RM-1224,3/26/2014,0,0,0,3456,0,0,3456
29791,RM-1224,3/28/2014,0,0,0,3456,0,0,3456
29792,RM-1224,3/29/2014,0,0,0,3456,0,0,3456
29793,RM-1224,3/30/2014,0,0,0,3456,0,0,3456
29794,RM-1224,3/31/2014,0,0,0,3456,0,0,3456
29795,RM-1224,4/1/2014,0,0,0,3456,0,0,3456
31063,RM-1230,1/19/2014,0,3456,0,0,0,0,3456
31067,RM-1230,1/23/2014,0,3456,0,0,0,0,3456
31068,RM-1230,1/24/2014,0,3456,0,0,0,0,3456
31073,RM-1230,1/29/2014,0,3456,0,0,0,0,3456
31077,RM-1230,2/2/2014,0,3456,0,0,0,0,3456
31078,RM-1230,2/3/2014,0,3456,0,0,0,0,3456
31079,RM-1230,2/4/2014,0,3456,0,0,0,0,3456
31080,RM-1230,2/5/2014,0,3456,0,0,0,0,3456
31081,RM-1230,2/6/2014,0,3456,0,0,0,0,3456
31083,RM-1230,2/8/2014,0,3456,0,0,0,0,3456
31084,RM-1230,2/9/2014,0,3456,0,0,0,0,3456
31085,RM-1230,2/10/2014,0,3456,0,0,0,0,3456
31086,RM-1230,2/11/2014,0,3456,0,0,0,0,3456
31089,RM-1230,2/14/2014,0,3456,0,0,0,0,3456
31090,RM-1230,2/15/2014,0,3456,0,0,0,0,3456
31091,RM-1230,2/16/2014,0,3456,0,0,0,0,3456
31092,RM-1230,2/17/2014,0,3456,0,0,0,0,3456
31093,RM-1230,2/18/2014,0,3456,0,0,0,0,3456
31094,RM-1230,2/19/2014,0,3456,0,0,0,0,3456
31095,RM-1230,2/20/2014,0,3456,0,0,0,0,3456
31096,RM-1230,2/21/2014,0,3456,0,0,0,0,3456
31097,RM-1230,2/22/2014,0,3456,0,0,0,0,3456
31098,RM-1230,2/23/2014,0,3456,0,0,0,0,3456
31099,RM-1230,2/24/2014,0,3456,0,0,0,0,3456
31100,RM-1230,2/25/2014,0,3456,0,0,0,0,3456
31101,RM-1230,2/26/2014,0,3456,0,0,0,0,3456
31102,RM-1230,2/27/2014,0,3456,0,0,0,0,3456
31103,RM-1230,2/28/2014,0,3456,0,0,0,0,3456
31104,RM-1230,3/1/2014,0,3456,0,0,0,0,3456
31107,RM-1230,3/4/2014,0,3456,0,0,0,0,3456
31108,RM-1230,3/5/2014,0,3456,0,0,0,0,3456
31109,RM-1230,3/6/2014,0,3456,0,0,0,0,3456
31110,RM-1230,3/7/2014,0,3456,0,0,0,0,3456
31114,RM-1230,3/11/2014,0,3456,0,0,0,0,3456
31115,RM-1230,3/12/2014,0,3456,0,0,0,0,3456
31116,RM-1230,3/13/2014,0,3456,0,0,0,0,3456
31117,RM-1230,3/14/2014,0,3456,0,0,0,0,3456
31118,RM-1230,3/15/2014,0,3456,0,0,0,0,3456
31119,RM-1230,3/16/2014,0,3456,0,0,0,0,3456
31120,RM-1230,3/17/2014,0,3456,0,0,0,0,3456
31121,RM-1230,3/18/2014,0,3456,0,0,0,0,3456
31122,RM-1230,3/19/2014,0,3456,0,0,0,0,3456
31123,RM-1230,3/20/2014,0,3456,0,0,0,0,3456
31124,RM-1230,3/21/2014,0,3456,0,0,0,0,3456
31125,RM-1230,3/22/2014,0,3456,0,0,0,0,3456
31126,RM-1230,3/23/2014,0,3456,0,0,0,0,3456
31127,RM-1230,3/24/2014,0,3456,0,0,0,0,3456
31128,RM-1230,3/25/2014,0,3456,0,0,0,0,3456
31129,RM-1230,3/26/2014,0,3456,0,0,0,0,3456
31131,RM-1230,3/28/2014,0,3456,0,0,0,0,3456
31132,RM-1230,3/29/2014,0,3456,0,0,0,0,3456
31133,RM-1230,3/30/2014,0,3456,0,0,0,0,3456
31134,RM-1230,3/31/2014,0,3456,0,0,0,0,3456
31135,RM-1230,4/1/2014,0,3456,0,0,0,0,3456
31137,RM-1230,4/3/2014,0,3456,0,0,0,0,3456
31138,RM-1230,4/4/2014,0,3456,0,0,0,0,3456
31139,RM-1230,4/5/2014,0,3456,0,0,0,0,3456
31140,RM-1230,4/6/2014,0,3456,0,0,0,0,3456
31141,RM-1230,4/7/2014,0,3456,0,0,0,0,3456
31142,RM-1230,4/8/2014,0,3456,0,0,0,0,3456
31143,RM-1230,4/9/2014,0,3456,0,0,0,0,3456
43776,RM-B240A,3/7/2014,0,3456,0,0,0,0,3456
43780,RM-B240A,3/11/2014,0,3456,0,0,0,0,3456
43781,RM-B240A,3/12/2014,0,3456,0,0,0,0,3456
43782,RM-B240A,3/13/2014,0,3456,0,0,0,0,3456
43783,RM-B240A,3/14/2014,0,3456,0,0,0,0,3456
43784,RM-B240A,3/15/2014,0,3456,0,0,0,0,3456
43785,RM-B240A,3/16/2014,0,3456,0,0,0,0,3456
43786,RM-B240A,3/17/2014,0,3456,0,0,0,0,3456
43787,RM-B240A,3/18/2014,0,3456,0,0,0,0,3456
43788,RM-B240A,3/19/2014,0,3456,0,0,0,0,3456
43789,RM-B240A,3/20/2014,0,3456,0,0,0,0,3456
43790,RM-B240A,3/21/2014,0,3456,0,0,0,0,3456
43791,RM-B240A,3/22/2014,0,3456,0,0,0,0,3456
43792,RM-B240A,3/23/2014,0,3456,0,0,0,0,3456
43793,RM-B240A,3/24/2014,0,3456,0,0,0,0,3456
43794,RM-B240A,3/25/2014,0,3456,0,0,0,0,3456
43795,RM-B240A,3/26/2014,0,3456,0,0,0,0,3456
43797,RM-B240A,3/28/2014,0,3456,0,0,0,0,3456
43798,RM-B240A,3/29/2014,0,3456,0,0,0,0,3456
43799,RM-B240A,3/30/2014,0,3456,0,0,0,0,3456
43800,RM-B240A,3/31/2014,0,3456,0,0,0,0,3456
43801,RM-B240A,4/1/2014,0,3456,0,0,0,0,3456
43803,RM-B240A,4/3/2014,0,3456,0,0,0,0,3456
43804,RM-B240A,4/4/2014,0,3456,0,0,0,0,3456
43805,RM-B240A,4/5/2014,0,3456,0,0,0,0,3456
43806,RM-B240A,4/6/2014,0,3456,0,0,0,0,3456
43807,RM-B240A,4/7/2014,0,3456,0,0,0,0,3456
43808,RM-B240A,4/8/2014,0,3456,0,0,0,0,3456
43809,RM-B240A,4/9/2014,0,3456,0,0,0,0,3456
43810,RM-B240A,4/10/2014,0,3456,0,0,0,0,3456
43811,RM-B240A,4/11/2014,0,3456,0,0,0,0,3456
43812,RM-B240A,4/12/2014,0,3456,0,0,0,0,3456
43813,RM-B240A,4/13/2014,0,3456,0,0,0,0,3456
43814,RM-B240A,4/14/2014,0,3456,0,0,0,0,3456
43815,RM-B240A,4/15/2014,0,3456,0,0,0,0,3456
43816,RM-B240A,4/16/2014,0,3456,0,0,0,0,3456
43817,RM-B240A,4/17/2014,0,3456,0,0,0,0,3456
43818,RM-B240A,4/18/2014,0,3456,0,0,0,0,3456
43819,RM-B240A,4/19/2014,0,3456,0,0,0,0,3456
43820,RM-B240A,4/20/2014,0,3456,0,0,0,0,3456
43821,RM-B240A,4/21/2014,0,3456,0,0,0,0,3456
43822,RM-B240A,4/22/2014,0,3456,0,0,0,0,3456
18920,RM-1155,2/23/2014,1134,0,0,1188,0,1131,3453
13059,RM-1132,3/11/2014,0,0,861,1728,0,861,3450
21561,RM-1200C,1/17/2014,0,1728,0,1722,0,0,3450
21700,RM-1200C,6/5/2014,0,1728,0,1722,0,0,3450
31061,RM-1230,1/17/2014,0,3450,0,0,0,0,3450
35117,RM-B103A,3/11/2014,861,0,0,1728,0,861,3450
41844,RM-B230,3/11/2014,861,1728,861,0,0,0,3450
45706,RM-B260,1/17/2014,0,0,0,3450,0,0,3450
8246,RM-1117,10/6/2013,1149,0,1149,0,0,1149,3447
30283,RM-1229,9/10/2013,1149,0,1149,0,0,1149,3447
30309,RM-1229,10/6/2013,1149,0,1149,0,0,1149,3447
7558,RM-1116,10/6/2013,1146,0,1149,0,0,1149,3444
9861,RM-1123,6/11/2014,0,3444,0,0,0,0,3444
9879,RM-1123,6/29/2014,0,3444,0,0,0,0,3444
20375,RM-1200A,6/28/2014,0,0,0,3444,0,0,3444
20376,RM-1200A,6/29/2014,0,0,0,3444,0,0,3444
20378,RM-1200A,7/1/2014,0,0,0,3444,0,0,3444
20879,RM-1200B,1/20/2014,0,1722,0,1722,0,0,3444
21564,RM-1200C,1/20/2014,0,1722,0,1722,0,0,3444
21582,RM-1200C,2/7/2014,0,1722,0,1722,0,0,3444
21587,RM-1200C,2/12/2014,0,1722,0,1722,0,0,3444
21605,RM-1200C,3/2/2014,0,1722,0,1722,0,0,3444
21706,RM-1200C,6/11/2014,0,1722,0,1722,0,0,3444
29724,RM-1224,1/20/2014,0,0,0,3444,0,0,3444
29730,RM-1224,1/26/2014,0,0,0,3444,0,0,3444
29734,RM-1224,1/30/2014,0,0,0,3444,0,0,3444
29742,RM-1224,2/7/2014,0,0,0,3444,0,0,3444
29747,RM-1224,2/12/2014,0,0,0,3444,0,0,3444
29765,RM-1224,3/2/2014,0,0,0,3444,0,0,3444
31064,RM-1230,1/20/2014,0,3444,0,0,0,0,3444
31070,RM-1230,1/26/2014,0,3444,0,0,0,0,3444
31074,RM-1230,1/30/2014,0,3444,0,0,0,0,3444
31082,RM-1230,2/7/2014,0,3444,0,0,0,0,3444
31087,RM-1230,2/12/2014,0,3444,0,0,0,0,3444
31105,RM-1230,3/2/2014,0,3444,0,0,0,0,3444
24414,RM-1208B,6/30/2014,852,0,861,1728,0,0,3441
20889,RM-1200B,1/30/2014,0,1716,0,1722,0,0,3438
21574,RM-1200C,1/30/2014,0,1716,0,1722,0,0,3438
8358,RM-1117,1/29/2014,0,870,837,1728,0,0,3435
18894,RM-1155,1/28/2014,858,0,861,1716,0,0,3435
30420,RM-1229,1/28/2014,0,0,861,1716,0,858,3435
20885,RM-1200B,1/26/2014,0,1716,0,1716,0,0,3432
20887,RM-1200B,1/28/2014,0,1716,0,1716,0,0,3432
21570,RM-1200C,1/26/2014,0,1716,0,1716,0,0,3432
21572,RM-1200C,1/28/2014,0,1716,0,1716,0,0,3432
21588,RM-1200C,2/13/2014,0,1716,0,1716,0,0,3432
21606,RM-1200C,3/3/2014,0,1716,0,1716,0,0,3432
21613,RM-1200C,3/10/2014,0,1716,0,1716,0,0,3432
29729,RM-1224,1/25/2014,0,0,0,3432,0,0,3432
29732,RM-1224,1/28/2014,0,0,0,3432,0,0,3432
29748,RM-1224,2/13/2014,0,0,0,3432,0,0,3432
29766,RM-1224,3/3/2014,0,0,0,3432,0,0,3432
29773,RM-1224,3/10/2014,0,0,0,3432,0,0,3432
31069,RM-1230,1/25/2014,0,3432,0,0,0,0,3432
31072,RM-1230,1/28/2014,0,3432,0,0,0,0,3432
31088,RM-1230,2/13/2014,0,3432,0,0,0,0,3432
31106,RM-1230,3/3/2014,0,3432,0,0,0,0,3432
31113,RM-1230,3/10/2014,0,3432,0,0,0,0,3432
35075,RM-B103A,1/28/2014,858,0,0,1716,0,858,3432
43779,RM-B240A,3/10/2014,0,3432,0,0,0,0,3432
38332,RM-B215,12/23/2013,1143,0,1143,0,0,1143,3429
20877,RM-1200B,1/18/2014,0,1710,0,1710,0,0,3420
20880,RM-1200B,1/21/2014,0,1710,0,1710,0,0,3420
20884,RM-1200B,1/25/2014,0,1710,0,1710,0,0,3420
21562,RM-1200C,1/18/2014,0,1710,0,1710,0,0,3420
21565,RM-1200C,1/21/2014,0,1710,0,1710,0,0,3420
21569,RM-1200C,1/25/2014,0,1710,0,1710,0,0,3420
29722,RM-1224,1/18/2014,0,0,0,3420,0,0,3420
29725,RM-1224,1/21/2014,0,0,0,3420,0,0,3420
31062,RM-1230,1/18/2014,0,3420,0,0,0,0,3420
31065,RM-1230,1/21/2014,0,3420,0,0,0,0,3420
23441,RM-1208,9/15/2013,1710,0,0,0,0,1707,3417
38324,RM-B215,12/15/2013,1137,0,1140,0,0,1140,3417
39609,RM-B222,9/15/2013,1707,0,1710,0,0,0,3417
7537,RM-1116,9/15/2013,0,0,1707,0,0,1707,3414
8225,RM-1117,9/15/2013,1707,0,0,0,0,1707,3414
18762,RM-1155,9/15/2013,1707,0,1707,0,0,0,3414
24346,RM-1208B,4/23/2014,843,0,843,1728,0,0,3414
32315,RM-1236,9/15/2013,1707,0,1707,0,0,0,3414
36860,RM-B200C,9/15/2013,0,0,1707,0,0,1707,3414
38236,RM-B215,9/15/2013,1707,0,0,0,0,1707,3414
47623,RM-B275,9/15/2013,0,0,1707,0,0,1707,3414
21630,RM-1200C,3/27/2014,0,1704,0,1704,0,0,3408
29790,RM-1224,3/27/2014,0,0,0,3408,0,0,3408
31130,RM-1230,3/27/2014,0,3408,0,0,0,0,3408
43796,RM-B240A,3/27/2014,0,3408,0,0,0,0,3408
41839,RM-B230,3/6/2014,837,1728,840,0,0,0,3405
13054,RM-1132,3/6/2014,0,0,837,1728,0,837,3402
18895,RM-1155,1/29/2014,837,0,837,1728,0,0,3402
35076,RM-B103A,1/29/2014,837,0,0,1728,0,837,3402
35112,RM-B103A,3/6/2014,837,0,0,1728,0,837,3402
20891,RM-1200B,2/1/2014,0,1698,0,1698,0,0,3396
21576,RM-1200C,2/1/2014,0,1698,0,1698,0,0,3396
21612,RM-1200C,3/9/2014,0,1698,0,1698,0,0,3396
29736,RM-1224,2/1/2014,0,0,0,3396,0,0,3396
29772,RM-1224,3/9/2014,0,0,0,3396,0,0,3396
31076,RM-1230,2/1/2014,0,3396,0,0,0,0,3396
31112,RM-1230,3/9/2014,0,3396,0,0,0,0,3396
43778,RM-B240A,3/9/2014,0,3396,0,0,0,0,3396
24389,RM-1208B,6/5/2014,834,0,837,1722,0,0,3393
2742,RM-1106,8/14/2013,1695,0,0,0,0,1695,3390
7514,RM-1116,8/14/2013,0,0,1695,0,0,1695,3390
8202,RM-1117,8/14/2013,1695,0,0,0,0,1695,3390
18739,RM-1155,8/14/2013,1695,0,1695,0,0,0,3390
23418,RM-1208,8/14/2013,1695,0,0,0,0,1695,3390
30265,RM-1229,8/14/2013,1695,0,1695,0,0,0,3390
32292,RM-1236,8/14/2013,1695,0,1695,0,0,0,3390
36837,RM-B200C,8/14/2013,0,0,1695,0,0,1695,3390
38213,RM-B215,8/14/2013,1695,0,0,0,0,1695,3390
39586,RM-B222,8/14/2013,1695,0,1695,0,0,0,3390
40274,RM-B224,8/14/2013,0,0,1695,0,0,1695,3390
47600,RM-B275,8/14/2013,0,0,1695,0,0,1695,3390
29726,RM-1224,1/22/2014,0,0,0,3384,0,0,3384
31066,RM-1230,1/22/2014,0,3384,0,0,0,0,3384
7564,RM-1116,10/12/2013,1125,0,1128,0,0,1128,3381
8252,RM-1117,10/12/2013,1125,0,1128,0,0,1128,3381
36887,RM-B200C,10/12/2013,1125,0,1128,0,0,1128,3381
30315,RM-1229,10/12/2013,1125,0,1128,0,0,1125,3378
43775,RM-B240A,3/6/2014,0,3378,0,0,0,0,3378
21611,RM-1200C,3/8/2014,0,1686,0,1686,0,0,3372
29771,RM-1224,3/8/2014,0,0,0,3372,0,0,3372
31111,RM-1230,3/8/2014,0,3372,0,0,0,0,3372
38340,RM-B215,12/31/2013,1125,0,1125,0,0,1122,3372
43777,RM-B240A,3/8/2014,0,3372,0,0,0,0,3372
36930,RM-B200C,11/27/2013,1122,0,1122,0,0,1125,3369
7607,RM-1116,11/27/2013,1122,0,1122,0,0,1122,3366
24324,RM-1208B,4/1/2014,816,0,822,1728,0,0,3366
35106,RM-B103A,2/28/2014,819,0,0,1728,0,819,3366
38306,RM-B215,11/27/2013,1122,0,1122,0,0,1122,3366
38328,RM-B215,12/19/2013,1122,0,1122,0,0,1122,3366
41833,RM-B230,2/28/2014,819,1728,819,0,0,0,3366
13048,RM-1132,2/28/2014,0,0,816,1728,0,819,3363
36945,RM-B200C,12/12/2013,1236,0,1236,0,0,891,3363
2752,RM-1106,8/28/2013,1680,0,0,0,0,1680,3360
8212,RM-1117,8/28/2013,1680,0,0,0,0,1680,3360
20881,RM-1200B,1/22/2014,0,1680,0,1680,0,0,3360
21566,RM-1200C,1/22/2014,0,1680,0,1680,0,0,3360
23428,RM-1208,8/28/2013,1680,0,0,0,0,1680,3360
29731,RM-1224,1/27/2014,0,0,0,3360,0,0,3360
31071,RM-1230,1/27/2014,0,3360,0,0,0,0,3360
38223,RM-B215,8/28/2013,1680,0,0,0,0,1680,3360
39596,RM-B222,8/28/2013,1680,0,1680,0,0,0,3360
7524,RM-1116,8/28/2013,0,0,1677,0,0,1680,3357
18749,RM-1155,8/28/2013,1680,0,1677,0,0,0,3357
30275,RM-1229,8/28/2013,1680,0,1677,0,0,0,3357
32302,RM-1236,8/28/2013,1680,0,1677,0,0,0,3357
36847,RM-B200C,8/28/2013,0,0,1677,0,0,1680,3357
40284,RM-B224,8/28/2013,0,0,1677,0,0,1680,3357
47610,RM-B275,8/28/2013,0,0,1677,0,0,1680,3357
7499,RM-1116,7/30/2013,0,0,1680,0,0,1674,3354
13058,RM-1132,3/10/2014,0,0,819,1716,0,819,3354
18724,RM-1155,7/30/2013,1674,0,1680,0,0,0,3354
29719,RM-1224,1/15/2014,0,1680,0,1674,0,0,3354
30250,RM-1229,7/30/2013,1674,0,1680,0,0,0,3354
32277,RM-1236,7/30/2013,1674,0,1680,0,0,0,3354
35116,RM-B103A,3/10/2014,819,0,0,1716,0,819,3354
36822,RM-B200C,7/30/2013,0,0,1680,0,0,1674,3354
40259,RM-B224,7/30/2013,0,0,1680,0,0,1674,3354
41843,RM-B230,3/10/2014,819,1716,819,0,0,0,3354
23403,RM-1208,7/30/2013,1677,0,0,0,0,1674,3351
39571,RM-B222,7/30/2013,1674,0,1677,0,0,0,3351
8187,RM-1117,7/30/2013,1674,0,0,0,0,1674,3348
20874,RM-1200B,1/15/2014,0,1674,0,1674,0,0,3348
38198,RM-B215,7/30/2013,1674,0,0,0,0,1674,3348
44178,RM-B250,7/30/2013,1674,0,0,0,0,1674,3348
30316,RM-1229,10/13/2013,1116,0,1113,0,0,1116,3345
7559,RM-1116,10/7/2013,1116,0,1113,0,0,1113,3342
7565,RM-1116,10/13/2013,1116,0,1113,0,0,1113,3342
8247,RM-1117,10/7/2013,1116,0,1113,0,0,1113,3342
8253,RM-1117,10/13/2013,1116,0,1113,0,0,1113,3342
24358,RM-1208B,5/5/2014,885,0,885,1572,0,0,3342
30310,RM-1229,10/7/2013,1116,0,1113,0,0,1113,3342
36888,RM-B200C,10/13/2013,1116,0,1113,0,0,1113,3342
20886,RM-1200B,1/27/2014,0,1668,0,1668,0,0,3336
21571,RM-1200C,1/27/2014,0,1668,0,1668,0,0,3336
7598,RM-1116,11/15/2013,1110,0,1113,0,0,1110,3333
36921,RM-B200C,11/15/2013,1110,0,1113,0,0,1110,3333
38297,RM-B215,11/15/2013,1110,0,1113,0,0,1110,3333
44159,RM-B250,7/10/2013,924,0,0,0,0,2406,3330
18727,RM-1155,8/2/2013,1659,0,1665,0,0,0,3324
30253,RM-1229,8/2/2013,1659,0,1665,0,0,0,3324
32280,RM-1236,8/2/2013,1659,0,1665,0,0,0,3324
36932,RM-B200C,11/29/2013,1110,0,1107,0,0,1107,3324
38308,RM-B215,11/29/2013,1110,0,1107,0,0,1107,3324
7502,RM-1116,8/2/2013,0,0,1665,0,0,1656,3321
36825,RM-B200C,8/2/2013,0,0,1665,0,0,1656,3321
40262,RM-B224,8/2/2013,0,0,1665,0,0,1656,3321
18896,RM-1155,1/30/2014,663,0,663,1722,0,270,3318
38333,RM-B215,12/24/2013,1104,0,1107,0,0,1107,3318
8190,RM-1117,8/2/2013,1659,0,0,0,0,1656,3315
39574,RM-B222,8/2/2013,1659,0,1656,0,0,0,3315
7600,RM-1116,11/20/2013,1104,0,1104,0,0,1104,3312
23406,RM-1208,8/2/2013,1656,0,0,0,0,1656,3312
36923,RM-B200C,11/20/2013,1104,0,1104,0,0,1104,3312
38201,RM-B215,8/2/2013,1656,0,0,0,0,1656,3312
38299,RM-B215,11/20/2013,1104,0,1104,0,0,1104,3312
44181,RM-B250,8/2/2013,1656,0,0,0,0,1656,3312
38325,RM-B215,12/16/2013,1104,0,1104,0,0,1101,3309
7601,RM-1116,11/21/2013,1101,0,1104,0,0,1101,3306
36924,RM-B200C,11/21/2013,1101,0,1104,0,0,1101,3306
38300,RM-B215,11/21/2013,1101,0,1104,0,0,1101,3306
2743,RM-1106,8/15/2013,1650,0,0,0,0,1650,3300
2902,RM-1106,2/2/2014,0,0,0,1728,0,1572,3300
7515,RM-1116,8/15/2013,0,0,1650,0,0,1650,3300
8203,RM-1117,8/15/2013,1650,0,0,0,0,1650,3300
8362,RM-1117,2/2/2014,0,0,1572,1728,0,0,3300
9732,RM-1123,2/2/2014,0,1728,1572,0,0,0,3300
13022,RM-1132,2/2/2014,0,0,1572,1728,0,0,3300
13707,RM-1133,2/2/2014,0,1728,1572,0,0,0,3300
18740,RM-1155,8/15/2013,1650,0,1650,0,0,0,3300
23419,RM-1208,8/15/2013,1650,0,0,0,0,1650,3300
24266,RM-1208B,2/2/2014,0,0,1572,1728,0,0,3300
26991,RM-1217,2/2/2014,1572,0,0,1728,0,0,3300
30266,RM-1229,8/15/2013,1650,0,1650,0,0,0,3300
32293,RM-1236,8/15/2013,1650,0,1650,0,0,0,3300
35629,RM-B109,2/2/2014,0,1728,1572,0,0,0,3300
36838,RM-B200C,8/15/2013,0,0,1650,0,0,1650,3300
38214,RM-B215,8/15/2013,1650,0,0,0,0,1650,3300
39587,RM-B222,8/15/2013,1650,0,1650,0,0,0,3300
39746,RM-B222,2/2/2014,1572,0,0,1728,0,0,3300
40275,RM-B224,8/15/2013,0,0,1650,0,0,1650,3300
41807,RM-B230,2/2/2014,0,1728,1572,0,0,0,3300
47601,RM-B275,8/15/2013,0,0,1650,0,0,1650,3300
7590,RM-1116,11/7/2013,1098,0,1101,0,0,1098,3297
36913,RM-B200C,11/7/2013,1098,0,1101,0,0,1098,3297
7538,RM-1116,9/16/2013,0,0,1647,0,0,1647,3294
8226,RM-1117,9/16/2013,1647,0,0,0,0,1647,3294
18763,RM-1155,9/16/2013,1647,0,1647,0,0,0,3294
23442,RM-1208,9/16/2013,1647,0,0,0,0,1647,3294
32316,RM-1236,9/16/2013,1647,0,1647,0,0,0,3294
36861,RM-B200C,9/16/2013,0,0,1647,0,0,1647,3294
38237,RM-B215,9/16/2013,1647,0,0,0,0,1647,3294
47624,RM-B275,9/16/2013,0,0,1647,0,0,1647,3294
2903,RM-1106,2/3/2014,0,0,0,1728,0,1563,3291
7509,RM-1116,8/9/2013,0,0,1644,0,0,1647,3291
7573,RM-1116,10/21/2013,1098,0,1095,0,0,1098,3291
8197,RM-1117,8/9/2013,1644,0,0,0,0,1647,3291
8363,RM-1117,2/3/2014,0,0,1563,1728,0,0,3291
9733,RM-1123,2/3/2014,0,1728,1563,0,0,0,3291
13708,RM-1133,2/3/2014,0,1728,1563,0,0,0,3291
23413,RM-1208,8/9/2013,1644,0,0,0,0,1647,3291
24267,RM-1208B,2/3/2014,0,0,1563,1728,0,0,3291
24390,RM-1208B,6/6/2014,783,0,780,1728,0,0,3291
26992,RM-1217,2/3/2014,1563,0,0,1728,0,0,3291
30324,RM-1229,10/21/2013,1098,0,1095,0,0,1098,3291
35630,RM-B109,2/3/2014,0,1728,1563,0,0,0,3291
36832,RM-B200C,8/9/2013,0,0,1644,0,0,1647,3291
36896,RM-B200C,10/21/2013,1098,0,1095,0,0,1098,3291
38208,RM-B215,8/9/2013,1644,0,0,0,0,1647,3291
39747,RM-B222,2/3/2014,1563,0,0,1728,0,0,3291
40269,RM-B224,8/9/2013,0,0,1644,0,0,1647,3291
41808,RM-B230,2/3/2014,0,1728,1563,0,0,0,3291
44188,RM-B250,8/9/2013,1644,0,0,0,0,1647,3291
7507,RM-1116,8/7/2013,0,0,1644,0,0,1644,3288
18733,RM-1155,8/8/2013,1644,0,1644,0,0,0,3288
18734,RM-1155,8/9/2013,1644,0,1644,0,0,0,3288
24347,RM-1208B,4/24/2014,780,0,780,1728,0,0,3288
30259,RM-1229,8/8/2013,1644,0,1644,0,0,0,3288
30260,RM-1229,8/9/2013,1644,0,1644,0,0,0,3288
32286,RM-1236,8/8/2013,1644,0,1644,0,0,0,3288
32287,RM-1236,8/9/2013,1644,0,1644,0,0,0,3288
36830,RM-B200C,8/7/2013,0,0,1644,0,0,1644,3288
39580,RM-B222,8/8/2013,1644,0,1644,0,0,0,3288
39581,RM-B222,8/9/2013,1644,0,1644,0,0,0,3288
40267,RM-B224,8/7/2013,0,0,1644,0,0,1644,3288
7508,RM-1116,8/8/2013,0,0,1644,0,0,1641,3285
7592,RM-1116,11/9/2013,1095,0,1095,0,0,1095,3285
8195,RM-1117,8/7/2013,1641,0,0,0,0,1644,3285
8196,RM-1117,8/8/2013,1644,0,0,0,0,1641,3285
18732,RM-1155,8/7/2013,1641,0,1644,0,0,0,3285
23411,RM-1208,8/7/2013,1641,0,0,0,0,1644,3285
23412,RM-1208,8/8/2013,1644,0,0,0,0,1641,3285
30258,RM-1229,8/7/2013,1641,0,1644,0,0,0,3285
32285,RM-1236,8/7/2013,1641,0,1644,0,0,0,3285
36831,RM-B200C,8/8/2013,0,0,1644,0,0,1641,3285
36915,RM-B200C,11/9/2013,1095,0,1095,0,0,1095,3285
38206,RM-B215,8/7/2013,1641,0,0,0,0,1644,3285
38207,RM-B215,8/8/2013,1644,0,0,0,0,1641,3285
38291,RM-B215,11/9/2013,1095,0,1095,0,0,1095,3285
40268,RM-B224,8/8/2013,0,0,1644,0,0,1641,3285
44186,RM-B250,8/7/2013,1641,0,0,0,0,1644,3285
44187,RM-B250,8/8/2013,1644,0,0,0,0,1641,3285
7593,RM-1116,11/10/2013,1095,0,1092,0,0,1095,3282
36916,RM-B200C,11/10/2013,1095,0,1092,0,0,1095,3282
38292,RM-B215,11/10/2013,1095,0,1092,0,0,1095,3282
39579,RM-B222,8/7/2013,1641,0,1641,0,0,0,3282
9836,RM-1123,5/17/2014,0,3276,0,0,0,0,3276
38334,RM-B215,12/25/2013,1092,0,1092,0,0,1089,3273
2904,RM-1106,2/4/2014,0,0,0,1728,0,1542,3270
8364,RM-1117,2/4/2014,0,0,1542,1728,0,0,3270
9734,RM-1123,2/4/2014,0,1728,1542,0,0,0,3270
13709,RM-1133,2/4/2014,0,1728,1542,0,0,0,3270
24268,RM-1208B,2/4/2014,0,0,1542,1728,0,0,3270
35631,RM-B109,2/4/2014,0,1728,1542,0,0,0,3270
41809,RM-B230,2/4/2014,0,1728,1542,0,0,0,3270
7492,RM-1116,7/23/2013,0,0,1635,0,0,1632,3267
26993,RM-1217,2/4/2014,1539,0,0,1728,0,0,3267
36815,RM-B200C,7/23/2013,0,0,1635,0,0,1632,3267
39748,RM-B222,2/4/2014,1539,0,0,1728,0,0,3267
40252,RM-B224,7/23/2013,0,0,1635,0,0,1632,3267
18717,RM-1155,7/23/2013,1629,0,1635,0,0,0,3264
29797,RM-1224,4/3/2014,0,0,0,3264,0,0,3264
30243,RM-1229,7/23/2013,1629,0,1635,0,0,0,3264
32270,RM-1236,7/23/2013,1629,0,1635,0,0,0,3264
8180,RM-1117,7/23/2013,1629,0,0,0,0,1632,3261
38191,RM-B215,7/23/2013,1629,0,0,0,0,1632,3261
44171,RM-B250,7/23/2013,1629,0,0,0,0,1632,3261
21681,RM-1200C,5/17/2014,0,1626,0,1632,0,0,3258
36933,RM-B200C,11/30/2013,1083,0,1086,0,0,1083,3252
38309,RM-B215,11/30/2013,1083,0,1086,0,0,1083,3252
7566,RM-1116,10/14/2013,1083,0,1083,0,0,1083,3249
8254,RM-1117,10/14/2013,1083,0,1083,0,0,1083,3249
30317,RM-1229,10/14/2013,1083,0,1083,0,0,1083,3249
36889,RM-B200C,10/14/2013,1083,0,1083,0,0,1083,3249
18765,RM-1155,9/18/2013,1617,0,1617,0,0,0,3234
32318,RM-1236,9/18/2013,1617,0,1617,0,0,0,3234
7525,RM-1116,8/29/2013,0,0,1617,0,0,1614,3231
7540,RM-1116,9/18/2013,0,0,1617,0,0,1614,3231
8228,RM-1117,9/18/2013,1617,0,0,0,0,1614,3231
18750,RM-1155,8/29/2013,1614,0,1617,0,0,0,3231
18878,RM-1155,1/12/2014,873,0,876,1482,0,0,3231
30276,RM-1229,8/29/2013,1614,0,1617,0,0,0,3231
32303,RM-1236,8/29/2013,1614,0,1617,0,0,0,3231
36848,RM-B200C,8/29/2013,0,0,1617,0,0,1614,3231
36863,RM-B200C,9/18/2013,0,0,1617,0,0,1614,3231
38239,RM-B215,9/18/2013,1617,0,0,0,0,1614,3231
47611,RM-B275,8/29/2013,0,0,1617,0,0,1614,3231
47626,RM-B275,9/18/2013,0,0,1617,0,0,1614,3231
2753,RM-1106,8/29/2013,1614,0,0,0,0,1614,3228
8213,RM-1117,8/29/2013,1614,0,0,0,0,1614,3228
23429,RM-1208,8/29/2013,1614,0,0,0,0,1614,3228
23444,RM-1208,9/18/2013,1614,0,0,0,0,1614,3228
38224,RM-B215,8/29/2013,1614,0,0,0,0,1614,3228
39597,RM-B222,8/29/2013,1614,0,1614,0,0,0,3228
23557,RM-1208,1/12/2014,876,1476,0,0,0,873,3225
24323,RM-1208B,3/31/2014,747,0,750,1728,0,0,3225
47597,RM-B275,8/11/2013,0,0,1887,0,0,1338,3225
7561,RM-1116,10/9/2013,1074,0,1074,0,0,1074,3222
7591,RM-1116,11/8/2013,1074,0,1074,0,0,1074,3222
8249,RM-1117,10/9/2013,1074,0,1074,0,0,1074,3222
30312,RM-1229,10/9/2013,1074,0,1074,0,0,1074,3222
36884,RM-B200C,10/9/2013,1074,0,1074,0,0,1074,3222
36914,RM-B200C,11/8/2013,1074,0,1074,0,0,1074,3222
38335,RM-B215,12/26/2013,1074,0,1071,0,0,1074,3219
21636,RM-1200C,4/2/2014,0,1608,0,1608,0,0,3216
29796,RM-1224,4/2/2014,0,0,0,3216,0,0,3216
31136,RM-1230,4/2/2014,0,3216,0,0,0,0,3216
38339,RM-B215,12/30/2013,1071,0,1071,0,0,1074,3216
43802,RM-B240A,4/2/2014,0,3216,0,0,0,0,3216
8365,RM-1117,2/5/2014,0,0,1485,1728,0,0,3213
9735,RM-1123,2/5/2014,0,1728,1485,0,0,0,3213
13710,RM-1133,2/5/2014,0,1728,1485,0,0,0,3213
24269,RM-1208B,2/5/2014,0,0,1485,1728,0,0,3213
26994,RM-1217,2/5/2014,1485,0,0,1728,0,0,3213
35632,RM-B109,2/5/2014,0,1728,1485,0,0,0,3213
39749,RM-B222,2/5/2014,1485,0,0,1728,0,0,3213
41810,RM-B230,2/5/2014,0,1728,1485,0,0,0,3213
2905,RM-1106,2/5/2014,0,0,0,1728,0,1482,3210
20893,RM-1200B,2/3/2014,0,1728,0,1482,0,0,3210
2744,RM-1106,8/16/2013,1599,0,0,0,0,1599,3198
7516,RM-1116,8/16/2013,0,0,1599,0,0,1599,3198
8204,RM-1117,8/16/2013,1599,0,0,0,0,1599,3198
18741,RM-1155,8/16/2013,1599,0,1599,0,0,0,3198
23420,RM-1208,8/16/2013,1599,0,0,0,0,1599,3198
30267,RM-1229,8/16/2013,1599,0,1599,0,0,0,3198
32294,RM-1236,8/16/2013,1599,0,1599,0,0,0,3198
36839,RM-B200C,8/16/2013,0,0,1599,0,0,1599,3198
38215,RM-B215,8/16/2013,1599,0,0,0,0,1599,3198
39588,RM-B222,8/16/2013,1599,0,1599,0,0,0,3198
40276,RM-B224,8/16/2013,0,0,1599,0,0,1599,3198
47602,RM-B275,8/16/2013,0,0,1599,0,0,1599,3198
35079,RM-B103A,2/1/2014,747,0,0,1698,0,747,3192
30572,RM-1229,6/29/2014,0,0,1467,1722,0,0,3189
32599,RM-1236,6/29/2014,0,1722,1467,0,0,0,3189
353,RM-1100A,6/29/2014,1458,1722,0,0,0,0,3180
1723,RM-1102,6/29/2014,1458,1722,0,0,0,0,3180
7560,RM-1116,10/8/2013,1059,0,1062,0,0,1059,3180
8248,RM-1117,10/8/2013,1059,0,1062,0,0,1059,3180
27138,RM-1217,6/29/2014,1458,1722,0,0,0,0,3180
30311,RM-1229,10/8/2013,1059,0,1062,0,0,1059,3180
39893,RM-B222,6/29/2014,1458,0,0,1722,0,0,3180
45869,RM-B260,6/29/2014,1458,0,0,1722,0,0,3180
2910,RM-1106,2/10/2014,0,0,0,1728,0,1440,3168
7603,RM-1116,11/23/2013,1056,0,1056,0,0,1056,3168
8370,RM-1117,2/10/2014,0,0,1440,1728,0,0,3168
9740,RM-1123,2/10/2014,0,1728,1440,0,0,0,3168
13715,RM-1133,2/10/2014,0,1728,1440,0,0,0,3168
24274,RM-1208B,2/10/2014,0,0,1440,1728,0,0,3168
26999,RM-1217,2/10/2014,1440,0,0,1728,0,0,3168
35637,RM-B109,2/10/2014,0,1728,1440,0,0,0,3168
36324,RM-B200B,2/10/2014,0,1728,0,0,0,1440,3168
36926,RM-B200C,11/23/2013,1056,0,1056,0,0,1056,3168
38181,RM-B215,7/12/2013,2421,0,0,0,0,747,3168
38302,RM-B215,11/23/2013,1056,0,1056,0,0,1056,3168
39754,RM-B222,2/10/2014,1440,0,0,1728,0,0,3168
41815,RM-B230,2/10/2014,0,1728,1440,0,0,0,3168
7602,RM-1116,11/22/2013,1056,0,1053,0,0,1056,3165
36925,RM-B200C,11/22/2013,1056,0,1053,0,0,1056,3165
38301,RM-B215,11/22/2013,1056,0,1053,0,0,1056,3165
38327,RM-B215,12/18/2013,1053,0,1056,0,0,1053,3162
38336,RM-B215,12/27/2013,1053,0,1056,0,0,1053,3162
9824,RM-1123,5/5/2014,0,3156,0,0,0,0,3156
29720,RM-1224,1/16/2014,0,1578,0,1578,0,0,3156
36883,RM-B200C,10/8/2013,1032,0,1062,0,0,1059,3153
2906,RM-1106,2/6/2014,0,0,0,1728,0,1416,3144
21669,RM-1200C,5/5/2014,0,1572,0,1572,0,0,3144
22893,RM-1207,2/2/2014,1572,0,0,0,0,1572,3144
24951,RM-1212,2/2/2014,1572,0,1572,0,0,0,3144
26995,RM-1217,2/6/2014,1416,0,0,1728,0,0,3144
28367,RM-1221,2/2/2014,0,0,1572,0,0,1572,3144
36997,RM-B200C,2/2/2014,1572,0,1572,0,0,0,3144
39750,RM-B222,2/6/2014,1416,0,0,1728,0,0,3144
8366,RM-1117,2/6/2014,0,0,1413,1728,0,0,3141
9736,RM-1123,2/6/2014,0,1728,1413,0,0,0,3141
13711,RM-1133,2/6/2014,0,1728,1413,0,0,0,3141
24270,RM-1208B,2/6/2014,0,0,1413,1728,0,0,3141
35633,RM-B109,2/6/2014,0,1728,1413,0,0,0,3141
36934,RM-B200C,12/1/2013,1047,0,1047,0,0,1047,3141
38310,RM-B215,12/1/2013,1047,0,1047,0,0,1047,3141
41811,RM-B230,2/6/2014,0,1728,1413,0,0,0,3141
7606,RM-1116,11/26/2013,1044,0,1047,0,0,1044,3135
36929,RM-B200C,11/26/2013,1044,0,1047,0,0,1044,3135
38305,RM-B215,11/26/2013,1044,0,1047,0,0,1044,3135
24320,RM-1208B,3/28/2014,693,0,711,1728,0,0,3132
44413,RM-B250,4/3/2014,0,1728,1218,186,0,0,3132
22894,RM-1207,2/3/2014,1563,0,0,0,0,1563,3126
24952,RM-1212,2/3/2014,1563,0,1563,0,0,0,3126
28368,RM-1221,2/3/2014,0,0,1563,0,0,1563,3126
36998,RM-B200C,2/3/2014,1563,0,1563,0,0,0,3126
13076,RM-1132,3/28/2014,0,0,693,1728,0,702,3123
17565,RM-1151,3/13/2014,1395,0,0,1728,0,0,3123
38337,RM-B215,12/28/2013,1041,0,1041,0,0,1041,3123
39785,RM-B222,3/13/2014,1395,0,0,1728,0,0,3123
2941,RM-1106,3/13/2014,0,0,0,1728,0,1392,3120
4310,RM-1108,3/13/2014,0,1728,0,0,0,1392,3120
24305,RM-1208B,3/13/2014,0,0,1392,1728,0,0,3120
27718,RM-1218,3/13/2014,0,0,1392,1728,0,0,3120
36355,RM-B200B,3/13/2014,0,1728,0,0,0,1392,3120
2739,RM-1106,8/11/2013,1887,0,0,0,0,1230,3117
7604,RM-1116,11/24/2013,1038,0,1041,0,0,1038,3117
36927,RM-B200C,11/24/2013,1038,0,1041,0,0,1038,3117
38303,RM-B215,11/24/2013,1038,0,1041,0,0,1038,3117
38326,RM-B215,12/17/2013,1038,0,1038,0,0,1041,3117
7563,RM-1116,10/11/2013,1035,0,1038,0,0,1035,3108
8251,RM-1117,10/11/2013,1035,0,1038,0,0,1035,3108
30314,RM-1229,10/11/2013,1035,0,1038,0,0,1035,3108
36886,RM-B200C,10/11/2013,1035,0,1038,0,0,1035,3108
7568,RM-1116,10/16/2013,1035,0,1035,0,0,1035,3105
8256,RM-1117,10/16/2013,1035,0,1035,0,0,1035,3105
30319,RM-1229,10/16/2013,1035,0,1035,0,0,1035,3105
36891,RM-B200C,10/16/2013,1035,0,1035,0,0,1035,3105
38200,RM-B215,8/1/2013,1551,0,0,0,0,1551,3102
44180,RM-B250,8/1/2013,1551,0,0,0,0,1551,3102
7501,RM-1116,8/1/2013,0,0,1548,0,0,1551,3099
8189,RM-1117,8/1/2013,1548,0,0,0,0,1551,3099
23405,RM-1208,8/1/2013,1548,0,0,0,0,1551,3099
36824,RM-B200C,8/1/2013,0,0,1548,0,0,1551,3099
40261,RM-B224,8/1/2013,0,0,1548,0,0,1551,3099
18726,RM-1155,8/1/2013,1548,0,1548,0,0,0,3096
30252,RM-1229,8/1/2013,1548,0,1548,0,0,0,3096
32279,RM-1236,8/1/2013,1548,0,1548,0,0,0,3096
39573,RM-B222,8/1/2013,1548,0,1548,0,0,0,3096
38338,RM-B215,12/29/2013,1029,0,1029,0,0,1029,3087
39610,RM-B222,9/16/2013,1647,0,1440,0,0,0,3087
8261,RM-1117,10/21/2013,1098,0,1095,0,0,891,3084
28369,RM-1221,2/4/2014,0,0,1542,0,0,1542,3084
36942,RM-B200C,12/9/2013,1011,0,1038,0,0,1035,3084
36999,RM-B200C,2/4/2014,1542,0,1542,0,0,0,3084
38318,RM-B215,12/9/2013,1011,0,1038,0,0,1035,3084
22895,RM-1207,2/4/2014,1539,0,0,0,0,1542,3081
24953,RM-1212,2/4/2014,1539,0,1542,0,0,0,3081
13127,RM-1132,5/18/2014,0,0,1338,1728,0,0,3066
27096,RM-1217,5/18/2014,1338,1728,0,0,0,0,3066
30530,RM-1229,5/18/2014,0,0,1338,1728,0,0,3066
32557,RM-1236,5/18/2014,0,1728,1338,0,0,0,3066
35185,RM-B103A,5/18/2014,1338,0,0,1728,0,0,3066
13129,RM-1132,5/20/2014,0,0,1335,1728,0,0,3063
27098,RM-1217,5/20/2014,1335,1728,0,0,0,0,3063
30532,RM-1229,5/20/2014,0,0,1335,1728,0,0,3063
32559,RM-1236,5/20/2014,0,1728,1335,0,0,0,3063
35187,RM-B103A,5/20/2014,1335,0,0,1728,0,0,3063
45829,RM-B260,5/20/2014,1335,0,0,1728,0,0,3063
45827,RM-B260,5/18/2014,1332,0,0,1728,0,0,3060
35077,RM-B103A,1/30/2014,663,0,0,1722,0,666,3051
40285,RM-B224,8/29/2013,0,0,1437,0,0,1614,3051
7500,RM-1116,7/31/2013,0,0,1524,0,0,1521,3045
18725,RM-1155,7/31/2013,1521,0,1524,0,0,0,3045
30251,RM-1229,7/31/2013,1521,0,1524,0,0,0,3045
32278,RM-1236,7/31/2013,1521,0,1524,0,0,0,3045
36823,RM-B200C,7/31/2013,0,0,1524,0,0,1521,3045
40260,RM-B224,7/31/2013,0,0,1524,0,0,1521,3045
8188,RM-1117,7/31/2013,1521,0,0,0,0,1521,3042
23404,RM-1208,7/31/2013,1521,0,0,0,0,1521,3042
38199,RM-B215,7/31/2013,1521,0,0,0,0,1521,3042
39572,RM-B222,7/31/2013,1521,0,1521,0,0,0,3042
44179,RM-B250,7/31/2013,1521,0,0,0,0,1521,3042
7496,RM-1116,7/27/2013,0,0,1518,0,0,1518,3036
8184,RM-1117,7/27/2013,1518,0,0,0,0,1518,3036
8369,RM-1117,2/9/2014,0,0,1308,1728,0,0,3036
9739,RM-1123,2/9/2014,0,1728,1308,0,0,0,3036
13714,RM-1133,2/9/2014,0,1728,1308,0,0,0,3036
18721,RM-1155,7/27/2013,1518,0,1518,0,0,0,3036
24273,RM-1208B,2/9/2014,0,0,1308,1728,0,0,3036
24393,RM-1208B,6/9/2014,654,0,654,1728,0,0,3036
30247,RM-1229,7/27/2013,1518,0,1518,0,0,0,3036
32274,RM-1236,7/27/2013,1518,0,1518,0,0,0,3036
35636,RM-B109,2/9/2014,0,1728,1308,0,0,0,3036
36819,RM-B200C,7/27/2013,0,0,1518,0,0,1518,3036
38195,RM-B215,7/27/2013,1518,0,0,0,0,1518,3036
39568,RM-B222,7/27/2013,1518,0,1518,0,0,0,3036
40256,RM-B224,7/27/2013,0,0,1518,0,0,1518,3036
41814,RM-B230,2/9/2014,0,1728,1308,0,0,0,3036
44175,RM-B250,7/27/2013,1518,0,0,0,0,1518,3036
2909,RM-1106,2/9/2014,0,0,0,1728,0,1305,3033
8367,RM-1117,2/7/2014,0,0,1311,1722,0,0,3033
9737,RM-1123,2/7/2014,0,1722,1311,0,0,0,3033
13712,RM-1133,2/7/2014,0,1722,1311,0,0,0,3033
24271,RM-1208B,2/7/2014,0,0,1311,1722,0,0,3033
26998,RM-1217,2/9/2014,1305,0,0,1728,0,0,3033
35634,RM-B109,2/7/2014,0,1722,1311,0,0,0,3033
39753,RM-B222,2/9/2014,1305,0,0,1728,0,0,3033
41812,RM-B230,2/7/2014,0,1722,1311,0,0,0,3033
2907,RM-1106,2/7/2014,0,0,0,1722,0,1308,3030
7605,RM-1116,11/25/2013,1011,0,1008,0,0,1011,3030
26996,RM-1217,2/7/2014,1308,0,0,1722,0,0,3030
36928,RM-B200C,11/25/2013,1011,0,1008,0,0,1011,3030
38304,RM-B215,11/25/2013,1011,0,1008,0,0,1011,3030
39751,RM-B222,2/7/2014,1308,0,0,1722,0,0,3030
7571,RM-1116,10/19/2013,1008,0,1008,0,0,1008,3024
8259,RM-1117,10/19/2013,1008,0,1008,0,0,1008,3024
23560,RM-1208,1/15/2014,672,1680,0,0,0,672,3024
30322,RM-1229,10/19/2013,1008,0,1008,0,0,1008,3024
36894,RM-B200C,10/19/2013,1008,0,1008,0,0,1008,3024
13131,RM-1132,5/22/2014,0,0,1293,1728,0,0,3021
18881,RM-1155,1/15/2014,672,0,675,1674,0,0,3021
27100,RM-1217,5/22/2014,1293,1728,0,0,0,0,3021
30534,RM-1229,5/22/2014,0,0,1293,1728,0,0,3021
32561,RM-1236,5/22/2014,0,1728,1293,0,0,0,3021
35189,RM-B103A,5/22/2014,1293,0,0,1728,0,0,3021
45831,RM-B260,5/22/2014,1293,0,0,1728,0,0,3021
2943,RM-1106,3/15/2014,0,0,0,1728,0,1290,3018
4312,RM-1108,3/15/2014,0,1728,0,0,0,1290,3018
17567,RM-1151,3/15/2014,1290,0,0,1728,0,0,3018
36357,RM-B200B,3/15/2014,0,1728,0,0,0,1290,3018
39787,RM-B222,3/15/2014,1290,0,0,1728,0,0,3018
8403,RM-1117,3/15/2014,0,1728,1287,0,0,0,3015
24307,RM-1208B,3/15/2014,0,0,1287,1728,0,0,3015
27720,RM-1218,3/15/2014,0,0,1287,1728,0,0,3015
44394,RM-B250,3/15/2014,0,1728,1287,0,0,0,3015
2908,RM-1106,2/8/2014,0,0,0,1728,0,1284,3012
26997,RM-1217,2/8/2014,1284,0,0,1728,0,0,3012
39752,RM-B222,2/8/2014,1284,0,0,1728,0,0,3012
6238,RM-1113,11/1/2013,1503,0,1506,0,0,0,3009
8272,RM-1117,11/1/2013,1503,0,1506,0,0,0,3009
8368,RM-1117,2/8/2014,0,0,1281,1728,0,0,3009
8957,RM-1122,11/1/2013,0,0,1506,0,0,1503,3009
9738,RM-1123,2/8/2014,0,1728,1281,0,0,0,3009
13713,RM-1133,2/8/2014,0,1728,1281,0,0,0,3009
18809,RM-1155,11/1/2013,1503,0,1506,0,0,0,3009
24272,RM-1208B,2/8/2014,0,0,1281,1728,0,0,3009
30335,RM-1229,11/1/2013,0,0,1506,0,0,1503,3009
30536,RM-1229,5/24/2014,0,0,1281,1728,0,0,3009
32362,RM-1236,11/1/2013,1503,0,1506,0,0,0,3009
32563,RM-1236,5/24/2014,0,1728,1281,0,0,0,3009
35635,RM-B109,2/8/2014,0,1728,1281,0,0,0,3009
41813,RM-B230,2/8/2014,0,1728,1281,0,0,0,3009
44263,RM-B250,11/1/2013,1503,0,1506,0,0,0,3009
47670,RM-B275,11/1/2013,0,0,1506,0,0,1503,3009
13133,RM-1132,5/24/2014,0,0,1278,1728,0,0,3006
23488,RM-1208,11/1/2013,1503,0,0,0,0,1503,3006
27102,RM-1217,5/24/2014,1278,1728,0,0,0,0,3006
35191,RM-B103A,5/24/2014,1278,0,0,1728,0,0,3006
38283,RM-B215,11/1/2013,1503,0,0,0,0,1503,3006
45833,RM-B260,5/24/2014,1278,0,0,1728,0,0,3006
30531,RM-1229,5/19/2014,0,0,1275,1728,0,0,3003
32558,RM-1236,5/19/2014,0,1728,1275,0,0,0,3003
13130,RM-1132,5/21/2014,0,0,1272,1728,0,0,3000
27099,RM-1217,5/21/2014,1272,1728,0,0,0,0,3000
30533,RM-1229,5/21/2014,0,0,1272,1728,0,0,3000
32560,RM-1236,5/21/2014,0,1728,1272,0,0,0,3000
35188,RM-B103A,5/21/2014,1272,0,0,1728,0,0,3000
36463,RM-B200B,6/29/2014,0,1722,1278,0,0,0,3000
45830,RM-B260,5/21/2014,1272,0,0,1728,0,0,3000
7572,RM-1116,10/20/2013,999,0,999,0,0,999,2997
8260,RM-1117,10/20/2013,999,0,999,0,0,999,2997
13128,RM-1132,5/19/2014,0,0,1269,1728,0,0,2997
27097,RM-1217,5/19/2014,1269,1728,0,0,0,0,2997
30323,RM-1229,10/20/2013,999,0,999,0,0,999,2997
35186,RM-B103A,5/19/2014,1269,0,0,1728,0,0,2997
36895,RM-B200C,10/20/2013,999,0,999,0,0,999,2997
36935,RM-B200C,12/2/2013,999,0,999,0,0,999,2997
38311,RM-B215,12/2/2013,999,0,999,0,0,999,2997
45828,RM-B260,5/19/2014,1269,0,0,1728,0,0,2997
2913,RM-1106,2/13/2014,0,0,0,1716,0,1275,2991
2920,RM-1106,2/20/2014,0,0,0,1728,0,1263,2991
27002,RM-1217,2/13/2014,1275,0,0,1716,0,0,2991
36327,RM-B200B,2/13/2014,0,1716,0,0,0,1275,2991
36334,RM-B200B,2/20/2014,0,1728,0,0,0,1263,2991
39757,RM-B222,2/13/2014,1275,0,0,1716,0,0,2991
9743,RM-1123,2/13/2014,0,1716,1272,0,0,0,2988
13718,RM-1133,2/13/2014,0,1716,1272,0,0,0,2988
24277,RM-1208B,2/13/2014,0,0,1272,1716,0,0,2988
24284,RM-1208B,2/20/2014,0,0,1260,1728,0,0,2988
27697,RM-1218,2/20/2014,0,0,1260,1728,0,0,2988
35640,RM-B109,2/13/2014,0,1716,1272,0,0,0,2988
39764,RM-B222,2/20/2014,1260,0,0,1728,0,0,2988
41818,RM-B230,2/13/2014,0,1716,1272,0,0,0,2988
248,RM-1100A,3/16/2014,1257,1728,0,0,0,0,2985
2944,RM-1106,3/16/2014,0,0,0,1728,0,1257,2985
4313,RM-1108,3/16/2014,0,1728,0,0,0,1257,2985
8404,RM-1117,3/16/2014,0,1728,1257,0,0,0,2985
17568,RM-1151,3/16/2014,1257,0,0,1728,0,0,2985
24308,RM-1208B,3/16/2014,0,0,1257,1728,0,0,2985
27721,RM-1218,3/16/2014,0,0,1257,1728,0,0,2985
36358,RM-B200B,3/16/2014,0,1728,0,0,0,1257,2985
39788,RM-B222,3/16/2014,1257,0,0,1728,0,0,2985
44395,RM-B250,3/16/2014,0,1728,1257,0,0,0,2985
8372,RM-1117,2/12/2014,0,0,1260,1722,0,0,2982
8445,RM-1117,4/26/2014,0,1728,1254,0,0,0,2982
9742,RM-1123,2/12/2014,0,1722,1260,0,0,0,2982
13105,RM-1132,4/26/2014,0,0,1254,1728,0,0,2982
13717,RM-1133,2/12/2014,0,1722,1260,0,0,0,2982
24276,RM-1208B,2/12/2014,0,0,1260,1722,0,0,2982
27074,RM-1217,4/26/2014,1254,1728,0,0,0,0,2982
27762,RM-1218,4/26/2014,0,0,1254,1728,0,0,2982
32535,RM-1236,4/26/2014,0,1728,1254,0,0,0,2982
35163,RM-B103A,4/26/2014,1254,0,0,1728,0,0,2982
35639,RM-B109,2/12/2014,0,1722,1260,0,0,0,2982
41817,RM-B230,2/12/2014,0,1722,1260,0,0,0,2982
2912,RM-1106,2/12/2014,0,0,0,1722,0,1254,2976
27001,RM-1217,2/12/2014,1254,0,0,1722,0,0,2976
36326,RM-B200B,2/12/2014,0,1722,0,0,0,1254,2976
39756,RM-B222,2/12/2014,1254,0,0,1722,0,0,2976
7569,RM-1116,10/17/2013,990,0,993,0,0,990,2973
8257,RM-1117,10/17/2013,990,0,993,0,0,990,2973
30320,RM-1229,10/17/2013,990,0,993,0,0,990,2973
36892,RM-B200C,10/17/2013,990,0,993,0,0,990,2973
24954,RM-1212,2/5/2014,1485,0,1485,0,0,0,2970
6990,RM-1115,2/5/2014,1485,0,0,0,0,1482,2967
22896,RM-1207,2/5/2014,1485,0,0,0,0,1482,2967
37000,RM-B200C,2/5/2014,1482,0,1485,0,0,0,2967
36936,RM-B200C,12/3/2013,987,0,987,0,0,990,2964
38312,RM-B215,12/3/2013,987,0,987,0,0,990,2964
7493,RM-1116,7/24/2013,0,0,1482,0,0,1479,2961
9744,RM-1123,2/14/2014,0,1728,1233,0,0,0,2961
13134,RM-1132,5/25/2014,0,0,1233,1728,0,0,2961
13719,RM-1133,2/14/2014,0,1728,1233,0,0,0,2961
24278,RM-1208B,2/14/2014,0,0,1233,1728,0,0,2961
27103,RM-1217,5/25/2014,1233,1728,0,0,0,0,2961
30537,RM-1229,5/25/2014,0,0,1233,1728,0,0,2961
32564,RM-1236,5/25/2014,0,1728,1233,0,0,0,2961
35192,RM-B103A,5/25/2014,1233,0,0,1728,0,0,2961
36816,RM-B200C,7/24/2013,0,0,1482,0,0,1479,2961
40253,RM-B224,7/24/2013,0,0,1482,0,0,1479,2961
41819,RM-B230,2/14/2014,0,1728,1233,0,0,0,2961
45834,RM-B260,5/25/2014,1233,0,0,1728,0,0,2961
2914,RM-1106,2/14/2014,0,0,0,1728,0,1230,2958
8402,RM-1117,3/14/2014,0,1728,1230,0,0,0,2958
18718,RM-1155,7/24/2013,1476,0,1482,0,0,0,2958
24306,RM-1208B,3/14/2014,0,0,1230,1728,0,0,2958
27003,RM-1217,2/14/2014,1230,0,0,1728,0,0,2958
27719,RM-1218,3/14/2014,0,0,1230,1728,0,0,2958
29716,RM-1224,1/12/2014,0,1476,0,1482,0,0,2958
30244,RM-1229,7/24/2013,1476,0,1482,0,0,0,2958
32271,RM-1236,7/24/2013,1476,0,1482,0,0,0,2958
36328,RM-B200B,2/14/2014,0,1728,0,0,0,1230,2958
39758,RM-B222,2/14/2014,1230,0,0,1728,0,0,2958
44393,RM-B250,3/14/2014,0,1728,1230,0,0,0,2958
8181,RM-1117,7/24/2013,1476,0,0,0,0,1479,2955
38192,RM-B215,7/24/2013,1476,0,0,0,0,1479,2955
44172,RM-B250,7/24/2013,1476,0,0,0,0,1479,2955
39565,RM-B222,7/24/2013,1476,0,1476,0,0,0,2952
266,RM-1100A,4/3/2014,1221,1728,0,0,0,0,2949
17586,RM-1151,4/3/2014,1221,0,0,1728,0,0,2949
39806,RM-B222,4/3/2014,1221,0,0,1728,0,0,2949
45098,RM-B250A,4/3/2014,1221,0,0,1728,0,0,2949
2942,RM-1106,3/14/2014,0,0,0,1728,0,1218,2946
4311,RM-1108,3/14/2014,0,1728,0,0,0,1218,2946
8422,RM-1117,4/3/2014,0,1728,1218,0,0,0,2946
13082,RM-1132,4/3/2014,0,0,1218,1728,0,0,2946
17566,RM-1151,3/14/2014,1218,0,0,1728,0,0,2946
18877,RM-1155,1/11/2014,831,0,831,1284,0,0,2946
20871,RM-1200B,1/12/2014,0,1470,0,1476,0,0,2946
27739,RM-1218,4/3/2014,0,0,1218,1728,0,0,2946
30535,RM-1229,5/23/2014,0,0,1218,1728,0,0,2946
32562,RM-1236,5/23/2014,0,1728,1218,0,0,0,2946
36356,RM-B200B,3/14/2014,0,1728,0,0,0,1218,2946
39786,RM-B222,3/14/2014,1218,0,0,1728,0,0,2946
23556,RM-1208,1/11/2014,828,1284,0,0,0,831,2943
24391,RM-1208B,6/7/2014,600,0,615,1728,0,0,2943
8405,RM-1117,3/17/2014,0,1728,1212,0,0,0,2940
24309,RM-1208B,3/17/2014,0,0,1212,1728,0,0,2940
27722,RM-1218,3/17/2014,0,0,1212,1728,0,0,2940
44396,RM-B250,3/17/2014,0,1728,1212,0,0,0,2940
249,RM-1100A,3/17/2014,1209,1728,0,0,0,0,2937
2945,RM-1106,3/17/2014,0,0,0,1728,0,1209,2937
4314,RM-1108,3/17/2014,0,1728,0,0,0,1209,2937
17569,RM-1151,3/17/2014,1209,0,0,1728,0,0,2937
36359,RM-B200B,3/17/2014,0,1728,0,0,0,1209,2937
39789,RM-B222,3/17/2014,1209,0,0,1728,0,0,2937
7539,RM-1116,9/17/2013,0,0,1476,0,0,1458,2934
36862,RM-B200C,9/17/2013,0,0,1476,0,0,1458,2934
47625,RM-B275,9/17/2013,0,0,1476,0,0,1458,2934
255,RM-1100A,3/23/2014,1203,1728,0,0,0,0,2931
2951,RM-1106,3/23/2014,0,0,0,1728,0,1203,2931
4320,RM-1108,3/23/2014,0,1728,0,0,0,1203,2931
8411,RM-1117,3/23/2014,0,1728,1203,0,0,0,2931
17575,RM-1151,3/23/2014,1203,0,0,1728,0,0,2931
24315,RM-1208B,3/23/2014,0,0,1203,1728,0,0,2931
27728,RM-1218,3/23/2014,0,0,1203,1728,0,0,2931
36365,RM-B200B,3/23/2014,0,1728,0,0,0,1203,2931
39795,RM-B222,3/23/2014,1203,0,0,1728,0,0,2931
44402,RM-B250,3/23/2014,0,1728,1203,0,0,0,2931
2915,RM-1106,2/15/2014,0,0,0,1728,0,1200,2928
8446,RM-1117,4/27/2014,0,1728,1200,0,0,0,2928
13106,RM-1132,4/27/2014,0,0,1200,1728,0,0,2928
18764,RM-1155,9/17/2013,1452,0,1476,0,0,0,2928
27075,RM-1217,4/27/2014,1200,1728,0,0,0,0,2928
27763,RM-1218,4/27/2014,0,0,1200,1728,0,0,2928
32536,RM-1236,4/27/2014,0,1728,1200,0,0,0,2928
35164,RM-B103A,4/27/2014,1200,0,0,1728,0,0,2928
36329,RM-B200B,2/15/2014,0,1728,0,0,0,1200,2928
9745,RM-1123,2/15/2014,0,1728,1197,0,0,0,2925
13720,RM-1133,2/15/2014,0,1728,1197,0,0,0,2925
24279,RM-1208B,2/15/2014,0,0,1197,1728,0,0,2925
32317,RM-1236,9/17/2013,1452,0,1473,0,0,0,2925
35776,RM-B109,6/29/2014,1458,0,1467,0,0,0,2925
39759,RM-B222,2/15/2014,1197,0,0,1728,0,0,2925
41820,RM-B230,2/15/2014,0,1728,1197,0,0,0,2925
27101,RM-1217,5/23/2014,1191,1728,0,0,0,0,2919
35190,RM-B103A,5/23/2014,1191,0,0,1728,0,0,2919
45832,RM-B260,5/23/2014,1191,0,0,1728,0,0,2919
13132,RM-1132,5/23/2014,0,0,1188,1728,0,0,2916
20875,RM-1200B,1/16/2014,0,1578,0,1338,0,0,2916
36940,RM-B200C,12/7/2013,972,0,972,0,0,972,2916
38316,RM-B215,12/7/2013,972,0,972,0,0,972,2916
6237,RM-1113,10/31/2013,1458,0,1455,0,0,0,2913
8271,RM-1117,10/31/2013,1458,0,1455,0,0,0,2913
18808,RM-1155,10/31/2013,1458,0,1455,0,0,0,2913
23487,RM-1208,10/31/2013,1458,0,0,0,0,1455,2913
32361,RM-1236,10/31/2013,1458,0,1455,0,0,0,2913
38282,RM-B215,10/31/2013,1458,0,0,0,0,1455,2913
8227,RM-1117,9/17/2013,1452,0,0,0,0,1458,2910
8956,RM-1122,10/31/2013,0,0,1455,0,0,1455,2910
24394,RM-1208B,6/10/2014,588,0,594,1728,0,0,2910
30334,RM-1229,10/31/2013,0,0,1455,0,0,1455,2910
38238,RM-B215,9/17/2013,1452,0,0,0,0,1458,2910
44262,RM-B250,10/31/2013,1455,0,1455,0,0,0,2910
47669,RM-B275,10/31/2013,0,0,1455,0,0,1455,2910
23443,RM-1208,9/17/2013,1449,0,0,0,0,1458,2907
39765,RM-B222,2/21/2014,1179,0,0,1728,0,0,2907
2921,RM-1106,2/21/2014,0,0,0,1728,0,1176,2904
9798,RM-1123,4/9/2014,0,2904,0,0,0,0,2904
23561,RM-1208,1/16/2014,660,1584,0,0,0,660,2904
24285,RM-1208B,2/21/2014,0,0,1176,1728,0,0,2904
27698,RM-1218,2/21/2014,0,0,1176,1728,0,0,2904
36335,RM-B200B,2/21/2014,0,1728,0,0,0,1176,2904
8423,RM-1117,4/4/2014,0,1728,1170,0,0,0,2898
13083,RM-1132,4/4/2014,0,0,1170,1728,0,0,2898
27740,RM-1218,4/4/2014,0,0,1170,1728,0,0,2898
36939,RM-B200C,12/6/2013,966,0,966,0,0,966,2898
38315,RM-B215,12/6/2013,966,0,966,0,0,966,2898
267,RM-1100A,4/4/2014,1167,1728,0,0,0,0,2895
17587,RM-1151,4/4/2014,1167,0,0,1728,0,0,2895
39807,RM-B222,4/4/2014,1167,0,0,1728,0,0,2895
45099,RM-B250A,4/4/2014,1167,0,0,1728,0,0,2895
8412,RM-1117,3/24/2014,0,1728,1161,0,0,0,2889
18882,RM-1155,1/16/2014,660,0,657,1572,0,0,2889
27729,RM-1218,3/24/2014,0,0,1161,1728,0,0,2889
36941,RM-B200C,12/8/2013,963,0,963,0,0,963,2889
38317,RM-B215,12/8/2013,963,0,963,0,0,963,2889
44403,RM-B250,3/24/2014,0,1728,1161,0,0,0,2889
254,RM-1100A,3/22/2014,1158,1728,0,0,0,0,2886
256,RM-1100A,3/24/2014,1158,1728,0,0,0,0,2886
2950,RM-1106,3/22/2014,0,0,0,1728,0,1158,2886
2952,RM-1106,3/24/2014,0,0,0,1728,0,1158,2886
4319,RM-1108,3/22/2014,0,1728,0,0,0,1158,2886
4321,RM-1108,3/24/2014,0,1728,0,0,0,1158,2886
9746,RM-1123,2/16/2014,0,1728,1158,0,0,0,2886
13721,RM-1133,2/16/2014,0,1728,1158,0,0,0,2886
17574,RM-1151,3/22/2014,1158,0,0,1728,0,0,2886
17576,RM-1151,3/24/2014,1158,0,0,1728,0,0,2886
24280,RM-1208B,2/16/2014,0,0,1158,1728,0,0,2886
27076,RM-1217,4/28/2014,1158,1728,0,0,0,0,2886
35165,RM-B103A,4/28/2014,1158,0,0,1728,0,0,2886
36364,RM-B200B,3/22/2014,0,1728,0,0,0,1158,2886
36366,RM-B200B,3/24/2014,0,1728,0,0,0,1158,2886
39760,RM-B222,2/16/2014,1158,0,0,1728,0,0,2886
39794,RM-B222,3/22/2014,1158,0,0,1728,0,0,2886
39796,RM-B222,3/24/2014,1158,0,0,1728,0,0,2886
2916,RM-1106,2/16/2014,0,0,0,1728,0,1155,2883
8410,RM-1117,3/22/2014,0,1728,1155,0,0,0,2883
8447,RM-1117,4/28/2014,0,1728,1155,0,0,0,2883
13107,RM-1132,4/28/2014,0,0,1155,1728,0,0,2883
24314,RM-1208B,3/22/2014,0,0,1155,1728,0,0,2883
27727,RM-1218,3/22/2014,0,0,1155,1728,0,0,2883
27764,RM-1218,4/28/2014,0,0,1155,1728,0,0,2883
32537,RM-1236,4/28/2014,0,1728,1155,0,0,0,2883
36330,RM-B200B,2/16/2014,0,1728,0,0,0,1155,2883
44401,RM-B250,3/22/2014,0,1728,1155,0,0,0,2883
6995,RM-1115,2/10/2014,1440,0,0,0,0,1440,2880
19583,RM-1156,2/10/2014,1440,0,0,0,0,1440,2880
22901,RM-1207,2/10/2014,1440,0,0,0,0,1440,2880
24959,RM-1212,2/10/2014,1440,0,1440,0,0,0,2880
37005,RM-B200C,2/10/2014,1440,0,1440,0,0,0,2880
1692,RM-1102,5/29/2014,1149,1728,0,0,0,0,2877
2922,RM-1106,2/22/2014,0,0,0,1728,0,1149,2877
7498,RM-1116,7/29/2013,0,0,1440,0,0,1437,2877
13138,RM-1132,5/29/2014,0,0,1149,1728,0,0,2877
24286,RM-1208B,2/22/2014,0,0,1149,1728,0,0,2877
27107,RM-1217,5/29/2014,1149,1728,0,0,0,0,2877
27699,RM-1218,2/22/2014,0,0,1149,1728,0,0,2877
30541,RM-1229,5/29/2014,0,0,1149,1728,0,0,2877
32568,RM-1236,5/29/2014,0,1728,1149,0,0,0,2877
35196,RM-B103A,5/29/2014,1149,0,0,1728,0,0,2877
36336,RM-B200B,2/22/2014,0,1728,0,0,0,1149,2877
36821,RM-B200C,7/29/2013,0,0,1440,0,0,1437,2877
39862,RM-B222,5/29/2014,1149,0,0,1728,0,0,2877
40258,RM-B224,7/29/2013,0,0,1440,0,0,1437,2877
45838,RM-B260,5/29/2014,1149,0,0,1728,0,0,2877
250,RM-1100A,3/18/2014,1146,1728,0,0,0,0,2874
268,RM-1100A,4/5/2014,1146,1728,0,0,0,0,2874
323,RM-1100A,5/30/2014,1146,1728,0,0,0,0,2874
1693,RM-1102,5/30/2014,1146,1728,0,0,0,0,2874
2946,RM-1106,3/18/2014,0,0,0,1728,0,1146,2874
4315,RM-1108,3/18/2014,0,1728,0,0,0,1146,2874
8406,RM-1117,3/18/2014,0,1728,1146,0,0,0,2874
13084,RM-1132,4/5/2014,0,0,1146,1728,0,0,2874
13135,RM-1132,5/26/2014,0,0,1146,1728,0,0,2874
13139,RM-1132,5/30/2014,0,0,1146,1728,0,0,2874
17570,RM-1151,3/18/2014,1146,0,0,1728,0,0,2874
17588,RM-1151,4/5/2014,1146,0,0,1728,0,0,2874
18723,RM-1155,7/29/2013,1434,0,1440,0,0,0,2874
24310,RM-1208B,3/18/2014,0,0,1146,1728,0,0,2874
27104,RM-1217,5/26/2014,1146,1728,0,0,0,0,2874
27108,RM-1217,5/30/2014,1146,1728,0,0,0,0,2874
27723,RM-1218,3/18/2014,0,0,1146,1728,0,0,2874
30249,RM-1229,7/29/2013,1434,0,1440,0,0,0,2874
30538,RM-1229,5/26/2014,0,0,1146,1728,0,0,2874
30542,RM-1229,5/30/2014,0,0,1146,1728,0,0,2874
32276,RM-1236,7/29/2013,1434,0,1440,0,0,0,2874
32565,RM-1236,5/26/2014,0,1728,1146,0,0,0,2874
32569,RM-1236,5/30/2014,0,1728,1146,0,0,0,2874
35193,RM-B103A,5/26/2014,1146,0,0,1728,0,0,2874
35197,RM-B103A,5/30/2014,1146,0,0,1728,0,0,2874
36360,RM-B200B,3/18/2014,0,1728,0,0,0,1146,2874
39766,RM-B222,2/22/2014,1146,0,0,1728,0,0,2874
39790,RM-B222,3/18/2014,1146,0,0,1728,0,0,2874
39808,RM-B222,4/5/2014,1146,0,0,1728,0,0,2874
39859,RM-B222,5/26/2014,1146,0,0,1728,0,0,2874
39863,RM-B222,5/30/2014,1146,0,0,1728,0,0,2874
44397,RM-B250,3/18/2014,0,1728,1146,0,0,0,2874
45100,RM-B250A,4/5/2014,1146,0,0,1728,0,0,2874
45835,RM-B260,5/26/2014,1146,0,0,1728,0,0,2874
45839,RM-B260,5/30/2014,1146,0,0,1728,0,0,2874
8424,RM-1117,4/5/2014,0,1728,1143,0,0,0,2871
27741,RM-1218,4/5/2014,0,0,1143,1728,0,0,2871
38197,RM-B215,7/29/2013,1434,0,0,0,0,1437,2871
44177,RM-B250,7/29/2013,1434,0,0,0,0,1437,2871
8186,RM-1117,7/29/2013,1434,0,0,0,0,1434,2868
23402,RM-1208,7/29/2013,1428,0,0,0,0,1434,2862
39570,RM-B222,7/29/2013,1434,0,1428,0,0,0,2862
39767,RM-B222,2/23/2014,1134,0,0,1728,0,0,2862
2923,RM-1106,2/23/2014,0,0,0,1728,0,1131,2859
24287,RM-1208B,2/23/2014,0,0,1131,1728,0,0,2859
27700,RM-1218,2/23/2014,0,0,1131,1728,0,0,2859
36337,RM-B200B,2/23/2014,0,1728,0,0,0,1131,2859
27105,RM-1217,5/27/2014,1128,1728,0,0,0,0,2856
30539,RM-1229,5/27/2014,0,0,1128,1728,0,0,2856
32566,RM-1236,5/27/2014,0,1728,1128,0,0,0,2856
35194,RM-B103A,5/27/2014,1128,0,0,1728,0,0,2856
39860,RM-B222,5/27/2014,1128,0,0,1728,0,0,2856
45836,RM-B260,5/27/2014,1128,0,0,1728,0,0,2856
324,RM-1100A,5/31/2014,1125,1728,0,0,0,0,2853
1694,RM-1102,5/31/2014,1125,1728,0,0,0,0,2853
13140,RM-1132,5/31/2014,0,0,1125,1728,0,0,2853
27109,RM-1217,5/31/2014,1125,1728,0,0,0,0,2853
35198,RM-B103A,5/31/2014,1125,0,0,1728,0,0,2853
39864,RM-B222,5/31/2014,1125,0,0,1728,0,0,2853
45840,RM-B260,5/31/2014,1125,0,0,1728,0,0,2853
327,RM-1100A,6/3/2014,1122,1728,0,0,0,0,2850
1697,RM-1102,6/3/2014,1122,1728,0,0,0,0,2850
13109,RM-1132,4/30/2014,0,0,1122,1728,0,0,2850
13136,RM-1132,5/27/2014,0,0,1122,1728,0,0,2850
13143,RM-1132,6/3/2014,0,0,1122,1728,0,0,2850
27078,RM-1217,4/30/2014,1122,1728,0,0,0,0,2850
27112,RM-1217,6/3/2014,1122,1728,0,0,0,0,2850
27766,RM-1218,4/30/2014,0,0,1122,1728,0,0,2850
30543,RM-1229,5/31/2014,0,0,1122,1728,0,0,2850
30546,RM-1229,6/3/2014,0,0,1122,1728,0,0,2850
32539,RM-1236,4/30/2014,0,1728,1122,0,0,0,2850
32570,RM-1236,5/31/2014,0,1728,1122,0,0,0,2850
32573,RM-1236,6/3/2014,0,1728,1122,0,0,0,2850
35167,RM-B103A,4/30/2014,1122,0,0,1728,0,0,2850
39867,RM-B222,6/3/2014,1122,0,0,1728,0,0,2850
45843,RM-B260,6/3/2014,1122,0,0,1728,0,0,2850
262,RM-1100A,3/30/2014,1116,1728,0,0,0,0,2844
13078,RM-1132,3/30/2014,0,0,1116,1728,0,0,2844
17582,RM-1151,3/30/2014,1116,0,0,1728,0,0,2844
39802,RM-B222,3/30/2014,1116,0,0,1728,0,0,2844
8418,RM-1117,3/30/2014,0,1728,1113,0,0,0,2841
27735,RM-1218,3/30/2014,0,0,1113,1728,0,0,2841
44409,RM-B250,3/30/2014,0,1728,1113,0,0,0,2841
2917,RM-1106,2/17/2014,0,0,0,1728,0,1107,2835
9747,RM-1123,2/17/2014,0,1728,1107,0,0,0,2835
24281,RM-1208B,2/17/2014,0,0,1107,1728,0,0,2835
27694,RM-1218,2/17/2014,0,0,1107,1728,0,0,2835
36331,RM-B200B,2/17/2014,0,1728,0,0,0,1107,2835
39761,RM-B222,2/17/2014,1107,0,0,1728,0,0,2835
6991,RM-1115,2/6/2014,1416,0,0,0,0,1416,2832
8194,RM-1117,8/6/2013,1416,0,0,0,0,1416,2832
19579,RM-1156,2/6/2014,1416,0,0,0,0,1416,2832
22897,RM-1207,2/6/2014,1416,0,0,0,0,1416,2832
23410,RM-1208,8/6/2013,1416,0,0,0,0,1416,2832
38205,RM-B215,8/6/2013,1416,0,0,0,0,1416,2832
39578,RM-B222,8/6/2013,1416,0,1416,0,0,0,2832
44185,RM-B250,8/6/2013,1416,0,0,0,0,1416,2832
7506,RM-1116,8/6/2013,0,0,1413,0,0,1416,2829
17621,RM-1151,5/8/2014,981,0,0,1848,0,0,2829
18731,RM-1155,8/6/2013,1416,0,1413,0,0,0,2829
24955,RM-1212,2/6/2014,1416,0,1413,0,0,0,2829
30257,RM-1229,8/6/2013,1416,0,1413,0,0,0,2829
32284,RM-1236,8/6/2013,1416,0,1413,0,0,0,2829
36829,RM-B200C,8/6/2013,0,0,1413,0,0,1416,2829
37001,RM-B200C,2/6/2014,1416,0,1413,0,0,0,2829
40266,RM-B224,8/6/2013,0,0,1413,0,0,1416,2829
7527,RM-1116,9/4/2013,0,0,1413,0,0,1410,2823
7554,RM-1116,10/2/2013,441,0,1191,0,0,1191,2823
13110,RM-1132,5/1/2014,0,0,1095,1728,0,0,2823
18752,RM-1155,9/4/2013,1410,0,1413,0,0,0,2823
27079,RM-1217,5/1/2014,1095,1728,0,0,0,0,2823
27767,RM-1218,5/1/2014,0,0,1095,1728,0,0,2823
30278,RM-1229,9/4/2013,1410,0,1413,0,0,0,2823
30513,RM-1229,5/1/2014,0,0,1095,1728,0,0,2823
30529,RM-1229,5/17/2014,0,0,1185,1638,0,0,2823
32305,RM-1236,9/4/2013,1410,0,1413,0,0,0,2823
32540,RM-1236,5/1/2014,0,1728,1095,0,0,0,2823
35168,RM-B103A,5/1/2014,1095,0,0,1728,0,0,2823
36850,RM-B200C,9/4/2013,0,0,1413,0,0,1410,2823
47613,RM-B275,9/4/2013,0,0,1413,0,0,1410,2823
258,RM-1100A,3/26/2014,1092,1728,0,0,0,0,2820
2755,RM-1106,9/4/2013,1410,0,0,0,0,1410,2820
2954,RM-1106,3/26/2014,0,0,0,1728,0,1092,2820
4323,RM-1108,3/26/2014,0,1728,0,0,0,1092,2820
8215,RM-1117,9/4/2013,1410,0,0,0,0,1410,2820
8414,RM-1117,3/26/2014,0,1728,1092,0,0,0,2820
17578,RM-1151,3/26/2014,1092,0,0,1728,0,0,2820
23431,RM-1208,9/4/2013,1410,0,0,0,0,1410,2820
27731,RM-1218,3/26/2014,0,0,1092,1728,0,0,2820
36368,RM-B200B,3/26/2014,0,1728,0,0,0,1092,2820
38226,RM-B215,9/4/2013,1410,0,0,0,0,1410,2820
39599,RM-B222,9/4/2013,1410,0,1410,0,0,0,2820
39798,RM-B222,3/26/2014,1092,0,0,1728,0,0,2820
44405,RM-B250,3/26/2014,0,1728,1092,0,0,0,2820
8425,RM-1117,4/6/2014,0,1728,1089,0,0,0,2817
23673,RM-1208,5/8/2014,981,1836,0,0,0,0,2817
27742,RM-1218,4/6/2014,0,0,1089,1728,0,0,2817
32556,RM-1236,5/17/2014,0,1632,1185,0,0,0,2817
269,RM-1100A,4/6/2014,1086,1728,0,0,0,0,2814
13085,RM-1132,4/6/2014,0,0,1086,1728,0,0,2814
13126,RM-1132,5/17/2014,0,0,1164,1650,0,0,2814
17589,RM-1151,4/6/2014,1086,0,0,1728,0,0,2814
39809,RM-B222,4/6/2014,1086,0,0,1728,0,0,2814
45101,RM-B250A,4/6/2014,1086,0,0,1728,0,0,2814
325,RM-1100A,6/1/2014,1083,1728,0,0,0,0,2811
1695,RM-1102,6/1/2014,1083,1728,0,0,0,0,2811
8371,RM-1117,2/11/2014,0,0,1083,1728,0,0,2811
9741,RM-1123,2/11/2014,0,1728,1083,0,0,0,2811
13141,RM-1132,6/1/2014,0,0,1083,1728,0,0,2811
13716,RM-1133,2/11/2014,0,1728,1083,0,0,0,2811
24275,RM-1208B,2/11/2014,0,0,1083,1728,0,0,2811
27110,RM-1217,6/1/2014,1083,1728,0,0,0,0,2811
30544,RM-1229,6/1/2014,0,0,1083,1728,0,0,2811
30545,RM-1229,6/2/2014,0,0,1083,1728,0,0,2811
32571,RM-1236,6/1/2014,0,1728,1083,0,0,0,2811
32572,RM-1236,6/2/2014,0,1728,1083,0,0,0,2811
35199,RM-B103A,6/1/2014,1083,0,0,1728,0,0,2811
35638,RM-B109,2/11/2014,0,1728,1083,0,0,0,2811
39865,RM-B222,6/1/2014,1083,0,0,1728,0,0,2811
41816,RM-B230,2/11/2014,0,1728,1083,0,0,0,2811
45841,RM-B260,6/1/2014,1083,0,0,1728,0,0,2811
326,RM-1100A,6/2/2014,1080,1728,0,0,0,0,2808
1696,RM-1102,6/2/2014,1080,1728,0,0,0,0,2808
7543,RM-1116,9/21/2013,0,0,1404,0,0,1404,2808
8231,RM-1117,9/21/2013,1404,0,0,0,0,1404,2808
13142,RM-1132,6/2/2014,0,0,1080,1728,0,0,2808
18768,RM-1155,9/21/2013,1404,0,1404,0,0,0,2808
23447,RM-1208,9/21/2013,1404,0,0,0,0,1404,2808
27111,RM-1217,6/2/2014,1080,1728,0,0,0,0,2808
32321,RM-1236,9/21/2013,1404,0,1404,0,0,0,2808
36866,RM-B200C,9/21/2013,0,0,1404,0,0,1404,2808
38242,RM-B215,9/21/2013,1404,0,0,0,0,1404,2808
39866,RM-B222,6/2/2014,1080,0,0,1728,0,0,2808
45842,RM-B260,6/2/2014,1080,0,0,1728,0,0,2808
47629,RM-B275,9/21/2013,0,0,1404,0,0,1404,2808
24288,RM-1208B,2/24/2014,0,0,1077,1728,0,0,2805
27701,RM-1218,2/24/2014,0,0,1077,1728,0,0,2805
2924,RM-1106,2/24/2014,0,0,0,1728,0,1074,2802
27095,RM-1217,5/17/2014,1164,1638,0,0,0,0,2802
36338,RM-B200B,2/24/2014,0,1728,0,0,0,1074,2802
39768,RM-B222,2/24/2014,1074,0,0,1728,0,0,2802
7570,RM-1116,10/18/2013,933,0,933,0,0,933,2799
8258,RM-1117,10/18/2013,933,0,933,0,0,933,2799
30321,RM-1229,10/18/2013,933,0,933,0,0,933,2799
36893,RM-B200C,10/18/2013,933,0,933,0,0,933,2799
2918,RM-1106,2/18/2014,0,0,0,1728,0,1068,2796
9748,RM-1123,2/18/2014,0,1728,1068,0,0,0,2796
21708,RM-1200C,6/13/2014,0,1068,0,1728,0,0,2796
24282,RM-1208B,2/18/2014,0,0,1068,1728,0,0,2796
27695,RM-1218,2/18/2014,0,0,1068,1728,0,0,2796
36332,RM-B200B,2/18/2014,0,1728,0,0,0,1068,2796
39762,RM-B222,2/18/2014,1068,0,0,1728,0,0,2796
2911,RM-1106,2/11/2014,0,0,0,1728,0,1065,2793
2930,RM-1106,3/2/2014,0,0,0,1722,0,1071,2793
17554,RM-1151,3/2/2014,1071,0,0,1722,0,0,2793
24294,RM-1208B,3/2/2014,0,0,1071,1722,0,0,2793
27707,RM-1218,3/2/2014,0,0,1071,1722,0,0,2793
36325,RM-B200B,2/11/2014,0,1728,0,0,0,1065,2793
36344,RM-B200B,3/2/2014,0,1722,0,0,0,1071,2793
39774,RM-B222,3/2/2014,1071,0,0,1722,0,0,2793
2940,RM-1106,3/12/2014,0,0,0,1728,0,1062,2790
4309,RM-1108,3/12/2014,0,1728,0,0,0,1062,2790
7026,RM-1115,3/13/2014,1395,0,0,0,0,1395,2790
22932,RM-1207,3/13/2014,1395,0,0,0,0,1395,2790
24304,RM-1208B,3/12/2014,0,0,1062,1728,0,0,2790
27717,RM-1218,3/12/2014,0,0,1062,1728,0,0,2790
36354,RM-B200B,3/12/2014,0,1728,0,0,0,1062,2790
270,RM-1100A,4/7/2014,1059,1728,0,0,0,0,2787
13086,RM-1132,4/7/2014,0,0,1059,1728,0,0,2787
13111,RM-1132,5/2/2014,0,0,1059,1728,0,0,2787
17564,RM-1151,3/12/2014,1059,0,0,1728,0,0,2787
17590,RM-1151,4/7/2014,1059,0,0,1728,0,0,2787
17624,RM-1151,5/11/2014,945,0,0,1842,0,0,2787
18938,RM-1155,3/13/2014,1395,0,0,0,0,1392,2787
19614,RM-1156,3/13/2014,1395,0,0,0,0,1392,2787
24990,RM-1212,3/13/2014,1395,0,1392,0,0,0,2787
27080,RM-1217,5/2/2014,1059,1728,0,0,0,0,2787
27768,RM-1218,5/2/2014,0,0,1059,1728,0,0,2787
30514,RM-1229,5/2/2014,0,0,1059,1728,0,0,2787
32541,RM-1236,5/2/2014,0,1728,1059,0,0,0,2787
35169,RM-B103A,5/2/2014,1059,0,0,1728,0,0,2787
37036,RM-B200C,3/13/2014,1395,0,1392,0,0,0,2787
39784,RM-B222,3/12/2014,1059,0,0,1728,0,0,2787
39810,RM-B222,4/7/2014,1059,0,0,1728,0,0,2787
45102,RM-B250A,4/7/2014,1059,0,0,1728,0,0,2787
259,RM-1100A,3/27/2014,1080,1704,0,0,0,0,2784
8415,RM-1117,3/27/2014,0,1704,1080,0,0,0,2784
8426,RM-1117,4/7/2014,0,1728,1056,0,0,0,2784
17579,RM-1151,3/27/2014,1080,0,0,1704,0,0,2784
24392,RM-1208B,6/8/2014,525,0,531,1728,0,0,2784
27732,RM-1218,3/27/2014,0,0,1080,1704,0,0,2784
27743,RM-1218,4/7/2014,0,0,1056,1728,0,0,2784
35184,RM-B103A,5/17/2014,1164,0,0,1620,0,0,2784
39799,RM-B222,3/27/2014,1080,0,0,1704,0,0,2784
44406,RM-B250,3/27/2014,0,1704,1080,0,0,0,2784
2955,RM-1106,3/27/2014,0,0,0,1704,0,1077,2781
4324,RM-1108,3/27/2014,0,1704,0,0,0,1077,2781
36369,RM-B200B,3/27/2014,0,1704,0,0,0,1077,2781
2929,RM-1106,3/1/2014,0,0,0,1728,0,1050,2778
8427,RM-1117,4/8/2014,0,1728,1050,0,0,0,2778
17553,RM-1151,3/1/2014,1050,0,0,1728,0,0,2778
24293,RM-1208B,3/1/2014,0,0,1050,1728,0,0,2778
27706,RM-1218,3/1/2014,0,0,1050,1728,0,0,2778
27744,RM-1218,4/8/2014,0,0,1050,1728,0,0,2778
36343,RM-B200B,3/1/2014,0,1728,0,0,0,1050,2778
39773,RM-B222,3/1/2014,1050,0,0,1728,0,0,2778
271,RM-1100A,4/8/2014,1047,1728,0,0,0,0,2775
277,RM-1100A,4/14/2014,1047,1728,0,0,0,0,2775
278,RM-1100A,4/15/2014,1047,1728,0,0,0,0,2775
8433,RM-1117,4/14/2014,0,1728,1047,0,0,0,2775
13087,RM-1132,4/8/2014,0,0,1047,1728,0,0,2775
13094,RM-1132,4/15/2014,0,0,1047,1728,0,0,2775
13137,RM-1132,5/28/2014,0,0,1047,1728,0,0,2775
17591,RM-1151,4/8/2014,1047,0,0,1728,0,0,2775
17597,RM-1151,4/14/2014,1047,0,0,1728,0,0,2775
17598,RM-1151,4/15/2014,1047,0,0,1728,0,0,2775
27000,RM-1217,2/11/2014,1047,0,0,1728,0,0,2775
27062,RM-1217,4/14/2014,1047,1728,0,0,0,0,2775
27063,RM-1217,4/15/2014,1047,1728,0,0,0,0,2775
27106,RM-1217,5/28/2014,1047,1728,0,0,0,0,2775
27750,RM-1218,4/14/2014,0,0,1047,1728,0,0,2775
30540,RM-1229,5/28/2014,0,0,1047,1728,0,0,2775
32567,RM-1236,5/28/2014,0,1728,1047,0,0,0,2775
35195,RM-B103A,5/28/2014,1047,0,0,1728,0,0,2775
39755,RM-B222,2/11/2014,1047,0,0,1728,0,0,2775
39811,RM-B222,4/8/2014,1047,0,0,1728,0,0,2775
39861,RM-B222,5/28/2014,1047,0,0,1728,0,0,2775
45103,RM-B250A,4/8/2014,1047,0,0,1728,0,0,2775
45109,RM-B250A,4/14/2014,1047,0,0,1728,0,0,2775
45110,RM-B250A,4/15/2014,1047,0,0,1728,0,0,2775
45837,RM-B260,5/28/2014,1047,0,0,1728,0,0,2775
328,RM-1100A,6/4/2014,1044,1728,0,0,0,0,2772
1698,RM-1102,6/4/2014,1044,1728,0,0,0,0,2772
8434,RM-1117,4/15/2014,0,1728,1044,0,0,0,2772
13093,RM-1132,4/14/2014,0,0,1044,1728,0,0,2772
13144,RM-1132,6/4/2014,0,0,1044,1728,0,0,2772
27113,RM-1217,6/4/2014,1044,1728,0,0,0,0,2772
27751,RM-1218,4/15/2014,0,0,1044,1728,0,0,2772
39868,RM-B222,6/4/2014,1044,0,0,1728,0,0,2772
45844,RM-B260,6/4/2014,1044,0,0,1728,0,0,2772
24361,RM-1208B,5/8/2014,981,0,978,810,0,0,2769
30547,RM-1229,6/4/2014,0,0,1041,1728,0,0,2769
32574,RM-1236,6/4/2014,0,1728,1041,0,0,0,2769
39858,RM-B222,5/25/2014,1233,0,0,1536,0,0,2769
18767,RM-1155,9/20/2013,1383,0,1383,0,0,0,2766
32320,RM-1236,9/20/2013,1383,0,1383,0,0,0,2766
2925,RM-1106,2/25/2014,0,0,0,1728,0,1035,2763
7534,RM-1116,9/12/2013,0,0,1383,0,0,1380,2763
7542,RM-1116,9/20/2013,0,0,1383,0,0,1380,2763
8230,RM-1117,9/20/2013,1383,0,0,0,0,1380,2763
17549,RM-1151,2/25/2014,1035,0,0,1728,0,0,2763
18759,RM-1155,9/12/2013,1380,0,1383,0,0,0,2763
23446,RM-1208,9/20/2013,1383,0,0,0,0,1380,2763
24289,RM-1208B,2/25/2014,0,0,1035,1728,0,0,2763
27702,RM-1218,2/25/2014,0,0,1035,1728,0,0,2763
32312,RM-1236,9/12/2013,1380,0,1383,0,0,0,2763
36339,RM-B200B,2/25/2014,0,1728,0,0,0,1035,2763
36857,RM-B200C,9/12/2013,0,0,1383,0,0,1380,2763
36865,RM-B200C,9/20/2013,0,0,1383,0,0,1380,2763
38241,RM-B215,9/20/2013,1383,0,0,0,0,1380,2763
39769,RM-B222,2/25/2014,1035,0,0,1728,0,0,2763
47620,RM-B275,9/12/2013,0,0,1383,0,0,1380,2763
47628,RM-B275,9/20/2013,0,0,1383,0,0,1380,2763
2762,RM-1106,9/12/2013,1380,0,0,0,0,1380,2760
2953,RM-1106,3/25/2014,0,0,0,1728,0,1032,2760
4322,RM-1108,3/25/2014,0,1728,0,0,0,1032,2760
8222,RM-1117,9/12/2013,1380,0,0,0,0,1380,2760
8413,RM-1117,3/25/2014,0,1728,1032,0,0,0,2760
23438,RM-1208,9/12/2013,1380,0,0,0,0,1380,2760
27730,RM-1218,3/25/2014,0,0,1032,1728,0,0,2760
36367,RM-B200B,3/25/2014,0,1728,0,0,0,1032,2760
38233,RM-B215,9/12/2013,1380,0,0,0,0,1380,2760
39606,RM-B222,9/12/2013,1380,0,1380,0,0,0,2760
44404,RM-B250,3/25/2014,0,1728,1032,0,0,0,2760
257,RM-1100A,3/25/2014,1029,1728,0,0,0,0,2757
2926,RM-1106,2/26/2014,0,0,0,1728,0,1029,2757
2933,RM-1106,3/5/2014,0,0,0,1728,0,1029,2757
7544,RM-1116,9/22/2013,0,0,1377,0,0,1380,2757
8232,RM-1117,9/22/2013,1377,0,0,0,0,1380,2757
8409,RM-1117,3/21/2014,0,1728,1029,0,0,0,2757
17550,RM-1151,2/26/2014,1029,0,0,1728,0,0,2757
17557,RM-1151,3/5/2014,1029,0,0,1728,0,0,2757
17577,RM-1151,3/25/2014,1029,0,0,1728,0,0,2757
23448,RM-1208,9/22/2013,1377,0,0,0,0,1380,2757
24290,RM-1208B,2/26/2014,0,0,1029,1728,0,0,2757
24297,RM-1208B,3/5/2014,0,0,1029,1728,0,0,2757
24313,RM-1208B,3/21/2014,0,0,1029,1728,0,0,2757
27703,RM-1218,2/26/2014,0,0,1029,1728,0,0,2757
27710,RM-1218,3/5/2014,0,0,1029,1728,0,0,2757
27726,RM-1218,3/21/2014,0,0,1029,1728,0,0,2757
36340,RM-B200B,2/26/2014,0,1728,0,0,0,1029,2757
36347,RM-B200B,3/5/2014,0,1728,0,0,0,1029,2757
36867,RM-B200C,9/22/2013,0,0,1377,0,0,1380,2757
38243,RM-B215,9/22/2013,1377,0,0,0,0,1380,2757
39770,RM-B222,2/26/2014,1029,0,0,1728,0,0,2757
39777,RM-B222,3/5/2014,1029,0,0,1728,0,0,2757
39797,RM-B222,3/25/2014,1029,0,0,1728,0,0,2757
44400,RM-B250,3/21/2014,0,1728,1029,0,0,0,2757
47630,RM-B275,9/22/2013,0,0,1377,0,0,1380,2757
253,RM-1100A,3/21/2014,1026,1728,0,0,0,0,2754
2949,RM-1106,3/21/2014,0,0,0,1728,0,1026,2754
4318,RM-1108,3/21/2014,0,1728,0,0,0,1026,2754
13112,RM-1132,5/3/2014,0,0,1026,1728,0,0,2754
17573,RM-1151,3/21/2014,1026,0,0,1728,0,0,2754
18769,RM-1155,9/22/2013,1377,0,1377,0,0,0,2754
27081,RM-1217,5/3/2014,1026,1728,0,0,0,0,2754
30515,RM-1229,5/3/2014,0,0,1026,1728,0,0,2754
32322,RM-1236,9/22/2013,1377,0,1377,0,0,0,2754
32542,RM-1236,5/3/2014,0,1728,1026,0,0,0,2754
35170,RM-B103A,5/3/2014,1026,0,0,1728,0,0,2754
36363,RM-B200B,3/21/2014,0,1728,0,0,0,1026,2754
39793,RM-B222,3/21/2014,1026,0,0,1728,0,0,2754
2931,RM-1106,3/3/2014,0,0,0,1716,0,1035,2751
9749,RM-1123,2/19/2014,0,1728,1023,0,0,0,2751
17555,RM-1151,3/3/2014,1035,0,0,1716,0,0,2751
24283,RM-1208B,2/19/2014,0,0,1023,1728,0,0,2751
24295,RM-1208B,3/3/2014,0,0,1035,1716,0,0,2751
27696,RM-1218,2/19/2014,0,0,1023,1728,0,0,2751
27708,RM-1218,3/3/2014,0,0,1035,1716,0,0,2751
36345,RM-B200B,3/3/2014,0,1716,0,0,0,1035,2751
39775,RM-B222,3/3/2014,1035,0,0,1716,0,0,2751
279,RM-1100A,4/16/2014,1020,1728,0,0,0,0,2748
2919,RM-1106,2/19/2014,0,0,0,1728,0,1020,2748
8435,RM-1117,4/16/2014,0,1728,1020,0,0,0,2748
17599,RM-1151,4/16/2014,1020,0,0,1728,0,0,2748
27064,RM-1217,4/16/2014,1020,1728,0,0,0,0,2748
27752,RM-1218,4/16/2014,0,0,1020,1728,0,0,2748
36333,RM-B200B,2/19/2014,0,1728,0,0,0,1020,2748
39763,RM-B222,2/19/2014,1020,0,0,1728,0,0,2748
45111,RM-B250A,4/16/2014,1020,0,0,1728,0,0,2748
13095,RM-1132,4/16/2014,0,0,1017,1728,0,0,2745
30279,RM-1229,9/5/2013,1245,0,1245,0,0,255,2745
272,RM-1100A,4/9/2014,1011,1728,0,0,0,0,2739
8428,RM-1117,4/9/2014,0,1728,1011,0,0,0,2739
13088,RM-1132,4/9/2014,0,0,1011,1728,0,0,2739
17592,RM-1151,4/9/2014,1011,0,0,1728,0,0,2739
27057,RM-1217,4/9/2014,1011,1728,0,0,0,0,2739
27745,RM-1218,4/9/2014,0,0,1011,1728,0,0,2739
39812,RM-B222,4/9/2014,1011,0,0,1728,0,0,2739
45104,RM-B250A,4/9/2014,1011,0,0,1728,0,0,2739
24362,RM-1208B,5/9/2014,978,0,981,768,0,0,2727
8436,RM-1117,4/17/2014,0,1728,996,0,0,0,2724
13096,RM-1132,4/17/2014,0,0,996,1728,0,0,2724
13113,RM-1132,5/4/2014,0,0,996,1728,0,0,2724
24395,RM-1208B,6/11/2014,498,0,504,1722,0,0,2724
27082,RM-1217,5/4/2014,996,1728,0,0,0,0,2724
27753,RM-1218,4/17/2014,0,0,996,1728,0,0,2724
30516,RM-1229,5/4/2014,0,0,996,1728,0,0,2724
32543,RM-1236,5/4/2014,0,1728,996,0,0,0,2724
35171,RM-B103A,5/4/2014,996,0,0,1728,0,0,2724
280,RM-1100A,4/17/2014,993,1728,0,0,0,0,2721
17600,RM-1151,4/17/2014,993,0,0,1728,0,0,2721
24291,RM-1208B,2/27/2014,0,0,993,1728,0,0,2721
27065,RM-1217,4/17/2014,993,1728,0,0,0,0,2721
27704,RM-1218,2/27/2014,0,0,993,1728,0,0,2721
45112,RM-B250A,4/17/2014,993,0,0,1728,0,0,2721
8444,RM-1117,4/25/2014,0,1728,990,0,0,0,2718
13104,RM-1132,4/25/2014,0,0,990,1728,0,0,2718
13108,RM-1132,4/29/2014,0,0,990,1728,0,0,2718
17622,RM-1151,5/9/2014,978,0,0,1740,0,0,2718
27073,RM-1217,4/25/2014,990,1728,0,0,0,0,2718
27761,RM-1218,4/25/2014,0,0,990,1728,0,0,2718
27765,RM-1218,4/29/2014,0,0,990,1728,0,0,2718
32534,RM-1236,4/25/2014,0,1728,990,0,0,0,2718
32538,RM-1236,4/29/2014,0,1728,990,0,0,0,2718
35162,RM-B103A,4/25/2014,990,0,0,1728,0,0,2718
27077,RM-1217,4/29/2014,987,1728,0,0,0,0,2715
35166,RM-B103A,4/29/2014,987,0,0,1728,0,0,2715
2932,RM-1106,3/4/2014,0,0,0,1728,0,984,2712
17556,RM-1151,3/4/2014,984,0,0,1728,0,0,2712
17623,RM-1151,5/10/2014,960,0,0,1752,0,0,2712
24296,RM-1208B,3/4/2014,0,0,984,1728,0,0,2712
27709,RM-1218,3/4/2014,0,0,984,1728,0,0,2712
36346,RM-B200B,3/4/2014,0,1728,0,0,0,984,2712
39776,RM-B222,3/4/2014,984,0,0,1728,0,0,2712
7505,RM-1116,8/5/2013,0,0,1356,0,0,1353,2709
18730,RM-1155,8/5/2013,1353,0,1356,0,0,0,2709
23409,RM-1208,8/5/2013,1356,0,0,0,0,1353,2709
30256,RM-1229,8/5/2013,1353,0,1356,0,0,0,2709
32283,RM-1236,8/5/2013,1353,0,1356,0,0,0,2709
36828,RM-B200C,8/5/2013,0,0,1356,0,0,1353,2709
39577,RM-B222,8/5/2013,1353,0,1356,0,0,0,2709
40265,RM-B224,8/5/2013,0,0,1356,0,0,1353,2709
2927,RM-1106,2/27/2014,0,0,0,1728,0,978,2706
8193,RM-1117,8/5/2013,1353,0,0,0,0,1353,2706
17551,RM-1151,2/27/2014,978,0,0,1728,0,0,2706
36341,RM-B200B,2/27/2014,0,1728,0,0,0,978,2706
38204,RM-B215,8/5/2013,1353,0,0,0,0,1353,2706
39771,RM-B222,2/27/2014,978,0,0,1728,0,0,2706
44184,RM-B250,8/5/2013,1353,0,0,0,0,1353,2706
24364,RM-1208B,5/11/2014,945,0,942,816,0,0,2703
8949,RM-1122,10/24/2013,0,0,1350,0,0,1350,2700
23480,RM-1208,10/24/2013,1350,0,0,0,0,1350,2700
23675,RM-1208,5/10/2014,960,1740,0,0,0,0,2700
47662,RM-B275,10/24/2013,0,0,1350,0,0,1350,2700
6230,RM-1113,10/24/2013,1347,0,1350,0,0,0,2697
8264,RM-1117,10/24/2013,1347,0,1350,0,0,0,2697
18801,RM-1155,10/24/2013,1347,0,1350,0,0,0,2697
32354,RM-1236,10/24/2013,1347,0,1350,0,0,0,2697
38275,RM-B215,10/24/2013,1347,0,0,0,0,1350,2697
44255,RM-B250,10/24/2013,1347,0,1350,0,0,0,2697
13097,RM-1132,4/18/2014,0,0,963,1728,0,0,2691
17601,RM-1151,4/18/2014,963,0,0,1728,0,0,2691
27066,RM-1217,4/18/2014,963,1728,0,0,0,0,2691
45113,RM-B250A,4/18/2014,963,0,0,1728,0,0,2691
8437,RM-1117,4/18/2014,0,1728,960,0,0,0,2688
27754,RM-1218,4/18/2014,0,0,960,1728,0,0,2688
273,RM-1100A,4/10/2014,957,1728,0,0,0,0,2685
13089,RM-1132,4/10/2014,0,0,957,1728,0,0,2685
17593,RM-1151,4/10/2014,957,0,0,1728,0,0,2685
27058,RM-1217,4/10/2014,957,1728,0,0,0,0,2685
39813,RM-B222,4/10/2014,957,0,0,1728,0,0,2685
45105,RM-B250A,4/10/2014,957,0,0,1728,0,0,2685
8429,RM-1117,4/10/2014,0,1728,954,0,0,0,2682
18770,RM-1155,9/23/2013,1341,0,1341,0,0,0,2682
24363,RM-1208B,5/10/2014,960,0,960,762,0,0,2682
27746,RM-1218,4/10/2014,0,0,954,1728,0,0,2682
32323,RM-1236,9/23/2013,1341,0,1341,0,0,0,2682
2935,RM-1106,3/7/2014,0,0,0,1728,0,951,2679
7545,RM-1116,9/23/2013,0,0,1341,0,0,1338,2679
8233,RM-1117,9/23/2013,1341,0,0,0,0,1338,2679
17559,RM-1151,3/7/2014,951,0,0,1728,0,0,2679
23449,RM-1208,9/23/2013,1341,0,0,0,0,1338,2679
24299,RM-1208B,3/7/2014,0,0,951,1728,0,0,2679
27712,RM-1218,3/7/2014,0,0,951,1728,0,0,2679
36349,RM-B200B,3/7/2014,0,1728,0,0,0,951,2679
36868,RM-B200C,9/23/2013,0,0,1341,0,0,1338,2679
38244,RM-B215,9/23/2013,1341,0,0,0,0,1338,2679
39779,RM-B222,3/7/2014,951,0,0,1728,0,0,2679
47631,RM-B275,9/23/2013,0,0,1341,0,0,1338,2679
35734,RM-B109,5/18/2014,1338,0,1338,0,0,0,2676
41912,RM-B230,5/18/2014,1338,0,1338,0,0,0,2676
265,RM-1100A,4/2/2014,1062,1608,0,0,0,0,2670
274,RM-1100A,4/11/2014,942,1728,0,0,0,0,2670
8421,RM-1117,4/2/2014,0,1608,1062,0,0,0,2670
8430,RM-1117,4/11/2014,0,1728,942,0,0,0,2670
13081,RM-1132,4/2/2014,0,0,1062,1608,0,0,2670
17585,RM-1151,4/2/2014,1062,0,0,1608,0,0,2670
17594,RM-1151,4/11/2014,942,0,0,1728,0,0,2670
27059,RM-1217,4/11/2014,942,1728,0,0,0,0,2670
27738,RM-1218,4/2/2014,0,0,1062,1608,0,0,2670
27747,RM-1218,4/11/2014,0,0,942,1728,0,0,2670
35736,RM-B109,5/20/2014,1335,0,1335,0,0,0,2670
39805,RM-B222,4/2/2014,1062,0,0,1608,0,0,2670
39814,RM-B222,4/11/2014,942,0,0,1728,0,0,2670
41914,RM-B230,5/20/2014,1335,0,1335,0,0,0,2670
44412,RM-B250,4/2/2014,0,1608,1062,0,0,0,2670
45106,RM-B250A,4/11/2014,942,0,0,1728,0,0,2670
13090,RM-1132,4/11/2014,0,0,939,1728,0,0,2667
7518,RM-1116,8/18/2013,0,0,1332,0,0,1329,2661
8432,RM-1117,4/13/2014,0,1728,933,0,0,0,2661
18743,RM-1155,8/18/2013,1329,0,1332,0,0,0,2661
23422,RM-1208,8/18/2013,1332,0,0,0,0,1329,2661
27749,RM-1218,4/13/2014,0,0,933,1728,0,0,2661
30269,RM-1229,8/18/2013,1329,0,1332,0,0,0,2661
32296,RM-1236,8/18/2013,1329,0,1332,0,0,0,2661
36841,RM-B200C,8/18/2013,0,0,1332,0,0,1329,2661
40278,RM-B224,8/18/2013,0,0,1332,0,0,1329,2661
47604,RM-B275,8/18/2013,0,0,1332,0,0,1329,2661
276,RM-1100A,4/13/2014,930,1728,0,0,0,0,2658
2746,RM-1106,8/18/2013,1329,0,0,0,0,1329,2658
8206,RM-1117,8/18/2013,1329,0,0,0,0,1329,2658
8407,RM-1117,3/19/2014,0,1728,930,0,0,0,2658
13092,RM-1132,4/13/2014,0,0,930,1728,0,0,2658
17596,RM-1151,4/13/2014,930,0,0,1728,0,0,2658
24311,RM-1208B,3/19/2014,0,0,930,1728,0,0,2658
27061,RM-1217,4/13/2014,930,1728,0,0,0,0,2658
27724,RM-1218,3/19/2014,0,0,930,1728,0,0,2658
38217,RM-B215,8/18/2013,1329,0,0,0,0,1329,2658
39590,RM-B222,8/18/2013,1329,0,1329,0,0,0,2658
39816,RM-B222,4/13/2014,930,0,0,1728,0,0,2658
44398,RM-B250,3/19/2014,0,1728,930,0,0,0,2658
45108,RM-B250A,4/13/2014,930,0,0,1728,0,0,2658
251,RM-1100A,3/19/2014,927,1728,0,0,0,0,2655
2947,RM-1106,3/19/2014,0,0,0,1728,0,927,2655
4316,RM-1108,3/19/2014,0,1728,0,0,0,927,2655
17571,RM-1151,3/19/2014,927,0,0,1728,0,0,2655
36361,RM-B200B,3/19/2014,0,1728,0,0,0,927,2655
39791,RM-B222,3/19/2014,927,0,0,1728,0,0,2655
20366,RM-1200A,6/19/2014,0,0,0,2652,0,0,2652
8438,RM-1117,4/19/2014,0,1728,918,0,0,0,2646
13098,RM-1132,4/19/2014,0,0,918,1728,0,0,2646
17602,RM-1151,4/19/2014,918,0,0,1728,0,0,2646
27067,RM-1217,4/19/2014,918,1728,0,0,0,0,2646
27755,RM-1218,4/19/2014,0,0,918,1728,0,0,2646
45114,RM-B250A,4/19/2014,918,0,0,1728,0,0,2646
24396,RM-1208B,6/12/2014,456,0,459,1728,0,0,2643
2936,RM-1106,3/8/2014,0,0,0,1686,0,954,2640
6228,RM-1113,10/22/2013,1320,0,1320,0,0,0,2640
7497,RM-1116,7/28/2013,0,0,1320,0,0,1320,2640
8185,RM-1117,7/28/2013,1320,0,0,0,0,1320,2640
8262,RM-1117,10/22/2013,1320,0,1320,0,0,0,2640
8947,RM-1122,10/22/2013,0,0,1320,0,0,1320,2640
17560,RM-1151,3/8/2014,954,0,0,1686,0,0,2640
18722,RM-1155,7/28/2013,1320,0,1320,0,0,0,2640
18799,RM-1155,10/22/2013,1320,0,1320,0,0,0,2640
23401,RM-1208,7/28/2013,1320,0,0,0,0,1320,2640
23478,RM-1208,10/22/2013,1320,0,0,0,0,1320,2640
24300,RM-1208B,3/8/2014,0,0,954,1686,0,0,2640
27713,RM-1218,3/8/2014,0,0,954,1686,0,0,2640
30248,RM-1229,7/28/2013,1320,0,1320,0,0,0,2640
32275,RM-1236,7/28/2013,1320,0,1320,0,0,0,2640
32352,RM-1236,10/22/2013,1320,0,1320,0,0,0,2640
36350,RM-B200B,3/8/2014,0,1686,0,0,0,954,2640
36820,RM-B200C,7/28/2013,0,0,1320,0,0,1320,2640
38196,RM-B215,7/28/2013,1320,0,0,0,0,1320,2640
38273,RM-B215,10/22/2013,1320,0,0,0,0,1320,2640
39569,RM-B222,7/28/2013,1320,0,1320,0,0,0,2640
39780,RM-B222,3/8/2014,954,0,0,1686,0,0,2640
40257,RM-B224,7/28/2013,0,0,1320,0,0,1320,2640
44176,RM-B250,7/28/2013,1320,0,0,0,0,1320,2640
44253,RM-B250,10/22/2013,1320,0,1320,0,0,0,2640
47660,RM-B275,10/22/2013,0,0,1320,0,0,1320,2640
2937,RM-1106,3/9/2014,0,0,0,1698,0,933,2631
13091,RM-1132,4/12/2014,0,0,903,1728,0,0,2631
17561,RM-1151,3/9/2014,933,0,0,1698,0,0,2631
17625,RM-1151,5/12/2014,915,0,0,1716,0,0,2631
24301,RM-1208B,3/9/2014,0,0,933,1698,0,0,2631
24365,RM-1208B,5/12/2014,915,0,918,798,0,0,2631
27714,RM-1218,3/9/2014,0,0,933,1698,0,0,2631
36351,RM-B200B,3/9/2014,0,1698,0,0,0,933,2631
39781,RM-B222,3/9/2014,933,0,0,1698,0,0,2631
275,RM-1100A,4/12/2014,900,1728,0,0,0,0,2628
7495,RM-1116,7/26/2013,0,0,1314,0,0,1314,2628
8183,RM-1117,7/26/2013,1314,0,0,0,0,1314,2628
8431,RM-1117,4/12/2014,0,1728,900,0,0,0,2628
17595,RM-1151,4/12/2014,900,0,0,1728,0,0,2628
18720,RM-1155,7/26/2013,1314,0,1314,0,0,0,2628
27060,RM-1217,4/12/2014,900,1728,0,0,0,0,2628
27748,RM-1218,4/12/2014,0,0,900,1728,0,0,2628
30246,RM-1229,7/26/2013,1314,0,1314,0,0,0,2628
32273,RM-1236,7/26/2013,1314,0,1314,0,0,0,2628
36818,RM-B200C,7/26/2013,0,0,1314,0,0,1314,2628
38194,RM-B215,7/26/2013,1314,0,0,0,0,1314,2628
39567,RM-B222,7/26/2013,1314,0,1314,0,0,0,2628
39815,RM-B222,4/12/2014,900,0,0,1728,0,0,2628
40255,RM-B224,7/26/2013,0,0,1314,0,0,1314,2628
44174,RM-B250,7/26/2013,1314,0,0,0,0,1314,2628
45107,RM-B250A,4/12/2014,900,0,0,1728,0,0,2628
8439,RM-1117,4/20/2014,0,1728,894,0,0,0,2622
27756,RM-1218,4/20/2014,0,0,894,1728,0,0,2622
13099,RM-1132,4/20/2014,0,0,891,1728,0,0,2619
17603,RM-1151,4/20/2014,891,0,0,1728,0,0,2619
24956,RM-1212,2/7/2014,1308,0,1311,0,0,0,2619
27068,RM-1217,4/20/2014,891,1728,0,0,0,0,2619
37002,RM-B200C,2/7/2014,1308,0,1311,0,0,0,2619
6992,RM-1115,2/7/2014,1308,0,0,0,0,1308,2616
19580,RM-1156,2/7/2014,1308,0,0,0,0,1308,2616
22898,RM-1207,2/7/2014,1308,0,0,0,0,1308,2616
24958,RM-1212,2/9/2014,1305,0,1308,0,0,0,2613
37004,RM-B200C,2/9/2014,1305,0,1308,0,0,0,2613
6994,RM-1115,2/9/2014,1305,0,0,0,0,1305,2610
19582,RM-1156,2/9/2014,1305,0,0,0,0,1305,2610
22900,RM-1207,2/9/2014,1305,0,0,0,0,1305,2610
30330,RM-1229,10/27/2013,147,0,1230,0,0,1230,2607
7546,RM-1116,9/24/2013,0,0,1302,0,0,1302,2604
18771,RM-1155,9/24/2013,1302,0,1302,0,0,0,2604
23450,RM-1208,9/24/2013,1302,0,0,0,0,1302,2604
32324,RM-1236,9/24/2013,1302,0,1302,0,0,0,2604
36869,RM-B200C,9/24/2013,0,0,1302,0,0,1302,2604
38245,RM-B215,9/24/2013,1302,0,0,0,0,1302,2604
47632,RM-B275,9/24/2013,0,0,1302,0,0,1302,2604
23674,RM-1208,5/9/2014,978,1620,0,0,0,0,2598
8440,RM-1117,4/21/2014,0,1728,867,0,0,0,2595
13100,RM-1132,4/21/2014,0,0,867,1728,0,0,2595
17604,RM-1151,4/21/2014,867,0,0,1728,0,0,2595
27069,RM-1217,4/21/2014,867,1728,0,0,0,0,2595
27757,RM-1218,4/21/2014,0,0,867,1728,0,0,2595
35158,RM-B103A,4/21/2014,867,0,0,1728,0,0,2595
8441,RM-1117,4/22/2014,0,1728,864,0,0,0,2592
13101,RM-1132,4/22/2014,0,0,864,1728,0,0,2592
27070,RM-1217,4/22/2014,864,1728,0,0,0,0,2592
27758,RM-1218,4/22/2014,0,0,864,1728,0,0,2592
35159,RM-B103A,4/22/2014,864,0,0,1728,0,0,2592
2939,RM-1106,3/11/2014,0,0,0,1728,0,861,2589
4308,RM-1108,3/11/2014,0,1728,0,0,0,861,2589
17563,RM-1151,3/11/2014,861,0,0,1728,0,0,2589
24303,RM-1208B,3/11/2014,0,0,861,1728,0,0,2589
27716,RM-1218,3/11/2014,0,0,861,1728,0,0,2589
30573,RM-1229,6/30/2014,0,0,861,1728,0,0,2589
36353,RM-B200B,3/11/2014,0,1728,0,0,0,861,2589
36464,RM-B200B,6/30/2014,0,1728,861,0,0,0,2589
39783,RM-B222,3/11/2014,861,0,0,1728,0,0,2589
32600,RM-1236,6/30/2014,0,1728,858,0,0,0,2586
35738,RM-B109,5/22/2014,1293,0,1293,0,0,0,2586
354,RM-1100A,6/30/2014,855,1728,0,0,0,0,2583
1724,RM-1102,6/30/2014,855,1728,0,0,0,0,2583
27139,RM-1217,6/30/2014,855,1728,0,0,0,0,2583
39894,RM-B222,6/30/2014,855,0,0,1728,0,0,2583
45870,RM-B260,6/30/2014,855,0,0,1728,0,0,2583
7028,RM-1115,3/15/2014,1290,0,0,0,0,1290,2580
18940,RM-1155,3/15/2014,1290,0,0,0,0,1290,2580
19616,RM-1156,3/15/2014,1290,0,0,0,0,1290,2580
22934,RM-1207,3/15/2014,1290,0,0,0,0,1290,2580
9727,RM-1123,1/28/2014,0,1716,861,0,0,0,2577
13702,RM-1133,1/28/2014,0,1716,861,0,0,0,2577
24261,RM-1208B,1/28/2014,0,0,861,1716,0,0,2577
24992,RM-1212,3/15/2014,1290,0,1287,0,0,0,2577
35624,RM-B109,1/28/2014,0,1716,861,0,0,0,2577
37038,RM-B200C,3/15/2014,1290,0,1287,0,0,0,2577
41802,RM-B230,1/28/2014,0,1716,861,0,0,0,2577
2897,RM-1106,1/28/2014,0,0,0,1716,0,858,2574
13017,RM-1132,1/28/2014,0,0,858,1716,0,0,2574
26986,RM-1217,1/28/2014,858,0,0,1716,0,0,2574
39741,RM-B222,1/28/2014,858,0,0,1716,0,0,2574
47755,RM-B275,1/28/2014,0,1716,0,0,0,858,2574
8442,RM-1117,4/23/2014,0,1728,843,0,0,0,2571
13102,RM-1132,4/23/2014,0,0,843,1728,0,0,2571
27071,RM-1217,4/23/2014,843,1728,0,0,0,0,2571
27759,RM-1218,4/23/2014,0,0,843,1728,0,0,2571
32532,RM-1236,4/23/2014,0,1728,843,0,0,0,2571
35160,RM-B103A,4/23/2014,843,0,0,1728,0,0,2571
6993,RM-1115,2/8/2014,1284,0,0,0,0,1284,2568
19581,RM-1156,2/8/2014,1284,0,0,0,0,1284,2568
22899,RM-1207,2/8/2014,1284,0,0,0,0,1284,2568
23456,RM-1208,9/30/2013,1284,0,0,0,0,1284,2568
24298,RM-1208B,3/6/2014,0,0,840,1728,0,0,2568
27711,RM-1218,3/6/2014,0,0,840,1728,0,0,2568
29715,RM-1224,1/11/2014,0,1284,0,1284,0,0,2568
38251,RM-B215,9/30/2013,1284,0,0,0,0,1284,2568
2898,RM-1106,1/29/2014,0,0,0,1728,0,837,2565
2934,RM-1106,3/6/2014,0,0,0,1728,0,837,2565
6206,RM-1113,9/30/2013,1284,0,1281,0,0,0,2565
7552,RM-1116,9/30/2013,0,0,1281,0,0,1284,2565
9728,RM-1123,1/29/2014,0,1728,837,0,0,0,2565
13018,RM-1132,1/29/2014,0,0,837,1728,0,0,2565
13703,RM-1133,1/29/2014,0,1728,837,0,0,0,2565
17558,RM-1151,3/6/2014,837,0,0,1728,0,0,2565
18777,RM-1155,9/30/2013,1284,0,1281,0,0,0,2565
24262,RM-1208B,1/29/2014,0,0,837,1728,0,0,2565
24957,RM-1212,2/8/2014,1284,0,1281,0,0,0,2565
26987,RM-1217,1/29/2014,837,0,0,1728,0,0,2565
30548,RM-1229,6/5/2014,0,0,837,1728,0,0,2565
32330,RM-1236,9/30/2013,1284,0,1281,0,0,0,2565
32575,RM-1236,6/5/2014,0,1728,837,0,0,0,2565
35625,RM-B109,1/29/2014,0,1728,837,0,0,0,2565
36348,RM-B200B,3/6/2014,0,1728,0,0,0,837,2565
36875,RM-B200C,9/30/2013,0,0,1281,0,0,1284,2565
37003,RM-B200C,2/8/2014,1284,0,1281,0,0,0,2565
39742,RM-B222,1/29/2014,837,0,0,1728,0,0,2565
39778,RM-B222,3/6/2014,837,0,0,1728,0,0,2565
41803,RM-B230,1/29/2014,0,1728,837,0,0,0,2565
47638,RM-B275,9/30/2013,0,0,1281,0,0,1284,2565
47756,RM-B275,1/29/2014,0,1728,0,0,0,837,2565
329,RM-1100A,6/5/2014,834,1728,0,0,0,0,2562
1699,RM-1102,6/5/2014,834,1728,0,0,0,0,2562
13145,RM-1132,6/5/2014,0,0,834,1728,0,0,2562
27114,RM-1217,6/5/2014,834,1728,0,0,0,0,2562
7567,RM-1116,10/15/2013,852,0,855,0,0,852,2559
8255,RM-1117,10/15/2013,852,0,855,0,0,852,2559
30318,RM-1229,10/15/2013,852,0,855,0,0,852,2559
35740,RM-B109,5/24/2014,1278,0,1281,0,0,0,2559
36890,RM-B200C,10/15/2013,852,0,855,0,0,852,2559
6231,RM-1113,10/25/2013,1278,0,1278,0,0,0,2556
8265,RM-1117,10/25/2013,1278,0,1278,0,0,0,2556
18802,RM-1155,10/25/2013,1278,0,1278,0,0,0,2556
20870,RM-1200B,1/11/2014,0,1278,0,1278,0,0,2556
32355,RM-1236,10/25/2013,1278,0,1278,0,0,0,2556
39869,RM-B222,6/5/2014,834,0,0,1722,0,0,2556
44256,RM-B250,10/25/2013,1278,0,1278,0,0,0,2556
45845,RM-B260,6/5/2014,834,0,0,1722,0,0,2556
8950,RM-1122,10/25/2013,0,0,1278,0,0,1275,2553
23481,RM-1208,10/25/2013,1278,0,0,0,0,1275,2553
23676,RM-1208,5/11/2014,945,1608,0,0,0,0,2553
38276,RM-B215,10/25/2013,1278,0,0,0,0,1275,2553
47663,RM-B275,10/25/2013,0,0,1278,0,0,1275,2553
6998,RM-1115,2/13/2014,1275,0,0,0,0,1275,2550
7491,RM-1116,7/22/2013,0,0,1278,0,0,1272,2550
8420,RM-1117,4/1/2014,0,1728,822,0,0,0,2550
18716,RM-1155,7/22/2013,1272,0,1278,0,0,0,2550
19586,RM-1156,2/13/2014,1275,0,0,0,0,1275,2550
22904,RM-1207,2/13/2014,1275,0,0,0,0,1275,2550
27737,RM-1218,4/1/2014,0,0,822,1728,0,0,2550
32269,RM-1236,7/22/2013,1272,0,1278,0,0,0,2550
36814,RM-B200C,7/22/2013,0,0,1278,0,0,1272,2550
40251,RM-B224,7/22/2013,0,0,1278,0,0,1272,2550
44411,RM-B250,4/1/2014,0,1728,822,0,0,0,2550
322,RM-1100A,5/29/2014,1149,1398,0,0,0,0,2547
2928,RM-1106,2/28/2014,0,0,0,1728,0,819,2547
17552,RM-1151,2/28/2014,819,0,0,1728,0,0,2547
24292,RM-1208B,2/28/2014,0,0,819,1728,0,0,2547
24962,RM-1212,2/13/2014,1275,0,1272,0,0,0,2547
27705,RM-1218,2/28/2014,0,0,819,1728,0,0,2547
36342,RM-B200B,2/28/2014,0,1728,0,0,0,819,2547
37008,RM-B200C,2/13/2014,1275,0,1272,0,0,0,2547
39772,RM-B222,2/28/2014,819,0,0,1728,0,0,2547
264,RM-1100A,4/1/2014,816,1728,0,0,0,0,2544
8179,RM-1117,7/22/2013,1272,0,0,0,0,1272,2544
13080,RM-1132,4/1/2014,0,0,816,1728,0,0,2544
17584,RM-1151,4/1/2014,816,0,0,1728,0,0,2544
35735,RM-B109,5/19/2014,1269,0,1275,0,0,0,2544
35737,RM-B109,5/21/2014,1272,0,1272,0,0,0,2544
38190,RM-B215,7/22/2013,1272,0,0,0,0,1272,2544
38284,RM-B215,11/2/2013,1272,0,0,0,0,1272,2544
39804,RM-B222,4/1/2014,816,0,0,1728,0,0,2544
41913,RM-B230,5/19/2014,1269,0,1275,0,0,0,2544
44170,RM-B250,7/22/2013,1272,0,0,0,0,1272,2544
247,RM-1100A,3/15/2014,813,1728,0,0,0,0,2541
2938,RM-1106,3/10/2014,0,0,0,1722,0,819,2541
6239,RM-1113,11/2/2013,1272,0,1269,0,0,0,2541
8273,RM-1117,11/2/2013,1272,0,1269,0,0,0,2541
8958,RM-1122,11/2/2013,0,0,1269,0,0,1272,2541
18810,RM-1155,11/2/2013,1272,0,1269,0,0,0,2541
23489,RM-1208,11/2/2013,1269,0,0,0,0,1272,2541
24368,RM-1208B,5/15/2014,873,0,870,798,0,0,2541
30336,RM-1229,11/2/2013,0,0,1269,0,0,1272,2541
32363,RM-1236,11/2/2013,1272,0,1269,0,0,0,2541
44264,RM-B250,11/2/2013,1272,0,1269,0,0,0,2541
47671,RM-B275,11/2/2013,0,0,1269,0,0,1272,2541
7541,RM-1116,9/19/2013,0,0,1269,0,0,1269,2538
7547,RM-1116,9/25/2013,0,0,1269,0,0,1269,2538
18772,RM-1155,9/25/2013,1269,0,1269,0,0,0,2538
23445,RM-1208,9/19/2013,1269,0,0,0,0,1269,2538
23451,RM-1208,9/25/2013,1269,0,0,0,0,1269,2538
32325,RM-1236,9/25/2013,1269,0,1269,0,0,0,2538
36864,RM-B200C,9/19/2013,0,0,1269,0,0,1269,2538
36870,RM-B200C,9/25/2013,0,0,1269,0,0,1269,2538
38246,RM-B215,9/25/2013,1269,0,0,0,0,1269,2538
47627,RM-B275,9/19/2013,0,0,1269,0,0,1269,2538
47633,RM-B275,9/25/2013,0,0,1269,0,0,1269,2538
8229,RM-1117,9/19/2013,1266,0,0,0,0,1269,2535
17562,RM-1151,3/10/2014,819,0,0,1716,0,0,2535
18766,RM-1155,9/19/2013,1266,0,1269,0,0,0,2535
24302,RM-1208B,3/10/2014,0,0,819,1716,0,0,2535
27715,RM-1218,3/10/2014,0,0,819,1716,0,0,2535
32319,RM-1236,9/19/2013,1266,0,1269,0,0,0,2535
36352,RM-B200B,3/10/2014,0,1716,0,0,0,819,2535
38240,RM-B215,9/19/2013,1266,0,0,0,0,1269,2535
39782,RM-B222,3/10/2014,819,0,0,1716,0,0,2535
44451,RM-B250,5/11/2014,0,780,942,810,0,0,2532
7005,RM-1115,2/20/2014,1260,0,0,0,0,1263,2523
19593,RM-1156,2/20/2014,1260,0,0,0,0,1263,2523
22911,RM-1207,2/20/2014,1260,0,0,0,0,1263,2523
24969,RM-1212,2/20/2014,1260,0,1260,0,0,0,2520
37015,RM-B200C,2/20/2014,1260,0,1260,0,0,0,2520
44450,RM-B250,5/10/2014,0,798,960,762,0,0,2520
15,RM-1100A,7/13/2013,2517,0,0,0,0,0,2517
2711,RM-1106,7/13/2013,2517,0,0,0,0,0,2517
3396,RM-1107,7/13/2013,0,0,2517,0,0,0,2517
4768,RM-1109,7/13/2013,2517,0,0,0,0,0,2517
5453,RM-1110,7/13/2013,0,0,0,0,0,2517,2517
6137,RM-1113,7/13/2013,0,0,2517,0,0,0,2517
6207,RM-1113,10/1/2013,1257,0,1260,0,0,0,2517
7553,RM-1116,10/1/2013,0,0,1260,0,0,1257,2517
8856,RM-1122,7/13/2013,0,0,2517,0,0,0,2517
12144,RM-1130,7/13/2013,0,0,0,0,0,2517,2517
12831,RM-1132,7/13/2013,2517,0,0,0,0,0,2517
13516,RM-1133,7/13/2013,0,0,2517,0,0,0,2517
18020,RM-1154,7/13/2013,0,0,2517,0,0,0,2517
18778,RM-1155,10/1/2013,1257,0,1260,0,0,0,2517
23387,RM-1208,7/13/2013,0,0,0,0,0,2517,2517
25430,RM-1213,7/13/2013,0,0,2517,0,0,0,2517
26115,RM-1213A,7/13/2013,0,0,0,0,0,2517,2517
27488,RM-1218,7/13/2013,0,0,2517,0,0,0,2517
28176,RM-1221,7/13/2013,0,0,0,0,0,2517,2517
30234,RM-1229,7/13/2013,2517,0,0,0,0,0,2517
32331,RM-1236,10/1/2013,1257,0,1260,0,0,0,2517
33673,RM-B102C,7/13/2013,0,0,2517,0,0,0,2517
34889,RM-B103A,7/13/2013,0,0,0,0,0,2517,2517
36876,RM-B200C,10/1/2013,0,0,1260,0,0,1257,2517
37494,RM-B210,7/13/2013,0,0,2517,0,0,0,2517
39555,RM-B222,7/13/2013,2517,0,0,0,0,0,2517
40931,RM-B225,7/13/2013,0,0,0,0,0,2517,2517
42301,RM-B230A,7/13/2013,0,0,0,0,0,2517,2517
43552,RM-B240A,7/13/2013,0,0,0,0,0,2517,2517
46901,RM-B270,7/13/2013,0,0,2517,0,0,0,2517
47569,RM-B275,7/13/2013,0,0,2517,0,0,0,2517
47639,RM-B275,10/1/2013,0,0,1260,0,0,1257,2517
7029,RM-1115,3/16/2014,1257,0,0,0,0,1257,2514
18941,RM-1155,3/16/2014,1257,0,0,0,0,1257,2514
19617,RM-1156,3/16/2014,1257,0,0,0,0,1257,2514
22935,RM-1207,3/16/2014,1257,0,0,0,0,1257,2514
23457,RM-1208,10/1/2013,1257,0,0,0,0,1257,2514
24961,RM-1212,2/12/2014,1254,0,1260,0,0,0,2514
24993,RM-1212,3/16/2014,1257,0,1257,0,0,0,2514
37007,RM-B200C,2/12/2014,1254,0,1260,0,0,0,2514
37039,RM-B200C,3/16/2014,1257,0,1257,0,0,0,2514
38252,RM-B215,10/1/2013,1257,0,0,0,0,1257,2514
330,RM-1100A,6/6/2014,783,1728,0,0,0,0,2511
1700,RM-1102,6/6/2014,783,1728,0,0,0,0,2511
8951,RM-1122,10/26/2013,0,0,1254,0,0,1257,2511
13146,RM-1132,6/6/2014,0,0,783,1728,0,0,2511
23482,RM-1208,10/26/2013,1254,0,0,0,0,1257,2511
27115,RM-1217,6/6/2014,783,1728,0,0,0,0,2511
38277,RM-B215,10/26/2013,1254,0,0,0,0,1257,2511
39870,RM-B222,6/6/2014,783,0,0,1728,0,0,2511
45846,RM-B260,6/6/2014,783,0,0,1728,0,0,2511
47664,RM-B275,10/26/2013,0,0,1254,0,0,1257,2511
2747,RM-1106,8/19/2013,1254,0,0,0,0,1254,2508
6232,RM-1113,10/26/2013,1254,0,1254,0,0,0,2508
6997,RM-1115,2/12/2014,1254,0,0,0,0,1254,2508
8207,RM-1117,8/19/2013,1254,0,0,0,0,1254,2508
8266,RM-1117,10/26/2013,1254,0,1254,0,0,0,2508
8443,RM-1117,4/24/2014,0,1728,780,0,0,0,2508
13103,RM-1132,4/24/2014,0,0,780,1728,0,0,2508
18803,RM-1155,10/26/2013,1254,0,1254,0,0,0,2508
19585,RM-1156,2/12/2014,1254,0,0,0,0,1254,2508
22903,RM-1207,2/12/2014,1254,0,0,0,0,1254,2508
23423,RM-1208,8/19/2013,1254,0,0,0,0,1254,2508
27072,RM-1217,4/24/2014,780,1728,0,0,0,0,2508
27760,RM-1218,4/24/2014,0,0,780,1728,0,0,2508
30371,RM-1229,12/10/2013,0,0,1257,0,0,1251,2508
30549,RM-1229,6/6/2014,0,0,780,1728,0,0,2508
32356,RM-1236,10/26/2013,1254,0,1254,0,0,0,2508
32533,RM-1236,4/24/2014,0,1728,780,0,0,0,2508
32576,RM-1236,6/6/2014,0,1728,780,0,0,0,2508
35161,RM-B103A,4/24/2014,780,0,0,1728,0,0,2508
35712,RM-B109,4/26/2014,1254,0,1254,0,0,0,2508
37080,RM-B200C,4/26/2014,1254,0,1254,0,0,0,2508
38218,RM-B215,8/19/2013,1254,0,0,0,0,1254,2508
39591,RM-B222,8/19/2013,1254,0,1254,0,0,0,2508
41890,RM-B230,4/26/2014,1254,0,1254,0,0,0,2508
44257,RM-B250,10/26/2013,1254,0,1254,0,0,0,2508
6274,RM-1113,12/10/2013,1248,0,1257,0,0,0,2505
7519,RM-1116,8/19/2013,0,0,1251,0,0,1254,2505
8308,RM-1117,12/10/2013,1248,0,1257,0,0,0,2505
18744,RM-1155,8/19/2013,1254,0,1251,0,0,0,2505
18845,RM-1155,12/10/2013,1248,0,1257,0,0,0,2505
24360,RM-1208B,5/7/2014,888,0,897,720,0,0,2505
30270,RM-1229,8/19/2013,1254,0,1251,0,0,0,2505
32297,RM-1236,8/19/2013,1254,0,1251,0,0,0,2505
36842,RM-B200C,8/19/2013,0,0,1251,0,0,1254,2505
38307,RM-B215,11/28/2013,834,0,834,0,0,837,2505
40279,RM-B224,8/19/2013,0,0,1251,0,0,1254,2505
44299,RM-B250,12/10/2013,1248,0,1257,0,0,0,2505
44448,RM-B250,5/8/2014,0,750,981,774,0,0,2505
47605,RM-B275,8/19/2013,0,0,1251,0,0,1254,2505
23524,RM-1208,12/10/2013,1251,0,0,0,0,1251,2502
36931,RM-B200C,11/28/2013,834,0,834,0,0,834,2502
38290,RM-B215,11/8/2013,1074,0,354,0,0,1074,2502
44449,RM-B250,5/9/2014,0,738,978,786,0,0,2502
7620,RM-1116,12/10/2013,1248,0,0,0,0,1251,2499
35026,RM-B103A,12/10/2013,1248,0,0,0,0,1251,2499
44191,RM-B250,8/12/2013,1791,0,0,0,0,708,2499
24398,RM-1208B,6/14/2014,384,0,384,1728,0,0,2496
2756,RM-1106,9/5/2013,1245,0,0,0,0,1248,2493
7528,RM-1116,9/5/2013,0,0,1245,0,0,1248,2493
8216,RM-1117,9/5/2013,1245,0,0,0,0,1248,2493
23432,RM-1208,9/5/2013,1245,0,0,0,0,1248,2493
36851,RM-B200C,9/5/2013,0,0,1245,0,0,1248,2493
38227,RM-B215,9/5/2013,1245,0,0,0,0,1248,2493
47614,RM-B275,9/5/2013,0,0,1245,0,0,1248,2493
16,RM-1100A,7/14/2013,2490,0,0,0,0,0,2490
2712,RM-1106,7/14/2013,2490,0,0,0,0,0,2490
4769,RM-1109,7/14/2013,2490,0,0,0,0,0,2490
5454,RM-1110,7/14/2013,0,0,0,0,0,2490,2490
6202,RM-1113,9/26/2013,1245,0,1245,0,0,0,2490
7548,RM-1116,9/26/2013,0,0,1245,0,0,1245,2490
12145,RM-1130,7/14/2013,0,0,0,0,0,2490,2490
12832,RM-1132,7/14/2013,2490,0,0,0,0,0,2490
18753,RM-1155,9/5/2013,1245,0,1245,0,0,0,2490
18773,RM-1155,9/26/2013,1245,0,1245,0,0,0,2490
23388,RM-1208,7/14/2013,0,0,0,0,0,2490,2490
23452,RM-1208,9/26/2013,1245,0,0,0,0,1245,2490
26116,RM-1213A,7/14/2013,0,0,0,0,0,2490,2490
28177,RM-1221,7/14/2013,0,0,0,0,0,2490,2490
30235,RM-1229,7/14/2013,2490,0,0,0,0,0,2490
32306,RM-1236,9/5/2013,1245,0,1245,0,0,0,2490
32326,RM-1236,9/26/2013,1245,0,1245,0,0,0,2490
34890,RM-B103A,7/14/2013,0,0,0,0,0,2490,2490
36871,RM-B200C,9/26/2013,0,0,1245,0,0,1245,2490
38247,RM-B215,9/26/2013,1245,0,0,0,0,1245,2490
39556,RM-B222,7/14/2013,2490,0,0,0,0,0,2490
39600,RM-B222,9/5/2013,1245,0,1245,0,0,0,2490
40932,RM-B225,7/14/2013,0,0,0,0,0,2490,2490
42302,RM-B230A,7/14/2013,0,0,0,0,0,2490,2490
43553,RM-B240A,7/14/2013,0,0,0,0,0,2490,2490
47634,RM-B275,9/26/2013,0,0,1245,0,0,1245,2490
1691,RM-1102,5/28/2014,1047,1440,0,0,0,0,2487
3397,RM-1107,7/14/2013,0,0,2487,0,0,0,2487
6138,RM-1113,7/14/2013,0,0,2487,0,0,0,2487
8857,RM-1122,7/14/2013,0,0,2487,0,0,0,2487
13517,RM-1133,7/14/2013,0,0,2487,0,0,0,2487
18021,RM-1154,7/14/2013,0,0,2487,0,0,0,2487
25431,RM-1213,7/14/2013,0,0,2487,0,0,0,2487
27489,RM-1218,7/14/2013,0,0,2487,0,0,0,2487
33674,RM-B102C,7/14/2013,0,0,2487,0,0,0,2487
37495,RM-B210,7/14/2013,0,0,2487,0,0,0,2487
46902,RM-B270,7/14/2013,0,0,2487,0,0,0,2487
47570,RM-B275,7/14/2013,0,0,2487,0,0,0,2487
45707,RM-B260,1/18/2014,0,0,0,2484,0,0,2484
8955,RM-1122,10/30/2013,0,0,1239,0,0,1242,2481
23486,RM-1208,10/30/2013,1239,0,0,0,0,1242,2481
30333,RM-1229,10/30/2013,0,0,1239,0,0,1242,2481
38281,RM-B215,10/30/2013,1239,0,0,0,0,1242,2481
44261,RM-B250,10/30/2013,1242,0,1239,0,0,0,2481
47668,RM-B275,10/30/2013,0,0,1239,0,0,1242,2481
6205,RM-1113,9/29/2013,1239,0,1239,0,0,0,2478
6236,RM-1113,10/30/2013,1239,0,1239,0,0,0,2478
7551,RM-1116,9/29/2013,0,0,1239,0,0,1239,2478
8270,RM-1117,10/30/2013,1239,0,1239,0,0,0,2478
8419,RM-1117,3/31/2014,0,1728,750,0,0,0,2478
18776,RM-1155,9/29/2013,1239,0,1239,0,0,0,2478
18807,RM-1155,10/30/2013,1239,0,1239,0,0,0,2478
23455,RM-1208,9/29/2013,1239,0,0,0,0,1239,2478
27736,RM-1218,3/31/2014,0,0,750,1728,0,0,2478
32329,RM-1236,9/29/2013,1239,0,1239,0,0,0,2478
32360,RM-1236,10/30/2013,1239,0,1239,0,0,0,2478
36874,RM-B200C,9/29/2013,0,0,1239,0,0,1239,2478
38250,RM-B215,9/29/2013,1239,0,0,0,0,1239,2478
44410,RM-B250,3/31/2014,0,1728,750,0,0,0,2478
44452,RM-B250,5/12/2014,0,792,918,768,0,0,2478
47637,RM-B275,9/29/2013,0,0,1239,0,0,1239,2478
263,RM-1100A,3/31/2014,747,1728,0,0,0,0,2475
13079,RM-1132,3/31/2014,0,0,747,1728,0,0,2475
17583,RM-1151,3/31/2014,747,0,0,1728,0,0,2475
39803,RM-B222,3/31/2014,747,0,0,1728,0,0,2475
6276,RM-1113,12/12/2013,1236,0,1236,0,0,0,2472
7622,RM-1116,12/12/2013,1236,0,0,0,0,1236,2472
8310,RM-1117,12/12/2013,1236,0,1236,0,0,0,2472
18847,RM-1155,12/12/2013,1236,0,1236,0,0,0,2472
23526,RM-1208,12/12/2013,1236,0,0,0,0,1236,2472
30373,RM-1229,12/12/2013,0,0,1236,0,0,1236,2472
35028,RM-B103A,12/12/2013,1236,0,0,0,0,1236,2472
44301,RM-B250,12/12/2013,1236,0,1236,0,0,0,2472
6203,RM-1113,9/27/2013,1233,0,1233,0,0,0,2466
7549,RM-1116,9/27/2013,0,0,1233,0,0,1233,2466
18774,RM-1155,9/27/2013,1233,0,1233,0,0,0,2466
23453,RM-1208,9/27/2013,1233,0,0,0,0,1233,2466
32327,RM-1236,9/27/2013,1233,0,1233,0,0,0,2466
35741,RM-B109,5/25/2014,1233,0,1233,0,0,0,2466
36872,RM-B200C,9/27/2013,0,0,1233,0,0,1233,2466
38248,RM-B215,9/27/2013,1233,0,0,0,0,1233,2466
47635,RM-B275,9/27/2013,0,0,1233,0,0,1233,2466
6233,RM-1113,10/27/2013,1233,0,1230,0,0,0,2463
8267,RM-1117,10/27/2013,1233,0,1230,0,0,0,2463
13114,RM-1132,5/5/2014,0,0,885,1578,0,0,2463
18804,RM-1155,10/27/2013,1233,0,1230,0,0,0,2463
23483,RM-1208,10/27/2013,1233,0,0,0,0,1230,2463
24963,RM-1212,2/14/2014,1230,0,1233,0,0,0,2463
27083,RM-1217,5/5/2014,885,1578,0,0,0,0,2463
30517,RM-1229,5/5/2014,0,0,885,1578,0,0,2463
32357,RM-1236,10/27/2013,1233,0,1230,0,0,0,2463
32544,RM-1236,5/5/2014,0,1578,885,0,0,0,2463
37009,RM-B200C,2/14/2014,1230,0,1233,0,0,0,2463
38228,RM-B215,9/6/2013,1233,0,0,0,0,1230,2463
38278,RM-B215,10/27/2013,1233,0,0,0,0,1230,2463
39601,RM-B222,9/6/2013,1233,0,1230,0,0,0,2463
44258,RM-B250,10/27/2013,1233,0,1230,0,0,0,2463
2757,RM-1106,9/6/2013,1230,0,0,0,0,1230,2460
6999,RM-1115,2/14/2014,1230,0,0,0,0,1230,2460
7529,RM-1116,9/6/2013,0,0,1230,0,0,1230,2460
8217,RM-1117,9/6/2013,1230,0,0,0,0,1230,2460
8952,RM-1122,10/27/2013,0,0,1230,0,0,1230,2460
18754,RM-1155,9/6/2013,1230,0,1230,0,0,0,2460
19587,RM-1156,2/14/2014,1230,0,0,0,0,1230,2460
22905,RM-1207,2/14/2014,1230,0,0,0,0,1230,2460
23433,RM-1208,9/6/2013,1230,0,0,0,0,1230,2460
24399,RM-1208B,6/15/2014,354,0,378,1728,0,0,2460
32307,RM-1236,9/6/2013,1230,0,1230,0,0,0,2460
36852,RM-B200C,9/6/2013,0,0,1230,0,0,1230,2460
47615,RM-B275,9/6/2013,0,0,1230,0,0,1230,2460
47665,RM-B275,10/27/2013,0,0,1230,0,0,1230,2460
35172,RM-B103A,5/5/2014,885,0,0,1572,0,0,2457
7608,RM-1116,11/28/2013,834,0,783,0,0,837,2454
6275,RM-1113,12/11/2013,1224,0,1224,0,0,0,2448
7621,RM-1116,12/11/2013,1224,0,0,0,0,1224,2448
8309,RM-1117,12/11/2013,1224,0,1224,0,0,0,2448
18846,RM-1155,12/11/2013,1224,0,1224,0,0,0,2448
23525,RM-1208,12/11/2013,1224,0,0,0,0,1224,2448
24366,RM-1208B,5/13/2014,837,0,837,774,0,0,2448
24991,RM-1212,3/14/2014,1218,0,1230,0,0,0,2448
30372,RM-1229,12/11/2013,0,0,1224,0,0,1224,2448
35027,RM-B103A,12/11/2013,1224,0,0,0,0,1224,2448
37037,RM-B200C,3/14/2014,1218,0,1230,0,0,0,2448
44300,RM-B250,12/11/2013,1224,0,1224,0,0,0,2448
2901,RM-1106,2/1/2014,0,0,0,1698,0,747,2445
6240,RM-1113,11/3/2013,1221,0,1224,0,0,0,2445
8274,RM-1117,11/3/2013,1221,0,1224,0,0,0,2445
8361,RM-1117,2/1/2014,0,0,747,1698,0,0,2445
8959,RM-1122,11/3/2013,0,0,1224,0,0,1221,2445
9731,RM-1123,2/1/2014,0,1698,747,0,0,0,2445
13021,RM-1132,2/1/2014,0,0,747,1698,0,0,2445
13706,RM-1133,2/1/2014,0,1698,747,0,0,0,2445
18811,RM-1155,11/3/2013,1221,0,1224,0,0,0,2445
23490,RM-1208,11/3/2013,1224,0,0,0,0,1221,2445
24265,RM-1208B,2/1/2014,0,0,747,1698,0,0,2445
26990,RM-1217,2/1/2014,747,0,0,1698,0,0,2445
30337,RM-1229,11/3/2013,0,0,1224,0,0,1221,2445
32364,RM-1236,11/3/2013,1221,0,1224,0,0,0,2445
35628,RM-B109,2/1/2014,0,1698,747,0,0,0,2445
39745,RM-B222,2/1/2014,747,0,0,1698,0,0,2445
41806,RM-B230,2/1/2014,0,1698,747,0,0,0,2445
44265,RM-B250,11/3/2013,1221,0,1224,0,0,0,2445
47672,RM-B275,11/3/2013,0,0,1224,0,0,1221,2445
47759,RM-B275,2/1/2014,0,1698,0,0,0,747,2445
38285,RM-B215,11/3/2013,1221,0,0,0,0,1221,2442
44407,RM-B250,3/28/2014,0,1728,714,0,0,0,2442
8416,RM-1117,3/28/2014,0,1728,711,0,0,0,2439
23677,RM-1208,5/12/2014,915,1524,0,0,0,0,2439
25011,RM-1212,4/3/2014,1221,0,1218,0,0,0,2439
27733,RM-1218,3/28/2014,0,0,711,1728,0,0,2439
37057,RM-B200C,4/3/2014,1221,0,1218,0,0,0,2439
41867,RM-B230,4/3/2014,1221,0,1218,0,0,0,2439
7027,RM-1115,3/14/2014,1218,0,0,0,0,1218,2436
18939,RM-1155,3/14/2014,1218,0,0,0,0,1218,2436
19615,RM-1156,3/14/2014,1218,0,0,0,0,1218,2436
22933,RM-1207,3/14/2014,1218,0,0,0,0,1218,2436
23491,RM-1208,11/4/2013,1218,0,0,0,0,1218,2436
38286,RM-B215,11/4/2013,1218,0,0,0,0,1218,2436
6241,RM-1113,11/4/2013,1218,0,1215,0,0,0,2433
8275,RM-1117,11/4/2013,1218,0,1215,0,0,0,2433
8960,RM-1122,11/4/2013,0,0,1215,0,0,1218,2433
17627,RM-1151,5/14/2014,831,0,0,1602,0,0,2433
18812,RM-1155,11/4/2013,1218,0,1215,0,0,0,2433
30338,RM-1229,11/4/2013,0,0,1215,0,0,1218,2433
32365,RM-1236,11/4/2013,1218,0,1215,0,0,0,2433
44266,RM-B250,11/4/2013,1218,0,1215,0,0,0,2433
47673,RM-B275,11/4/2013,0,0,1215,0,0,1218,2433
2956,RM-1106,3/28/2014,0,0,0,1728,0,702,2430
4325,RM-1108,3/28/2014,0,1728,0,0,0,702,2430
27769,RM-1218,5/3/2014,0,0,702,1728,0,0,2430
36370,RM-B200B,3/28/2014,0,1728,0,0,0,702,2430
44455,RM-B250,5/15/2014,0,762,870,792,0,0,2424
14,RM-1100A,7/12/2013,2421,0,0,0,0,0,2421
260,RM-1100A,3/28/2014,693,1728,0,0,0,0,2421
2710,RM-1106,7/12/2013,2421,0,0,0,0,0,2421
3395,RM-1107,7/12/2013,0,0,2421,0,0,0,2421
4767,RM-1109,7/12/2013,2421,0,0,0,0,0,2421
5452,RM-1110,7/12/2013,0,0,0,0,0,2421,2421
6136,RM-1113,7/12/2013,0,0,2421,0,0,0,2421
8855,RM-1122,7/12/2013,0,0,2421,0,0,0,2421
11595,RM-1126,7/12/2013,0,0,0,0,0,2421,2421
12143,RM-1130,7/12/2013,0,0,0,0,0,2421,2421
12830,RM-1132,7/12/2013,2421,0,0,0,0,0,2421
13515,RM-1133,7/12/2013,0,0,2421,0,0,0,2421
17580,RM-1151,3/28/2014,693,0,0,1728,0,0,2421
17628,RM-1151,5/15/2014,873,0,0,1548,0,0,2421
18019,RM-1154,7/12/2013,0,0,2421,0,0,0,2421
23386,RM-1208,7/12/2013,0,0,0,0,0,2421,2421
24397,RM-1208B,6/13/2014,324,0,369,1728,0,0,2421
24994,RM-1212,3/17/2014,1209,0,1212,0,0,0,2421
25429,RM-1213,7/12/2013,0,0,2421,0,0,0,2421
26114,RM-1213A,7/12/2013,0,0,0,0,0,2421,2421
27487,RM-1218,7/12/2013,0,0,2421,0,0,0,2421
28175,RM-1221,7/12/2013,0,0,0,0,0,2421,2421
30233,RM-1229,7/12/2013,2421,0,0,0,0,0,2421
33672,RM-B102C,7/12/2013,0,0,2421,0,0,0,2421
34888,RM-B103A,7/12/2013,0,0,0,0,0,2421,2421
37040,RM-B200C,3/17/2014,1209,0,1212,0,0,0,2421
37493,RM-B210,7/12/2013,0,0,2421,0,0,0,2421
39554,RM-B222,7/12/2013,2421,0,0,0,0,0,2421
39800,RM-B222,3/28/2014,693,0,0,1728,0,0,2421
40930,RM-B225,7/12/2013,0,0,0,0,0,2421,2421
42300,RM-B230A,7/12/2013,0,0,0,0,0,2421,2421
43551,RM-B240A,7/12/2013,0,0,0,0,0,2421,2421
46900,RM-B270,7/12/2013,0,0,2421,0,0,0,2421
47568,RM-B275,7/12/2013,0,0,2421,0,0,0,2421
7030,RM-1115,3/17/2014,1209,0,0,0,0,1209,2418
18942,RM-1155,3/17/2014,1209,0,0,0,0,1209,2418
19618,RM-1156,3/17/2014,1209,0,0,0,0,1209,2418
22936,RM-1207,3/17/2014,1209,0,0,0,0,1209,2418
23459,RM-1208,10/3/2013,1209,0,0,0,0,1209,2418
38254,RM-B215,10/3/2013,1209,0,0,0,0,1209,2418
6209,RM-1113,10/3/2013,1209,0,1206,0,0,0,2415
18780,RM-1155,10/3/2013,1209,0,1206,0,0,0,2415
32333,RM-1236,10/3/2013,1209,0,1206,0,0,0,2415
36878,RM-B200C,10/3/2013,0,0,1206,0,0,1209,2415
44456,RM-B250,5/16/2014,0,852,717,846,0,0,2415
47641,RM-B275,10/3/2013,0,0,1206,0,0,1209,2415
6204,RM-1113,9/28/2013,1206,0,1206,0,0,0,2412
7550,RM-1116,9/28/2013,0,0,1206,0,0,1206,2412
7630,RM-1116,12/20/2013,1206,0,0,0,0,1206,2412
8318,RM-1117,12/20/2013,1206,0,1206,0,0,0,2412
18775,RM-1155,9/28/2013,1206,0,1206,0,0,0,2412
18855,RM-1155,12/20/2013,1206,0,1206,0,0,0,2412
22849,RM-1207,12/20/2013,1206,0,0,0,0,1206,2412
23454,RM-1208,9/28/2013,1206,0,0,0,0,1206,2412
23534,RM-1208,12/20/2013,1206,0,0,0,0,1206,2412
30381,RM-1229,12/20/2013,0,0,1206,0,0,1206,2412
32328,RM-1236,9/28/2013,1206,0,1206,0,0,0,2412
35036,RM-B103A,12/20/2013,1206,0,0,0,0,1206,2412
36873,RM-B200C,9/28/2013,0,0,1206,0,0,1206,2412
36953,RM-B200C,12/20/2013,1206,0,1206,0,0,0,2412
38249,RM-B215,9/28/2013,1206,0,0,0,0,1206,2412
44309,RM-B250,12/20/2013,1206,0,1206,0,0,0,2412
47636,RM-B275,9/28/2013,0,0,1206,0,0,1206,2412
35739,RM-B109,5/23/2014,1191,0,1218,0,0,0,2409
5450,RM-1110,7/10/2013,0,0,0,0,0,2406,2406
7036,RM-1115,3/23/2014,1203,0,0,0,0,1203,2406
11593,RM-1126,7/10/2013,0,0,0,0,0,2406,2406
12141,RM-1130,7/10/2013,0,0,0,0,0,2406,2406
18948,RM-1155,3/23/2014,1203,0,0,0,0,1203,2406
19624,RM-1156,3/23/2014,1203,0,0,0,0,1203,2406
22942,RM-1207,3/23/2014,1203,0,0,0,0,1203,2406
23384,RM-1208,7/10/2013,0,0,0,0,0,2406,2406
25000,RM-1212,3/23/2014,1203,0,1203,0,0,0,2406
26112,RM-1213A,7/10/2013,0,0,0,0,0,2406,2406
28173,RM-1221,7/10/2013,0,0,0,0,0,2406,2406
34886,RM-B103A,7/10/2013,0,0,0,0,0,2406,2406
37046,RM-B200C,3/23/2014,1203,0,1203,0,0,0,2406
40928,RM-B225,7/10/2013,0,0,0,0,0,2406,2406
42298,RM-B230A,7/10/2013,0,0,0,0,0,2406,2406
43549,RM-B240A,7/10/2013,0,0,0,0,0,2406,2406
12,RM-1100A,7/10/2013,2403,0,0,0,0,0,2403
2708,RM-1106,7/10/2013,2403,0,0,0,0,0,2403
3393,RM-1107,7/10/2013,0,0,2403,0,0,0,2403
4765,RM-1109,7/10/2013,2403,0,0,0,0,0,2403
6134,RM-1113,7/10/2013,0,0,2403,0,0,0,2403
8853,RM-1122,7/10/2013,0,0,2403,0,0,0,2403
12828,RM-1132,7/10/2013,2403,0,0,0,0,0,2403
13513,RM-1133,7/10/2013,0,0,2403,0,0,0,2403
18017,RM-1154,7/10/2013,0,0,2403,0,0,0,2403
25427,RM-1213,7/10/2013,0,0,2403,0,0,0,2403
27485,RM-1218,7/10/2013,0,0,2403,0,0,0,2403
30231,RM-1229,7/10/2013,2403,0,0,0,0,0,2403
33670,RM-B102C,7/10/2013,0,0,2403,0,0,0,2403
37491,RM-B210,7/10/2013,0,0,2403,0,0,0,2403
38179,RM-B215,7/10/2013,2403,0,0,0,0,0,2403
39552,RM-B222,7/10/2013,2403,0,0,0,0,0,2403
46898,RM-B270,7/10/2013,0,0,2403,0,0,0,2403
47566,RM-B275,7/10/2013,0,0,2403,0,0,0,2403
24400,RM-1208B,6/16/2014,327,0,345,1728,0,0,2400
35713,RM-B109,4/27/2014,1200,0,1200,0,0,0,2400
37081,RM-B200C,4/27/2014,1200,0,1200,0,0,0,2400
41891,RM-B230,4/27/2014,1200,0,1200,0,0,0,2400
7000,RM-1115,2/15/2014,1197,0,0,0,0,1200,2397
19588,RM-1156,2/15/2014,1197,0,0,0,0,1200,2397
22906,RM-1207,2/15/2014,1197,0,0,0,0,1200,2397
23680,RM-1208,5/15/2014,873,1524,0,0,0,0,2397
24401,RM-1208B,6/17/2014,321,0,345,1728,0,0,2394
24964,RM-1212,2/15/2014,1197,0,1197,0,0,0,2394
37010,RM-B200C,2/15/2014,1197,0,1197,0,0,0,2394
6242,RM-1113,11/5/2013,1194,0,1197,0,0,0,2391
7520,RM-1116,8/20/2013,0,0,1197,0,0,1194,2391
8276,RM-1117,11/5/2013,1194,0,1197,0,0,0,2391
8961,RM-1122,11/5/2013,0,0,1197,0,0,1194,2391
18745,RM-1155,8/20/2013,1194,0,1197,0,0,0,2391
18813,RM-1155,11/5/2013,1194,0,1197,0,0,0,2391
24402,RM-1208B,6/18/2014,330,0,333,1728,0,0,2391
30271,RM-1229,8/20/2013,1194,0,1197,0,0,0,2391
30339,RM-1229,11/5/2013,0,0,1197,0,0,1194,2391
32298,RM-1236,8/20/2013,1194,0,1197,0,0,0,2391
32366,RM-1236,11/5/2013,1194,0,1197,0,0,0,2391
36843,RM-B200C,8/20/2013,0,0,1197,0,0,1194,2391
40280,RM-B224,8/20/2013,0,0,1197,0,0,1194,2391
44267,RM-B250,11/5/2013,1194,0,1197,0,0,0,2391
44453,RM-B250,5/13/2014,0,768,837,786,0,0,2391
47606,RM-B275,8/20/2013,0,0,1197,0,0,1194,2391
47674,RM-B275,11/5/2013,0,0,1197,0,0,1194,2391
2748,RM-1106,8/20/2013,1194,0,0,0,0,1194,2388
2899,RM-1106,1/30/2014,0,0,0,1722,0,666,2388
6235,RM-1113,10/29/2013,1194,0,1194,0,0,0,2388
8208,RM-1117,8/20/2013,1194,0,0,0,0,1194,2388
8269,RM-1117,10/29/2013,1194,0,1194,0,0,0,2388
8954,RM-1122,10/29/2013,0,0,1194,0,0,1194,2388
18806,RM-1155,10/29/2013,1194,0,1194,0,0,0,2388
23424,RM-1208,8/20/2013,1194,0,0,0,0,1194,2388
23485,RM-1208,10/29/2013,1194,0,0,0,0,1194,2388
23492,RM-1208,11/5/2013,1194,0,0,0,0,1194,2388
30332,RM-1229,10/29/2013,0,0,1194,0,0,1194,2388
32359,RM-1236,10/29/2013,1194,0,1194,0,0,0,2388
38219,RM-B215,8/20/2013,1194,0,0,0,0,1194,2388
38280,RM-B215,10/29/2013,1194,0,0,0,0,1194,2388
38287,RM-B215,11/5/2013,1194,0,0,0,0,1194,2388
39592,RM-B222,8/20/2013,1194,0,1194,0,0,0,2388
44260,RM-B250,10/29/2013,1194,0,1194,0,0,0,2388
47667,RM-B275,10/29/2013,0,0,1194,0,0,1194,2388
3400,RM-1107,7/18/2013,0,0,2385,0,0,0,2385
6141,RM-1113,7/18/2013,0,0,2385,0,0,0,2385
6234,RM-1113,10/28/2013,1191,0,1194,0,0,0,2385
6249,RM-1113,11/12/2013,1191,0,1194,0,0,0,2385
8268,RM-1117,10/28/2013,1191,0,1194,0,0,0,2385
8283,RM-1117,11/12/2013,1191,0,1194,0,0,0,2385
8359,RM-1117,1/30/2014,0,0,663,1722,0,0,2385
8860,RM-1122,7/18/2013,0,0,2385,0,0,0,2385
8953,RM-1122,10/28/2013,0,0,1194,0,0,1191,2385
8968,RM-1122,11/12/2013,0,0,1194,0,0,1191,2385
9729,RM-1123,1/30/2014,0,1722,663,0,0,0,2385
13019,RM-1132,1/30/2014,0,0,663,1722,0,0,2385
13520,RM-1133,7/18/2013,0,0,2385,0,0,0,2385
13704,RM-1133,1/30/2014,0,1722,663,0,0,0,2385
18024,RM-1154,7/18/2013,0,0,2385,0,0,0,2385
18805,RM-1155,10/28/2013,1191,0,1194,0,0,0,2385
18820,RM-1155,11/12/2013,1191,0,1194,0,0,0,2385
24263,RM-1208B,1/30/2014,0,0,663,1722,0,0,2385
25434,RM-1213,7/18/2013,0,0,2385,0,0,0,2385
26988,RM-1217,1/30/2014,663,0,0,1722,0,0,2385
30331,RM-1229,10/28/2013,0,0,1194,0,0,1191,2385
30346,RM-1229,11/12/2013,0,0,1194,0,0,1191,2385
32358,RM-1236,10/28/2013,1191,0,1194,0,0,0,2385
32373,RM-1236,11/12/2013,1191,0,1194,0,0,0,2385
33677,RM-B102C,7/18/2013,0,0,2385,0,0,0,2385
37498,RM-B210,7/18/2013,0,0,2385,0,0,0,2385
39743,RM-B222,1/30/2014,663,0,0,1722,0,0,2385
44259,RM-B250,10/28/2013,1191,0,1194,0,0,0,2385
44274,RM-B250,11/12/2013,1191,0,1194,0,0,0,2385
46905,RM-B270,7/18/2013,0,0,2385,0,0,0,2385
47573,RM-B275,7/18/2013,0,0,2385,0,0,0,2385
47666,RM-B275,10/28/2013,0,0,1194,0,0,1191,2385
47681,RM-B275,11/12/2013,0,0,1194,0,0,1191,2385
19,RM-1100A,7/18/2013,2382,0,0,0,0,0,2382
333,RM-1100A,6/9/2014,654,1728,0,0,0,0,2382
1703,RM-1102,6/9/2014,654,1728,0,0,0,0,2382
2715,RM-1106,7/18/2013,2382,0,0,0,0,0,2382
5457,RM-1110,7/18/2013,0,0,0,0,0,2382,2382
6208,RM-1113,10/2/2013,1191,0,1191,0,0,0,2382
12148,RM-1130,7/18/2013,0,0,0,0,0,2382,2382
12835,RM-1132,7/18/2013,2382,0,0,0,0,0,2382
13149,RM-1132,6/9/2014,0,0,654,1728,0,0,2382
18779,RM-1155,10/2/2013,1191,0,1191,0,0,0,2382
23391,RM-1208,7/18/2013,0,0,0,0,0,2382,2382
23458,RM-1208,10/2/2013,1191,0,0,0,0,1191,2382
23484,RM-1208,10/28/2013,1191,0,0,0,0,1191,2382
23499,RM-1208,11/12/2013,1191,0,0,0,0,1191,2382
26119,RM-1213A,7/18/2013,0,0,0,0,0,2382,2382
27118,RM-1217,6/9/2014,654,1728,0,0,0,0,2382
28180,RM-1221,7/18/2013,0,0,0,0,0,2382,2382
30238,RM-1229,7/18/2013,2382,0,0,0,0,0,2382
30552,RM-1229,6/9/2014,0,0,654,1728,0,0,2382
32332,RM-1236,10/2/2013,1191,0,1191,0,0,0,2382
32579,RM-1236,6/9/2014,0,1728,654,0,0,0,2382
34893,RM-B103A,7/18/2013,0,0,0,0,0,2382,2382
36877,RM-B200C,10/2/2013,0,0,1191,0,0,1191,2382
38253,RM-B215,10/2/2013,1191,0,0,0,0,1191,2382
38279,RM-B215,10/28/2013,1191,0,0,0,0,1191,2382
39559,RM-B222,7/18/2013,2382,0,0,0,0,0,2382
39873,RM-B222,6/9/2014,654,0,0,1728,0,0,2382
40935,RM-B225,7/18/2013,0,0,0,0,0,2382,2382
42305,RM-B230A,7/18/2013,0,0,0,0,0,2382,2382
43556,RM-B240A,7/18/2013,0,0,0,0,0,2382,2382
43823,RM-B240A,4/23/2014,0,2382,0,0,0,0,2382
45849,RM-B260,6/9/2014,654,0,0,1728,0,0,2382
47640,RM-B275,10/2/2013,0,0,1191,0,0,1191,2382
47757,RM-B275,1/30/2014,0,1716,0,0,0,666,2382
35626,RM-B109,1/30/2014,0,1716,663,0,0,0,2379
41804,RM-B230,1/30/2014,0,1716,663,0,0,0,2379
7631,RM-1116,12/21/2013,1188,0,0,0,0,1188,2376
8319,RM-1117,12/21/2013,1188,0,1188,0,0,0,2376
18856,RM-1155,12/21/2013,1188,0,1188,0,0,0,2376
22850,RM-1207,12/21/2013,1188,0,0,0,0,1188,2376
23535,RM-1208,12/21/2013,1188,0,0,0,0,1188,2376
30382,RM-1229,12/21/2013,0,0,1188,0,0,1188,2376
35037,RM-B103A,12/21/2013,1188,0,0,0,0,1188,2376
36954,RM-B200C,12/21/2013,1188,0,1188,0,0,0,2376
44310,RM-B250,12/21/2013,1188,0,1188,0,0,0,2376
3398,RM-1107,7/15/2013,0,0,2373,0,0,0,2373
5455,RM-1110,7/15/2013,0,0,0,0,0,2373,2373
6139,RM-1113,7/15/2013,0,0,2373,0,0,0,2373
8858,RM-1122,7/15/2013,0,0,2373,0,0,0,2373
12146,RM-1130,7/15/2013,0,0,0,0,0,2373,2373
13518,RM-1133,7/15/2013,0,0,2373,0,0,0,2373
18022,RM-1154,7/15/2013,0,0,2373,0,0,0,2373
23389,RM-1208,7/15/2013,0,0,0,0,0,2373,2373
25432,RM-1213,7/15/2013,0,0,2373,0,0,0,2373
26117,RM-1213A,7/15/2013,0,0,0,0,0,2373,2373
28178,RM-1221,7/15/2013,0,0,0,0,0,2373,2373
33675,RM-B102C,7/15/2013,0,0,2373,0,0,0,2373
34891,RM-B103A,7/15/2013,0,0,0,0,0,2373,2373
37496,RM-B210,7/15/2013,0,0,2373,0,0,0,2373
40933,RM-B225,7/15/2013,0,0,0,0,0,2373,2373
42303,RM-B230A,7/15/2013,0,0,0,0,0,2373,2373
43554,RM-B240A,7/15/2013,0,0,0,0,0,2373,2373
46903,RM-B270,7/15/2013,0,0,2373,0,0,0,2373
47571,RM-B275,7/15/2013,0,0,2373,0,0,0,2373
17,RM-1100A,7/15/2013,2370,0,0,0,0,0,2370
2713,RM-1106,7/15/2013,2370,0,0,0,0,0,2370
12833,RM-1132,7/15/2013,2370,0,0,0,0,0,2370
23466,RM-1208,10/10/2013,1185,0,0,0,0,1185,2370
30236,RM-1229,7/15/2013,2370,0,0,0,0,0,2370
38261,RM-B215,10/10/2013,1185,0,0,0,0,1185,2370
39557,RM-B222,7/15/2013,2370,0,0,0,0,0,2370
6216,RM-1113,10/10/2013,1185,0,1182,0,0,0,2367
8935,RM-1122,10/10/2013,0,0,1182,0,0,1185,2367
18787,RM-1155,10/10/2013,1185,0,1182,0,0,0,2367
32340,RM-1236,10/10/2013,1185,0,1182,0,0,0,2367
44241,RM-B250,10/10/2013,1185,0,1182,0,0,0,2367
47648,RM-B275,10/10/2013,0,0,1182,0,0,1185,2367
3402,RM-1107,7/20/2013,0,0,2361,0,0,0,2361
6143,RM-1113,7/20/2013,0,0,2361,0,0,0,2361
8862,RM-1122,7/20/2013,0,0,2361,0,0,0,2361
13522,RM-1133,7/20/2013,0,0,2361,0,0,0,2361
17626,RM-1151,5/13/2014,837,0,0,1524,0,0,2361
25436,RM-1213,7/20/2013,0,0,2361,0,0,0,2361
33679,RM-B102C,7/20/2013,0,0,2361,0,0,0,2361
37500,RM-B210,7/20/2013,0,0,2361,0,0,0,2361
46907,RM-B270,7/20/2013,0,0,2361,0,0,0,2361
47575,RM-B275,7/20/2013,0,0,2361,0,0,0,2361
21,RM-1100A,7/20/2013,2358,0,0,0,0,0,2358
2717,RM-1106,7/20/2013,2358,0,0,0,0,0,2358
5459,RM-1110,7/20/2013,0,0,0,0,0,2358,2358
6248,RM-1113,11/11/2013,1179,0,1179,0,0,0,2358
8282,RM-1117,11/11/2013,1179,0,1179,0,0,0,2358
8341,RM-1117,1/12/2014,0,0,876,1482,0,0,2358
8967,RM-1122,11/11/2013,0,0,1179,0,0,1179,2358
12150,RM-1130,7/20/2013,0,0,0,0,0,2358,2358
12837,RM-1132,7/20/2013,2358,0,0,0,0,0,2358
18819,RM-1155,11/11/2013,1179,0,1179,0,0,0,2358
23393,RM-1208,7/20/2013,0,0,0,0,0,2358,2358
23498,RM-1208,11/11/2013,1179,0,0,0,0,1179,2358
23500,RM-1208,11/13/2013,1179,0,0,0,0,1179,2358
26121,RM-1213A,7/20/2013,0,0,0,0,0,2358,2358
28182,RM-1221,7/20/2013,0,0,0,0,0,2358,2358
30240,RM-1229,7/20/2013,2358,0,0,0,0,0,2358
30345,RM-1229,11/11/2013,0,0,1179,0,0,1179,2358
32372,RM-1236,11/11/2013,1179,0,1179,0,0,0,2358
34895,RM-B103A,7/20/2013,0,0,0,0,0,2358,2358
39561,RM-B222,7/20/2013,2358,0,0,0,0,0,2358
40937,RM-B225,7/20/2013,0,0,0,0,0,2358,2358
42307,RM-B230A,7/20/2013,0,0,0,0,0,2358,2358
43558,RM-B240A,7/20/2013,0,0,0,0,0,2358,2358
44273,RM-B250,11/11/2013,1179,0,1179,0,0,0,2358
47680,RM-B275,11/11/2013,0,0,1179,0,0,1179,2358
6210,RM-1113,10/4/2013,1176,0,1179,0,0,0,2355
6250,RM-1113,11/13/2013,1179,0,1176,0,0,0,2355
7006,RM-1115,2/21/2014,1179,0,0,0,0,1176,2355
8284,RM-1117,11/13/2013,1179,0,1176,0,0,0,2355
8969,RM-1122,11/13/2013,0,0,1176,0,0,1179,2355
13689,RM-1133,1/15/2014,0,1680,675,0,0,0,2355
18781,RM-1155,10/4/2013,1176,0,1179,0,0,0,2355
18821,RM-1155,11/13/2013,1179,0,1176,0,0,0,2355
19594,RM-1156,2/21/2014,1179,0,0,0,0,1176,2355
22912,RM-1207,2/21/2014,1179,0,0,0,0,1176,2355
24970,RM-1212,2/21/2014,1179,0,1176,0,0,0,2355
26970,RM-1217,1/12/2014,873,0,0,1482,0,0,2355
30347,RM-1229,11/13/2013,0,0,1176,0,0,1179,2355
32334,RM-1236,10/4/2013,1176,0,1179,0,0,0,2355
32374,RM-1236,11/13/2013,1179,0,1176,0,0,0,2355
36879,RM-B200C,10/4/2013,0,0,1179,0,0,1176,2355
37016,RM-B200C,2/21/2014,1179,0,1176,0,0,0,2355
44275,RM-B250,11/13/2013,1179,0,1176,0,0,0,2355
47642,RM-B275,10/4/2013,0,0,1179,0,0,1176,2355
47682,RM-B275,11/13/2013,0,0,1176,0,0,1179,2355
13686,RM-1133,1/12/2014,0,1476,876,0,0,0,2352
23460,RM-1208,10/4/2013,1176,0,0,0,0,1176,2352
38255,RM-B215,10/4/2013,1176,0,0,0,0,1176,2352
38288,RM-B215,11/6/2013,1176,0,0,0,0,1176,2352
6243,RM-1113,11/6/2013,1176,0,1173,0,0,0,2349
8277,RM-1117,11/6/2013,1176,0,1173,0,0,0,2349
8344,RM-1117,1/15/2014,0,0,675,1674,0,0,2349
8962,RM-1122,11/6/2013,0,0,1173,0,0,1176,2349
18814,RM-1155,11/6/2013,1176,0,1173,0,0,0,2349
23493,RM-1208,11/6/2013,1173,0,0,0,0,1176,2349
30340,RM-1229,11/6/2013,0,0,1173,0,0,1176,2349
32367,RM-1236,11/6/2013,1176,0,1173,0,0,0,2349
35733,RM-B109,5/17/2014,1164,0,1185,0,0,0,2349
36298,RM-B200B,1/15/2014,0,1674,0,0,0,675,2349
41789,RM-B230,1/15/2014,0,1674,675,0,0,0,2349
41911,RM-B230,5/17/2014,1164,0,1185,0,0,0,2349
44268,RM-B250,11/6/2013,1176,0,1173,0,0,0,2349
44447,RM-B250,5/7/2014,0,714,897,738,0,0,2349
47675,RM-B275,11/6/2013,0,0,1173,0,0,1176,2349
47742,RM-B275,1/15/2014,0,1674,0,0,0,675,2349
24403,RM-1208B,6/19/2014,309,0,309,1728,0,0,2346
26973,RM-1217,1/15/2014,672,0,0,1674,0,0,2346
41786,RM-B230,1/12/2014,0,1470,876,0,0,0,2346
30550,RM-1229,6/7/2014,0,0,615,1728,0,0,2343
32577,RM-1236,6/7/2014,0,1728,615,0,0,0,2343
36295,RM-B200B,1/12/2014,0,1470,0,0,0,873,2343
47739,RM-B275,1/12/2014,0,1470,0,0,0,873,2343
7632,RM-1116,12/22/2013,1170,0,0,0,0,1170,2340
22851,RM-1207,12/22/2013,1170,0,0,0,0,1170,2340
23536,RM-1208,12/22/2013,1170,0,0,0,0,1170,2340
35038,RM-B103A,12/22/2013,1170,0,0,0,0,1170,2340
8320,RM-1117,12/22/2013,1170,0,1167,0,0,0,2337
18857,RM-1155,12/22/2013,1170,0,1167,0,0,0,2337
25012,RM-1212,4/4/2014,1167,0,1170,0,0,0,2337
28325,RM-1221,12/22/2013,0,0,1167,0,0,1170,2337
30383,RM-1229,12/22/2013,0,0,1167,0,0,1170,2337
36955,RM-B200C,12/22/2013,1170,0,1167,0,0,0,2337
37058,RM-B200C,4/4/2014,1167,0,1170,0,0,0,2337
41868,RM-B230,4/4/2014,1167,0,1170,0,0,0,2337
44311,RM-B250,12/22/2013,1170,0,1167,0,0,0,2337
13,RM-1100A,7/11/2013,2331,0,0,0,0,0,2331
2709,RM-1106,7/11/2013,2331,0,0,0,0,0,2331
3394,RM-1107,7/11/2013,0,0,2331,0,0,0,2331
4766,RM-1109,7/11/2013,2331,0,0,0,0,0,2331
6135,RM-1113,7/11/2013,0,0,2331,0,0,0,2331
8854,RM-1122,7/11/2013,0,0,2331,0,0,0,2331
12829,RM-1132,7/11/2013,2331,0,0,0,0,0,2331
13514,RM-1133,7/11/2013,0,0,2331,0,0,0,2331
18018,RM-1154,7/11/2013,0,0,2331,0,0,0,2331
24404,RM-1208B,6/20/2014,303,0,300,1728,0,0,2331
25428,RM-1213,7/11/2013,0,0,2331,0,0,0,2331
27486,RM-1218,7/11/2013,0,0,2331,0,0,0,2331
30232,RM-1229,7/11/2013,2331,0,0,0,0,0,2331
33671,RM-B102C,7/11/2013,0,0,2331,0,0,0,2331
37492,RM-B210,7/11/2013,0,0,2331,0,0,0,2331
38180,RM-B215,7/11/2013,2331,0,0,0,0,0,2331
39553,RM-B222,7/11/2013,2331,0,0,0,0,0,2331
46899,RM-B270,7/11/2013,0,0,2331,0,0,0,2331
47567,RM-B275,7/11/2013,0,0,2331,0,0,0,2331
331,RM-1100A,6/7/2014,600,1728,0,0,0,0,2328
1701,RM-1102,6/7/2014,600,1728,0,0,0,0,2328
5451,RM-1110,7/11/2013,0,0,0,0,0,2328,2328
11594,RM-1126,7/11/2013,0,0,0,0,0,2328,2328
12142,RM-1130,7/11/2013,0,0,0,0,0,2328,2328
13147,RM-1132,6/7/2014,0,0,600,1728,0,0,2328
23385,RM-1208,7/11/2013,0,0,0,0,0,2328,2328
26113,RM-1213A,7/11/2013,0,0,0,0,0,2328,2328
27116,RM-1217,6/7/2014,600,1728,0,0,0,0,2328
28174,RM-1221,7/11/2013,0,0,0,0,0,2328,2328
34887,RM-B103A,7/11/2013,0,0,0,0,0,2328,2328
39871,RM-B222,6/7/2014,600,0,0,1728,0,0,2328
40929,RM-B225,7/11/2013,0,0,0,0,0,2328,2328
42299,RM-B230A,7/11/2013,0,0,0,0,0,2328,2328
43550,RM-B240A,7/11/2013,0,0,0,0,0,2328,2328
45847,RM-B260,6/7/2014,600,0,0,1728,0,0,2328
7623,RM-1116,12/13/2013,1161,0,0,0,0,1161,2322
30553,RM-1229,6/10/2014,0,0,594,1728,0,0,2322
32580,RM-1236,6/10/2014,0,1728,594,0,0,0,2322
35029,RM-B103A,12/13/2013,1161,0,0,0,0,1161,2322
6229,RM-1113,10/23/2013,1158,0,1161,0,0,0,2319
6277,RM-1113,12/13/2013,1161,0,1158,0,0,0,2319
8263,RM-1117,10/23/2013,1158,0,1161,0,0,0,2319
8312,RM-1117,12/14/2013,1161,0,1158,0,0,0,2319
8948,RM-1122,10/23/2013,0,0,1161,0,0,1158,2319
18800,RM-1155,10/23/2013,1158,0,1161,0,0,0,2319
18848,RM-1155,12/13/2013,1161,0,1158,0,0,0,2319
23527,RM-1208,12/13/2013,1158,0,0,0,0,1161,2319
25001,RM-1212,3/24/2014,1158,0,1161,0,0,0,2319
30374,RM-1229,12/13/2013,0,0,1158,0,0,1161,2319
32353,RM-1236,10/23/2013,1158,0,1161,0,0,0,2319
36946,RM-B200C,12/13/2013,1161,0,1158,0,0,0,2319
37047,RM-B200C,3/24/2014,1158,0,1161,0,0,0,2319
44254,RM-B250,10/23/2013,1158,0,1161,0,0,0,2319
44302,RM-B250,12/13/2013,1161,0,1158,0,0,0,2319
47661,RM-B275,10/23/2013,0,0,1161,0,0,1158,2319
334,RM-1100A,6/10/2014,588,1728,0,0,0,0,2316
1704,RM-1102,6/10/2014,588,1728,0,0,0,0,2316
2761,RM-1106,9/11/2013,1158,0,0,0,0,1158,2316
6251,RM-1113,11/14/2013,1158,0,1158,0,0,0,2316
6278,RM-1113,12/14/2013,1158,0,1158,0,0,0,2316
7035,RM-1115,3/22/2014,1158,0,0,0,0,1158,2316
7037,RM-1115,3/24/2014,1158,0,0,0,0,1158,2316
7533,RM-1116,9/11/2013,0,0,1158,0,0,1158,2316
7624,RM-1116,12/14/2013,1158,0,0,0,0,1158,2316
8221,RM-1117,9/11/2013,1158,0,0,0,0,1158,2316
8285,RM-1117,11/14/2013,1158,0,1158,0,0,0,2316
8311,RM-1117,12/13/2013,1158,0,1158,0,0,0,2316
8970,RM-1122,11/14/2013,0,0,1158,0,0,1158,2316
13150,RM-1132,6/10/2014,0,0,588,1728,0,0,2316
18758,RM-1155,9/11/2013,1158,0,1158,0,0,0,2316
18822,RM-1155,11/14/2013,1158,0,1158,0,0,0,2316
18849,RM-1155,12/14/2013,1158,0,1158,0,0,0,2316
18947,RM-1155,3/22/2014,1158,0,0,0,0,1158,2316
18949,RM-1155,3/24/2014,1158,0,0,0,0,1158,2316
19623,RM-1156,3/22/2014,1158,0,0,0,0,1158,2316
19625,RM-1156,3/24/2014,1158,0,0,0,0,1158,2316
22941,RM-1207,3/22/2014,1158,0,0,0,0,1158,2316
22943,RM-1207,3/24/2014,1158,0,0,0,0,1158,2316
23437,RM-1208,9/11/2013,1158,0,0,0,0,1158,2316
23479,RM-1208,10/23/2013,1158,0,0,0,0,1158,2316
23501,RM-1208,11/14/2013,1158,0,0,0,0,1158,2316
23528,RM-1208,12/14/2013,1158,0,0,0,0,1158,2316
24965,RM-1212,2/16/2014,1158,0,1158,0,0,0,2316
27119,RM-1217,6/10/2014,588,1728,0,0,0,0,2316
30348,RM-1229,11/14/2013,0,0,1158,0,0,1158,2316
30375,RM-1229,12/14/2013,0,0,1158,0,0,1158,2316
32311,RM-1236,9/11/2013,1158,0,1158,0,0,0,2316
32375,RM-1236,11/14/2013,1158,0,1158,0,0,0,2316
35030,RM-B103A,12/14/2013,1158,0,0,0,0,1158,2316
36856,RM-B200C,9/11/2013,0,0,1158,0,0,1158,2316
36947,RM-B200C,12/14/2013,1158,0,1158,0,0,0,2316
37011,RM-B200C,2/16/2014,1158,0,1158,0,0,0,2316
38232,RM-B215,9/11/2013,1158,0,0,0,0,1158,2316
38256,RM-B215,10/5/2013,1158,0,0,0,0,1158,2316
38274,RM-B215,10/23/2013,1158,0,0,0,0,1158,2316
39605,RM-B222,9/11/2013,1158,0,1158,0,0,0,2316
39874,RM-B222,6/10/2014,588,0,0,1728,0,0,2316
44276,RM-B250,11/14/2013,1158,0,1158,0,0,0,2316
44303,RM-B250,12/14/2013,1158,0,1158,0,0,0,2316
45850,RM-B260,6/10/2014,588,0,0,1728,0,0,2316
47619,RM-B275,9/11/2013,0,0,1158,0,0,1158,2316
47683,RM-B275,11/14/2013,0,0,1158,0,0,1158,2316
7001,RM-1115,2/16/2014,1158,0,0,0,0,1155,2313
18782,RM-1155,10/5/2013,1158,0,1155,0,0,0,2313
19589,RM-1156,2/16/2014,1158,0,0,0,0,1155,2313
22907,RM-1207,2/16/2014,1158,0,0,0,0,1155,2313
23461,RM-1208,10/5/2013,1155,0,0,0,0,1158,2313
24999,RM-1212,3/22/2014,1158,0,1155,0,0,0,2313
35714,RM-B109,4/28/2014,1158,0,1155,0,0,0,2313
36880,RM-B200C,10/5/2013,0,0,1155,0,0,1158,2313
37045,RM-B200C,3/22/2014,1158,0,1155,0,0,0,2313
37082,RM-B200C,4/28/2014,1158,0,1155,0,0,0,2313
41892,RM-B230,4/28/2014,1158,0,1155,0,0,0,2313
44236,RM-B250,10/5/2013,1158,0,1155,0,0,0,2313
47643,RM-B275,10/5/2013,0,0,1155,0,0,1158,2313
6211,RM-1113,10/5/2013,1155,0,1155,0,0,0,2310
32335,RM-1236,10/5/2013,1155,0,1155,0,0,0,2310
23679,RM-1208,5/14/2014,831,1476,0,0,0,0,2307
22,RM-1100A,7/21/2013,2301,0,0,0,0,0,2301
2718,RM-1106,7/21/2013,2301,0,0,0,0,0,2301
3403,RM-1107,7/21/2013,0,0,2301,0,0,0,2301
5460,RM-1110,7/21/2013,0,0,0,0,0,2301,2301
6144,RM-1113,7/21/2013,0,0,2301,0,0,0,2301
8863,RM-1122,7/21/2013,0,0,2301,0,0,0,2301
12151,RM-1130,7/21/2013,0,0,0,0,0,2301,2301
12838,RM-1132,7/21/2013,2301,0,0,0,0,0,2301
13523,RM-1133,7/21/2013,0,0,2301,0,0,0,2301
18883,RM-1155,1/17/2014,285,0,288,1728,0,0,2301
23394,RM-1208,7/21/2013,0,0,0,0,0,2301,2301
25437,RM-1213,7/21/2013,0,0,2301,0,0,0,2301
26122,RM-1213A,7/21/2013,0,0,0,0,0,2301,2301
28183,RM-1221,7/21/2013,0,0,0,0,0,2301,2301
30241,RM-1229,7/21/2013,2301,0,0,0,0,0,2301
33680,RM-B102C,7/21/2013,0,0,2301,0,0,0,2301
34896,RM-B103A,7/21/2013,0,0,0,0,0,2301,2301
37501,RM-B210,7/21/2013,0,0,2301,0,0,0,2301
39562,RM-B222,7/21/2013,2301,0,0,0,0,0,2301
40938,RM-B225,7/21/2013,0,0,0,0,0,2301,2301
42308,RM-B230A,7/21/2013,0,0,0,0,0,2301,2301
43559,RM-B240A,7/21/2013,0,0,0,0,0,2301,2301
46908,RM-B270,7/21/2013,0,0,2301,0,0,0,2301
47576,RM-B275,7/21/2013,0,0,2301,0,0,0,2301
2760,RM-1106,9/10/2013,1149,0,0,0,0,1149,2298
6212,RM-1113,10/6/2013,1149,0,1149,0,0,0,2298
7532,RM-1116,9/10/2013,0,0,1149,0,0,1149,2298
8220,RM-1117,9/10/2013,1149,0,0,0,0,1149,2298
8931,RM-1122,10/6/2013,0,0,1149,0,0,1149,2298
18757,RM-1155,9/10/2013,1149,0,1149,0,0,0,2298
23436,RM-1208,9/10/2013,1149,0,0,0,0,1149,2298
23462,RM-1208,10/6/2013,1149,0,0,0,0,1149,2298
32310,RM-1236,9/10/2013,1149,0,1149,0,0,0,2298
32336,RM-1236,10/6/2013,1149,0,1149,0,0,0,2298
35745,RM-B109,5/29/2014,1149,0,1149,0,0,0,2298
36855,RM-B200C,9/10/2013,0,0,1149,0,0,1149,2298
36881,RM-B200C,10/6/2013,0,0,1149,0,0,1149,2298
38231,RM-B215,9/10/2013,1149,0,0,0,0,1149,2298
39604,RM-B222,9/10/2013,1149,0,1149,0,0,0,2298
47618,RM-B275,9/10/2013,0,0,1149,0,0,1149,2298
47644,RM-B275,10/6/2013,0,0,1149,0,0,1149,2298
7007,RM-1115,2/22/2014,1146,0,0,0,0,1149,2295
18783,RM-1155,10/6/2013,1146,0,1149,0,0,0,2295
19595,RM-1156,2/22/2014,1146,0,0,0,0,1149,2295
22913,RM-1207,2/22/2014,1146,0,0,0,0,1149,2295
24971,RM-1212,2/22/2014,1146,0,1149,0,0,0,2295
30409,RM-1229,1/17/2014,0,0,288,1722,0,285,2295
37017,RM-B200C,2/22/2014,1146,0,1149,0,0,0,2295
38257,RM-B215,10/6/2013,1146,0,0,0,0,1149,2295
44237,RM-B250,10/6/2013,1146,0,1149,0,0,0,2295
7031,RM-1115,3/18/2014,1146,0,0,0,0,1146,2292
18943,RM-1155,3/18/2014,1146,0,0,0,0,1146,2292
19619,RM-1156,3/18/2014,1146,0,0,0,0,1146,2292
22937,RM-1207,3/18/2014,1146,0,0,0,0,1146,2292
24995,RM-1212,3/18/2014,1146,0,1146,0,0,0,2292
35064,RM-B103A,1/17/2014,285,0,0,1722,0,285,2292
35742,RM-B109,5/26/2014,1146,0,1146,0,0,0,2292
35746,RM-B109,5/30/2014,1146,0,1146,0,0,0,2292
37041,RM-B200C,3/18/2014,1146,0,1146,0,0,0,2292
24405,RM-1208B,6/21/2014,279,0,282,1728,0,0,2289
25013,RM-1212,4/5/2014,1146,0,1143,0,0,0,2289
37059,RM-B200C,4/5/2014,1146,0,1143,0,0,0,2289
41869,RM-B230,4/5/2014,1146,0,1143,0,0,0,2289
7633,RM-1116,12/23/2013,1143,0,0,0,0,1143,2286
8321,RM-1117,12/23/2013,1143,0,1143,0,0,0,2286
18858,RM-1155,12/23/2013,1143,0,1143,0,0,0,2286
22852,RM-1207,12/23/2013,1143,0,0,0,0,1143,2286
28326,RM-1221,12/23/2013,0,0,1143,0,0,1143,2286
30384,RM-1229,12/23/2013,0,0,1143,0,0,1143,2286
35039,RM-B103A,12/23/2013,1143,0,0,0,0,1143,2286
36956,RM-B200C,12/23/2013,1143,0,1143,0,0,0,2286
44312,RM-B250,12/23/2013,1143,0,1143,0,0,0,2286
23537,RM-1208,12/23/2013,1140,0,0,0,0,1143,2283
24408,RM-1208B,6/24/2014,273,0,282,1728,0,0,2283
24409,RM-1208B,6/25/2014,273,0,282,1728,0,0,2283
30410,RM-1229,1/18/2014,0,0,285,1710,0,288,2283
35065,RM-B103A,1/18/2014,285,0,0,1710,0,288,2283
18884,RM-1155,1/18/2014,285,0,285,1710,0,0,2280
23529,RM-1208,12/15/2013,1140,0,0,0,0,1140,2280
30376,RM-1229,12/15/2013,0,0,1140,0,0,1140,2280
6279,RM-1113,12/15/2013,1137,0,1140,0,0,0,2277
7625,RM-1116,12/15/2013,1137,0,0,0,0,1140,2277
8313,RM-1117,12/15/2013,1137,0,1140,0,0,0,2277
18850,RM-1155,12/15/2013,1137,0,1140,0,0,0,2277
22844,RM-1207,12/15/2013,1137,0,0,0,0,1140,2277
24369,RM-1208B,5/16/2014,714,0,717,846,0,0,2277
35031,RM-B103A,12/15/2013,1137,0,0,0,0,1140,2277
36948,RM-B200C,12/15/2013,1137,0,1140,0,0,0,2277
44304,RM-B250,12/15/2013,1137,0,1140,0,0,0,2277
24406,RM-1208B,6/22/2014,273,0,273,1728,0,0,2274
41853,RM-B230,3/20/2014,273,1728,273,0,0,0,2274
13068,RM-1132,3/20/2014,0,0,270,1728,0,273,2271
7008,RM-1115,2/23/2014,1134,0,0,0,0,1131,2265
17629,RM-1151,5/16/2014,717,0,0,1548,0,0,2265
19596,RM-1156,2/23/2014,1134,0,0,0,0,1131,2265
22914,RM-1207,2/23/2014,1134,0,0,0,0,1131,2265
24972,RM-1212,2/23/2014,1134,0,1131,0,0,0,2265
27490,RM-1218,7/15/2013,0,0,2265,0,0,0,2265
37018,RM-B200C,2/23/2014,1134,0,1131,0,0,0,2265
18885,RM-1155,1/19/2014,267,0,267,1728,0,0,2262
24407,RM-1208B,6/23/2014,267,0,267,1728,0,0,2262
30411,RM-1229,1/19/2014,0,0,267,1728,0,264,2259
30551,RM-1229,6/8/2014,0,0,531,1728,0,0,2259
32578,RM-1236,6/8/2014,0,1728,531,0,0,0,2259
35066,RM-B103A,1/19/2014,267,0,0,1728,0,264,2259
8937,RM-1122,10/12/2013,0,0,1128,0,0,1128,2256
35743,RM-B109,5/27/2014,1128,0,1128,0,0,0,2256
44235,RM-B250,10/4/2013,1176,0,1080,0,0,0,2256
47650,RM-B275,10/12/2013,0,0,1128,0,0,1128,2256
332,RM-1100A,6/8/2014,525,1728,0,0,0,0,2253
1702,RM-1102,6/8/2014,525,1728,0,0,0,0,2253
6218,RM-1113,10/12/2013,1125,0,1128,0,0,0,2253
13148,RM-1132,6/8/2014,0,0,525,1728,0,0,2253
18789,RM-1155,10/12/2013,1125,0,1128,0,0,0,2253
27117,RM-1217,6/8/2014,525,1728,0,0,0,0,2253
32342,RM-1236,10/12/2013,1125,0,1128,0,0,0,2253
38263,RM-B215,10/12/2013,1125,0,0,0,0,1128,2253
39872,RM-B222,6/8/2014,525,0,0,1728,0,0,2253
44243,RM-B250,10/12/2013,1125,0,1128,0,0,0,2253
45848,RM-B260,6/8/2014,525,0,0,1728,0,0,2253
8329,RM-1117,12/31/2013,1125,0,1125,0,0,0,2250
18866,RM-1155,12/31/2013,1125,0,1125,0,0,0,2250
23468,RM-1208,10/12/2013,1125,0,0,0,0,1125,2250
24367,RM-1208B,5/14/2014,831,0,831,588,0,0,2250
36964,RM-B200C,12/31/2013,1125,0,1125,0,0,0,2250
44320,RM-B250,12/31/2013,1125,0,1125,0,0,0,2250
7641,RM-1116,12/31/2013,1125,0,0,0,0,1122,2247
22860,RM-1207,12/31/2013,1125,0,0,0,0,1122,2247
23545,RM-1208,12/31/2013,1125,0,0,0,0,1122,2247
28334,RM-1221,12/31/2013,0,0,1125,0,0,1122,2247
30392,RM-1229,12/31/2013,0,0,1125,0,0,1122,2247
35047,RM-B103A,12/31/2013,1125,0,0,0,0,1122,2247
35747,RM-B109,5/31/2014,1125,0,1122,0,0,0,2247
6261,RM-1113,11/27/2013,1122,0,1122,0,0,0,2244
6283,RM-1113,12/19/2013,1122,0,1122,0,0,0,2244
7629,RM-1116,12/19/2013,1122,0,0,0,0,1122,2244
8295,RM-1117,11/27/2013,1122,0,1122,0,0,0,2244
8317,RM-1117,12/19/2013,1122,0,1122,0,0,0,2244
18832,RM-1155,11/27/2013,1122,0,1122,0,0,0,2244
18854,RM-1155,12/19/2013,1122,0,1122,0,0,0,2244
22848,RM-1207,12/19/2013,1122,0,0,0,0,1122,2244
23511,RM-1208,11/27/2013,1122,0,0,0,0,1122,2244
23533,RM-1208,12/19/2013,1122,0,0,0,0,1122,2244
30358,RM-1229,11/27/2013,0,0,1122,0,0,1122,2244
30380,RM-1229,12/19/2013,0,0,1122,0,0,1122,2244
35035,RM-B103A,12/19/2013,1122,0,0,0,0,1122,2244
35716,RM-B109,4/30/2014,1122,0,1122,0,0,0,2244
35750,RM-B109,6/3/2014,1122,0,1122,0,0,0,2244
36952,RM-B200C,12/19/2013,1122,0,1122,0,0,0,2244
37084,RM-B200C,4/30/2014,1122,0,1122,0,0,0,2244
41894,RM-B230,4/30/2014,1122,0,1122,0,0,0,2244
44286,RM-B250,11/27/2013,1122,0,1122,0,0,0,2244
44308,RM-B250,12/19/2013,1122,0,1122,0,0,0,2244
23678,RM-1208,5/13/2014,837,1404,0,0,0,0,2241
36299,RM-B200B,1/16/2014,0,1584,0,0,0,657,2241
2749,RM-1106,8/21/2013,1119,0,0,0,0,1119,2238
8209,RM-1117,8/21/2013,1119,0,0,0,0,1119,2238
23425,RM-1208,8/21/2013,1119,0,0,0,0,1119,2238
38220,RM-B215,8/21/2013,1119,0,0,0,0,1119,2238
39593,RM-B222,8/21/2013,1119,0,1119,0,0,0,2238
7521,RM-1116,8/21/2013,0,0,1116,0,0,1119,2235
8345,RM-1117,1/16/2014,0,6,657,1572,0,0,2235
13690,RM-1133,1/16/2014,0,1578,657,0,0,0,2235
18746,RM-1155,8/21/2013,1119,0,1116,0,0,0,2235
30272,RM-1229,8/21/2013,1119,0,1116,0,0,0,2235
32299,RM-1236,8/21/2013,1119,0,1116,0,0,0,2235
36844,RM-B200C,8/21/2013,0,0,1116,0,0,1119,2235
40281,RM-B224,8/21/2013,0,0,1116,0,0,1119,2235
41790,RM-B230,1/16/2014,0,1578,657,0,0,0,2235
47607,RM-B275,8/21/2013,0,0,1116,0,0,1119,2235
47743,RM-B275,1/16/2014,0,1578,0,0,0,657,2235
23469,RM-1208,10/13/2013,1116,0,0,0,0,1116,2232
26974,RM-1217,1/16/2014,660,0,0,1572,0,0,2232
6213,RM-1113,10/7/2013,1116,0,1113,0,0,0,2229
6219,RM-1113,10/13/2013,1116,0,1113,0,0,0,2229
18784,RM-1155,10/7/2013,1116,0,1113,0,0,0,2229
18790,RM-1155,10/13/2013,1116,0,1113,0,0,0,2229
25007,RM-1212,3/30/2014,1116,0,1113,0,0,0,2229
32337,RM-1236,10/7/2013,1116,0,1113,0,0,0,2229
32343,RM-1236,10/13/2013,1116,0,1113,0,0,0,2229
37053,RM-B200C,3/30/2014,1116,0,1113,0,0,0,2229
38258,RM-B215,10/7/2013,1116,0,0,0,0,1113,2229
38264,RM-B215,10/13/2013,1116,0,0,0,0,1113,2229
41863,RM-B230,3/30/2014,1116,0,1113,0,0,0,2229
44238,RM-B250,10/7/2013,1116,0,1113,0,0,0,2229
44244,RM-B250,10/13/2013,1116,0,1113,0,0,0,2229
8932,RM-1122,10/7/2013,0,0,1113,0,0,1113,2226
8938,RM-1122,10/13/2013,0,0,1113,0,0,1113,2226
23463,RM-1208,10/7/2013,1113,0,0,0,0,1113,2226
23681,RM-1208,5/16/2014,714,1512,0,0,0,0,2226
30554,RM-1229,6/11/2014,0,0,504,1722,0,0,2226
32581,RM-1236,6/11/2014,0,1722,504,0,0,0,2226
36882,RM-B200C,10/7/2013,0,0,1113,0,0,1113,2226
47645,RM-B275,10/7/2013,0,0,1113,0,0,1113,2226
47651,RM-B275,10/13/2013,0,0,1113,0,0,1113,2226
6252,RM-1113,11/15/2013,1110,0,1113,0,0,0,2223
8286,RM-1117,11/15/2013,1110,0,1113,0,0,0,2223
8971,RM-1122,11/15/2013,0,0,1113,0,0,1110,2223
18823,RM-1155,11/15/2013,1110,0,1113,0,0,0,2223
30349,RM-1229,11/15/2013,0,0,1113,0,0,1110,2223
44277,RM-B250,11/15/2013,1110,0,1113,0,0,0,2223
45851,RM-B260,6/11/2014,501,0,0,1722,0,0,2223
47684,RM-B275,11/15/2013,0,0,1113,0,0,1110,2223
335,RM-1100A,6/11/2014,498,1722,0,0,0,0,2220
1705,RM-1102,6/11/2014,498,1722,0,0,0,0,2220
18886,RM-1155,1/20/2014,249,0,249,1722,0,0,2220
23502,RM-1208,11/15/2013,1110,0,0,0,0,1110,2220
27120,RM-1217,6/11/2014,498,1722,0,0,0,0,2220
30412,RM-1229,1/20/2014,0,0,249,1722,0,249,2220
35067,RM-B103A,1/20/2014,249,0,0,1722,0,249,2220
39875,RM-B222,6/11/2014,498,0,0,1722,0,0,2220
6263,RM-1113,11/29/2013,1110,0,1107,0,0,0,2217
7609,RM-1116,11/29/2013,1110,0,0,0,0,1107,2217
8297,RM-1117,11/29/2013,1110,0,1107,0,0,0,2217
13151,RM-1132,6/11/2014,0,0,495,1722,0,0,2217
18834,RM-1155,11/29/2013,1110,0,1107,0,0,0,2217
44288,RM-B250,11/29/2013,1110,0,1107,0,0,0,2217
7002,RM-1115,2/17/2014,1107,0,0,0,0,1107,2214
19590,RM-1156,2/17/2014,1107,0,0,0,0,1107,2214
22908,RM-1207,2/17/2014,1107,0,0,0,0,1107,2214
23513,RM-1208,11/29/2013,1107,0,0,0,0,1107,2214
24410,RM-1208B,6/26/2014,228,0,258,1728,0,0,2214
24966,RM-1212,2/17/2014,1107,0,1107,0,0,0,2214
30360,RM-1229,11/29/2013,0,0,1107,0,0,1107,2214
37012,RM-B200C,2/17/2014,1107,0,1107,0,0,0,2214
7634,RM-1116,12/24/2013,1104,0,0,0,0,1107,2211
8322,RM-1117,12/24/2013,1104,0,1107,0,0,0,2211
18859,RM-1155,12/24/2013,1104,0,1107,0,0,0,2211
23504,RM-1208,11/20/2013,1107,0,0,0,0,1104,2211
23538,RM-1208,12/24/2013,1107,0,0,0,0,1104,2211
28327,RM-1221,12/24/2013,0,0,1107,0,0,1104,2211
30385,RM-1229,12/24/2013,0,0,1107,0,0,1104,2211
30415,RM-1229,1/23/2014,0,0,240,1728,0,243,2211
35040,RM-B103A,12/24/2013,1104,0,0,0,0,1107,2211
35070,RM-B103A,1/23/2014,240,0,0,1728,0,243,2211
36957,RM-B200C,12/24/2013,1104,0,1107,0,0,0,2211
44313,RM-B250,12/24/2013,1104,0,1107,0,0,0,2211
6254,RM-1113,11/20/2013,1104,0,1104,0,0,0,2208
6280,RM-1113,12/16/2013,1104,0,1104,0,0,0,2208
7642,RM-1116,1/1/2014,1104,0,0,0,0,1104,2208
8288,RM-1117,11/20/2013,1104,0,1104,0,0,0,2208
8314,RM-1117,12/16/2013,1104,0,1104,0,0,0,2208
8330,RM-1117,1/1/2014,1104,0,1104,0,0,0,2208
8973,RM-1122,11/20/2013,0,0,1104,0,0,1104,2208
18825,RM-1155,11/20/2013,1104,0,1104,0,0,0,2208
18851,RM-1155,12/16/2013,1104,0,1104,0,0,0,2208
18867,RM-1155,1/1/2014,1104,0,1104,0,0,0,2208
18889,RM-1155,1/23/2014,240,0,240,1728,0,0,2208
22853,RM-1207,12/24/2013,1104,0,0,0,0,1104,2208
22861,RM-1207,1/1/2014,1104,0,0,0,0,1104,2208
23546,RM-1208,1/1/2014,1104,0,0,0,0,1104,2208
28335,RM-1221,1/1/2014,0,0,1104,0,0,1104,2208
30351,RM-1229,11/20/2013,0,0,1104,0,0,1104,2208
30393,RM-1229,1/1/2014,0,0,1104,0,0,1104,2208
35048,RM-B103A,1/1/2014,1104,0,0,0,0,1104,2208
36949,RM-B200C,12/16/2013,1104,0,1104,0,0,0,2208
36965,RM-B200C,1/1/2014,1104,0,1104,0,0,0,2208
38341,RM-B215,1/1/2014,0,0,1104,0,0,1104,2208
44279,RM-B250,11/20/2013,1104,0,1104,0,0,0,2208
44305,RM-B250,12/16/2013,1104,0,1104,0,0,0,2208
44321,RM-B250,1/1/2014,1104,0,1104,0,0,0,2208
47686,RM-B275,11/20/2013,0,0,1104,0,0,1104,2208
6255,RM-1113,11/21/2013,1101,0,1104,0,0,0,2205
7626,RM-1116,12/16/2013,1104,0,0,0,0,1101,2205
8289,RM-1117,11/21/2013,1101,0,1104,0,0,0,2205
8974,RM-1122,11/21/2013,0,0,1104,0,0,1101,2205
18826,RM-1155,11/21/2013,1101,0,1104,0,0,0,2205
22845,RM-1207,12/16/2013,1104,0,0,0,0,1101,2205
23530,RM-1208,12/16/2013,1104,0,0,0,0,1101,2205
30352,RM-1229,11/21/2013,0,0,1104,0,0,1101,2205
30377,RM-1229,12/16/2013,0,0,1104,0,0,1101,2205
35032,RM-B103A,12/16/2013,1104,0,0,0,0,1101,2205
44280,RM-B250,11/21/2013,1101,0,1104,0,0,0,2205
47687,RM-B275,11/21/2013,0,0,1104,0,0,1101,2205
23505,RM-1208,11/21/2013,1101,0,0,0,0,1101,2202
6244,RM-1113,11/7/2013,1098,0,1101,0,0,0,2199
8278,RM-1117,11/7/2013,1098,0,1101,0,0,0,2199
8963,RM-1122,11/7/2013,0,0,1101,0,0,1098,2199
18815,RM-1155,11/7/2013,1098,0,1101,0,0,0,2199
23494,RM-1208,11/7/2013,1101,0,0,0,0,1098,2199
30341,RM-1229,11/7/2013,0,0,1101,0,0,1098,2199
32368,RM-1236,11/7/2013,1098,0,1101,0,0,0,2199
44269,RM-B250,11/7/2013,1098,0,1101,0,0,0,2199
47676,RM-B275,11/7/2013,0,0,1101,0,0,1098,2199
38272,RM-B215,10/21/2013,1098,0,0,0,0,1098,2196
38289,RM-B215,11/7/2013,1098,0,0,0,0,1098,2196
6227,RM-1113,10/21/2013,1098,0,1095,0,0,0,2193
8946,RM-1122,10/21/2013,0,0,1095,0,0,1098,2193
18798,RM-1155,10/21/2013,1098,0,1095,0,0,0,2193
23477,RM-1208,10/21/2013,1095,0,0,0,0,1098,2193
32351,RM-1236,10/21/2013,1098,0,1095,0,0,0,2193
44252,RM-B250,10/21/2013,1098,0,1095,0,0,0,2193
47659,RM-B275,10/21/2013,0,0,1095,0,0,1098,2193
6246,RM-1113,11/9/2013,1095,0,1095,0,0,0,2190
8280,RM-1117,11/9/2013,1095,0,1095,0,0,0,2190
8965,RM-1122,11/9/2013,0,0,1095,0,0,1095,2190
18817,RM-1155,11/9/2013,1095,0,1095,0,0,0,2190
23496,RM-1208,11/9/2013,1095,0,0,0,0,1095,2190
23497,RM-1208,11/10/2013,1095,0,0,0,0,1095,2190
30343,RM-1229,11/9/2013,0,0,1095,0,0,1095,2190
32370,RM-1236,11/9/2013,1095,0,1095,0,0,0,2190
35717,RM-B109,5/1/2014,1095,0,1095,0,0,0,2190
37085,RM-B200C,5/1/2014,1095,0,1095,0,0,0,2190
41895,RM-B230,5/1/2014,1095,0,1095,0,0,0,2190
44271,RM-B250,11/9/2013,1095,0,1095,0,0,0,2190
47678,RM-B275,11/9/2013,0,0,1095,0,0,1095,2190
6247,RM-1113,11/10/2013,1095,0,1092,0,0,0,2187
8281,RM-1117,11/10/2013,1095,0,1092,0,0,0,2187
8966,RM-1122,11/10/2013,0,0,1092,0,0,1095,2187
18818,RM-1155,11/10/2013,1095,0,1092,0,0,0,2187
30344,RM-1229,11/10/2013,0,0,1092,0,0,1095,2187
30555,RM-1229,6/12/2014,0,0,459,1728,0,0,2187
32371,RM-1236,11/10/2013,1095,0,1092,0,0,0,2187
32582,RM-1236,6/12/2014,0,1728,459,0,0,0,2187
44272,RM-B250,11/10/2013,1095,0,1092,0,0,0,2187
47679,RM-B275,11/10/2013,0,0,1092,0,0,1095,2187
336,RM-1100A,6/12/2014,456,1728,0,0,0,0,2184
1706,RM-1102,6/12/2014,456,1728,0,0,0,0,2184
8323,RM-1117,12/25/2013,1092,0,1092,0,0,0,2184
13152,RM-1132,6/12/2014,0,0,456,1728,0,0,2184
17620,RM-1151,5/7/2014,888,0,0,1296,0,0,2184
18860,RM-1155,12/25/2013,1092,0,1092,0,0,0,2184
22854,RM-1207,12/25/2013,1092,0,0,0,0,1092,2184
23539,RM-1208,12/25/2013,1092,0,0,0,0,1092,2184
25003,RM-1212,3/26/2014,1092,0,1092,0,0,0,2184
27121,RM-1217,6/12/2014,456,1728,0,0,0,0,2184
28328,RM-1221,12/25/2013,0,0,1092,0,0,1092,2184
30386,RM-1229,12/25/2013,0,0,1092,0,0,1092,2184
36958,RM-B200C,12/25/2013,1092,0,1092,0,0,0,2184
37049,RM-B200C,3/26/2014,1092,0,1092,0,0,0,2184
39876,RM-B222,6/12/2014,456,0,0,1728,0,0,2184
44314,RM-B250,12/25/2013,1092,0,1092,0,0,0,2184
45852,RM-B260,6/12/2014,456,0,0,1728,0,0,2184
7039,RM-1115,3/26/2014,1092,0,0,0,0,1089,2181
7635,RM-1116,12/25/2013,1092,0,0,0,0,1089,2181
18951,RM-1155,3/26/2014,1092,0,0,0,0,1089,2181
19627,RM-1156,3/26/2014,1092,0,0,0,0,1089,2181
22945,RM-1207,3/26/2014,1092,0,0,0,0,1089,2181
35041,RM-B103A,12/25/2013,1092,0,0,0,0,1089,2181
25014,RM-1212,4/6/2014,1086,0,1089,0,0,0,2175
37060,RM-B200C,4/6/2014,1086,0,1089,0,0,0,2175
41870,RM-B230,4/6/2014,1086,0,1089,0,0,0,2175
7643,RM-1116,1/2/2014,1086,0,0,0,0,1086,2172
8331,RM-1117,1/2/2014,1086,0,1086,0,0,0,2172
18868,RM-1155,1/2/2014,1086,0,1086,0,0,0,2172
22862,RM-1207,1/2/2014,1086,0,0,0,0,1086,2172
23547,RM-1208,1/2/2014,1086,0,0,0,0,1086,2172
24920,RM-1212,1/2/2014,1086,0,1086,0,0,0,2172
28336,RM-1221,1/2/2014,0,0,1086,0,0,1086,2172
30394,RM-1229,1/2/2014,0,0,1086,0,0,1086,2172
35049,RM-B103A,1/2/2014,1086,0,0,0,0,1086,2172
36966,RM-B200C,1/2/2014,1086,0,1086,0,0,0,2172
38342,RM-B215,1/2/2014,0,0,1086,0,0,1086,2172
44322,RM-B250,1/2/2014,1086,0,1086,0,0,0,2172
6264,RM-1113,11/30/2013,1083,0,1086,0,0,0,2169
8298,RM-1117,11/30/2013,1083,0,1086,0,0,0,2169
18835,RM-1155,11/30/2013,1083,0,1086,0,0,0,2169
23514,RM-1208,11/30/2013,1086,0,0,0,0,1083,2169
30361,RM-1229,11/30/2013,0,0,1086,0,0,1083,2169
44289,RM-B250,11/30/2013,1083,0,1086,0,0,0,2169
6220,RM-1113,10/14/2013,1083,0,1083,0,0,0,2166
7610,RM-1116,11/30/2013,1083,0,0,0,0,1083,2166
8939,RM-1122,10/14/2013,0,0,1083,0,0,1083,2166
18791,RM-1155,10/14/2013,1083,0,1083,0,0,0,2166
18890,RM-1155,1/24/2014,219,0,219,1728,0,0,2166
23470,RM-1208,10/14/2013,1083,0,0,0,0,1083,2166
24415,RM-1208B,7/1/2014,222,0,222,1722,0,0,2166
30416,RM-1229,1/24/2014,0,0,219,1728,0,219,2166
32344,RM-1236,10/14/2013,1083,0,1083,0,0,0,2166
35016,RM-B103A,11/30/2013,1083,0,0,0,0,1083,2166
35071,RM-B103A,1/24/2014,219,0,0,1728,0,219,2166
35748,RM-B109,6/1/2014,1083,0,1083,0,0,0,2166
38265,RM-B215,10/14/2013,1083,0,0,0,0,1083,2166
44245,RM-B250,10/14/2013,1083,0,1083,0,0,0,2166
47652,RM-B275,10/14/2013,0,0,1083,0,0,1083,2166
6284,RM-1113,12/20/2013,957,0,1206,0,0,0,2163
35749,RM-B109,6/2/2014,1080,0,1083,0,0,0,2163
7040,RM-1115,3/27/2014,1080,0,0,0,0,1080,2160
18952,RM-1155,3/27/2014,1080,0,0,0,0,1080,2160
19628,RM-1156,3/27/2014,1080,0,0,0,0,1080,2160
22946,RM-1207,3/27/2014,1080,0,0,0,0,1080,2160
25004,RM-1212,3/27/2014,1080,0,1080,0,0,0,2160
37050,RM-B200C,3/27/2014,1080,0,1080,0,0,0,2160
24973,RM-1212,2/24/2014,1074,0,1077,0,0,0,2151
37019,RM-B200C,2/24/2014,1074,0,1077,0,0,0,2151
6215,RM-1113,10/9/2013,1074,0,1074,0,0,0,2148
6245,RM-1113,11/8/2013,1074,0,1074,0,0,0,2148
7009,RM-1115,2/24/2014,1074,0,0,0,0,1074,2148
7636,RM-1116,12/26/2013,1074,0,0,0,0,1074,2148
8279,RM-1117,11/8/2013,1074,0,1074,0,0,0,2148
8934,RM-1122,10/9/2013,0,0,1074,0,0,1074,2148
8964,RM-1122,11/8/2013,0,0,1074,0,0,1074,2148
18786,RM-1155,10/9/2013,1074,0,1074,0,0,0,2148
18816,RM-1155,11/8/2013,1074,0,1074,0,0,0,2148
18921,RM-1155,2/24/2014,1074,0,0,0,0,1074,2148
19597,RM-1156,2/24/2014,1074,0,0,0,0,1074,2148
22855,RM-1207,12/26/2013,1074,0,0,0,0,1074,2148
22915,RM-1207,2/24/2014,1074,0,0,0,0,1074,2148
23465,RM-1208,10/9/2013,1074,0,0,0,0,1074,2148
23495,RM-1208,11/8/2013,1074,0,0,0,0,1074,2148
23540,RM-1208,12/26/2013,1074,0,0,0,0,1074,2148
30342,RM-1229,11/8/2013,0,0,1074,0,0,1074,2148
32339,RM-1236,10/9/2013,1074,0,1074,0,0,0,2148
32369,RM-1236,11/8/2013,1074,0,1074,0,0,0,2148
35042,RM-B103A,12/26/2013,1074,0,0,0,0,1074,2148
38260,RM-B215,10/9/2013,1074,0,0,0,0,1074,2148
44240,RM-B250,10/9/2013,1074,0,1074,0,0,0,2148
44270,RM-B250,11/8/2013,1074,0,1074,0,0,0,2148
47647,RM-B275,10/9/2013,0,0,1074,0,0,1074,2148
47677,RM-B275,11/8/2013,0,0,1074,0,0,1074,2148
7640,RM-1116,12/30/2013,1071,0,0,0,0,1074,2145
8324,RM-1117,12/26/2013,1074,0,1071,0,0,0,2145
18861,RM-1155,12/26/2013,1074,0,1071,0,0,0,2145
22859,RM-1207,12/30/2013,1071,0,0,0,0,1074,2145
23544,RM-1208,12/30/2013,1071,0,0,0,0,1074,2145
24412,RM-1208B,6/28/2014,210,0,213,1722,0,0,2145
28329,RM-1221,12/26/2013,0,0,1071,0,0,1074,2145
28333,RM-1221,12/30/2013,0,0,1071,0,0,1074,2145
30387,RM-1229,12/26/2013,0,0,1071,0,0,1074,2145
30391,RM-1229,12/30/2013,0,0,1071,0,0,1074,2145
35046,RM-B103A,12/30/2013,1071,0,0,0,0,1074,2145
36959,RM-B200C,12/26/2013,1074,0,1071,0,0,0,2145
44315,RM-B250,12/26/2013,1074,0,1071,0,0,0,2145
7015,RM-1115,3/2/2014,1071,0,0,0,0,1071,2142
8328,RM-1117,12/30/2013,1071,0,1071,0,0,0,2142
18865,RM-1155,12/30/2013,1071,0,1071,0,0,0,2142
18891,RM-1155,1/25/2014,213,0,213,1716,0,0,2142
18927,RM-1155,3/2/2014,1071,0,0,0,0,1071,2142
19578,RM-1156,2/5/2014,1485,0,0,0,0,657,2142
19603,RM-1156,3/2/2014,1071,0,0,0,0,1071,2142
22921,RM-1207,3/2/2014,1071,0,0,0,0,1071,2142
24979,RM-1212,3/2/2014,1071,0,1071,0,0,0,2142
36963,RM-B200C,12/30/2013,1071,0,1071,0,0,0,2142
37025,RM-B200C,3/2/2014,1071,0,1071,0,0,0,2142
44319,RM-B250,12/30/2013,1071,0,1071,0,0,0,2142
30417,RM-1229,1/25/2014,0,0,213,1716,0,210,2139
2,RM-1100A,6/30/2013,2136,0,0,0,0,0,2136
2698,RM-1106,6/30/2013,2136,0,0,0,0,0,2136
4755,RM-1109,6/30/2013,2136,0,0,0,0,0,2136
7003,RM-1115,2/18/2014,1068,0,0,0,0,1068,2136
8158,RM-1117,6/30/2013,2136,0,0,0,0,0,2136
12818,RM-1132,6/30/2013,2136,0,0,0,0,0,2136
18695,RM-1155,6/30/2013,2136,0,0,0,0,0,2136
19591,RM-1156,2/18/2014,1068,0,0,0,0,1068,2136
22909,RM-1207,2/18/2014,1068,0,0,0,0,1068,2136
24967,RM-1212,2/18/2014,1068,0,1068,0,0,0,2136
30221,RM-1229,6/30/2013,2136,0,0,0,0,0,2136
32248,RM-1236,6/30/2013,2136,0,0,0,0,0,2136
37013,RM-B200C,2/18/2014,1068,0,1068,0,0,0,2136
38169,RM-B215,6/30/2013,2136,0,0,0,0,0,2136
39542,RM-B222,6/30/2013,2136,0,0,0,0,0,2136
1,RM-1100A,6/29/2013,2133,0,0,0,0,0,2133
2697,RM-1106,6/29/2013,2133,0,0,0,0,0,2133
4754,RM-1109,6/29/2013,2133,0,0,0,0,0,2133
8157,RM-1117,6/29/2013,2133,0,0,0,0,0,2133
12817,RM-1132,6/29/2013,2133,0,0,0,0,0,2133
18694,RM-1155,6/29/2013,2133,0,0,0,0,0,2133
30220,RM-1229,6/29/2013,2133,0,0,0,0,0,2133
32247,RM-1236,6/29/2013,2133,0,0,0,0,0,2133
35072,RM-B103A,1/25/2014,213,0,0,1710,0,210,2133
38168,RM-B215,6/29/2013,2133,0,0,0,0,0,2133
39541,RM-B222,6/29/2013,2133,0,0,0,0,0,2133
41861,RM-B230,3/28/2014,693,726,714,0,0,0,2133
24960,RM-1212,2/11/2014,1047,0,1083,0,0,0,2130
37006,RM-B200C,2/11/2014,1047,0,1083,0,0,0,2130
17548,RM-1151,2/24/2014,399,0,0,1728,0,0,2127
18888,RM-1155,1/22/2014,216,0,219,1692,0,0,2127
30414,RM-1229,1/22/2014,0,0,219,1692,0,216,2127
8448,RM-1117,4/29/2014,0,1728,396,0,0,0,2124
25010,RM-1212,4/2/2014,1062,0,1062,0,0,0,2124
37056,RM-B200C,4/2/2014,1062,0,1062,0,0,0,2124
41866,RM-B230,4/2/2014,1062,0,1062,0,0,0,2124
6214,RM-1113,10/8/2013,1059,0,1062,0,0,0,2121
8933,RM-1122,10/8/2013,0,0,1062,0,0,1059,2121
18785,RM-1155,10/8/2013,1059,0,1062,0,0,0,2121
18937,RM-1155,3/12/2014,1059,0,0,0,0,1062,2121
19613,RM-1156,3/12/2014,1059,0,0,0,0,1062,2121
23464,RM-1208,10/8/2013,1062,0,0,0,0,1059,2121
24989,RM-1212,3/12/2014,1059,0,1062,0,0,0,2121
32338,RM-1236,10/8/2013,1059,0,1062,0,0,0,2121
37035,RM-B200C,3/12/2014,1059,0,1062,0,0,0,2121
44239,RM-B250,10/8/2013,1059,0,1062,0,0,0,2121
47646,RM-B275,10/8/2013,0,0,1062,0,0,1059,2121
7025,RM-1115,3/12/2014,1059,0,0,0,0,1059,2118
22931,RM-1207,3/12/2014,1059,0,0,0,0,1059,2118
35718,RM-B109,5/2/2014,1059,0,1059,0,0,0,2118
37086,RM-B200C,5/2/2014,1059,0,1059,0,0,0,2118
38259,RM-B215,10/8/2013,1059,0,0,0,0,1059,2118
41896,RM-B230,5/2/2014,1059,0,1059,0,0,0,2118
8340,RM-1117,1/11/2014,0,0,831,1284,0,0,2115
13685,RM-1133,1/11/2014,0,1284,831,0,0,0,2115
25015,RM-1212,4/7/2014,1059,0,1056,0,0,0,2115
26969,RM-1217,1/11/2014,831,0,0,1284,0,0,2115
37061,RM-B200C,4/7/2014,1059,0,1056,0,0,0,2115
41871,RM-B230,4/7/2014,1059,0,1056,0,0,0,2115
338,RM-1100A,6/14/2014,384,1728,0,0,0,0,2112
1708,RM-1102,6/14/2014,384,1728,0,0,0,0,2112
6257,RM-1113,11/23/2013,1056,0,1056,0,0,0,2112
6996,RM-1115,2/11/2014,1047,0,0,0,0,1065,2112
7644,RM-1116,1/3/2014,1056,0,0,0,0,1056,2112
8291,RM-1117,11/23/2013,1056,0,1056,0,0,0,2112
8332,RM-1117,1/3/2014,1056,0,1056,0,0,0,2112
8976,RM-1122,11/23/2013,0,0,1056,0,0,1056,2112
13154,RM-1132,6/14/2014,0,0,384,1728,0,0,2112
18828,RM-1155,11/23/2013,1056,0,1056,0,0,0,2112
18869,RM-1155,1/3/2014,1056,0,1056,0,0,0,2112
19584,RM-1156,2/11/2014,1047,0,0,0,0,1065,2112
22863,RM-1207,1/3/2014,1056,0,0,0,0,1056,2112
22902,RM-1207,2/11/2014,1047,0,0,0,0,1065,2112
23506,RM-1208,11/22/2013,1056,0,0,0,0,1056,2112
23507,RM-1208,11/23/2013,1056,0,0,0,0,1056,2112
23548,RM-1208,1/3/2014,1056,0,0,0,0,1056,2112
24921,RM-1212,1/3/2014,1056,0,1056,0,0,0,2112
27123,RM-1217,6/14/2014,384,1728,0,0,0,0,2112
28337,RM-1221,1/3/2014,0,0,1056,0,0,1056,2112
30354,RM-1229,11/23/2013,0,0,1056,0,0,1056,2112
30395,RM-1229,1/3/2014,0,0,1056,0,0,1056,2112
30557,RM-1229,6/14/2014,0,0,384,1728,0,0,2112
32584,RM-1236,6/14/2014,0,1728,384,0,0,0,2112
35050,RM-B103A,1/3/2014,1056,0,0,0,0,1056,2112
35069,RM-B103A,1/22/2014,216,0,0,1680,0,216,2112
36967,RM-B200C,1/3/2014,1056,0,1056,0,0,0,2112
38343,RM-B215,1/3/2014,0,0,1056,0,0,1056,2112
39878,RM-B222,6/14/2014,384,0,0,1728,0,0,2112
44282,RM-B250,11/23/2013,1056,0,1056,0,0,0,2112
44323,RM-B250,1/3/2014,1056,0,1056,0,0,0,2112
45854,RM-B260,6/14/2014,384,0,0,1728,0,0,2112
47689,RM-B275,11/23/2013,0,0,1056,0,0,1056,2112
6256,RM-1113,11/22/2013,1056,0,1053,0,0,0,2109
6282,RM-1113,12/18/2013,1053,0,1056,0,0,0,2109
8290,RM-1117,11/22/2013,1056,0,1053,0,0,0,2109
8316,RM-1117,12/18/2013,1053,0,1056,0,0,0,2109
8325,RM-1117,12/27/2013,1053,0,1056,0,0,0,2109
8975,RM-1122,11/22/2013,0,0,1053,0,0,1056,2109
18827,RM-1155,11/22/2013,1056,0,1053,0,0,0,2109
18853,RM-1155,12/18/2013,1053,0,1056,0,0,0,2109
18862,RM-1155,12/27/2013,1053,0,1056,0,0,0,2109
28330,RM-1221,12/27/2013,0,0,1056,0,0,1053,2109
30353,RM-1229,11/22/2013,0,0,1053,0,0,1056,2109
30379,RM-1229,12/18/2013,0,0,1056,0,0,1053,2109
30388,RM-1229,12/27/2013,0,0,1056,0,0,1053,2109
36294,RM-B200B,1/11/2014,0,1278,0,0,0,831,2109
36951,RM-B200C,12/18/2013,1053,0,1056,0,0,0,2109
36960,RM-B200C,12/27/2013,1053,0,1056,0,0,0,2109
41785,RM-B230,1/11/2014,0,1278,831,0,0,0,2109
44281,RM-B250,11/22/2013,1056,0,1053,0,0,0,2109
44307,RM-B250,12/18/2013,1053,0,1056,0,0,0,2109
44316,RM-B250,12/27/2013,1053,0,1056,0,0,0,2109
47688,RM-B275,11/22/2013,0,0,1053,0,0,1056,2109
47738,RM-B275,1/11/2014,0,1278,0,0,0,831,2109
7628,RM-1116,12/18/2013,1053,0,0,0,0,1053,2106
7637,RM-1116,12/27/2013,1053,0,0,0,0,1053,2106
22847,RM-1207,12/18/2013,1053,0,0,0,0,1053,2106
22856,RM-1207,12/27/2013,1053,0,0,0,0,1053,2106
23532,RM-1208,12/18/2013,1053,0,0,0,0,1053,2106
23541,RM-1208,12/27/2013,1053,0,0,0,0,1053,2106
24411,RM-1208B,6/27/2014,189,0,189,1728,0,0,2106
30558,RM-1229,6/15/2014,0,0,378,1728,0,0,2106
32585,RM-1236,6/15/2014,0,1728,378,0,0,0,2106
35034,RM-B103A,12/18/2013,1053,0,0,0,0,1053,2106
35043,RM-B103A,12/27/2013,1053,0,0,0,0,1053,2106
37101,RM-B200C,5/17/2014,1164,0,942,0,0,0,2106
7014,RM-1115,3/1/2014,1050,0,0,0,0,1050,2100
18926,RM-1155,3/1/2014,1050,0,0,0,0,1050,2100
19602,RM-1156,3/1/2014,1050,0,0,0,0,1050,2100
22920,RM-1207,3/1/2014,1050,0,0,0,0,1050,2100
24978,RM-1212,3/1/2014,1050,0,1050,0,0,0,2100
37024,RM-B200C,3/1/2014,1050,0,1050,0,0,0,2100
25016,RM-1212,4/8/2014,1047,0,1050,0,0,0,2097
30556,RM-1229,6/13/2014,0,0,369,1728,0,0,2097
32583,RM-1236,6/13/2014,0,1728,369,0,0,0,2097
37062,RM-B200C,4/8/2014,1047,0,1050,0,0,0,2097
41872,RM-B230,4/8/2014,1047,0,1050,0,0,0,2097
6265,RM-1113,12/1/2013,1047,0,1047,0,0,0,2094
7611,RM-1116,12/1/2013,1047,0,0,0,0,1047,2094
8299,RM-1117,12/1/2013,1047,0,1047,0,0,0,2094
18836,RM-1155,12/1/2013,1047,0,1047,0,0,0,2094
23515,RM-1208,12/1/2013,1047,0,0,0,0,1047,2094
25022,RM-1212,4/14/2014,1047,0,1047,0,0,0,2094
30362,RM-1229,12/1/2013,0,0,1047,0,0,1047,2094
35017,RM-B103A,12/1/2013,1047,0,0,0,0,1047,2094
35744,RM-B109,5/28/2014,1047,0,1047,0,0,0,2094
37068,RM-B200C,4/14/2014,1047,0,1047,0,0,0,2094
41878,RM-B230,4/14/2014,1047,0,1047,0,0,0,2094
44290,RM-B250,12/1/2013,1047,0,1047,0,0,0,2094
6260,RM-1113,11/26/2013,1044,0,1047,0,0,0,2091
8294,RM-1117,11/26/2013,1044,0,1047,0,0,0,2091
18831,RM-1155,11/26/2013,1044,0,1047,0,0,0,2091
25023,RM-1212,4/15/2014,1047,0,1044,0,0,0,2091
30357,RM-1229,11/26/2013,0,0,1047,0,0,1044,2091
35701,RM-B109,4/15/2014,1047,0,1044,0,0,0,2091
37069,RM-B200C,4/15/2014,1047,0,1044,0,0,0,2091
41879,RM-B230,4/15/2014,1047,0,1044,0,0,0,2091
44285,RM-B250,11/26/2013,1044,0,1047,0,0,0,2091
23510,RM-1208,11/26/2013,1044,0,0,0,0,1044,2088
35751,RM-B109,6/4/2014,1044,0,1041,0,0,0,2085
36937,RM-B200C,12/4/2013,696,0,696,0,0,693,2085
38313,RM-B215,12/4/2013,696,0,696,0,0,693,2085
339,RM-1100A,6/15/2014,354,1728,0,0,0,0,2082
1709,RM-1102,6/15/2014,354,1728,0,0,0,0,2082
7638,RM-1116,12/28/2013,1041,0,0,0,0,1041,2082
8326,RM-1117,12/28/2013,1041,0,1041,0,0,0,2082
13155,RM-1132,6/15/2014,0,0,354,1728,0,0,2082
18863,RM-1155,12/28/2013,1041,0,1041,0,0,0,2082
22857,RM-1207,12/28/2013,1041,0,0,0,0,1041,2082
23542,RM-1208,12/28/2013,1041,0,0,0,0,1041,2082
27124,RM-1217,6/15/2014,354,1728,0,0,0,0,2082
28331,RM-1221,12/28/2013,0,0,1041,0,0,1041,2082
30389,RM-1229,12/28/2013,0,0,1041,0,0,1041,2082
35044,RM-B103A,12/28/2013,1041,0,0,0,0,1041,2082
36961,RM-B200C,12/28/2013,1041,0,1041,0,0,0,2082
39879,RM-B222,6/15/2014,354,0,0,1728,0,0,2082
44317,RM-B250,12/28/2013,1041,0,1041,0,0,0,2082
45855,RM-B260,6/15/2014,354,0,0,1728,0,0,2082
6258,RM-1113,11/24/2013,1038,0,1041,0,0,0,2079
7627,RM-1116,12/17/2013,1038,0,0,0,0,1041,2079
8292,RM-1117,11/24/2013,1038,0,1041,0,0,0,2079
8977,RM-1122,11/24/2013,0,0,1041,0,0,1038,2079
18829,RM-1155,11/24/2013,1038,0,1041,0,0,0,2079
22846,RM-1207,12/17/2013,1038,0,0,0,0,1041,2079
23531,RM-1208,12/17/2013,1038,0,0,0,0,1041,2079
30355,RM-1229,11/24/2013,0,0,1041,0,0,1038,2079
30378,RM-1229,12/17/2013,0,0,1038,0,0,1041,2079
35033,RM-B103A,12/17/2013,1038,0,0,0,0,1041,2079
35641,RM-B109,2/14/2014,0,846,1233,0,0,0,2079
44283,RM-B250,11/24/2013,1038,0,1041,0,0,0,2079
47690,RM-B275,11/24/2013,0,0,1041,0,0,1038,2079
6281,RM-1113,12/17/2013,1038,0,1038,0,0,0,2076
8315,RM-1117,12/17/2013,1038,0,1038,0,0,0,2076
18852,RM-1155,12/17/2013,1038,0,1038,0,0,0,2076
23508,RM-1208,11/24/2013,1038,0,0,0,0,1038,2076
35200,RM-B103A,6/2/2014,348,0,0,1728,0,0,2076
36950,RM-B200C,12/17/2013,1038,0,1038,0,0,0,2076
44306,RM-B250,12/17/2013,1038,0,1038,0,0,0,2076
6217,RM-1113,10/11/2013,1035,0,1038,0,0,0,2073
7645,RM-1116,1/4/2014,1035,0,0,0,0,1038,2073
8337,RM-1117,1/8/2014,963,0,966,144,0,0,2073
8936,RM-1122,10/11/2013,0,0,1038,0,0,1035,2073
18788,RM-1155,10/11/2013,1035,0,1038,0,0,0,2073
18874,RM-1155,1/8/2014,963,0,966,144,0,0,2073
22864,RM-1207,1/4/2014,1035,0,0,0,0,1038,2073
23549,RM-1208,1/4/2014,1035,0,0,0,0,1038,2073
28338,RM-1221,1/4/2014,0,0,1035,0,0,1038,2073
30370,RM-1229,12/9/2013,0,0,1038,0,0,1035,2073
30396,RM-1229,1/4/2014,0,0,1035,0,0,1038,2073
30559,RM-1229,6/16/2014,0,0,345,1728,0,0,2073
30560,RM-1229,6/17/2014,0,0,345,1728,0,0,2073
32341,RM-1236,10/11/2013,1035,0,1038,0,0,0,2073
32586,RM-1236,6/16/2014,0,1728,345,0,0,0,2073
32587,RM-1236,6/17/2014,0,1728,345,0,0,0,2073
35051,RM-B103A,1/4/2014,1035,0,0,0,0,1038,2073
38344,RM-B215,1/4/2014,0,0,1035,0,0,1038,2073
44242,RM-B250,10/11/2013,1035,0,1038,0,0,0,2073
47649,RM-B275,10/11/2013,0,0,1038,0,0,1035,2073
6222,RM-1113,10/16/2013,1035,0,1035,0,0,0,2070
7010,RM-1115,2/25/2014,1035,0,0,0,0,1035,2070
7016,RM-1115,3/3/2014,1035,0,0,0,0,1035,2070
8333,RM-1117,1/4/2014,1035,0,1035,0,0,0,2070
8941,RM-1122,10/16/2013,0,0,1035,0,0,1035,2070
18793,RM-1155,10/16/2013,1035,0,1035,0,0,0,2070
18870,RM-1155,1/4/2014,1035,0,1035,0,0,0,2070
18922,RM-1155,2/25/2014,1035,0,0,0,0,1035,2070
18928,RM-1155,3/3/2014,1035,0,0,0,0,1035,2070
19598,RM-1156,2/25/2014,1035,0,0,0,0,1035,2070
19604,RM-1156,3/3/2014,1035,0,0,0,0,1035,2070
22916,RM-1207,2/25/2014,1035,0,0,0,0,1035,2070
22922,RM-1207,3/3/2014,1035,0,0,0,0,1035,2070
23467,RM-1208,10/11/2013,1035,0,0,0,0,1035,2070
23472,RM-1208,10/16/2013,1035,0,0,0,0,1035,2070
24922,RM-1212,1/4/2014,1035,0,1035,0,0,0,2070
24974,RM-1212,2/25/2014,1035,0,1035,0,0,0,2070
24980,RM-1212,3/3/2014,1035,0,1035,0,0,0,2070
32346,RM-1236,10/16/2013,1035,0,1035,0,0,0,2070
35068,RM-B103A,1/21/2014,180,0,0,1710,0,180,2070
36968,RM-B200C,1/4/2014,1035,0,1035,0,0,0,2070
37020,RM-B200C,2/25/2014,1035,0,1035,0,0,0,2070
37026,RM-B200C,3/3/2014,1035,0,1035,0,0,0,2070
38262,RM-B215,10/11/2013,1035,0,0,0,0,1035,2070
38267,RM-B215,10/16/2013,1035,0,0,0,0,1035,2070
44247,RM-B250,10/16/2013,1035,0,1035,0,0,0,2070
44324,RM-B250,1/4/2014,1035,0,1035,0,0,0,2070
47654,RM-B275,10/16/2013,0,0,1035,0,0,1035,2070
18887,RM-1155,1/21/2014,180,0,177,1710,0,0,2067
30413,RM-1229,1/21/2014,0,0,177,1710,0,180,2067
7038,RM-1115,3/25/2014,1029,0,0,0,0,1032,2061
18950,RM-1155,3/25/2014,1029,0,0,0,0,1032,2061
19626,RM-1156,3/25/2014,1029,0,0,0,0,1032,2061
22944,RM-1207,3/25/2014,1029,0,0,0,0,1032,2061
25002,RM-1212,3/25/2014,1029,0,1032,0,0,0,2061
30561,RM-1229,6/18/2014,0,0,333,1728,0,0,2061
32588,RM-1236,6/18/2014,0,1728,333,0,0,0,2061
37048,RM-B200C,3/25/2014,1029,0,1032,0,0,0,2061
342,RM-1100A,6/18/2014,330,1728,0,0,0,0,2058
1712,RM-1102,6/18/2014,330,1728,0,0,0,0,2058
7011,RM-1115,2/26/2014,1029,0,0,0,0,1029,2058
7018,RM-1115,3/5/2014,1029,0,0,0,0,1029,2058
7639,RM-1116,12/29/2013,1029,0,0,0,0,1029,2058
8327,RM-1117,12/29/2013,1029,0,1029,0,0,0,2058
13158,RM-1132,6/18/2014,0,0,330,1728,0,0,2058
18864,RM-1155,12/29/2013,1029,0,1029,0,0,0,2058
18923,RM-1155,2/26/2014,1029,0,0,0,0,1029,2058
18930,RM-1155,3/5/2014,1029,0,0,0,0,1029,2058
19599,RM-1156,2/26/2014,1029,0,0,0,0,1029,2058
19606,RM-1156,3/5/2014,1029,0,0,0,0,1029,2058
22858,RM-1207,12/29/2013,1029,0,0,0,0,1029,2058
22917,RM-1207,2/26/2014,1029,0,0,0,0,1029,2058
22924,RM-1207,3/5/2014,1029,0,0,0,0,1029,2058
23543,RM-1208,12/29/2013,1029,0,0,0,0,1029,2058
24975,RM-1212,2/26/2014,1029,0,1029,0,0,0,2058
24982,RM-1212,3/5/2014,1029,0,1029,0,0,0,2058
27127,RM-1217,6/18/2014,330,1728,0,0,0,0,2058
28332,RM-1221,12/29/2013,0,0,1029,0,0,1029,2058
30390,RM-1229,12/29/2013,0,0,1029,0,0,1029,2058
35045,RM-B103A,12/29/2013,1029,0,0,0,0,1029,2058
36962,RM-B200C,12/29/2013,1029,0,1029,0,0,0,2058
37021,RM-B200C,2/26/2014,1029,0,1029,0,0,0,2058
37028,RM-B200C,3/5/2014,1029,0,1029,0,0,0,2058
39882,RM-B222,6/18/2014,330,0,0,1728,0,0,2058
44318,RM-B250,12/29/2013,1029,0,1029,0,0,0,2058
45858,RM-B260,6/18/2014,330,0,0,1728,0,0,2058
340,RM-1100A,6/16/2014,327,1728,0,0,0,0,2055
1710,RM-1102,6/16/2014,327,1728,0,0,0,0,2055
13153,RM-1132,6/13/2014,0,0,327,1728,0,0,2055
13156,RM-1132,6/16/2014,0,0,327,1728,0,0,2055
24998,RM-1212,3/21/2014,1026,0,1029,0,0,0,2055
27125,RM-1217,6/16/2014,327,1728,0,0,0,0,2055
37044,RM-B200C,3/21/2014,1026,0,1029,0,0,0,2055
39880,RM-B222,6/16/2014,327,0,0,1728,0,0,2055
45856,RM-B260,6/16/2014,327,0,0,1728,0,0,2055
337,RM-1100A,6/13/2014,324,1728,0,0,0,0,2052
1707,RM-1102,6/13/2014,324,1728,0,0,0,0,2052
7034,RM-1115,3/21/2014,1026,0,0,0,0,1026,2052
8334,RM-1117,1/5/2014,1026,0,1026,0,0,0,2052
18871,RM-1155,1/5/2014,1026,0,1026,0,0,0,2052
18946,RM-1155,3/21/2014,1026,0,0,0,0,1026,2052
19622,RM-1156,3/21/2014,1026,0,0,0,0,1026,2052
22940,RM-1207,3/21/2014,1026,0,0,0,0,1026,2052
24923,RM-1212,1/5/2014,1026,0,1026,0,0,0,2052
27122,RM-1217,6/13/2014,324,1728,0,0,0,0,2052
35719,RM-B109,5/3/2014,1026,0,1026,0,0,0,2052
36969,RM-B200C,1/5/2014,1026,0,1026,0,0,0,2052
37087,RM-B200C,5/3/2014,1026,0,1026,0,0,0,2052
39877,RM-B222,6/13/2014,324,0,0,1728,0,0,2052
41897,RM-B230,5/3/2014,1026,0,1026,0,0,0,2052
44325,RM-B250,1/5/2014,1026,0,1026,0,0,0,2052
45853,RM-B260,6/13/2014,324,0,0,1728,0,0,2052
341,RM-1100A,6/17/2014,321,1728,0,0,0,0,2049
1711,RM-1102,6/17/2014,321,1728,0,0,0,0,2049
6273,RM-1113,12/9/2013,1011,0,1038,0,0,0,2049
7646,RM-1116,1/5/2014,1026,0,0,0,0,1023,2049
8307,RM-1117,12/9/2013,1011,0,1038,0,0,0,2049
13157,RM-1132,6/17/2014,0,0,321,1728,0,0,2049
18844,RM-1155,12/9/2013,1011,0,1038,0,0,0,2049
22865,RM-1207,1/5/2014,1026,0,0,0,0,1023,2049
23550,RM-1208,1/5/2014,1026,0,0,0,0,1023,2049
27126,RM-1217,6/17/2014,321,1728,0,0,0,0,2049
28339,RM-1221,1/5/2014,0,0,1026,0,0,1023,2049
30397,RM-1229,1/5/2014,0,0,1026,0,0,1023,2049
35052,RM-B103A,1/5/2014,1026,0,0,0,0,1023,2049
38345,RM-B215,1/5/2014,0,0,1026,0,0,1023,2049
39881,RM-B222,6/17/2014,321,0,0,1728,0,0,2049
44298,RM-B250,12/9/2013,1011,0,1038,0,0,0,2049
45857,RM-B260,6/17/2014,321,0,0,1728,0,0,2049
2764,RM-1106,9/14/2013,279,0,0,0,0,1767,2046
7619,RM-1116,12/9/2013,1011,0,0,0,0,1035,2046
35025,RM-B103A,12/9/2013,1011,0,0,0,0,1035,2046
23523,RM-1208,12/9/2013,1008,0,0,0,0,1035,2043
24968,RM-1212,2/19/2014,1020,0,1023,0,0,0,2043
37014,RM-B200C,2/19/2014,1020,0,1023,0,0,0,2043
7004,RM-1115,2/19/2014,1020,0,0,0,0,1020,2040
19592,RM-1156,2/19/2014,1020,0,0,0,0,1020,2040
22910,RM-1207,2/19/2014,1020,0,0,0,0,1020,2040
25024,RM-1212,4/16/2014,1020,0,1020,0,0,0,2040
35702,RM-B109,4/16/2014,1020,0,1020,0,0,0,2040
37070,RM-B200C,4/16/2014,1020,0,1020,0,0,0,2040
41880,RM-B230,4/16/2014,1020,0,1020,0,0,0,2040
343,RM-1100A,6/19/2014,309,1728,0,0,0,0,2037
1713,RM-1102,6/19/2014,309,1728,0,0,0,0,2037
13159,RM-1132,6/19/2014,0,0,309,1728,0,0,2037
27128,RM-1217,6/19/2014,309,1728,0,0,0,0,2037
30562,RM-1229,6/19/2014,0,0,309,1728,0,0,2037
32589,RM-1236,6/19/2014,0,1728,309,0,0,0,2037
39883,RM-B222,6/19/2014,309,0,0,1728,0,0,2037
45859,RM-B260,6/19/2014,309,0,0,1728,0,0,2037
23555,RM-1208,1/10/2014,918,198,0,0,0,918,2034
344,RM-1100A,6/20/2014,303,1728,0,0,0,0,2031
1714,RM-1102,6/20/2014,303,1728,0,0,0,0,2031
27129,RM-1217,6/20/2014,303,1728,0,0,0,0,2031
39884,RM-B222,6/20/2014,303,0,0,1728,0,0,2031
45860,RM-B260,6/20/2014,303,0,0,1728,0,0,2031
9827,RM-1123,5/8/2014,0,2028,0,0,0,0,2028
30563,RM-1229,6/20/2014,0,0,300,1728,0,0,2028
32590,RM-1236,6/20/2014,0,1728,300,0,0,0,2028
18876,RM-1155,1/10/2014,918,0,915,192,0,0,2025
23509,RM-1208,11/25/2013,1011,0,0,0,0,1011,2022
25017,RM-1212,4/9/2014,1011,0,1011,0,0,0,2022
30281,RM-1229,9/7/2013,675,0,675,0,0,672,2022
37063,RM-B200C,4/9/2014,1011,0,1011,0,0,0,2022
41873,RM-B230,4/9/2014,1011,0,1011,0,0,0,2022
6259,RM-1113,11/25/2013,1011,0,1008,0,0,0,2019
8293,RM-1117,11/25/2013,1011,0,1008,0,0,0,2019
8978,RM-1122,11/25/2013,0,0,1008,0,0,1011,2019
18830,RM-1155,11/25/2013,1011,0,1008,0,0,0,2019
30356,RM-1229,11/25/2013,0,0,1008,0,0,1011,2019
44284,RM-B250,11/25/2013,1011,0,1008,0,0,0,2019
6225,RM-1113,10/19/2013,1008,0,1008,0,0,0,2016
8944,RM-1122,10/19/2013,0,0,1008,0,0,1008,2016
13691,RM-1133,1/17/2014,0,1728,288,0,0,0,2016
18796,RM-1155,10/19/2013,1008,0,1008,0,0,0,2016
23475,RM-1208,10/19/2013,1008,0,0,0,0,1008,2016
32349,RM-1236,10/19/2013,1008,0,1008,0,0,0,2016
38270,RM-B215,10/19/2013,1008,0,0,0,0,1008,2016
41791,RM-B230,1/17/2014,0,1728,288,0,0,0,2016
44250,RM-B250,10/19/2013,1008,0,1008,0,0,0,2016
47657,RM-B275,10/19/2013,0,0,1008,0,0,1008,2016
26975,RM-1217,1/17/2014,285,0,0,1728,0,0,2013
47744,RM-B275,1/17/2014,0,1728,0,0,0,285,2013
9716,RM-1123,1/17/2014,0,1722,288,0,0,0,2010
24250,RM-1208B,1/17/2014,0,0,288,1722,0,0,2010
30564,RM-1229,6/21/2014,0,0,282,1728,0,0,2010
30567,RM-1229,6/24/2014,0,0,282,1728,0,0,2010
30568,RM-1229,6/25/2014,0,0,282,1728,0,0,2010
32591,RM-1236,6/21/2014,0,1728,282,0,0,0,2010
32594,RM-1236,6/24/2014,0,1728,282,0,0,0,2010
32595,RM-1236,6/25/2014,0,1728,282,0,0,0,2010
345,RM-1100A,6/21/2014,279,1728,0,0,0,0,2007
1715,RM-1102,6/21/2014,279,1728,0,0,0,0,2007
2886,RM-1106,1/17/2014,0,0,0,1722,0,285,2007
13006,RM-1132,1/17/2014,0,0,285,1722,0,0,2007
27130,RM-1217,6/21/2014,279,1728,0,0,0,0,2007
39730,RM-B222,1/17/2014,285,0,0,1722,0,0,2007
39885,RM-B222,6/21/2014,279,0,0,1728,0,0,2007
45861,RM-B260,6/21/2014,279,0,0,1728,0,0,2007
45865,RM-B260,6/25/2014,276,0,0,1728,0,0,2004
252,RM-1100A,3/20/2014,273,1728,0,0,0,0,2001
346,RM-1100A,6/22/2014,273,1728,0,0,0,0,2001
348,RM-1100A,6/24/2014,273,1728,0,0,0,0,2001
349,RM-1100A,6/25/2014,273,1728,0,0,0,0,2001
1716,RM-1102,6/22/2014,273,1728,0,0,0,0,2001
1718,RM-1102,6/24/2014,273,1728,0,0,0,0,2001
1719,RM-1102,6/25/2014,273,1728,0,0,0,0,2001
2948,RM-1106,3/20/2014,0,0,0,1728,0,273,2001
4317,RM-1108,3/20/2014,0,1728,0,0,0,273,2001
8408,RM-1117,3/20/2014,0,1728,273,0,0,0,2001
17572,RM-1151,3/20/2014,273,0,0,1728,0,0,2001
24312,RM-1208B,3/20/2014,0,0,273,1728,0,0,2001
27131,RM-1217,6/22/2014,273,1728,0,0,0,0,2001
27133,RM-1217,6/24/2014,273,1728,0,0,0,0,2001
27134,RM-1217,6/25/2014,273,1728,0,0,0,0,2001
27725,RM-1218,3/20/2014,0,0,273,1728,0,0,2001
30565,RM-1229,6/22/2014,0,0,273,1728,0,0,2001
32592,RM-1236,6/22/2014,0,1728,273,0,0,0,2001
36362,RM-B200B,3/20/2014,0,1728,0,0,0,273,2001
39792,RM-B222,3/20/2014,273,0,0,1728,0,0,2001
39886,RM-B222,6/22/2014,273,0,0,1728,0,0,2001
39888,RM-B222,6/24/2014,273,0,0,1728,0,0,2001
39889,RM-B222,6/25/2014,273,0,0,1728,0,0,2001
44399,RM-B250,3/20/2014,0,1728,273,0,0,0,2001
45862,RM-B260,6/22/2014,273,0,0,1728,0,0,2001
45864,RM-B260,6/24/2014,273,0,0,1728,0,0,2001
2887,RM-1106,1/18/2014,0,0,0,1710,0,288,1998
6226,RM-1113,10/20/2013,999,0,999,0,0,0,1998
6266,RM-1113,12/2/2013,999,0,999,0,0,0,1998
7612,RM-1116,12/2/2013,999,0,0,0,0,999,1998
8300,RM-1117,12/2/2013,999,0,999,0,0,0,1998
8945,RM-1122,10/20/2013,0,0,999,0,0,999,1998
18797,RM-1155,10/20/2013,999,0,999,0,0,0,1998
18837,RM-1155,12/2/2013,999,0,999,0,0,0,1998
23476,RM-1208,10/20/2013,999,0,0,0,0,999,1998
23516,RM-1208,12/2/2013,999,0,0,0,0,999,1998
23553,RM-1208,1/8/2014,963,72,0,0,0,963,1998
30363,RM-1229,12/2/2013,0,0,999,0,0,999,1998
32350,RM-1236,10/20/2013,999,0,999,0,0,0,1998
35018,RM-B103A,12/2/2013,999,0,0,0,0,999,1998
38271,RM-B215,10/20/2013,999,0,0,0,0,999,1998
44251,RM-B250,10/20/2013,999,0,999,0,0,0,1998
44291,RM-B250,12/2/2013,999,0,999,0,0,0,1998
47658,RM-B275,10/20/2013,0,0,999,0,0,999,1998
47745,RM-B275,1/18/2014,0,1710,0,0,0,288,1998
347,RM-1100A,6/23/2014,267,1728,0,0,0,0,1995
1717,RM-1102,6/23/2014,267,1728,0,0,0,0,1995
9717,RM-1123,1/18/2014,0,1710,285,0,0,0,1995
9718,RM-1123,1/19/2014,0,1728,267,0,0,0,1995
13007,RM-1132,1/18/2014,0,0,285,1710,0,0,1995
13008,RM-1132,1/19/2014,0,0,267,1728,0,0,1995
13692,RM-1133,1/18/2014,0,1710,285,0,0,0,1995
13693,RM-1133,1/19/2014,0,1728,267,0,0,0,1995
18892,RM-1155,1/26/2014,135,0,138,1722,0,0,1995
24251,RM-1208B,1/18/2014,0,0,285,1710,0,0,1995
24252,RM-1208B,1/19/2014,0,0,267,1728,0,0,1995
26976,RM-1217,1/18/2014,285,0,0,1710,0,0,1995
26977,RM-1217,1/19/2014,267,0,0,1728,0,0,1995
27132,RM-1217,6/23/2014,267,1728,0,0,0,0,1995
30418,RM-1229,1/26/2014,0,0,138,1722,0,135,1995
30566,RM-1229,6/23/2014,0,0,267,1728,0,0,1995
32593,RM-1236,6/23/2014,0,1728,267,0,0,0,1995
39731,RM-B222,1/18/2014,285,0,0,1710,0,0,1995
39732,RM-B222,1/19/2014,267,0,0,1728,0,0,1995
39887,RM-B222,6/23/2014,267,0,0,1728,0,0,1995
41792,RM-B230,1/18/2014,0,1710,285,0,0,0,1995
41793,RM-B230,1/19/2014,0,1728,267,0,0,0,1995
44454,RM-B250,5/14/2014,0,582,831,582,0,0,1995
45863,RM-B260,6/23/2014,267,0,0,1728,0,0,1995
2888,RM-1106,1/19/2014,0,0,0,1728,0,264,1992
7647,RM-1116,1/6/2014,996,0,0,0,0,996,1992
22866,RM-1207,1/6/2014,996,0,0,0,0,996,1992
23551,RM-1208,1/6/2014,996,0,0,0,0,996,1992
35053,RM-B103A,1/6/2014,996,0,0,0,0,996,1992
35720,RM-B109,5/4/2014,996,0,996,0,0,0,1992
37088,RM-B200C,5/4/2014,996,0,996,0,0,0,1992
41898,RM-B230,5/4/2014,996,0,996,0,0,0,1992
47746,RM-B275,1/19/2014,0,1728,0,0,0,264,1992
8335,RM-1117,1/6/2014,996,0,993,0,0,0,1989
18872,RM-1155,1/6/2014,996,0,993,0,0,0,1989
24924,RM-1212,1/6/2014,996,0,993,0,0,0,1989
25025,RM-1212,4/17/2014,993,0,996,0,0,0,1989
28340,RM-1221,1/6/2014,0,0,993,0,0,996,1989
30398,RM-1229,1/6/2014,0,0,993,0,0,996,1989
35703,RM-B109,4/17/2014,993,0,996,0,0,0,1989
36970,RM-B200C,1/6/2014,996,0,993,0,0,0,1989
37071,RM-B200C,4/17/2014,993,0,996,0,0,0,1989
38346,RM-B215,1/6/2014,0,0,993,0,0,996,1989
41881,RM-B230,4/17/2014,993,0,996,0,0,0,1989
44326,RM-B250,1/6/2014,996,0,993,0,0,0,1989
30569,RM-1229,6/26/2014,0,0,258,1728,0,0,1986
32596,RM-1236,6/26/2014,0,1728,258,0,0,0,1986
35073,RM-B103A,1/26/2014,135,0,0,1716,0,135,1986
6223,RM-1113,10/17/2013,990,0,993,0,0,0,1983
8942,RM-1122,10/17/2013,0,0,993,0,0,990,1983
18794,RM-1155,10/17/2013,990,0,993,0,0,0,1983
32347,RM-1236,10/17/2013,990,0,993,0,0,0,1983
44248,RM-B250,10/17/2013,990,0,993,0,0,0,1983
47655,RM-B275,10/17/2013,0,0,993,0,0,990,1983
23473,RM-1208,10/17/2013,990,0,0,0,0,990,1980
35711,RM-B109,4/25/2014,990,0,990,0,0,0,1980
37079,RM-B200C,4/25/2014,990,0,990,0,0,0,1980
38268,RM-B215,10/17/2013,990,0,0,0,0,990,1980
41889,RM-B230,4/25/2014,990,0,990,0,0,0,1980
7613,RM-1116,12/3/2013,987,0,0,0,0,990,1977
23517,RM-1208,12/3/2013,987,0,0,0,0,990,1977
30364,RM-1229,12/3/2013,0,0,987,0,0,990,1977
35019,RM-B103A,12/3/2013,987,0,0,0,0,990,1977
35715,RM-B109,4/29/2014,987,0,990,0,0,0,1977
37083,RM-B200C,4/29/2014,987,0,990,0,0,0,1977
41893,RM-B230,4/29/2014,987,0,990,0,0,0,1977
6267,RM-1113,12/3/2013,987,0,987,0,0,0,1974
8301,RM-1117,12/3/2013,987,0,987,0,0,0,1974
18838,RM-1155,12/3/2013,987,0,987,0,0,0,1974
44292,RM-B250,12/3/2013,987,0,987,0,0,0,1974
2889,RM-1106,1/20/2014,0,0,0,1722,0,249,1971
2892,RM-1106,1/23/2014,0,0,0,1728,0,243,1971
9719,RM-1123,1/20/2014,0,1722,249,0,0,0,1971
13009,RM-1132,1/20/2014,0,0,249,1722,0,0,1971
13694,RM-1133,1/20/2014,0,1722,249,0,0,0,1971
24253,RM-1208B,1/20/2014,0,0,249,1722,0,0,1971
24976,RM-1212,2/27/2014,978,0,993,0,0,0,1971
26978,RM-1217,1/20/2014,249,0,0,1722,0,0,1971
35616,RM-B109,1/20/2014,0,1722,249,0,0,0,1971
37022,RM-B200C,2/27/2014,978,0,993,0,0,0,1971
39733,RM-B222,1/20/2014,249,0,0,1722,0,0,1971
41794,RM-B230,1/20/2014,0,1722,249,0,0,0,1971
47747,RM-B275,1/20/2014,0,1722,0,0,0,249,1971
47750,RM-B275,1/23/2014,0,1728,0,0,0,243,1971
7017,RM-1115,3/4/2014,984,0,0,0,0,984,1968
9722,RM-1123,1/23/2014,0,1728,240,0,0,0,1968
13012,RM-1132,1/23/2014,0,0,240,1728,0,0,1968
13697,RM-1133,1/23/2014,0,1728,240,0,0,0,1968
18929,RM-1155,3/4/2014,984,0,0,0,0,984,1968
19605,RM-1156,3/4/2014,984,0,0,0,0,984,1968
22923,RM-1207,3/4/2014,984,0,0,0,0,984,1968
24256,RM-1208B,1/23/2014,0,0,240,1728,0,0,1968
24981,RM-1212,3/4/2014,984,0,984,0,0,0,1968
26981,RM-1217,1/23/2014,240,0,0,1728,0,0,1968
35619,RM-B109,1/23/2014,0,1728,240,0,0,0,1968
37027,RM-B200C,3/4/2014,984,0,984,0,0,0,1968
39736,RM-B222,1/23/2014,240,0,0,1728,0,0,1968
41797,RM-B230,1/23/2014,0,1728,240,0,0,0,1968
35724,RM-B109,5/8/2014,981,0,981,0,0,0,1962
37092,RM-B200C,5/8/2014,981,0,981,0,0,0,1962
41902,RM-B230,5/8/2014,981,0,981,0,0,0,1962
39890,RM-B222,6/26/2014,231,0,0,1728,0,0,1959
45866,RM-B260,6/26/2014,231,0,0,1728,0,0,1959
350,RM-1100A,6/26/2014,228,1728,0,0,0,0,1956
1720,RM-1102,6/26/2014,228,1728,0,0,0,0,1956
7012,RM-1115,2/27/2014,978,0,0,0,0,978,1956
18893,RM-1155,1/27/2014,138,0,138,1680,0,0,1956
18924,RM-1155,2/27/2014,978,0,0,0,0,978,1956
19600,RM-1156,2/27/2014,978,0,0,0,0,978,1956
22918,RM-1207,2/27/2014,978,0,0,0,0,978,1956
23672,RM-1208,5/7/2014,888,1068,0,0,0,0,1956
27135,RM-1217,6/26/2014,228,1728,0,0,0,0,1956
30419,RM-1229,1/27/2014,0,0,138,1680,0,138,1956
35725,RM-B109,5/9/2014,978,0,978,0,0,0,1956
37093,RM-B200C,5/9/2014,978,0,978,0,0,0,1956
41903,RM-B230,5/9/2014,978,0,978,0,0,0,1956
1725,RM-1102,7/1/2014,222,1728,0,0,0,0,1950
2738,RM-1106,8/10/2013,1950,0,0,0,0,0,1950
3423,RM-1107,8/10/2013,0,0,1950,0,0,0,1950
6164,RM-1113,8/10/2013,0,0,1950,0,0,0,1950
8883,RM-1122,8/10/2013,0,0,1950,0,0,0,1950
9568,RM-1123,8/10/2013,0,0,1950,0,0,0,1950
12171,RM-1130,8/10/2013,0,0,0,0,0,1950,1950
13543,RM-1133,8/10/2013,0,0,1950,0,0,0,1950
15335,RM-1144,8/10/2013,0,0,0,0,0,1950,1950
18047,RM-1154,8/10/2013,1950,0,0,0,0,0,1950
20728,RM-1200B,8/10/2013,0,0,0,0,0,1950,1950
25457,RM-1213,8/10/2013,0,0,1950,0,0,0,1950
26827,RM-1217,8/10/2013,1950,0,0,0,0,0,1950
27140,RM-1217,7/1/2014,222,1728,0,0,0,0,1950
30574,RM-1229,7/1/2014,0,0,222,1728,0,0,1950
32601,RM-1236,7/1/2014,0,1728,222,0,0,0,1950
33700,RM-B102C,8/10/2013,0,0,1950,0,0,0,1950
34916,RM-B103A,8/10/2013,0,0,0,0,0,1950,1950
37521,RM-B210,8/10/2013,0,0,1950,0,0,0,1950
40958,RM-B225,8/10/2013,0,0,0,0,0,1950,1950
42328,RM-B230A,8/10/2013,0,0,0,0,0,1950,1950
43579,RM-B240A,8/10/2013,0,0,0,0,0,1950,1950
46928,RM-B270,8/10/2013,0,0,1950,0,0,0,1950
47596,RM-B275,8/10/2013,0,0,1950,0,0,0,1950
2893,RM-1106,1/24/2014,0,0,0,1728,0,219,1947
9723,RM-1123,1/24/2014,0,1728,219,0,0,0,1947
13013,RM-1132,1/24/2014,0,0,219,1728,0,0,1947
13698,RM-1133,1/24/2014,0,1728,219,0,0,0,1947
24257,RM-1208B,1/24/2014,0,0,219,1728,0,0,1947
26142,RM-1213A,8/10/2013,0,0,0,0,0,1947,1947
26982,RM-1217,1/24/2014,219,0,0,1728,0,0,1947
31598,RM-1231,8/10/2013,0,0,0,0,0,1947,1947
35620,RM-B109,1/24/2014,0,1728,219,0,0,0,1947
36465,RM-B200B,7/1/2014,0,1722,225,0,0,0,1947
39737,RM-B222,1/24/2014,219,0,0,1728,0,0,1947
39895,RM-B222,7/1/2014,225,0,0,1722,0,0,1947
41798,RM-B230,1/24/2014,0,1728,219,0,0,0,1947
45871,RM-B260,7/1/2014,225,0,0,1722,0,0,1947
47751,RM-B275,1/24/2014,0,1728,0,0,0,219,1947
355,RM-1100A,7/1/2014,222,1722,0,0,0,0,1944
6271,RM-1113,12/7/2013,972,0,972,0,0,0,1944
7617,RM-1116,12/7/2013,972,0,0,0,0,972,1944
8305,RM-1117,12/7/2013,972,0,972,0,0,0,1944
18842,RM-1155,12/7/2013,972,0,972,0,0,0,1944
23521,RM-1208,12/7/2013,972,0,0,0,0,972,1944
30368,RM-1229,12/7/2013,0,0,972,0,0,972,1944
35023,RM-B103A,12/7/2013,972,0,0,0,0,972,1944
35074,RM-B103A,1/27/2014,138,0,0,1668,0,138,1944
44296,RM-B250,12/7/2013,972,0,972,0,0,0,1944
30571,RM-1229,6/28/2014,0,0,213,1728,0,0,1941
32598,RM-1236,6/28/2014,0,1728,213,0,0,0,1941
1722,RM-1102,6/28/2014,210,1728,0,0,0,0,1938
27137,RM-1217,6/28/2014,210,1728,0,0,0,0,1938
27056,RM-1217,4/8/2014,1047,888,0,0,0,0,1935
352,RM-1100A,6/28/2014,210,1722,0,0,0,0,1932
6270,RM-1113,12/6/2013,966,0,966,0,0,0,1932
7616,RM-1116,12/6/2013,966,0,0,0,0,966,1932
8304,RM-1117,12/6/2013,966,0,966,0,0,0,1932
9829,RM-1123,5/10/2014,0,1932,0,0,0,0,1932
18841,RM-1155,12/6/2013,966,0,966,0,0,0,1932
23520,RM-1208,12/6/2013,966,0,0,0,0,966,1932
30367,RM-1229,12/6/2013,0,0,966,0,0,966,1932
35022,RM-B103A,12/6/2013,966,0,0,0,0,966,1932
39892,RM-B222,6/28/2014,210,0,0,1722,0,0,1932
44295,RM-B250,12/6/2013,966,0,966,0,0,0,1932
45868,RM-B260,6/28/2014,210,0,0,1722,0,0,1932
9724,RM-1123,1/25/2014,0,1716,213,0,0,0,1929
13014,RM-1132,1/25/2014,0,0,213,1716,0,0,1929
13117,RM-1132,5/8/2014,0,0,981,948,0,0,1929
13699,RM-1133,1/25/2014,0,1716,213,0,0,0,1929
24926,RM-1212,1/8/2014,963,0,966,0,0,0,1929
26983,RM-1217,1/25/2014,213,0,0,1716,0,0,1929
28342,RM-1221,1/8/2014,0,0,966,0,0,963,1929
30400,RM-1229,1/8/2014,0,0,966,0,0,963,1929
36972,RM-B200C,1/8/2014,963,0,966,0,0,0,1929
38348,RM-B215,1/8/2014,0,0,966,0,0,963,1929
44328,RM-B250,1/8/2014,963,0,966,0,0,0,1929
2894,RM-1106,1/25/2014,0,0,0,1716,0,210,1926
6272,RM-1113,12/8/2013,963,0,963,0,0,0,1926
7618,RM-1116,12/8/2013,963,0,0,0,0,963,1926
8306,RM-1117,12/8/2013,963,0,963,0,0,0,1926
18843,RM-1155,12/8/2013,963,0,963,0,0,0,1926
22868,RM-1207,1/8/2014,963,0,0,0,0,963,1926
23522,RM-1208,12/8/2013,963,0,0,0,0,963,1926
30369,RM-1229,12/8/2013,0,0,963,0,0,963,1926
35024,RM-B103A,12/8/2013,963,0,0,0,0,963,1926
35055,RM-B103A,1/8/2014,963,0,0,0,0,963,1926
44297,RM-B250,12/8/2013,963,0,963,0,0,0,1926
24258,RM-1208B,1/25/2014,0,0,213,1710,0,0,1923
25026,RM-1212,4/18/2014,963,0,960,0,0,0,1923
35621,RM-B109,1/25/2014,0,1710,213,0,0,0,1923
35704,RM-B109,4/18/2014,963,0,960,0,0,0,1923
35726,RM-B109,5/10/2014,963,0,960,0,0,0,1923
37072,RM-B200C,4/18/2014,963,0,960,0,0,0,1923
37094,RM-B200C,5/10/2014,963,0,960,0,0,0,1923
39738,RM-B222,1/25/2014,213,0,0,1710,0,0,1923
41799,RM-B230,1/25/2014,0,1710,213,0,0,0,1923
41882,RM-B230,4/18/2014,963,0,960,0,0,0,1923
41904,RM-B230,5/10/2014,963,0,960,0,0,0,1923
47752,RM-B275,1/25/2014,0,1710,0,0,0,210,1920
351,RM-1100A,6/27/2014,189,1728,0,0,0,0,1917
1721,RM-1102,6/27/2014,189,1728,0,0,0,0,1917
13120,RM-1132,5/11/2014,0,0,945,972,0,0,1917
27136,RM-1217,6/27/2014,189,1728,0,0,0,0,1917
30570,RM-1229,6/27/2014,0,0,189,1728,0,0,1917
32597,RM-1236,6/27/2014,0,1728,189,0,0,0,1917
39891,RM-B222,6/27/2014,189,0,0,1728,0,0,1917
45867,RM-B260,6/27/2014,189,0,0,1728,0,0,1917
9721,RM-1123,1/22/2014,0,1692,219,0,0,0,1911
13011,RM-1132,1/22/2014,0,0,219,1692,0,0,1911
13696,RM-1133,1/22/2014,0,1692,219,0,0,0,1911
25018,RM-1212,4/10/2014,957,0,954,0,0,0,1911
37064,RM-B200C,4/10/2014,957,0,954,0,0,0,1911
41874,RM-B230,4/10/2014,957,0,954,0,0,0,1911
2891,RM-1106,1/22/2014,0,0,0,1692,0,216,1908
6989,RM-1115,2/4/2014,366,0,0,0,0,1542,1908
7021,RM-1115,3/8/2014,954,0,0,0,0,954,1908
18933,RM-1155,3/8/2014,954,0,0,0,0,954,1908
19609,RM-1156,3/8/2014,954,0,0,0,0,954,1908
22927,RM-1207,3/8/2014,954,0,0,0,0,954,1908
24985,RM-1212,3/8/2014,954,0,954,0,0,0,1908
26980,RM-1217,1/22/2014,216,0,0,1692,0,0,1908
37031,RM-B200C,3/8/2014,954,0,954,0,0,0,1908
7020,RM-1115,3/7/2014,951,0,0,0,0,951,1902
9831,RM-1123,5/12/2014,0,1902,0,0,0,0,1902
18932,RM-1155,3/7/2014,951,0,0,0,0,951,1902
19608,RM-1156,3/7/2014,951,0,0,0,0,951,1902
22926,RM-1207,3/7/2014,951,0,0,0,0,951,1902
24984,RM-1212,3/7/2014,951,0,951,0,0,0,1902
37030,RM-B200C,3/7/2014,951,0,951,0,0,0,1902
7513,RM-1116,8/13/2013,0,0,951,0,0,948,1899
24255,RM-1208B,1/22/2014,0,0,219,1680,0,0,1899
27086,RM-1217,5/8/2014,981,918,0,0,0,0,1899
35618,RM-B109,1/22/2014,0,1680,219,0,0,0,1899
36836,RM-B200C,8/13/2013,0,0,951,0,0,948,1899
40273,RM-B224,8/13/2013,0,0,951,0,0,948,1899
41796,RM-B230,1/22/2014,0,1680,219,0,0,0,1899
47599,RM-B275,8/13/2013,0,0,951,0,0,948,1899
13119,RM-1132,5/10/2014,0,0,960,936,0,0,1896
18738,RM-1155,8/13/2013,945,0,951,0,0,0,1896
30264,RM-1229,8/13/2013,945,0,951,0,0,0,1896
32291,RM-1236,8/13/2013,945,0,951,0,0,0,1896
39735,RM-B222,1/22/2014,216,0,0,1680,0,0,1896
47749,RM-B275,1/22/2014,0,1680,0,0,0,216,1896
2741,RM-1106,8/13/2013,945,0,0,0,0,948,1893
8201,RM-1117,8/13/2013,945,0,0,0,0,948,1893
23417,RM-1208,8/13/2013,945,0,0,0,0,948,1893
38212,RM-B215,8/13/2013,945,0,0,0,0,948,1893
2890,RM-1106,1/21/2014,0,0,0,1710,0,180,1890
13118,RM-1132,5/9/2014,0,0,978,912,0,0,1890
22873,RM-1207,1/13/2014,945,0,0,0,0,945,1890
23558,RM-1208,1/13/2014,945,0,0,0,0,945,1890
26979,RM-1217,1/21/2014,180,0,0,1710,0,0,1890
35060,RM-B103A,1/13/2014,945,0,0,0,0,945,1890
39585,RM-B222,8/13/2013,945,0,945,0,0,0,1890
39734,RM-B222,1/21/2014,180,0,0,1710,0,0,1890
47748,RM-B275,1/21/2014,0,1710,0,0,0,180,1890
3424,RM-1107,8/11/2013,0,0,1887,0,0,0,1887
6165,RM-1113,8/11/2013,0,0,1887,0,0,0,1887
8884,RM-1122,8/11/2013,0,0,1887,0,0,0,1887
9569,RM-1123,8/11/2013,0,0,1887,0,0,0,1887
9720,RM-1123,1/21/2014,0,1710,177,0,0,0,1887
13010,RM-1132,1/21/2014,0,0,177,1710,0,0,1887
13544,RM-1133,8/11/2013,0,0,1887,0,0,0,1887
13695,RM-1133,1/21/2014,0,1710,177,0,0,0,1887
18048,RM-1154,8/11/2013,1887,0,0,0,0,0,1887
18879,RM-1155,1/13/2014,945,0,942,0,0,0,1887
20729,RM-1200B,8/11/2013,0,0,0,0,0,1887,1887
24254,RM-1208B,1/21/2014,0,0,177,1710,0,0,1887
24931,RM-1212,1/13/2014,945,0,942,0,0,0,1887
25458,RM-1213,8/11/2013,0,0,1887,0,0,0,1887
26143,RM-1213A,8/11/2013,0,0,0,0,0,1887,1887
26828,RM-1217,8/11/2013,1887,0,0,0,0,0,1887
28347,RM-1221,1/13/2014,0,0,942,0,0,945,1887
30405,RM-1229,1/13/2014,0,0,942,0,0,945,1887
31599,RM-1231,8/11/2013,0,0,0,0,0,1887,1887
33701,RM-B102C,8/11/2013,0,0,1887,0,0,0,1887
35617,RM-B109,1/21/2014,0,1710,177,0,0,0,1887
36977,RM-B200C,1/13/2014,945,0,942,0,0,0,1887
38353,RM-B215,1/13/2014,0,0,942,0,0,945,1887
41795,RM-B230,1/21/2014,0,1710,177,0,0,0,1887
46929,RM-B270,8/11/2013,0,0,1887,0,0,0,1887
26,RM-1100A,7/25/2013,1884,0,0,0,0,0,1884
2722,RM-1106,7/25/2013,1884,0,0,0,0,0,1884
3407,RM-1107,7/25/2013,0,0,1884,0,0,0,1884
6148,RM-1113,7/25/2013,0,0,1884,0,0,0,1884
8867,RM-1122,7/25/2013,0,0,1884,0,0,0,1884
9830,RM-1123,5/11/2014,0,1884,0,0,0,0,1884
9835,RM-1123,5/16/2014,0,1884,0,0,0,0,1884
12172,RM-1130,8/11/2013,0,0,0,0,0,1884,1884
12842,RM-1132,7/25/2013,1884,0,0,0,0,0,1884
13527,RM-1133,7/25/2013,0,0,1884,0,0,0,1884
15336,RM-1144,8/11/2013,0,0,0,0,0,1884,1884
18031,RM-1154,7/25/2013,1884,0,0,0,0,0,1884
20712,RM-1200B,7/25/2013,0,0,0,0,0,1884,1884
25019,RM-1212,4/11/2014,942,0,942,0,0,0,1884
25441,RM-1213,7/25/2013,0,0,1884,0,0,0,1884
33684,RM-B102C,7/25/2013,0,0,1884,0,0,0,1884
34917,RM-B103A,8/11/2013,0,0,0,0,0,1884,1884
35727,RM-B109,5/11/2014,942,0,942,0,0,0,1884
37065,RM-B200C,4/11/2014,942,0,942,0,0,0,1884
37095,RM-B200C,5/11/2014,942,0,942,0,0,0,1884
37505,RM-B210,7/25/2013,0,0,1884,0,0,0,1884
40959,RM-B225,8/11/2013,0,0,0,0,0,1884,1884
41875,RM-B230,4/11/2014,942,0,942,0,0,0,1884
41905,RM-B230,5/11/2014,942,0,942,0,0,0,1884
42329,RM-B230A,8/11/2013,0,0,0,0,0,1884,1884
43580,RM-B240A,8/11/2013,0,0,0,0,0,1884,1884
46912,RM-B270,7/25/2013,0,0,1884,0,0,0,1884
47580,RM-B275,7/25/2013,0,0,1884,0,0,0,1884
5464,RM-1110,7/25/2013,0,0,0,0,0,1881,1881
12155,RM-1130,7/25/2013,0,0,0,0,0,1881,1881
23398,RM-1208,7/25/2013,0,0,0,0,0,1881,1881
26126,RM-1213A,7/25/2013,0,0,0,0,0,1881,1881
28187,RM-1221,7/25/2013,0,0,0,0,0,1881,1881
31582,RM-1231,7/25/2013,0,0,0,0,0,1881,1881
34900,RM-B103A,7/25/2013,0,0,0,0,0,1881,1881
40942,RM-B225,7/25/2013,0,0,0,0,0,1881,1881
42312,RM-B230A,7/25/2013,0,0,0,0,0,1881,1881
43563,RM-B240A,7/25/2013,0,0,0,0,0,1881,1881
8338,RM-1117,1/9/2014,939,0,939,0,0,0,1878
18875,RM-1155,1/9/2014,939,0,939,0,0,0,1878
22869,RM-1207,1/9/2014,939,0,0,0,0,939,1878
23554,RM-1208,1/9/2014,939,0,0,0,0,939,1878
24927,RM-1212,1/9/2014,939,0,939,0,0,0,1878
28343,RM-1221,1/9/2014,0,0,939,0,0,939,1878
30401,RM-1229,1/9/2014,0,0,939,0,0,939,1878
35056,RM-B103A,1/9/2014,939,0,0,0,0,939,1878
36973,RM-B200C,1/9/2014,939,0,939,0,0,0,1878
38349,RM-B215,1/9/2014,0,0,939,0,0,939,1878
13121,RM-1132,5/12/2014,0,0,915,960,0,0,1875
6224,RM-1113,10/18/2013,933,0,933,0,0,0,1866
7022,RM-1115,3/9/2014,933,0,0,0,0,933,1866
8943,RM-1122,10/18/2013,0,0,933,0,0,933,1866
18795,RM-1155,10/18/2013,933,0,933,0,0,0,1866
18934,RM-1155,3/9/2014,933,0,0,0,0,933,1866
19610,RM-1156,3/9/2014,933,0,0,0,0,933,1866
22928,RM-1207,3/9/2014,933,0,0,0,0,933,1866
23474,RM-1208,10/18/2013,933,0,0,0,0,933,1866
24986,RM-1212,3/9/2014,933,0,933,0,0,0,1866
32348,RM-1236,10/18/2013,933,0,933,0,0,0,1866
37032,RM-B200C,3/9/2014,933,0,933,0,0,0,1866
38269,RM-B215,10/18/2013,933,0,0,0,0,933,1866
44249,RM-B250,10/18/2013,933,0,933,0,0,0,1866
47656,RM-B275,10/18/2013,0,0,933,0,0,933,1866
25021,RM-1212,4/13/2014,930,0,933,0,0,0,1863
27693,RM-1218,2/16/2014,0,0,135,1728,0,0,1863
37067,RM-B200C,4/13/2014,930,0,933,0,0,0,1863
41877,RM-B230,4/13/2014,930,0,933,0,0,0,1863
9725,RM-1123,1/26/2014,0,1722,138,0,0,0,1860
13700,RM-1133,1/26/2014,0,1722,138,0,0,0,1860
30242,RM-1229,7/22/2013,1272,0,588,0,0,0,1860
2895,RM-1106,1/26/2014,0,0,0,1722,0,135,1857
13015,RM-1132,1/26/2014,0,0,135,1722,0,0,1857
24996,RM-1212,3/19/2014,927,0,930,0,0,0,1857
26984,RM-1217,1/26/2014,135,0,0,1722,0,0,1857
37042,RM-B200C,3/19/2014,927,0,930,0,0,0,1857
7032,RM-1115,3/19/2014,927,0,0,0,0,927,1854
18944,RM-1155,3/19/2014,927,0,0,0,0,927,1854
19620,RM-1156,3/19/2014,927,0,0,0,0,927,1854
22938,RM-1207,3/19/2014,927,0,0,0,0,927,1854
24259,RM-1208B,1/26/2014,0,0,138,1716,0,0,1854
24458,RM-1208B,8/13/2014,927,0,927,0,0,0,1854
32644,RM-1236,8/13/2014,927,0,927,0,0,0,1854
35622,RM-B109,1/26/2014,0,1716,138,0,0,0,1854
35821,RM-B109,8/13/2014,927,0,927,0,0,0,1854
41800,RM-B230,1/26/2014,0,1716,138,0,0,0,1854
13722,RM-1133,2/17/2014,0,1728,123,0,0,0,1851
39739,RM-B222,1/26/2014,135,0,0,1716,0,0,1851
47753,RM-B275,1/26/2014,0,1716,0,0,0,135,1851
31144,RM-1230,4/10/2014,0,1848,0,0,0,0,1848
30520,RM-1229,5/8/2014,0,0,978,864,0,0,1842
22870,RM-1207,1/10/2014,918,0,0,0,0,918,1836
35057,RM-B103A,1/10/2014,918,0,0,0,0,918,1836
35705,RM-B109,4/19/2014,918,0,918,0,0,0,1836
37073,RM-B200C,4/19/2014,918,0,918,0,0,0,1836
41883,RM-B230,4/19/2014,918,0,918,0,0,0,1836
24928,RM-1212,1/10/2014,918,0,915,0,0,0,1833
28344,RM-1221,1/10/2014,0,0,915,0,0,918,1833
30402,RM-1229,1/10/2014,0,0,915,0,0,918,1833
35728,RM-B109,5/12/2014,915,0,918,0,0,0,1833
36974,RM-B200C,1/10/2014,918,0,915,0,0,0,1833
37096,RM-B200C,5/12/2014,915,0,918,0,0,0,1833
38350,RM-B215,1/10/2014,0,0,915,0,0,918,1833
41906,RM-B230,5/12/2014,915,0,918,0,0,0,1833
3416,RM-1107,8/3/2013,0,0,1830,0,0,0,1830
6157,RM-1113,8/3/2013,0,0,1830,0,0,0,1830
8876,RM-1122,8/3/2013,0,0,1830,0,0,0,1830
13536,RM-1133,8/3/2013,0,0,1830,0,0,0,1830
20721,RM-1200B,8/3/2013,0,0,0,0,0,1830,1830
25450,RM-1213,8/3/2013,0,0,1830,0,0,0,1830
33693,RM-B102C,8/3/2013,0,0,1830,0,0,0,1830
35178,RM-B103A,5/11/2014,942,0,0,888,0,0,1830
37514,RM-B210,8/3/2013,0,0,1830,0,0,0,1830
46921,RM-B270,8/3/2013,0,0,1830,0,0,0,1830
47589,RM-B275,8/3/2013,0,0,1830,0,0,0,1830
2731,RM-1106,8/3/2013,1827,0,0,0,0,0,1827
12164,RM-1130,8/3/2013,0,0,0,0,0,1827,1827
15328,RM-1144,8/3/2013,0,0,0,0,0,1827,1827
18040,RM-1154,8/3/2013,1827,0,0,0,0,0,1827
26135,RM-1213A,8/3/2013,0,0,0,0,0,1827,1827
28196,RM-1221,8/3/2013,0,0,0,0,0,1827,1827
31591,RM-1231,8/3/2013,0,0,0,0,0,1827,1827
34909,RM-B103A,8/3/2013,0,0,0,0,0,1827,1827
40951,RM-B225,8/3/2013,0,0,0,0,0,1827,1827
42321,RM-B230A,8/3/2013,0,0,0,0,0,1827,1827
43572,RM-B240A,8/3/2013,0,0,0,0,0,1827,1827
32547,RM-1236,5/8/2014,0,846,978,0,0,0,1824
2896,RM-1106,1/27/2014,0,0,0,1680,0,138,1818
9726,RM-1123,1/27/2014,0,1680,138,0,0,0,1818
13701,RM-1133,1/27/2014,0,1680,138,0,0,0,1818
26985,RM-1217,1/27/2014,138,0,0,1680,0,0,1818
45097,RM-B250A,4/2/2014,1062,0,0,756,0,0,1818
8979,RM-1122,11/26/2013,0,0,771,0,0,1044,1815
13016,RM-1132,1/27/2014,0,0,135,1680,0,0,1815
24452,RM-1208B,8/7/2014,906,0,906,0,0,0,1812
35815,RM-B109,8/7/2014,906,0,906,0,0,0,1812
32638,RM-1236,8/7/2014,906,0,903,0,0,0,1809
6650,RM-1113,12/23/2014,903,0,903,0,0,0,1806
9828,RM-1123,5/9/2014,0,1806,0,0,0,0,1806
24260,RM-1208B,1/27/2014,0,0,138,1668,0,0,1806
35623,RM-B109,1/27/2014,0,1668,138,0,0,0,1806
35951,RM-B109,12/23/2014,903,0,903,0,0,0,1806
39740,RM-B222,1/27/2014,138,0,0,1668,0,0,1806
41801,RM-B230,1/27/2014,0,1668,138,0,0,0,1806
47754,RM-B275,1/27/2014,0,1668,0,0,0,138,1806
9750,RM-1123,2/20/2014,0,1728,75,0,0,0,1803
9832,RM-1123,5/13/2014,0,1800,0,0,0,0,1800
25020,RM-1212,4/12/2014,900,0,900,0,0,0,1800
27088,RM-1217,5/10/2014,960,840,0,0,0,0,1800
37066,RM-B200C,4/12/2014,900,0,900,0,0,0,1800
41876,RM-B230,4/12/2014,900,0,900,0,0,0,1800
281,RM-1100A,4/18/2014,963,834,0,0,0,0,1797
9834,RM-1123,5/15/2014,0,1794,0,0,0,0,1794
12173,RM-1130,8/12/2013,0,0,0,0,0,1791,1791
15337,RM-1144,8/12/2013,0,0,0,0,0,1791,1791
18049,RM-1154,8/12/2013,1791,0,0,0,0,0,1791
20730,RM-1200B,8/12/2013,0,0,0,0,0,1791,1791
26144,RM-1213A,8/12/2013,0,0,0,0,0,1791,1791
26829,RM-1217,8/12/2013,1791,0,0,0,0,0,1791
31600,RM-1231,8/12/2013,0,0,0,0,0,1791,1791
34918,RM-B103A,8/12/2013,0,0,0,0,0,1791,1791
35177,RM-B103A,5/10/2014,963,0,0,828,0,0,1791
40960,RM-B225,8/12/2013,0,0,0,0,0,1791,1791
42330,RM-B230A,8/12/2013,0,0,0,0,0,1791,1791
43581,RM-B240A,8/12/2013,0,0,0,0,0,1791,1791
3425,RM-1107,8/12/2013,0,0,1788,0,0,0,1788
6166,RM-1113,8/12/2013,0,0,1788,0,0,0,1788
6631,RM-1113,12/4/2014,894,0,894,0,0,0,1788
6632,RM-1113,12/5/2014,894,0,894,0,0,0,1788
6633,RM-1113,12/6/2014,894,0,894,0,0,0,1788
6634,RM-1113,12/7/2014,894,0,894,0,0,0,1788
6652,RM-1113,12/25/2014,894,0,894,0,0,0,1788
6683,RM-1113,1/25/2015,894,0,894,0,0,0,1788
8885,RM-1122,8/12/2013,0,0,1788,0,0,0,1788
9570,RM-1123,8/12/2013,0,0,1788,0,0,0,1788
13545,RM-1133,8/12/2013,0,0,1788,0,0,0,1788
24454,RM-1208B,8/9/2014,894,0,894,0,0,0,1788
24455,RM-1208B,8/10/2014,894,0,894,0,0,0,1788
24456,RM-1208B,8/11/2014,894,0,894,0,0,0,1788
25459,RM-1213,8/12/2013,0,0,1788,0,0,0,1788
29407,RM-1223,1/25/2015,894,0,894,0,0,0,1788
32640,RM-1236,8/9/2014,894,0,894,0,0,0,1788
32641,RM-1236,8/10/2014,894,0,894,0,0,0,1788
32642,RM-1236,8/11/2014,894,0,894,0,0,0,1788
33702,RM-B102C,8/12/2013,0,0,1788,0,0,0,1788
35817,RM-B109,8/9/2014,894,0,894,0,0,0,1788
35818,RM-B109,8/10/2014,894,0,894,0,0,0,1788
35819,RM-B109,8/11/2014,894,0,894,0,0,0,1788
35932,RM-B109,12/4/2014,894,0,894,0,0,0,1788
35933,RM-B109,12/5/2014,894,0,894,0,0,0,1788
35934,RM-B109,12/6/2014,894,0,894,0,0,0,1788
35935,RM-B109,12/7/2014,894,0,894,0,0,0,1788
35953,RM-B109,12/25/2014,894,0,894,0,0,0,1788
35984,RM-B109,1/25/2015,894,0,894,0,0,0,1788
37091,RM-B200C,5/7/2014,891,0,897,0,0,0,1788
46025,RM-B260,12/4/2014,894,0,894,0,0,0,1788
46026,RM-B260,12/5/2014,894,0,894,0,0,0,1788
46027,RM-B260,12/6/2014,894,0,894,0,0,0,1788
46028,RM-B260,12/7/2014,894,0,894,0,0,0,1788
46930,RM-B270,8/12/2013,0,0,1788,0,0,0,1788
35706,RM-B109,4/20/2014,891,0,894,0,0,0,1785
35723,RM-B109,5/7/2014,888,0,897,0,0,0,1785
37074,RM-B200C,4/20/2014,891,0,894,0,0,0,1785
41884,RM-B230,4/20/2014,891,0,894,0,0,0,1785
41901,RM-B230,5/7/2014,888,0,897,0,0,0,1785
6628,RM-1113,12/1/2014,891,0,891,0,0,0,1782
6635,RM-1113,12/8/2014,891,0,891,0,0,0,1782
6653,RM-1113,12/26/2014,891,0,891,0,0,0,1782
6669,RM-1113,1/11/2015,891,0,891,0,0,0,1782
24443,RM-1208B,7/29/2014,891,0,891,0,0,0,1782
24450,RM-1208B,8/5/2014,891,0,891,0,0,0,1782
24457,RM-1208B,8/12/2014,891,0,891,0,0,0,1782
29393,RM-1223,1/11/2015,891,0,891,0,0,0,1782
32636,RM-1236,8/5/2014,891,0,891,0,0,0,1782
32643,RM-1236,8/12/2014,891,0,891,0,0,0,1782
35806,RM-B109,7/29/2014,891,0,891,0,0,0,1782
35813,RM-B109,8/5/2014,891,0,891,0,0,0,1782
35820,RM-B109,8/12/2014,891,0,891,0,0,0,1782
35929,RM-B109,12/1/2014,891,0,891,0,0,0,1782
35936,RM-B109,12/8/2014,891,0,891,0,0,0,1782
35954,RM-B109,12/26/2014,891,0,891,0,0,0,1782
35970,RM-B109,1/11/2015,891,0,891,0,0,0,1782
46022,RM-B260,12/1/2014,891,0,891,0,0,0,1782
46029,RM-B260,12/8/2014,891,0,891,0,0,0,1782
3448,RM-1107,9/13/2013,0,0,1779,0,0,0,1779
6189,RM-1113,9/13/2013,0,0,1779,0,0,0,1779
8908,RM-1122,9/13/2013,0,0,1779,0,0,0,1779
9593,RM-1123,9/13/2013,0,0,1779,0,0,0,1779
13568,RM-1133,9/13/2013,0,0,1779,0,0,0,1779
25482,RM-1213,9/13/2013,0,0,1779,0,0,0,1779
30521,RM-1229,5/9/2014,0,0,981,798,0,0,1779
46953,RM-B270,9/13/2013,0,0,1779,0,0,0,1779
2732,RM-1106,8/4/2013,1776,0,0,0,0,0,1776
6623,RM-1113,11/26/2014,888,0,888,0,0,0,1776
6646,RM-1113,12/19/2014,888,0,888,0,0,0,1776
6655,RM-1113,12/28/2014,888,0,888,0,0,0,1776
6688,RM-1113,1/30/2015,888,0,888,0,0,0,1776
12165,RM-1130,8/4/2013,0,0,0,0,0,1776,1776
12196,RM-1130,9/13/2013,0,0,0,0,0,1776,1776
15329,RM-1144,8/4/2013,0,0,0,0,0,1776,1776
15360,RM-1144,9/13/2013,0,0,0,0,0,1776,1776
18041,RM-1154,8/4/2013,1776,0,0,0,0,0,1776
20753,RM-1200B,9/13/2013,0,0,0,0,0,1776,1776
24453,RM-1208B,8/8/2014,888,0,888,0,0,0,1776
26136,RM-1213A,8/4/2013,0,0,0,0,0,1776,1776
26852,RM-1217,9/13/2013,1776,0,0,0,0,0,1776
27087,RM-1217,5/9/2014,978,798,0,0,0,0,1776
28197,RM-1221,8/4/2013,0,0,0,0,0,1776,1776
29379,RM-1223,12/28/2014,888,0,888,0,0,0,1776
29412,RM-1223,1/30/2015,888,0,888,0,0,0,1776
31592,RM-1231,8/4/2013,0,0,0,0,0,1776,1776
31623,RM-1231,9/13/2013,0,0,0,0,0,1776,1776
32639,RM-1236,8/8/2014,888,0,888,0,0,0,1776
34910,RM-B103A,8/4/2013,0,0,0,0,0,1776,1776
34941,RM-B103A,9/13/2013,0,0,0,0,0,1776,1776
35816,RM-B109,8/8/2014,888,0,888,0,0,0,1776
35924,RM-B109,11/26/2014,888,0,888,0,0,0,1776
35956,RM-B109,12/28/2014,888,0,888,0,0,0,1776
35989,RM-B109,1/30/2015,888,0,888,0,0,0,1776
36177,RM-B200B,9/13/2013,0,0,0,0,0,1776,1776
40295,RM-B224,9/13/2013,0,0,0,0,0,1776,1776
40952,RM-B225,8/4/2013,0,0,0,0,0,1776,1776
40983,RM-B225,9/13/2013,0,0,0,0,0,1776,1776
42322,RM-B230A,8/4/2013,0,0,0,0,0,1776,1776
42353,RM-B230A,9/13/2013,0,0,0,0,0,1776,1776
43573,RM-B240A,8/4/2013,0,0,0,0,0,1776,1776
43604,RM-B240A,9/13/2013,0,0,0,0,0,1776,1776
44214,RM-B250,9/13/2013,1776,0,0,0,0,0,1776
46017,RM-B260,11/26/2014,888,0,888,0,0,0,1776
3417,RM-1107,8/4/2013,0,0,1773,0,0,0,1773
6158,RM-1113,8/4/2013,0,0,1773,0,0,0,1773
6201,RM-1113,9/25/2013,504,0,1269,0,0,0,1773
8877,RM-1122,8/4/2013,0,0,1773,0,0,0,1773
13537,RM-1133,8/4/2013,0,0,1773,0,0,0,1773
20722,RM-1200B,8/4/2013,0,0,0,0,0,1773,1773
25451,RM-1213,8/4/2013,0,0,1773,0,0,0,1773
33694,RM-B102C,8/4/2013,0,0,1773,0,0,0,1773
37515,RM-B210,8/4/2013,0,0,1773,0,0,0,1773
46922,RM-B270,8/4/2013,0,0,1773,0,0,0,1773
47590,RM-B275,8/4/2013,0,0,1773,0,0,0,1773
6624,RM-1113,11/27/2014,885,0,885,0,0,0,1770
6629,RM-1113,12/2/2014,885,0,885,0,0,0,1770
6647,RM-1113,12/20/2014,885,0,885,0,0,0,1770
6651,RM-1113,12/24/2014,885,0,885,0,0,0,1770
6657,RM-1113,12/30/2014,885,0,885,0,0,0,1770
24459,RM-1208B,8/14/2014,885,0,885,0,0,0,1770
29381,RM-1223,12/30/2014,885,0,885,0,0,0,1770
32645,RM-1236,8/14/2014,885,0,885,0,0,0,1770
35721,RM-B109,5/5/2014,885,0,885,0,0,0,1770
35822,RM-B109,8/14/2014,885,0,885,0,0,0,1770
35925,RM-B109,11/27/2014,885,0,885,0,0,0,1770
35930,RM-B109,12/2/2014,885,0,885,0,0,0,1770
35946,RM-B109,12/18/2014,885,0,885,0,0,0,1770
35947,RM-B109,12/19/2014,885,0,885,0,0,0,1770
35948,RM-B109,12/20/2014,885,0,885,0,0,0,1770
35952,RM-B109,12/24/2014,885,0,885,0,0,0,1770
35958,RM-B109,12/30/2014,885,0,885,0,0,0,1770
35988,RM-B109,1/29/2015,885,0,885,0,0,0,1770
41899,RM-B230,5/5/2014,885,0,885,0,0,0,1770
46018,RM-B260,11/27/2014,885,0,885,0,0,0,1770
46023,RM-B260,12/2/2014,885,0,885,0,0,0,1770
12197,RM-1130,9/14/2013,0,0,0,0,0,1767,1767
15361,RM-1144,9/14/2013,0,0,0,0,0,1767,1767
26853,RM-1217,9/14/2013,1767,0,0,0,0,0,1767
31624,RM-1231,9/14/2013,0,0,0,0,0,1767,1767
34942,RM-B103A,9/14/2013,0,0,0,0,0,1767,1767
35175,RM-B103A,5/8/2014,981,0,0,786,0,0,1767
36178,RM-B200B,9/14/2013,0,0,0,0,0,1767,1767
37089,RM-B200C,5/5/2014,885,0,882,0,0,0,1767
40296,RM-B224,9/14/2013,0,0,0,0,0,1767,1767
40984,RM-B225,9/14/2013,0,0,0,0,0,1767,1767
42354,RM-B230A,9/14/2013,0,0,0,0,0,1767,1767
43605,RM-B240A,9/14/2013,0,0,0,0,0,1767,1767
44215,RM-B250,9/14/2013,1767,0,0,0,0,0,1767
3449,RM-1107,9/14/2013,0,0,1764,0,0,0,1764
6190,RM-1113,9/14/2013,0,0,1764,0,0,0,1764
6627,RM-1113,11/30/2014,882,0,882,0,0,0,1764
6644,RM-1113,12/17/2014,882,0,882,0,0,0,1764
6645,RM-1113,12/18/2014,882,0,882,0,0,0,1764
6654,RM-1113,12/27/2014,882,0,882,0,0,0,1764
6658,RM-1113,12/31/2014,882,0,882,0,0,0,1764
6684,RM-1113,1/26/2015,882,0,882,0,0,0,1764
6687,RM-1113,1/29/2015,882,0,882,0,0,0,1764
8909,RM-1122,9/14/2013,0,0,1764,0,0,0,1764
9594,RM-1123,9/14/2013,0,0,1764,0,0,0,1764
13569,RM-1133,9/14/2013,0,0,1764,0,0,0,1764
20754,RM-1200B,9/14/2013,0,0,0,0,0,1764,1764
29378,RM-1223,12/27/2014,882,0,882,0,0,0,1764
29382,RM-1223,12/31/2014,882,0,882,0,0,0,1764
29408,RM-1223,1/26/2015,882,0,882,0,0,0,1764
29411,RM-1223,1/29/2015,882,0,882,0,0,0,1764
35928,RM-B109,11/30/2014,882,0,882,0,0,0,1764
35945,RM-B109,12/17/2014,882,0,882,0,0,0,1764
35955,RM-B109,12/27/2014,882,0,882,0,0,0,1764
35959,RM-B109,12/31/2014,882,0,882,0,0,0,1764
35985,RM-B109,1/26/2015,882,0,882,0,0,0,1764
46021,RM-B260,11/30/2014,882,0,882,0,0,0,1764
46954,RM-B270,9/14/2013,0,0,1764,0,0,0,1764
6637,RM-1113,12/10/2014,879,0,879,0,0,0,1758
6662,RM-1113,1/4/2015,879,0,879,0,0,0,1758
6670,RM-1113,1/12/2015,879,0,879,0,0,0,1758
6671,RM-1113,1/13/2015,879,0,879,0,0,0,1758
6672,RM-1113,1/14/2015,879,0,879,0,0,0,1758
29386,RM-1223,1/4/2015,879,0,879,0,0,0,1758
29394,RM-1223,1/12/2015,879,0,879,0,0,0,1758
29395,RM-1223,1/13/2015,879,0,879,0,0,0,1758
29396,RM-1223,1/14/2015,879,0,879,0,0,0,1758
29418,RM-1223,2/5/2015,879,0,879,0,0,0,1758
35176,RM-B103A,5/9/2014,978,0,0,780,0,0,1758
35938,RM-B109,12/10/2014,879,0,879,0,0,0,1758
35963,RM-B109,1/4/2015,879,0,879,0,0,0,1758
35971,RM-B109,1/12/2015,879,0,879,0,0,0,1758
35972,RM-B109,1/13/2015,879,0,879,0,0,0,1758
35973,RM-B109,1/14/2015,879,0,879,0,0,0,1758
35995,RM-B109,2/5/2015,879,0,879,0,0,0,1758
46031,RM-B260,12/10/2014,879,0,879,0,0,0,1758
39817,RM-B222,4/14/2014,1047,0,0,708,0,0,1755
4307,RM-1108,3/10/2014,0,1716,0,0,0,36,1752
6641,RM-1113,12/14/2014,876,0,876,0,0,0,1752
6642,RM-1113,12/15/2014,876,0,876,0,0,0,1752
6648,RM-1113,12/21/2014,876,0,876,0,0,0,1752
6656,RM-1113,12/29/2014,876,0,876,0,0,0,1752
6660,RM-1113,1/2/2015,876,0,876,0,0,0,1752
6661,RM-1113,1/3/2015,876,0,876,0,0,0,1752
6681,RM-1113,1/23/2015,876,0,876,0,0,0,1752
6682,RM-1113,1/24/2015,876,0,876,0,0,0,1752
29380,RM-1223,12/29/2014,876,0,876,0,0,0,1752
29384,RM-1223,1/2/2015,876,0,876,0,0,0,1752
29385,RM-1223,1/3/2015,876,0,876,0,0,0,1752
29405,RM-1223,1/23/2015,876,0,876,0,0,0,1752
29406,RM-1223,1/24/2015,876,0,876,0,0,0,1752
35942,RM-B109,12/14/2014,876,0,876,0,0,0,1752
35943,RM-B109,12/15/2014,876,0,876,0,0,0,1752
35949,RM-B109,12/21/2014,876,0,876,0,0,0,1752
35957,RM-B109,12/29/2014,876,0,876,0,0,0,1752
35961,RM-B109,1/2/2015,876,0,876,0,0,0,1752
35962,RM-B109,1/3/2015,876,0,876,0,0,0,1752
35982,RM-B109,1/23/2015,876,0,876,0,0,0,1752
35983,RM-B109,1/24/2015,876,0,876,0,0,0,1752
46035,RM-B260,12/14/2014,876,0,876,0,0,0,1752
24930,RM-1212,1/12/2014,873,0,876,0,0,0,1749
28346,RM-1221,1/12/2014,0,0,876,0,0,873,1749
30404,RM-1229,1/12/2014,0,0,876,0,0,873,1749
32548,RM-1236,5/9/2014,0,768,981,0,0,0,1749
36976,RM-B200C,1/12/2014,873,0,876,0,0,0,1749
38352,RM-B215,1/12/2014,0,0,876,0,0,873,1749
6640,RM-1113,12/13/2014,873,0,873,0,0,0,1746
6673,RM-1113,1/15/2015,873,0,873,0,0,0,1746
6676,RM-1113,1/18/2015,873,0,873,0,0,0,1746
6679,RM-1113,1/21/2015,873,0,873,0,0,0,1746
22872,RM-1207,1/12/2014,873,0,0,0,0,873,1746
29397,RM-1223,1/15/2015,873,0,873,0,0,0,1746
29400,RM-1223,1/18/2015,873,0,873,0,0,0,1746
29403,RM-1223,1/21/2015,873,0,873,0,0,0,1746
30522,RM-1229,5/10/2014,0,0,960,786,0,0,1746
30523,RM-1229,5/11/2014,0,0,942,804,0,0,1746
35059,RM-B103A,1/12/2014,873,0,0,0,0,873,1746
35941,RM-B109,12/13/2014,873,0,873,0,0,0,1746
35974,RM-B109,1/15/2015,873,0,873,0,0,0,1746
35977,RM-B109,1/18/2015,873,0,873,0,0,0,1746
35980,RM-B109,1/21/2015,873,0,873,0,0,0,1746
46034,RM-B260,12/13/2014,873,0,873,0,0,0,1746
35179,RM-B103A,5/12/2014,915,0,0,828,0,0,1743
35731,RM-B109,5/15/2014,873,0,870,0,0,0,1743
37099,RM-B200C,5/15/2014,873,0,870,0,0,0,1743
41909,RM-B230,5/15/2014,873,0,870,0,0,0,1743
6630,RM-1113,12/3/2014,870,0,870,0,0,0,1740
6638,RM-1113,12/11/2014,870,0,870,0,0,0,1740
6639,RM-1113,12/12/2014,870,0,870,0,0,0,1740
6667,RM-1113,1/9/2015,870,0,870,0,0,0,1740
6675,RM-1113,1/17/2015,870,0,870,0,0,0,1740
6680,RM-1113,1/22/2015,870,0,870,0,0,0,1740
24447,RM-1208B,8/2/2014,870,0,870,0,0,0,1740
24451,RM-1208B,8/6/2014,870,0,870,0,0,0,1740
29399,RM-1223,1/17/2015,870,0,870,0,0,0,1740
29404,RM-1223,1/22/2015,870,0,870,0,0,0,1740
32633,RM-1236,8/2/2014,870,0,870,0,0,0,1740
32637,RM-1236,8/6/2014,870,0,870,0,0,0,1740
35810,RM-B109,8/2/2014,870,0,870,0,0,0,1740
35814,RM-B109,8/6/2014,870,0,870,0,0,0,1740
35931,RM-B109,12/3/2014,870,0,870,0,0,0,1740
35939,RM-B109,12/11/2014,870,0,870,0,0,0,1740
35940,RM-B109,12/12/2014,870,0,870,0,0,0,1740
35968,RM-B109,1/9/2015,870,0,870,0,0,0,1740
35976,RM-B109,1/17/2015,870,0,870,0,0,0,1740
35981,RM-B109,1/22/2015,870,0,870,0,0,0,1740
46024,RM-B260,12/3/2014,870,0,870,0,0,0,1740
46032,RM-B260,12/11/2014,870,0,870,0,0,0,1740
46033,RM-B260,12/12/2014,870,0,870,0,0,0,1740
24321,RM-1208B,3/29/2014,3,0,6,1728,0,0,1737
35615,RM-B109,1/19/2014,0,1728,9,0,0,0,1737
6659,RM-1113,1/1/2015,867,0,867,0,0,0,1734
6663,RM-1113,1/5/2015,867,0,867,0,0,0,1734
6664,RM-1113,1/6/2015,867,0,867,0,0,0,1734
6665,RM-1113,1/7/2015,867,0,867,0,0,0,1734
6666,RM-1113,1/8/2015,867,0,867,0,0,0,1734
8417,RM-1117,3/29/2014,0,1728,6,0,0,0,1734
20028,RM-1156,5/3/2015,867,0,867,0,0,0,1734
24446,RM-1208B,8/1/2014,867,0,867,0,0,0,1734
24448,RM-1208B,8/3/2014,867,0,867,0,0,0,1734
27734,RM-1218,3/29/2014,0,0,6,1728,0,0,1734
29383,RM-1223,1/1/2015,867,0,867,0,0,0,1734
29387,RM-1223,1/5/2015,867,0,867,0,0,0,1734
29388,RM-1223,1/6/2015,867,0,867,0,0,0,1734
29389,RM-1223,1/7/2015,867,0,867,0,0,0,1734
29390,RM-1223,1/8/2015,867,0,867,0,0,0,1734
29391,RM-1223,1/9/2015,867,0,867,0,0,0,1734
29392,RM-1223,1/10/2015,867,0,867,0,0,0,1734
32634,RM-1236,8/3/2014,867,0,867,0,0,0,1734
35707,RM-B109,4/21/2014,867,0,867,0,0,0,1734
35809,RM-B109,8/1/2014,867,0,867,0,0,0,1734
35811,RM-B109,8/3/2014,867,0,867,0,0,0,1734
35960,RM-B109,1/1/2015,867,0,867,0,0,0,1734
35964,RM-B109,1/5/2015,867,0,867,0,0,0,1734
35965,RM-B109,1/6/2015,867,0,867,0,0,0,1734
35966,RM-B109,1/7/2015,867,0,867,0,0,0,1734
35967,RM-B109,1/8/2015,867,0,867,0,0,0,1734
36082,RM-B109,5/3/2015,867,0,867,0,0,0,1734
37075,RM-B200C,4/21/2014,867,0,867,0,0,0,1734
41885,RM-B230,4/21/2014,867,0,867,0,0,0,1734
44408,RM-B250,3/29/2014,0,1728,6,0,0,0,1734
261,RM-1100A,3/29/2014,3,1728,0,0,0,0,1731
13077,RM-1132,3/29/2014,0,0,3,1728,0,0,1731
13124,RM-1132,5/15/2014,0,0,873,858,0,0,1731
17581,RM-1151,3/29/2014,3,0,0,1728,0,0,1731
27089,RM-1217,5/11/2014,945,786,0,0,0,0,1731
39801,RM-B222,3/29/2014,3,0,0,1728,0,0,1731
192,RM-1100A,1/19/2014,0,1728,0,0,0,0,1728
196,RM-1100A,1/23/2014,0,1728,0,0,0,0,1728
197,RM-1100A,1/24/2014,0,1728,0,0,0,0,1728
202,RM-1100A,1/29/2014,0,1728,0,0,0,0,1728
206,RM-1100A,2/2/2014,0,1728,0,0,0,0,1728
207,RM-1100A,2/3/2014,0,1728,0,0,0,0,1728
208,RM-1100A,2/4/2014,0,1728,0,0,0,0,1728
209,RM-1100A,2/5/2014,0,1728,0,0,0,0,1728
210,RM-1100A,2/6/2014,0,1728,0,0,0,0,1728
212,RM-1100A,2/8/2014,0,1728,0,0,0,0,1728
213,RM-1100A,2/9/2014,0,1728,0,0,0,0,1728
214,RM-1100A,2/10/2014,0,1728,0,0,0,0,1728
215,RM-1100A,2/11/2014,0,1728,0,0,0,0,1728
218,RM-1100A,2/14/2014,0,1728,0,0,0,0,1728
219,RM-1100A,2/15/2014,0,1728,0,0,0,0,1728
220,RM-1100A,2/16/2014,0,1728,0,0,0,0,1728
221,RM-1100A,2/17/2014,0,1728,0,0,0,0,1728
222,RM-1100A,2/18/2014,0,1728,0,0,0,0,1728
223,RM-1100A,2/19/2014,0,1728,0,0,0,0,1728
224,RM-1100A,2/20/2014,0,1728,0,0,0,0,1728
225,RM-1100A,2/21/2014,0,1728,0,0,0,0,1728
226,RM-1100A,2/22/2014,0,1728,0,0,0,0,1728
227,RM-1100A,2/23/2014,0,1728,0,0,0,0,1728
228,RM-1100A,2/24/2014,0,1728,0,0,0,0,1728
229,RM-1100A,2/25/2014,0,1728,0,0,0,0,1728
230,RM-1100A,2/26/2014,0,1728,0,0,0,0,1728
231,RM-1100A,2/27/2014,0,1728,0,0,0,0,1728
232,RM-1100A,2/28/2014,0,1728,0,0,0,0,1728
233,RM-1100A,3/1/2014,0,1728,0,0,0,0,1728
236,RM-1100A,3/4/2014,0,1728,0,0,0,0,1728
237,RM-1100A,3/5/2014,0,1728,0,0,0,0,1728
238,RM-1100A,3/6/2014,0,1728,0,0,0,0,1728
239,RM-1100A,3/7/2014,0,1728,0,0,0,0,1728
243,RM-1100A,3/11/2014,0,1728,0,0,0,0,1728
244,RM-1100A,3/12/2014,0,1728,0,0,0,0,1728
245,RM-1100A,3/13/2014,0,1728,0,0,0,0,1728
246,RM-1100A,3/14/2014,0,1728,0,0,0,0,1728
943,RM-1100D,3/26/2014,0,0,0,1728,0,0,1728
945,RM-1100D,3/28/2014,0,0,0,1728,0,0,1728
946,RM-1100D,3/29/2014,0,0,0,1728,0,0,1728
947,RM-1100D,3/30/2014,0,0,0,1728,0,0,1728
948,RM-1100D,3/31/2014,0,0,0,1728,0,0,1728
949,RM-1100D,4/1/2014,0,0,0,1728,0,0,1728
951,RM-1100D,4/3/2014,0,0,0,1728,0,0,1728
952,RM-1100D,4/4/2014,0,0,0,1728,0,0,1728
953,RM-1100D,4/5/2014,0,0,0,1728,0,0,1728
954,RM-1100D,4/6/2014,0,0,0,1728,0,0,1728
955,RM-1100D,4/7/2014,0,0,0,1728,0,0,1728
956,RM-1100D,4/8/2014,0,0,0,1728,0,0,1728
957,RM-1100D,4/9/2014,0,0,0,1728,0,0,1728
958,RM-1100D,4/10/2014,0,0,0,1728,0,0,1728
959,RM-1100D,4/11/2014,0,0,0,1728,0,0,1728
960,RM-1100D,4/12/2014,0,0,0,1728,0,0,1728
961,RM-1100D,4/13/2014,0,0,0,1728,0,0,1728
962,RM-1100D,4/14/2014,0,0,0,1728,0,0,1728
963,RM-1100D,4/15/2014,0,0,0,1728,0,0,1728
964,RM-1100D,4/16/2014,0,0,0,1728,0,0,1728
965,RM-1100D,4/17/2014,0,0,0,1728,0,0,1728
966,RM-1100D,4/18/2014,0,0,0,1728,0,0,1728
967,RM-1100D,4/19/2014,0,0,0,1728,0,0,1728
968,RM-1100D,4/20/2014,0,0,0,1728,0,0,1728
969,RM-1100D,4/21/2014,0,0,0,1728,0,0,1728
970,RM-1100D,4/22/2014,0,0,0,1728,0,0,1728
971,RM-1100D,4/23/2014,0,0,0,1728,0,0,1728
972,RM-1100D,4/24/2014,0,0,0,1728,0,0,1728
973,RM-1100D,4/25/2014,0,0,0,1728,0,0,1728
974,RM-1100D,4/26/2014,0,0,0,1728,0,0,1728
975,RM-1100D,4/27/2014,0,0,0,1728,0,0,1728
976,RM-1100D,4/28/2014,0,0,0,1728,0,0,1728
977,RM-1100D,4/29/2014,0,0,0,1728,0,0,1728
978,RM-1100D,4/30/2014,0,0,0,1728,0,0,1728
979,RM-1100D,5/1/2014,0,0,0,1728,0,0,1728
980,RM-1100D,5/2/2014,0,0,0,1728,0,0,1728
981,RM-1100D,5/3/2014,0,0,0,1728,0,0,1728
982,RM-1100D,5/4/2014,0,0,0,1728,0,0,1728
996,RM-1100D,5/18/2014,0,0,0,1728,0,0,1728
997,RM-1100D,5/19/2014,0,0,0,1728,0,0,1728
998,RM-1100D,5/20/2014,0,0,0,1728,0,0,1728
999,RM-1100D,5/21/2014,0,0,0,1728,0,0,1728
1000,RM-1100D,5/22/2014,0,0,0,1728,0,0,1728
1001,RM-1100D,5/23/2014,0,0,0,1728,0,0,1728
1002,RM-1100D,5/24/2014,0,0,0,1728,0,0,1728
1003,RM-1100D,5/25/2014,0,0,0,1728,0,0,1728
1004,RM-1100D,5/26/2014,0,0,0,1728,0,0,1728
1005,RM-1100D,5/27/2014,0,0,0,1728,0,0,1728
1006,RM-1100D,5/28/2014,0,0,0,1728,0,0,1728
1007,RM-1100D,5/29/2014,0,0,0,1728,0,0,1728
1008,RM-1100D,5/30/2014,0,0,0,1728,0,0,1728
1009,RM-1100D,5/31/2014,0,0,0,1728,0,0,1728
1010,RM-1100D,6/1/2014,0,0,0,1728,0,0,1728
1011,RM-1100D,6/2/2014,0,0,0,1728,0,0,1728
1012,RM-1100D,6/3/2014,0,0,0,1728,0,0,1728
1013,RM-1100D,6/4/2014,0,0,0,1728,0,0,1728
1015,RM-1100D,6/6/2014,0,0,0,1728,0,0,1728
1016,RM-1100D,6/7/2014,0,0,0,1728,0,0,1728
1017,RM-1100D,6/8/2014,0,0,0,1728,0,0,1728
1018,RM-1100D,6/9/2014,0,0,0,1728,0,0,1728
1019,RM-1100D,6/10/2014,0,0,0,1728,0,0,1728
1021,RM-1100D,6/12/2014,0,0,0,1728,0,0,1728
1022,RM-1100D,6/13/2014,0,0,0,1728,0,0,1728
1023,RM-1100D,6/14/2014,0,0,0,1728,0,0,1728
1024,RM-1100D,6/15/2014,0,0,0,1728,0,0,1728
1025,RM-1100D,6/16/2014,0,0,0,1728,0,0,1728
1026,RM-1100D,6/17/2014,0,0,0,1728,0,0,1728
1027,RM-1100D,6/18/2014,0,0,0,1728,0,0,1728
1028,RM-1100D,6/19/2014,0,0,0,1728,0,0,1728
1029,RM-1100D,6/20/2014,0,0,0,1728,0,0,1728
1030,RM-1100D,6/21/2014,0,0,0,1728,0,0,1728
1031,RM-1100D,6/22/2014,0,0,0,1728,0,0,1728
1032,RM-1100D,6/23/2014,0,0,0,1728,0,0,1728
1033,RM-1100D,6/24/2014,0,0,0,1728,0,0,1728
1034,RM-1100D,6/25/2014,0,0,0,1728,0,0,1728
1035,RM-1100D,6/26/2014,0,0,0,1728,0,0,1728
1036,RM-1100D,6/27/2014,0,0,0,1728,0,0,1728
1039,RM-1100D,6/30/2014,0,0,0,1728,0,0,1728
2245,RM-1104,1/17/2014,0,1728,0,0,0,0,1728
2247,RM-1104,1/19/2014,0,1728,0,0,0,0,1728
2251,RM-1104,1/23/2014,0,1728,0,0,0,0,1728
2252,RM-1104,1/24/2014,0,1728,0,0,0,0,1728
2257,RM-1104,1/29/2014,0,1728,0,0,0,0,1728
2261,RM-1104,2/2/2014,0,1728,0,0,0,0,1728
2262,RM-1104,2/3/2014,0,1728,0,0,0,0,1728
2263,RM-1104,2/4/2014,0,1728,0,0,0,0,1728
2264,RM-1104,2/5/2014,0,1728,0,0,0,0,1728
2265,RM-1104,2/6/2014,0,1728,0,0,0,0,1728
2267,RM-1104,2/8/2014,0,1728,0,0,0,0,1728
2268,RM-1104,2/9/2014,0,1728,0,0,0,0,1728
2269,RM-1104,2/10/2014,0,1728,0,0,0,0,1728
2270,RM-1104,2/11/2014,0,1728,0,0,0,0,1728
2273,RM-1104,2/14/2014,0,1728,0,0,0,0,1728
2274,RM-1104,2/15/2014,0,1728,0,0,0,0,1728
2275,RM-1104,2/16/2014,0,1728,0,0,0,0,1728
2276,RM-1104,2/17/2014,0,1728,0,0,0,0,1728
2277,RM-1104,2/18/2014,0,1728,0,0,0,0,1728
2278,RM-1104,2/19/2014,0,1728,0,0,0,0,1728
2279,RM-1104,2/20/2014,0,1728,0,0,0,0,1728
2280,RM-1104,2/21/2014,0,1728,0,0,0,0,1728
2281,RM-1104,2/22/2014,0,1728,0,0,0,0,1728
2282,RM-1104,2/23/2014,0,1728,0,0,0,0,1728
2283,RM-1104,2/24/2014,0,1728,0,0,0,0,1728
2284,RM-1104,2/25/2014,0,1728,0,0,0,0,1728
2285,RM-1104,2/26/2014,0,1728,0,0,0,0,1728
2286,RM-1104,2/27/2014,0,1728,0,0,0,0,1728
2287,RM-1104,2/28/2014,0,1728,0,0,0,0,1728
2288,RM-1104,3/1/2014,0,1728,0,0,0,0,1728
2291,RM-1104,3/4/2014,0,1728,0,0,0,0,1728
2292,RM-1104,3/5/2014,0,1728,0,0,0,0,1728
2293,RM-1104,3/6/2014,0,1728,0,0,0,0,1728
2294,RM-1104,3/7/2014,0,1728,0,0,0,0,1728
2298,RM-1104,3/11/2014,0,1728,0,0,0,0,1728
2299,RM-1104,3/12/2014,0,1728,0,0,0,0,1728
2300,RM-1104,3/13/2014,0,1728,0,0,0,0,1728
2301,RM-1104,3/14/2014,0,1728,0,0,0,0,1728
2302,RM-1104,3/15/2014,0,1728,0,0,0,0,1728
2303,RM-1104,3/16/2014,0,1728,0,0,0,0,1728
2304,RM-1104,3/17/2014,0,1728,0,0,0,0,1728
2305,RM-1104,3/18/2014,0,1728,0,0,0,0,1728
2306,RM-1104,3/19/2014,0,1728,0,0,0,0,1728
2307,RM-1104,3/20/2014,0,1728,0,0,0,0,1728
2308,RM-1104,3/21/2014,0,1728,0,0,0,0,1728
2309,RM-1104,3/22/2014,0,1728,0,0,0,0,1728
2310,RM-1104,3/23/2014,0,1728,0,0,0,0,1728
2311,RM-1104,3/24/2014,0,1728,0,0,0,0,1728
2312,RM-1104,3/25/2014,0,1728,0,0,0,0,1728
2313,RM-1104,3/26/2014,0,1728,0,0,0,0,1728
2315,RM-1104,3/28/2014,0,1728,0,0,0,0,1728
2316,RM-1104,3/29/2014,0,1728,0,0,0,0,1728
2317,RM-1104,3/30/2014,0,1728,0,0,0,0,1728
2318,RM-1104,3/31/2014,0,1728,0,0,0,0,1728
2319,RM-1104,4/1/2014,0,1728,0,0,0,0,1728
2321,RM-1104,4/3/2014,0,1728,0,0,0,0,1728
2322,RM-1104,4/4/2014,0,1728,0,0,0,0,1728
2323,RM-1104,4/5/2014,0,1728,0,0,0,0,1728
2324,RM-1104,4/6/2014,0,1728,0,0,0,0,1728
2325,RM-1104,4/7/2014,0,1728,0,0,0,0,1728
2326,RM-1104,4/8/2014,0,1728,0,0,0,0,1728
2327,RM-1104,4/9/2014,0,1728,0,0,0,0,1728
2328,RM-1104,4/10/2014,0,1728,0,0,0,0,1728
2329,RM-1104,4/11/2014,0,1728,0,0,0,0,1728
2330,RM-1104,4/12/2014,0,1728,0,0,0,0,1728
2331,RM-1104,4/13/2014,0,1728,0,0,0,0,1728
2332,RM-1104,4/14/2014,0,1728,0,0,0,0,1728
2333,RM-1104,4/15/2014,0,1728,0,0,0,0,1728
2334,RM-1104,4/16/2014,0,1728,0,0,0,0,1728
2335,RM-1104,4/17/2014,0,1728,0,0,0,0,1728
2336,RM-1104,4/18/2014,0,1728,0,0,0,0,1728
2337,RM-1104,4/19/2014,0,1728,0,0,0,0,1728
2338,RM-1104,4/20/2014,0,1728,0,0,0,0,1728
2339,RM-1104,4/21/2014,0,1728,0,0,0,0,1728
2340,RM-1104,4/22/2014,0,1728,0,0,0,0,1728
2341,RM-1104,4/23/2014,0,1728,0,0,0,0,1728
2342,RM-1104,4/24/2014,0,1728,0,0,0,0,1728
2343,RM-1104,4/25/2014,0,1728,0,0,0,0,1728
2344,RM-1104,4/26/2014,0,1728,0,0,0,0,1728
2345,RM-1104,4/27/2014,0,1728,0,0,0,0,1728
2346,RM-1104,4/28/2014,0,1728,0,0,0,0,1728
2347,RM-1104,4/29/2014,0,1728,0,0,0,0,1728
2348,RM-1104,4/30/2014,0,1728,0,0,0,0,1728
2349,RM-1104,5/1/2014,0,1728,0,0,0,0,1728
2350,RM-1104,5/2/2014,0,1728,0,0,0,0,1728
2351,RM-1104,5/3/2014,0,1728,0,0,0,0,1728
2352,RM-1104,5/4/2014,0,1728,0,0,0,0,1728
2366,RM-1104,5/18/2014,0,1728,0,0,0,0,1728
2367,RM-1104,5/19/2014,0,1728,0,0,0,0,1728
2368,RM-1104,5/20/2014,0,1728,0,0,0,0,1728
2369,RM-1104,5/21/2014,0,1728,0,0,0,0,1728
2370,RM-1104,5/22/2014,0,1728,0,0,0,0,1728
2371,RM-1104,5/23/2014,0,1728,0,0,0,0,1728
2372,RM-1104,5/24/2014,0,1728,0,0,0,0,1728
2373,RM-1104,5/25/2014,0,1728,0,0,0,0,1728
2957,RM-1106,3/29/2014,0,0,0,1728,0,0,1728
2958,RM-1106,3/30/2014,0,0,0,1728,0,0,1728
2959,RM-1106,3/31/2014,0,0,0,1728,0,0,1728
2960,RM-1106,4/1/2014,0,0,0,1728,0,0,1728
2962,RM-1106,4/3/2014,0,0,0,1728,0,0,1728
2963,RM-1106,4/4/2014,0,0,0,1728,0,0,1728
2964,RM-1106,4/5/2014,0,0,0,1728,0,0,1728
2965,RM-1106,4/6/2014,0,0,0,1728,0,0,1728
2966,RM-1106,4/7/2014,0,0,0,1728,0,0,1728
2967,RM-1106,4/8/2014,0,0,0,1728,0,0,1728
2968,RM-1106,4/9/2014,0,0,0,1728,0,0,1728
2969,RM-1106,4/10/2014,0,0,0,1728,0,0,1728
2970,RM-1106,4/11/2014,0,0,0,1728,0,0,1728
2971,RM-1106,4/12/2014,0,0,0,1728,0,0,1728
2972,RM-1106,4/13/2014,0,0,0,1728,0,0,1728
2973,RM-1106,4/14/2014,0,0,0,1728,0,0,1728
2974,RM-1106,4/15/2014,0,0,0,1728,0,0,1728
2975,RM-1106,4/16/2014,0,0,0,1728,0,0,1728
2976,RM-1106,4/17/2014,0,0,0,1728,0,0,1728
2977,RM-1106,4/18/2014,0,0,0,1728,0,0,1728
2978,RM-1106,4/19/2014,0,0,0,1728,0,0,1728
2979,RM-1106,4/20/2014,0,0,0,1728,0,0,1728
2980,RM-1106,4/21/2014,0,0,0,1728,0,0,1728
2981,RM-1106,4/22/2014,0,0,0,1728,0,0,1728
2982,RM-1106,4/23/2014,0,0,0,1728,0,0,1728
2983,RM-1106,4/24/2014,0,0,0,1728,0,0,1728
2984,RM-1106,4/25/2014,0,0,0,1728,0,0,1728
2985,RM-1106,4/26/2014,0,0,0,1728,0,0,1728
2986,RM-1106,4/27/2014,0,0,0,1728,0,0,1728
2987,RM-1106,4/28/2014,0,0,0,1728,0,0,1728
2988,RM-1106,4/29/2014,0,0,0,1728,0,0,1728
2989,RM-1106,4/30/2014,0,0,0,1728,0,0,1728
2990,RM-1106,5/1/2014,0,0,0,1728,0,0,1728
2991,RM-1106,5/2/2014,0,0,0,1728,0,0,1728
2992,RM-1106,5/3/2014,0,0,0,1728,0,0,1728
2993,RM-1106,5/4/2014,0,0,0,1728,0,0,1728
3007,RM-1106,5/18/2014,0,0,0,1728,0,0,1728
3008,RM-1106,5/19/2014,0,0,0,1728,0,0,1728
3009,RM-1106,5/20/2014,0,0,0,1728,0,0,1728
3010,RM-1106,5/21/2014,0,0,0,1728,0,0,1728
3011,RM-1106,5/22/2014,0,0,0,1728,0,0,1728
3012,RM-1106,5/23/2014,0,0,0,1728,0,0,1728
3013,RM-1106,5/24/2014,0,0,0,1728,0,0,1728
3014,RM-1106,5/25/2014,0,0,0,1728,0,0,1728
3015,RM-1106,5/26/2014,0,0,0,1728,0,0,1728
3016,RM-1106,5/27/2014,0,0,0,1728,0,0,1728
3017,RM-1106,5/28/2014,0,0,0,1728,0,0,1728
3018,RM-1106,5/29/2014,0,0,0,1728,0,0,1728
3019,RM-1106,5/30/2014,0,0,0,1728,0,0,1728
3020,RM-1106,5/31/2014,0,0,0,1728,0,0,1728
3021,RM-1106,6/1/2014,0,0,0,1728,0,0,1728
3022,RM-1106,6/2/2014,0,0,0,1728,0,0,1728
3023,RM-1106,6/3/2014,0,0,0,1728,0,0,1728
3024,RM-1106,6/4/2014,0,0,0,1728,0,0,1728
3025,RM-1106,6/5/2014,0,0,0,1728,0,0,1728
3026,RM-1106,6/6/2014,0,0,0,1728,0,0,1728
3027,RM-1106,6/7/2014,0,0,0,1728,0,0,1728
3028,RM-1106,6/8/2014,0,0,0,1728,0,0,1728
3029,RM-1106,6/9/2014,0,0,0,1728,0,0,1728
3030,RM-1106,6/10/2014,0,0,0,1728,0,0,1728
3032,RM-1106,6/12/2014,0,0,0,1728,0,0,1728
3033,RM-1106,6/13/2014,0,0,0,1728,0,0,1728
3034,RM-1106,6/14/2014,0,0,0,1728,0,0,1728
3035,RM-1106,6/15/2014,0,0,0,1728,0,0,1728
3036,RM-1106,6/16/2014,0,0,0,1728,0,0,1728
3037,RM-1106,6/17/2014,0,0,0,1728,0,0,1728
3038,RM-1106,6/18/2014,0,0,0,1728,0,0,1728
3039,RM-1106,6/19/2014,0,0,0,1728,0,0,1728
3040,RM-1106,6/20/2014,0,0,0,1728,0,0,1728
3041,RM-1106,6/21/2014,0,0,0,1728,0,0,1728
3042,RM-1106,6/22/2014,0,0,0,1728,0,0,1728
3043,RM-1106,6/23/2014,0,0,0,1728,0,0,1728
3044,RM-1106,6/24/2014,0,0,0,1728,0,0,1728
3045,RM-1106,6/25/2014,0,0,0,1728,0,0,1728
3048,RM-1106,6/28/2014,0,0,0,1728,0,0,1728
3050,RM-1106,6/30/2014,0,0,0,1728,0,0,1728
3051,RM-1106,7/1/2014,0,0,0,1728,0,0,1728
4280,RM-1108,2/11/2014,0,1728,0,0,0,0,1728
4283,RM-1108,2/14/2014,0,1728,0,0,0,0,1728
4284,RM-1108,2/15/2014,0,1728,0,0,0,0,1728
4285,RM-1108,2/16/2014,0,1728,0,0,0,0,1728
4286,RM-1108,2/17/2014,0,1728,0,0,0,0,1728
4287,RM-1108,2/18/2014,0,1728,0,0,0,0,1728
4288,RM-1108,2/19/2014,0,1728,0,0,0,0,1728
4289,RM-1108,2/20/2014,0,1728,0,0,0,0,1728
4290,RM-1108,2/21/2014,0,1728,0,0,0,0,1728
4291,RM-1108,2/22/2014,0,1728,0,0,0,0,1728
4292,RM-1108,2/23/2014,0,1728,0,0,0,0,1728
4293,RM-1108,2/24/2014,0,1728,0,0,0,0,1728
4294,RM-1108,2/25/2014,0,1728,0,0,0,0,1728
4295,RM-1108,2/26/2014,0,1728,0,0,0,0,1728
4296,RM-1108,2/27/2014,0,1728,0,0,0,0,1728
4297,RM-1108,2/28/2014,0,1728,0,0,0,0,1728
4298,RM-1108,3/1/2014,0,1728,0,0,0,0,1728
4301,RM-1108,3/4/2014,0,1728,0,0,0,0,1728
4302,RM-1108,3/5/2014,0,1728,0,0,0,0,1728
4303,RM-1108,3/6/2014,0,1728,0,0,0,0,1728
4304,RM-1108,3/7/2014,0,1728,0,0,0,0,1728
4326,RM-1108,3/29/2014,0,1728,0,0,0,0,1728
4327,RM-1108,3/30/2014,0,1728,0,0,0,0,1728
4328,RM-1108,3/31/2014,0,1728,0,0,0,0,1728
4329,RM-1108,4/1/2014,0,1728,0,0,0,0,1728
4331,RM-1108,4/3/2014,0,1728,0,0,0,0,1728
4332,RM-1108,4/4/2014,0,1728,0,0,0,0,1728
4333,RM-1108,4/5/2014,0,1728,0,0,0,0,1728
4334,RM-1108,4/6/2014,0,1728,0,0,0,0,1728
4335,RM-1108,4/7/2014,0,1728,0,0,0,0,1728
4336,RM-1108,4/8/2014,0,1728,0,0,0,0,1728
4337,RM-1108,4/9/2014,0,1728,0,0,0,0,1728
4338,RM-1108,4/10/2014,0,1728,0,0,0,0,1728
4339,RM-1108,4/11/2014,0,1728,0,0,0,0,1728
4340,RM-1108,4/12/2014,0,1728,0,0,0,0,1728
4341,RM-1108,4/13/2014,0,1728,0,0,0,0,1728
4342,RM-1108,4/14/2014,0,1728,0,0,0,0,1728
4343,RM-1108,4/15/2014,0,1728,0,0,0,0,1728
4344,RM-1108,4/16/2014,0,1728,0,0,0,0,1728
4345,RM-1108,4/17/2014,0,1728,0,0,0,0,1728
4346,RM-1108,4/18/2014,0,1728,0,0,0,0,1728
4347,RM-1108,4/19/2014,0,1728,0,0,0,0,1728
4348,RM-1108,4/20/2014,0,1728,0,0,0,0,1728
4349,RM-1108,4/21/2014,0,1728,0,0,0,0,1728
4350,RM-1108,4/22/2014,0,1728,0,0,0,0,1728
4351,RM-1108,4/23/2014,0,1728,0,0,0,0,1728
4352,RM-1108,4/24/2014,0,1728,0,0,0,0,1728
4353,RM-1108,4/25/2014,0,1728,0,0,0,0,1728
4354,RM-1108,4/26/2014,0,1728,0,0,0,0,1728
4355,RM-1108,4/27/2014,0,1728,0,0,0,0,1728
4356,RM-1108,4/28/2014,0,1728,0,0,0,0,1728
4357,RM-1108,4/29/2014,0,1728,0,0,0,0,1728
4358,RM-1108,4/30/2014,0,1728,0,0,0,0,1728
4359,RM-1108,5/1/2014,0,1728,0,0,0,0,1728
4360,RM-1108,5/2/2014,0,1728,0,0,0,0,1728
4361,RM-1108,5/3/2014,0,1728,0,0,0,0,1728
4362,RM-1108,5/4/2014,0,1728,0,0,0,0,1728
4376,RM-1108,5/18/2014,0,1728,0,0,0,0,1728
4377,RM-1108,5/19/2014,0,1728,0,0,0,0,1728
4378,RM-1108,5/20/2014,0,1728,0,0,0,0,1728
4379,RM-1108,5/21/2014,0,1728,0,0,0,0,1728
4380,RM-1108,5/22/2014,0,1728,0,0,0,0,1728
4381,RM-1108,5/23/2014,0,1728,0,0,0,0,1728
4382,RM-1108,5/24/2014,0,1728,0,0,0,0,1728
4383,RM-1108,5/25/2014,0,1728,0,0,0,0,1728
4384,RM-1108,5/26/2014,0,1728,0,0,0,0,1728
4385,RM-1108,5/27/2014,0,1728,0,0,0,0,1728
4386,RM-1108,5/28/2014,0,1728,0,0,0,0,1728
4387,RM-1108,5/29/2014,0,1728,0,0,0,0,1728
4388,RM-1108,5/30/2014,0,1728,0,0,0,0,1728
4389,RM-1108,5/31/2014,0,1728,0,0,0,0,1728
4390,RM-1108,6/1/2014,0,1728,0,0,0,0,1728
4391,RM-1108,6/2/2014,0,1728,0,0,0,0,1728
4392,RM-1108,6/3/2014,0,1728,0,0,0,0,1728
4393,RM-1108,6/4/2014,0,1728,0,0,0,0,1728
4394,RM-1108,6/5/2014,0,1728,0,0,0,0,1728
4395,RM-1108,6/6/2014,0,1728,0,0,0,0,1728
4396,RM-1108,6/7/2014,0,1728,0,0,0,0,1728
4397,RM-1108,6/8/2014,0,1728,0,0,0,0,1728
4398,RM-1108,6/9/2014,0,1728,0,0,0,0,1728
4399,RM-1108,6/10/2014,0,1728,0,0,0,0,1728
4401,RM-1108,6/12/2014,0,1728,0,0,0,0,1728
4402,RM-1108,6/13/2014,0,1728,0,0,0,0,1728
4403,RM-1108,6/14/2014,0,1728,0,0,0,0,1728
4404,RM-1108,6/15/2014,0,1728,0,0,0,0,1728
4405,RM-1108,6/16/2014,0,1728,0,0,0,0,1728
4406,RM-1108,6/17/2014,0,1728,0,0,0,0,1728
4407,RM-1108,6/18/2014,0,1728,0,0,0,0,1728
4408,RM-1108,6/19/2014,0,1728,0,0,0,0,1728
4409,RM-1108,6/20/2014,0,1728,0,0,0,0,1728
4410,RM-1108,6/21/2014,0,1728,0,0,0,0,1728
4411,RM-1108,6/22/2014,0,1728,0,0,0,0,1728
4412,RM-1108,6/23/2014,0,1728,0,0,0,0,1728
4413,RM-1108,6/24/2014,0,1728,0,0,0,0,1728
4414,RM-1108,6/25/2014,0,1728,0,0,0,0,1728
4415,RM-1108,6/26/2014,0,1728,0,0,0,0,1728
4416,RM-1108,6/27/2014,0,1728,0,0,0,0,1728
4417,RM-1108,6/28/2014,0,1728,0,0,0,0,1728
4419,RM-1108,6/30/2014,0,1728,0,0,0,0,1728
4420,RM-1108,7/1/2014,0,1728,0,0,0,0,1728
6625,RM-1113,11/28/2014,864,0,864,0,0,0,1728
6626,RM-1113,11/29/2014,864,0,864,0,0,0,1728
6668,RM-1113,1/10/2015,864,0,864,0,0,0,1728
8449,RM-1117,4/30/2014,0,1728,0,0,0,0,1728
8450,RM-1117,5/1/2014,0,1728,0,0,0,0,1728
8451,RM-1117,5/2/2014,0,1728,0,0,0,0,1728
8452,RM-1117,5/3/2014,0,1728,0,0,0,0,1728
8453,RM-1117,5/4/2014,0,1728,0,0,0,0,1728
8467,RM-1117,5/18/2014,0,1728,0,0,0,0,1728
8468,RM-1117,5/19/2014,0,1728,0,0,0,0,1728
8469,RM-1117,5/20/2014,0,1728,0,0,0,0,1728
8470,RM-1117,5/21/2014,0,1728,0,0,0,0,1728
8471,RM-1117,5/22/2014,0,1728,0,0,0,0,1728
8472,RM-1117,5/23/2014,0,1728,0,0,0,0,1728
8473,RM-1117,5/24/2014,0,1728,0,0,0,0,1728
8474,RM-1117,5/25/2014,0,1728,0,0,0,0,1728
8475,RM-1117,5/26/2014,0,1728,0,0,0,0,1728
8476,RM-1117,5/27/2014,0,1728,0,0,0,0,1728
8477,RM-1117,5/28/2014,0,1728,0,0,0,0,1728
8478,RM-1117,5/29/2014,0,1728,0,0,0,0,1728
8479,RM-1117,5/30/2014,0,1728,0,0,0,0,1728
8480,RM-1117,5/31/2014,0,1728,0,0,0,0,1728
8481,RM-1117,6/1/2014,0,1728,0,0,0,0,1728
8482,RM-1117,6/2/2014,0,1728,0,0,0,0,1728
8483,RM-1117,6/3/2014,0,1728,0,0,0,0,1728
8484,RM-1117,6/4/2014,0,1728,0,0,0,0,1728
8485,RM-1117,6/5/2014,0,1728,0,0,0,0,1728
8486,RM-1117,6/6/2014,0,1728,0,0,0,0,1728
8487,RM-1117,6/7/2014,0,1728,0,0,0,0,1728
8488,RM-1117,6/8/2014,0,1728,0,0,0,0,1728
8489,RM-1117,6/9/2014,0,1728,0,0,0,0,1728
8490,RM-1117,6/10/2014,0,1728,0,0,0,0,1728
8492,RM-1117,6/12/2014,0,1728,0,0,0,0,1728
8493,RM-1117,6/13/2014,0,1728,0,0,0,0,1728
8494,RM-1117,6/14/2014,0,1728,0,0,0,0,1728
8495,RM-1117,6/15/2014,0,1728,0,0,0,0,1728
8496,RM-1117,6/16/2014,0,1728,0,0,0,0,1728
8497,RM-1117,6/17/2014,0,1728,0,0,0,0,1728
8498,RM-1117,6/18/2014,0,1728,0,0,0,0,1728
8499,RM-1117,6/19/2014,0,1728,0,0,0,0,1728
8500,RM-1117,6/20/2014,0,1728,0,0,0,0,1728
8501,RM-1117,6/21/2014,0,1728,0,0,0,0,1728
8502,RM-1117,6/22/2014,0,1728,0,0,0,0,1728
8503,RM-1117,6/23/2014,0,1728,0,0,0,0,1728
8504,RM-1117,6/24/2014,0,1728,0,0,0,0,1728
8505,RM-1117,6/25/2014,0,1728,0,0,0,0,1728
8506,RM-1117,6/26/2014,0,1728,0,0,0,0,1728
8507,RM-1117,6/27/2014,0,1728,0,0,0,0,1728
8508,RM-1117,6/28/2014,0,1728,0,0,0,0,1728
8510,RM-1117,6/30/2014,0,1728,0,0,0,0,1728
8511,RM-1117,7/1/2014,0,1728,0,0,0,0,1728
9751,RM-1123,2/21/2014,0,1728,0,0,0,0,1728
9752,RM-1123,2/22/2014,0,1728,0,0,0,0,1728
9753,RM-1123,2/23/2014,0,1728,0,0,0,0,1728
9754,RM-1123,2/24/2014,0,1728,0,0,0,0,1728
9755,RM-1123,2/25/2014,0,1728,0,0,0,0,1728
9756,RM-1123,2/26/2014,0,1728,0,0,0,0,1728
9757,RM-1123,2/27/2014,0,1728,0,0,0,0,1728
9758,RM-1123,2/28/2014,0,1728,0,0,0,0,1728
9759,RM-1123,3/1/2014,0,1728,0,0,0,0,1728
9762,RM-1123,3/4/2014,0,1728,0,0,0,0,1728
9763,RM-1123,3/5/2014,0,1728,0,0,0,0,1728
9764,RM-1123,3/6/2014,0,1728,0,0,0,0,1728
9765,RM-1123,3/7/2014,0,1728,0,0,0,0,1728
9769,RM-1123,3/11/2014,0,1728,0,0,0,0,1728
9770,RM-1123,3/12/2014,0,1728,0,0,0,0,1728
9771,RM-1123,3/13/2014,0,1728,0,0,0,0,1728
9772,RM-1123,3/14/2014,0,1728,0,0,0,0,1728
9773,RM-1123,3/15/2014,0,1728,0,0,0,0,1728
9774,RM-1123,3/16/2014,0,1728,0,0,0,0,1728
9775,RM-1123,3/17/2014,0,1728,0,0,0,0,1728
9776,RM-1123,3/18/2014,0,1728,0,0,0,0,1728
9777,RM-1123,3/19/2014,0,1728,0,0,0,0,1728
9778,RM-1123,3/20/2014,0,1728,0,0,0,0,1728
9779,RM-1123,3/21/2014,0,1728,0,0,0,0,1728
9780,RM-1123,3/22/2014,0,1728,0,0,0,0,1728
9781,RM-1123,3/23/2014,0,1728,0,0,0,0,1728
9782,RM-1123,3/24/2014,0,1728,0,0,0,0,1728
9783,RM-1123,3/25/2014,0,1728,0,0,0,0,1728
9784,RM-1123,3/26/2014,0,1728,0,0,0,0,1728
9786,RM-1123,3/28/2014,0,1728,0,0,0,0,1728
9787,RM-1123,3/29/2014,0,1728,0,0,0,0,1728
9788,RM-1123,3/30/2014,0,1728,0,0,0,0,1728
9789,RM-1123,3/31/2014,0,1728,0,0,0,0,1728
9790,RM-1123,4/1/2014,0,1728,0,0,0,0,1728
9792,RM-1123,4/3/2014,0,1728,0,0,0,0,1728
9793,RM-1123,4/4/2014,0,1728,0,0,0,0,1728
9794,RM-1123,4/5/2014,0,1728,0,0,0,0,1728
9795,RM-1123,4/6/2014,0,1728,0,0,0,0,1728
9796,RM-1123,4/7/2014,0,1728,0,0,0,0,1728
9797,RM-1123,4/8/2014,0,1728,0,0,0,0,1728
13723,RM-1133,2/18/2014,0,1728,0,0,0,0,1728
13724,RM-1133,2/19/2014,0,1728,0,0,0,0,1728
13725,RM-1133,2/20/2014,0,1728,0,0,0,0,1728
13726,RM-1133,2/21/2014,0,1728,0,0,0,0,1728
13727,RM-1133,2/22/2014,0,1728,0,0,0,0,1728
13728,RM-1133,2/23/2014,0,1728,0,0,0,0,1728
13729,RM-1133,2/24/2014,0,1728,0,0,0,0,1728
13730,RM-1133,2/25/2014,0,1728,0,0,0,0,1728
13731,RM-1133,2/26/2014,0,1728,0,0,0,0,1728
13732,RM-1133,2/27/2014,0,1728,0,0,0,0,1728
13733,RM-1133,2/28/2014,0,1728,0,0,0,0,1728
13734,RM-1133,3/1/2014,0,1728,0,0,0,0,1728
13737,RM-1133,3/4/2014,0,1728,0,0,0,0,1728
13738,RM-1133,3/5/2014,0,1728,0,0,0,0,1728
13739,RM-1133,3/6/2014,0,1728,0,0,0,0,1728
13740,RM-1133,3/7/2014,0,1728,0,0,0,0,1728
13744,RM-1133,3/11/2014,0,1728,0,0,0,0,1728
13745,RM-1133,3/12/2014,0,1728,0,0,0,0,1728
13746,RM-1133,3/13/2014,0,1728,0,0,0,0,1728
13747,RM-1133,3/14/2014,0,1728,0,0,0,0,1728
13748,RM-1133,3/15/2014,0,1728,0,0,0,0,1728
13749,RM-1133,3/16/2014,0,1728,0,0,0,0,1728
13750,RM-1133,3/17/2014,0,1728,0,0,0,0,1728
13751,RM-1133,3/18/2014,0,1728,0,0,0,0,1728
13752,RM-1133,3/19/2014,0,1728,0,0,0,0,1728
13753,RM-1133,3/20/2014,0,1728,0,0,0,0,1728
13754,RM-1133,3/21/2014,0,1728,0,0,0,0,1728
13755,RM-1133,3/22/2014,0,1728,0,0,0,0,1728
13756,RM-1133,3/23/2014,0,1728,0,0,0,0,1728
13757,RM-1133,3/24/2014,0,1728,0,0,0,0,1728
13758,RM-1133,3/25/2014,0,1728,0,0,0,0,1728
13759,RM-1133,3/26/2014,0,1728,0,0,0,0,1728
13761,RM-1133,3/28/2014,0,1728,0,0,0,0,1728
13762,RM-1133,3/29/2014,0,1728,0,0,0,0,1728
13763,RM-1133,3/30/2014,0,1728,0,0,0,0,1728
13764,RM-1133,3/31/2014,0,1728,0,0,0,0,1728
13765,RM-1133,4/1/2014,0,1728,0,0,0,0,1728
13767,RM-1133,4/3/2014,0,1728,0,0,0,0,1728
13768,RM-1133,4/4/2014,0,1728,0,0,0,0,1728
13769,RM-1133,4/5/2014,0,1728,0,0,0,0,1728
13770,RM-1133,4/6/2014,0,1728,0,0,0,0,1728
13771,RM-1133,4/7/2014,0,1728,0,0,0,0,1728
13772,RM-1133,4/8/2014,0,1728,0,0,0,0,1728
13773,RM-1133,4/9/2014,0,1728,0,0,0,0,1728
13774,RM-1133,4/10/2014,0,1728,0,0,0,0,1728
13775,RM-1133,4/11/2014,0,1728,0,0,0,0,1728
13776,RM-1133,4/12/2014,0,1728,0,0,0,0,1728
13777,RM-1133,4/13/2014,0,1728,0,0,0,0,1728
13778,RM-1133,4/14/2014,0,1728,0,0,0,0,1728
13779,RM-1133,4/15/2014,0,1728,0,0,0,0,1728
13780,RM-1133,4/16/2014,0,1728,0,0,0,0,1728
13781,RM-1133,4/17/2014,0,1728,0,0,0,0,1728
13782,RM-1133,4/18/2014,0,1728,0,0,0,0,1728
13783,RM-1133,4/19/2014,0,1728,0,0,0,0,1728
13784,RM-1133,4/20/2014,0,1728,0,0,0,0,1728
13785,RM-1133,4/21/2014,0,1728,0,0,0,0,1728
13786,RM-1133,4/22/2014,0,1728,0,0,0,0,1728
13787,RM-1133,4/23/2014,0,1728,0,0,0,0,1728
13852,RM-1133,6/27/2014,0,1728,0,0,0,0,1728
13853,RM-1133,6/28/2014,0,1728,0,0,0,0,1728
13855,RM-1133,6/30/2014,0,1728,0,0,0,0,1728
13856,RM-1133,7/1/2014,0,1728,0,0,0,0,1728
16827,RM-1150,1/19/2014,0,0,0,1728,0,0,1728
16831,RM-1150,1/23/2014,0,0,0,1728,0,0,1728
16832,RM-1150,1/24/2014,0,0,0,1728,0,0,1728
16837,RM-1150,1/29/2014,0,0,0,1728,0,0,1728
16841,RM-1150,2/2/2014,0,0,0,1728,0,0,1728
16842,RM-1150,2/3/2014,0,0,0,1728,0,0,1728
16865,RM-1150,2/26/2014,0,0,0,1728,0,0,1728
16866,RM-1150,2/27/2014,0,0,0,1728,0,0,1728
16867,RM-1150,2/28/2014,0,0,0,1728,0,0,1728
16868,RM-1150,3/1/2014,0,0,0,1728,0,0,1728
16871,RM-1150,3/4/2014,0,0,0,1728,0,0,1728
16872,RM-1150,3/5/2014,0,0,0,1728,0,0,1728
16873,RM-1150,3/6/2014,0,0,0,1728,0,0,1728
16874,RM-1150,3/7/2014,0,0,0,1728,0,0,1728
16878,RM-1150,3/11/2014,0,0,0,1728,0,0,1728
16879,RM-1150,3/12/2014,0,0,0,1728,0,0,1728
16880,RM-1150,3/13/2014,0,0,0,1728,0,0,1728
16881,RM-1150,3/14/2014,0,0,0,1728,0,0,1728
16882,RM-1150,3/15/2014,0,0,0,1728,0,0,1728
16883,RM-1150,3/16/2014,0,0,0,1728,0,0,1728
16884,RM-1150,3/17/2014,0,0,0,1728,0,0,1728
16885,RM-1150,3/18/2014,0,0,0,1728,0,0,1728
16886,RM-1150,3/19/2014,0,0,0,1728,0,0,1728
16887,RM-1150,3/20/2014,0,0,0,1728,0,0,1728
16888,RM-1150,3/21/2014,0,0,0,1728,0,0,1728
16889,RM-1150,3/22/2014,0,0,0,1728,0,0,1728
16890,RM-1150,3/23/2014,0,0,0,1728,0,0,1728
16891,RM-1150,3/24/2014,0,0,0,1728,0,0,1728
16892,RM-1150,3/25/2014,0,0,0,1728,0,0,1728
16893,RM-1150,3/26/2014,0,0,0,1728,0,0,1728
16895,RM-1150,3/28/2014,0,0,0,1728,0,0,1728
16896,RM-1150,3/29/2014,0,0,0,1728,0,0,1728
16897,RM-1150,3/30/2014,0,0,0,1728,0,0,1728
16898,RM-1150,3/31/2014,0,0,0,1728,0,0,1728
16899,RM-1150,4/1/2014,0,0,0,1728,0,0,1728
16901,RM-1150,4/3/2014,0,0,0,1728,0,0,1728
16902,RM-1150,4/4/2014,0,0,0,1728,0,0,1728
16903,RM-1150,4/5/2014,0,0,0,1728,0,0,1728
16904,RM-1150,4/6/2014,0,0,0,1728,0,0,1728
16905,RM-1150,4/7/2014,0,0,0,1728,0,0,1728
16906,RM-1150,4/8/2014,0,0,0,1728,0,0,1728
16907,RM-1150,4/9/2014,0,0,0,1728,0,0,1728
16908,RM-1150,4/10/2014,0,0,0,1728,0,0,1728
16909,RM-1150,4/11/2014,0,0,0,1728,0,0,1728
16910,RM-1150,4/12/2014,0,0,0,1728,0,0,1728
16911,RM-1150,4/13/2014,0,0,0,1728,0,0,1728
16912,RM-1150,4/14/2014,0,0,0,1728,0,0,1728
16913,RM-1150,4/15/2014,0,0,0,1728,0,0,1728
16914,RM-1150,4/16/2014,0,0,0,1728,0,0,1728
16915,RM-1150,4/17/2014,0,0,0,1728,0,0,1728
16916,RM-1150,4/18/2014,0,0,0,1728,0,0,1728
16917,RM-1150,4/19/2014,0,0,0,1728,0,0,1728
16918,RM-1150,4/20/2014,0,0,0,1728,0,0,1728
16919,RM-1150,4/21/2014,0,0,0,1728,0,0,1728
16920,RM-1150,4/22/2014,0,0,0,1728,0,0,1728
16921,RM-1150,4/23/2014,0,0,0,1728,0,0,1728
16922,RM-1150,4/24/2014,0,0,0,1728,0,0,1728
16923,RM-1150,4/25/2014,0,0,0,1728,0,0,1728
16924,RM-1150,4/26/2014,0,0,0,1728,0,0,1728
16925,RM-1150,4/27/2014,0,0,0,1728,0,0,1728
16926,RM-1150,4/28/2014,0,0,0,1728,0,0,1728
16927,RM-1150,4/29/2014,0,0,0,1728,0,0,1728
16928,RM-1150,4/30/2014,0,0,0,1728,0,0,1728
16929,RM-1150,5/1/2014,0,0,0,1728,0,0,1728
16930,RM-1150,5/2/2014,0,0,0,1728,0,0,1728
16931,RM-1150,5/3/2014,0,0,0,1728,0,0,1728
16932,RM-1150,5/4/2014,0,0,0,1728,0,0,1728
16946,RM-1150,5/18/2014,0,0,0,1728,0,0,1728
16947,RM-1150,5/19/2014,0,0,0,1728,0,0,1728
16948,RM-1150,5/20/2014,0,0,0,1728,0,0,1728
16949,RM-1150,5/21/2014,0,0,0,1728,0,0,1728
16950,RM-1150,5/22/2014,0,0,0,1728,0,0,1728
16951,RM-1150,5/23/2014,0,0,0,1728,0,0,1728
16952,RM-1150,5/24/2014,0,0,0,1728,0,0,1728
16953,RM-1150,5/25/2014,0,0,0,1728,0,0,1728
16954,RM-1150,5/26/2014,0,0,0,1728,0,0,1728
16955,RM-1150,5/27/2014,0,0,0,1728,0,0,1728
16956,RM-1150,5/28/2014,0,0,0,1728,0,0,1728
16957,RM-1150,5/29/2014,0,0,0,1728,0,0,1728
16958,RM-1150,5/30/2014,0,0,0,1728,0,0,1728
16959,RM-1150,5/31/2014,0,0,0,1728,0,0,1728
16960,RM-1150,6/1/2014,0,0,0,1728,0,0,1728
16961,RM-1150,6/2/2014,0,0,0,1728,0,0,1728
16962,RM-1150,6/3/2014,0,0,0,1728,0,0,1728
16963,RM-1150,6/4/2014,0,0,0,1728,0,0,1728
16964,RM-1150,6/5/2014,0,0,0,1728,0,0,1728
16965,RM-1150,6/6/2014,0,0,0,1728,0,0,1728
16966,RM-1150,6/7/2014,0,0,0,1728,0,0,1728
16967,RM-1150,6/8/2014,0,0,0,1728,0,0,1728
16968,RM-1150,6/9/2014,0,0,0,1728,0,0,1728
16969,RM-1150,6/10/2014,0,0,0,1728,0,0,1728
16971,RM-1150,6/12/2014,0,0,0,1728,0,0,1728
16972,RM-1150,6/13/2014,0,0,0,1728,0,0,1728
16973,RM-1150,6/14/2014,0,0,0,1728,0,0,1728
16974,RM-1150,6/15/2014,0,0,0,1728,0,0,1728
16975,RM-1150,6/16/2014,0,0,0,1728,0,0,1728
16976,RM-1150,6/17/2014,0,0,0,1728,0,0,1728
16977,RM-1150,6/18/2014,0,0,0,1728,0,0,1728
16978,RM-1150,6/19/2014,0,0,0,1728,0,0,1728
16979,RM-1150,6/20/2014,0,0,0,1728,0,0,1728
16980,RM-1150,6/21/2014,0,0,0,1728,0,0,1728
16981,RM-1150,6/22/2014,0,0,0,1728,0,0,1728
16982,RM-1150,6/23/2014,0,0,0,1728,0,0,1728
16983,RM-1150,6/24/2014,0,0,0,1728,0,0,1728
16984,RM-1150,6/25/2014,0,0,0,1728,0,0,1728
16985,RM-1150,6/26/2014,0,0,0,1728,0,0,1728
16986,RM-1150,6/27/2014,0,0,0,1728,0,0,1728
16987,RM-1150,6/28/2014,0,0,0,1728,0,0,1728
16989,RM-1150,6/30/2014,0,0,0,1728,0,0,1728
16990,RM-1150,7/1/2014,0,0,0,1728,0,0,1728
17512,RM-1151,1/19/2014,0,0,0,1728,0,0,1728
17516,RM-1151,1/23/2014,0,0,0,1728,0,0,1728
17517,RM-1151,1/24/2014,0,0,0,1728,0,0,1728
17522,RM-1151,1/29/2014,0,0,0,1728,0,0,1728
17526,RM-1151,2/2/2014,0,0,0,1728,0,0,1728
17527,RM-1151,2/3/2014,0,0,0,1728,0,0,1728
17528,RM-1151,2/4/2014,0,0,0,1728,0,0,1728
17529,RM-1151,2/5/2014,0,0,0,1728,0,0,1728
17530,RM-1151,2/6/2014,0,0,0,1728,0,0,1728
17532,RM-1151,2/8/2014,0,0,0,1728,0,0,1728
17533,RM-1151,2/9/2014,0,0,0,1728,0,0,1728
17534,RM-1151,2/10/2014,0,0,0,1728,0,0,1728
17535,RM-1151,2/11/2014,0,0,0,1728,0,0,1728
17538,RM-1151,2/14/2014,0,0,0,1728,0,0,1728
17539,RM-1151,2/15/2014,0,0,0,1728,0,0,1728
17540,RM-1151,2/16/2014,0,0,0,1728,0,0,1728
17541,RM-1151,2/17/2014,0,0,0,1728,0,0,1728
17542,RM-1151,2/18/2014,0,0,0,1728,0,0,1728
17543,RM-1151,2/19/2014,0,0,0,1728,0,0,1728
17544,RM-1151,2/20/2014,0,0,0,1728,0,0,1728
17545,RM-1151,2/21/2014,0,0,0,1728,0,0,1728
17546,RM-1151,2/22/2014,0,0,0,1728,0,0,1728
17547,RM-1151,2/23/2014,0,0,0,1728,0,0,1728
19949,RM-1156,2/13/2015,864,0,864,0,0,0,1728
19955,RM-1156,2/19/2015,864,0,864,0,0,0,1728
19956,RM-1156,2/20/2015,864,0,864,0,0,0,1728
19961,RM-1156,2/25/2015,864,0,864,0,0,0,1728
19964,RM-1156,2/28/2015,864,0,864,0,0,0,1728
20215,RM-1200A,1/19/2014,0,0,0,1728,0,0,1728
20219,RM-1200A,1/23/2014,0,0,0,1728,0,0,1728
20220,RM-1200A,1/24/2014,0,0,0,1728,0,0,1728
20225,RM-1200A,1/29/2014,0,0,0,1728,0,0,1728
20229,RM-1200A,2/2/2014,0,0,0,1728,0,0,1728
20230,RM-1200A,2/3/2014,0,0,0,1728,0,0,1728
20231,RM-1200A,2/4/2014,0,0,0,1728,0,0,1728
20232,RM-1200A,2/5/2014,0,0,0,1728,0,0,1728
20233,RM-1200A,2/6/2014,0,0,0,1728,0,0,1728
20235,RM-1200A,2/8/2014,0,0,0,1728,0,0,1728
20236,RM-1200A,2/9/2014,0,0,0,1728,0,0,1728
20237,RM-1200A,2/10/2014,0,0,0,1728,0,0,1728
20238,RM-1200A,2/11/2014,0,0,0,1728,0,0,1728
20241,RM-1200A,2/14/2014,0,0,0,1728,0,0,1728
20242,RM-1200A,2/15/2014,0,0,0,1728,0,0,1728
20243,RM-1200A,2/16/2014,0,0,0,1728,0,0,1728
20244,RM-1200A,2/17/2014,0,0,0,1728,0,0,1728
20245,RM-1200A,2/18/2014,0,0,0,1728,0,0,1728
20246,RM-1200A,2/19/2014,0,0,0,1728,0,0,1728
20247,RM-1200A,2/20/2014,0,0,0,1728,0,0,1728
20248,RM-1200A,2/21/2014,0,0,0,1728,0,0,1728
20249,RM-1200A,2/22/2014,0,0,0,1728,0,0,1728
20250,RM-1200A,2/23/2014,0,0,0,1728,0,0,1728
20251,RM-1200A,2/24/2014,0,0,0,1728,0,0,1728
20252,RM-1200A,2/25/2014,0,0,0,1728,0,0,1728
20253,RM-1200A,2/26/2014,0,0,0,1728,0,0,1728
20254,RM-1200A,2/27/2014,0,0,0,1728,0,0,1728
20255,RM-1200A,2/28/2014,0,0,0,1728,0,0,1728
20256,RM-1200A,3/1/2014,0,0,0,1728,0,0,1728
20259,RM-1200A,3/4/2014,0,0,0,1728,0,0,1728
20260,RM-1200A,3/5/2014,0,0,0,1728,0,0,1728
20261,RM-1200A,3/6/2014,0,0,0,1728,0,0,1728
20262,RM-1200A,3/7/2014,0,0,0,1728,0,0,1728
20266,RM-1200A,3/11/2014,0,0,0,1728,0,0,1728
20267,RM-1200A,3/12/2014,0,0,0,1728,0,0,1728
20268,RM-1200A,3/13/2014,0,0,0,1728,0,0,1728
20269,RM-1200A,3/14/2014,0,0,0,1728,0,0,1728
20270,RM-1200A,3/15/2014,0,0,0,1728,0,0,1728
20271,RM-1200A,3/16/2014,0,0,0,1728,0,0,1728
20272,RM-1200A,3/17/2014,0,0,0,1728,0,0,1728
20273,RM-1200A,3/18/2014,0,0,0,1728,0,0,1728
20274,RM-1200A,3/19/2014,0,0,0,1728,0,0,1728
20275,RM-1200A,3/20/2014,0,0,0,1728,0,0,1728
20276,RM-1200A,3/21/2014,0,0,0,1728,0,0,1728
20277,RM-1200A,3/22/2014,0,0,0,1728,0,0,1728
20278,RM-1200A,3/23/2014,0,0,0,1728,0,0,1728
20279,RM-1200A,3/24/2014,0,0,0,1728,0,0,1728
20280,RM-1200A,3/25/2014,0,0,0,1728,0,0,1728
20281,RM-1200A,3/26/2014,0,0,0,1728,0,0,1728
20283,RM-1200A,3/28/2014,0,0,0,1728,0,0,1728
20284,RM-1200A,3/29/2014,0,0,0,1728,0,0,1728
20285,RM-1200A,3/30/2014,0,0,0,1728,0,0,1728
20286,RM-1200A,3/31/2014,0,0,0,1728,0,0,1728
20287,RM-1200A,4/1/2014,0,0,0,1728,0,0,1728
20289,RM-1200A,4/3/2014,0,0,0,1728,0,0,1728
20290,RM-1200A,4/4/2014,0,0,0,1728,0,0,1728
20291,RM-1200A,4/5/2014,0,0,0,1728,0,0,1728
20292,RM-1200A,4/6/2014,0,0,0,1728,0,0,1728
20293,RM-1200A,4/7/2014,0,0,0,1728,0,0,1728
20294,RM-1200A,4/8/2014,0,0,0,1728,0,0,1728
20295,RM-1200A,4/9/2014,0,0,0,1728,0,0,1728
20296,RM-1200A,4/10/2014,0,0,0,1728,0,0,1728
20297,RM-1200A,4/11/2014,0,0,0,1728,0,0,1728
20298,RM-1200A,4/12/2014,0,0,0,1728,0,0,1728
20299,RM-1200A,4/13/2014,0,0,0,1728,0,0,1728
20300,RM-1200A,4/14/2014,0,0,0,1728,0,0,1728
20301,RM-1200A,4/15/2014,0,0,0,1728,0,0,1728
20302,RM-1200A,4/16/2014,0,0,0,1728,0,0,1728
20303,RM-1200A,4/17/2014,0,0,0,1728,0,0,1728
20304,RM-1200A,4/18/2014,0,0,0,1728,0,0,1728
20305,RM-1200A,4/19/2014,0,0,0,1728,0,0,1728
20306,RM-1200A,4/20/2014,0,0,0,1728,0,0,1728
20307,RM-1200A,4/21/2014,0,0,0,1728,0,0,1728
20308,RM-1200A,4/22/2014,0,0,0,1728,0,0,1728
20309,RM-1200A,4/23/2014,0,0,0,1728,0,0,1728
20310,RM-1200A,4/24/2014,0,0,0,1728,0,0,1728
20311,RM-1200A,4/25/2014,0,0,0,1728,0,0,1728
20312,RM-1200A,4/26/2014,0,0,0,1728,0,0,1728
20313,RM-1200A,4/27/2014,0,0,0,1728,0,0,1728
20314,RM-1200A,4/28/2014,0,0,0,1728,0,0,1728
20315,RM-1200A,4/29/2014,0,0,0,1728,0,0,1728
20316,RM-1200A,4/30/2014,0,0,0,1728,0,0,1728
20317,RM-1200A,5/1/2014,0,0,0,1728,0,0,1728
20318,RM-1200A,5/2/2014,0,0,0,1728,0,0,1728
20319,RM-1200A,5/3/2014,0,0,0,1728,0,0,1728
20320,RM-1200A,5/4/2014,0,0,0,1728,0,0,1728
20334,RM-1200A,5/18/2014,0,0,0,1728,0,0,1728
20335,RM-1200A,5/19/2014,0,0,0,1728,0,0,1728
20336,RM-1200A,5/20/2014,0,0,0,1728,0,0,1728
20337,RM-1200A,5/21/2014,0,0,0,1728,0,0,1728
20338,RM-1200A,5/22/2014,0,0,0,1728,0,0,1728
20339,RM-1200A,5/23/2014,0,0,0,1728,0,0,1728
20340,RM-1200A,5/24/2014,0,0,0,1728,0,0,1728
20341,RM-1200A,5/25/2014,0,0,0,1728,0,0,1728
20342,RM-1200A,5/26/2014,0,0,0,1728,0,0,1728
20343,RM-1200A,5/27/2014,0,0,0,1728,0,0,1728
20344,RM-1200A,5/28/2014,0,0,0,1728,0,0,1728
20345,RM-1200A,5/29/2014,0,0,0,1728,0,0,1728
20346,RM-1200A,5/30/2014,0,0,0,1728,0,0,1728
20347,RM-1200A,5/31/2014,0,0,0,1728,0,0,1728
20348,RM-1200A,6/1/2014,0,0,0,1728,0,0,1728
20349,RM-1200A,6/2/2014,0,0,0,1728,0,0,1728
20350,RM-1200A,6/3/2014,0,0,0,1728,0,0,1728
20351,RM-1200A,6/4/2014,0,0,0,1728,0,0,1728
20353,RM-1200A,6/6/2014,0,0,0,1728,0,0,1728
20354,RM-1200A,6/7/2014,0,0,0,1728,0,0,1728
20355,RM-1200A,6/8/2014,0,0,0,1728,0,0,1728
20356,RM-1200A,6/9/2014,0,0,0,1728,0,0,1728
20357,RM-1200A,6/10/2014,0,0,0,1728,0,0,1728
20359,RM-1200A,6/12/2014,0,0,0,1728,0,0,1728
20360,RM-1200A,6/13/2014,0,0,0,1728,0,0,1728
20361,RM-1200A,6/14/2014,0,0,0,1728,0,0,1728
20362,RM-1200A,6/15/2014,0,0,0,1728,0,0,1728
20363,RM-1200A,6/16/2014,0,0,0,1728,0,0,1728
20364,RM-1200A,6/17/2014,0,0,0,1728,0,0,1728
20365,RM-1200A,6/18/2014,0,0,0,1728,0,0,1728
20894,RM-1200B,2/4/2014,0,1728,0,0,0,0,1728
20895,RM-1200B,2/5/2014,0,1728,0,0,0,0,1728
20896,RM-1200B,2/6/2014,0,1728,0,0,0,0,1728
20898,RM-1200B,2/8/2014,0,1728,0,0,0,0,1728
20899,RM-1200B,2/9/2014,0,1728,0,0,0,0,1728
20900,RM-1200B,2/10/2014,0,1728,0,0,0,0,1728
20901,RM-1200B,2/11/2014,0,1728,0,0,0,0,1728
20904,RM-1200B,2/14/2014,0,1728,0,0,0,0,1728
20905,RM-1200B,2/15/2014,0,1728,0,0,0,0,1728
20906,RM-1200B,2/16/2014,0,1728,0,0,0,0,1728
20907,RM-1200B,2/17/2014,0,1728,0,0,0,0,1728
20908,RM-1200B,2/18/2014,0,1728,0,0,0,0,1728
20909,RM-1200B,2/19/2014,0,1728,0,0,0,0,1728
20910,RM-1200B,2/20/2014,0,1728,0,0,0,0,1728
20911,RM-1200B,2/21/2014,0,1728,0,0,0,0,1728
20912,RM-1200B,2/22/2014,0,1728,0,0,0,0,1728
20913,RM-1200B,2/23/2014,0,1728,0,0,0,0,1728
20914,RM-1200B,2/24/2014,0,1728,0,0,0,0,1728
20915,RM-1200B,2/25/2014,0,1728,0,0,0,0,1728
20916,RM-1200B,2/26/2014,0,1728,0,0,0,0,1728
20917,RM-1200B,2/27/2014,0,1728,0,0,0,0,1728
20918,RM-1200B,2/28/2014,0,1728,0,0,0,0,1728
20919,RM-1200B,3/1/2014,0,1728,0,0,0,0,1728
20922,RM-1200B,3/4/2014,0,1728,0,0,0,0,1728
20923,RM-1200B,3/5/2014,0,1728,0,0,0,0,1728
20924,RM-1200B,3/6/2014,0,1728,0,0,0,0,1728
20925,RM-1200B,3/7/2014,0,1728,0,0,0,0,1728
20929,RM-1200B,3/11/2014,0,1728,0,0,0,0,1728
20930,RM-1200B,3/12/2014,0,1728,0,0,0,0,1728
20931,RM-1200B,3/13/2014,0,1728,0,0,0,0,1728
20932,RM-1200B,3/14/2014,0,1728,0,0,0,0,1728
20933,RM-1200B,3/15/2014,0,1728,0,0,0,0,1728
20934,RM-1200B,3/16/2014,0,1728,0,0,0,0,1728
20935,RM-1200B,3/17/2014,0,1728,0,0,0,0,1728
20936,RM-1200B,3/18/2014,0,1728,0,0,0,0,1728
20937,RM-1200B,3/19/2014,0,1728,0,0,0,0,1728
20938,RM-1200B,3/20/2014,0,1728,0,0,0,0,1728
20939,RM-1200B,3/21/2014,0,1728,0,0,0,0,1728
20940,RM-1200B,3/22/2014,0,1728,0,0,0,0,1728
20941,RM-1200B,3/23/2014,0,1728,0,0,0,0,1728
20942,RM-1200B,3/24/2014,0,1728,0,0,0,0,1728
20943,RM-1200B,3/25/2014,0,1728,0,0,0,0,1728
20944,RM-1200B,3/26/2014,0,1728,0,0,0,0,1728
20946,RM-1200B,3/28/2014,0,1728,0,0,0,0,1728
20947,RM-1200B,3/29/2014,0,1728,0,0,0,0,1728
20948,RM-1200B,3/30/2014,0,1728,0,0,0,0,1728
20949,RM-1200B,3/31/2014,0,1728,0,0,0,0,1728
20950,RM-1200B,4/1/2014,0,1728,0,0,0,0,1728
20952,RM-1200B,4/3/2014,0,1728,0,0,0,0,1728
20953,RM-1200B,4/4/2014,0,1728,0,0,0,0,1728
20954,RM-1200B,4/5/2014,0,1728,0,0,0,0,1728
20955,RM-1200B,4/6/2014,0,1728,0,0,0,0,1728
20956,RM-1200B,4/7/2014,0,1728,0,0,0,0,1728
20957,RM-1200B,4/8/2014,0,1728,0,0,0,0,1728
20958,RM-1200B,4/9/2014,0,1728,0,0,0,0,1728
20959,RM-1200B,4/10/2014,0,1728,0,0,0,0,1728
20960,RM-1200B,4/11/2014,0,1728,0,0,0,0,1728
20961,RM-1200B,4/12/2014,0,1728,0,0,0,0,1728
20962,RM-1200B,4/13/2014,0,1728,0,0,0,0,1728
20963,RM-1200B,4/14/2014,0,1728,0,0,0,0,1728
20964,RM-1200B,4/15/2014,0,1728,0,0,0,0,1728
20965,RM-1200B,4/16/2014,0,1728,0,0,0,0,1728
20966,RM-1200B,4/17/2014,0,1728,0,0,0,0,1728
20967,RM-1200B,4/18/2014,0,1728,0,0,0,0,1728
20968,RM-1200B,4/19/2014,0,1728,0,0,0,0,1728
20969,RM-1200B,4/20/2014,0,1728,0,0,0,0,1728
20970,RM-1200B,4/21/2014,0,1728,0,0,0,0,1728
20971,RM-1200B,4/22/2014,0,1728,0,0,0,0,1728
20972,RM-1200B,4/23/2014,0,1728,0,0,0,0,1728
20973,RM-1200B,4/24/2014,0,1728,0,0,0,0,1728
20974,RM-1200B,4/25/2014,0,1728,0,0,0,0,1728
20975,RM-1200B,4/26/2014,0,1728,0,0,0,0,1728
20976,RM-1200B,4/27/2014,0,1728,0,0,0,0,1728
20977,RM-1200B,4/28/2014,0,1728,0,0,0,0,1728
20978,RM-1200B,4/29/2014,0,1728,0,0,0,0,1728
20979,RM-1200B,4/30/2014,0,1728,0,0,0,0,1728
20980,RM-1200B,5/1/2014,0,1728,0,0,0,0,1728
20981,RM-1200B,5/2/2014,0,1728,0,0,0,0,1728
20982,RM-1200B,5/3/2014,0,1728,0,0,0,0,1728
20983,RM-1200B,5/4/2014,0,1728,0,0,0,0,1728
20997,RM-1200B,5/18/2014,0,1728,0,0,0,0,1728
20998,RM-1200B,5/19/2014,0,1728,0,0,0,0,1728
20999,RM-1200B,5/20/2014,0,1728,0,0,0,0,1728
21709,RM-1200C,6/14/2014,0,0,0,1728,0,0,1728
21710,RM-1200C,6/15/2014,0,0,0,1728,0,0,1728
21711,RM-1200C,6/16/2014,0,0,0,1728,0,0,1728
21712,RM-1200C,6/17/2014,0,0,0,1728,0,0,1728
21713,RM-1200C,6/18/2014,0,0,0,1728,0,0,1728
21714,RM-1200C,6/19/2014,0,0,0,1728,0,0,1728
21715,RM-1200C,6/20/2014,0,0,0,1728,0,0,1728
21716,RM-1200C,6/21/2014,0,0,0,1728,0,0,1728
21717,RM-1200C,6/22/2014,0,0,0,1728,0,0,1728
21718,RM-1200C,6/23/2014,0,0,0,1728,0,0,1728
21719,RM-1200C,6/24/2014,0,0,0,1728,0,0,1728
21720,RM-1200C,6/25/2014,0,0,0,1728,0,0,1728
21721,RM-1200C,6/26/2014,0,0,0,1728,0,0,1728
21722,RM-1200C,6/27/2014,0,0,0,1728,0,0,1728
21725,RM-1200C,6/30/2014,0,0,0,1728,0,0,1728
24445,RM-1208B,7/31/2014,864,0,864,0,0,0,1728
24460,RM-1208B,8/15/2014,864,0,864,0,0,0,1728
27665,RM-1218,1/19/2014,0,0,0,1728,0,0,1728
27669,RM-1218,1/23/2014,0,0,0,1728,0,0,1728
27670,RM-1218,1/24/2014,0,0,0,1728,0,0,1728
27675,RM-1218,1/29/2014,0,0,0,1728,0,0,1728
27679,RM-1218,2/2/2014,0,0,0,1728,0,0,1728
27680,RM-1218,2/3/2014,0,0,0,1728,0,0,1728
27681,RM-1218,2/4/2014,0,0,0,1728,0,0,1728
27682,RM-1218,2/5/2014,0,0,0,1728,0,0,1728
27683,RM-1218,2/6/2014,0,0,0,1728,0,0,1728
27685,RM-1218,2/8/2014,0,0,0,1728,0,0,1728
27686,RM-1218,2/9/2014,0,0,0,1728,0,0,1728
27687,RM-1218,2/10/2014,0,0,0,1728,0,0,1728
27688,RM-1218,2/11/2014,0,0,0,1728,0,0,1728
27691,RM-1218,2/14/2014,0,0,0,1728,0,0,1728
27692,RM-1218,2/15/2014,0,0,0,1728,0,0,1728
27770,RM-1218,5/4/2014,0,0,0,1728,0,0,1728
27784,RM-1218,5/18/2014,0,0,0,1728,0,0,1728
27785,RM-1218,5/19/2014,0,0,0,1728,0,0,1728
27786,RM-1218,5/20/2014,0,0,0,1728,0,0,1728
27787,RM-1218,5/21/2014,0,0,0,1728,0,0,1728
27788,RM-1218,5/22/2014,0,0,0,1728,0,0,1728
27789,RM-1218,5/23/2014,0,0,0,1728,0,0,1728
27790,RM-1218,5/24/2014,0,0,0,1728,0,0,1728
27791,RM-1218,5/25/2014,0,0,0,1728,0,0,1728
27792,RM-1218,5/26/2014,0,0,0,1728,0,0,1728
27793,RM-1218,5/27/2014,0,0,0,1728,0,0,1728
27794,RM-1218,5/28/2014,0,0,0,1728,0,0,1728
27795,RM-1218,5/29/2014,0,0,0,1728,0,0,1728
27796,RM-1218,5/30/2014,0,0,0,1728,0,0,1728
27797,RM-1218,5/31/2014,0,0,0,1728,0,0,1728
27798,RM-1218,6/1/2014,0,0,0,1728,0,0,1728
27799,RM-1218,6/2/2014,0,0,0,1728,0,0,1728
27800,RM-1218,6/3/2014,0,0,0,1728,0,0,1728
27801,RM-1218,6/4/2014,0,0,0,1728,0,0,1728
27802,RM-1218,6/5/2014,0,0,0,1728,0,0,1728
27803,RM-1218,6/6/2014,0,0,0,1728,0,0,1728
27804,RM-1218,6/7/2014,0,0,0,1728,0,0,1728
27805,RM-1218,6/8/2014,0,0,0,1728,0,0,1728
27806,RM-1218,6/9/2014,0,0,0,1728,0,0,1728
27807,RM-1218,6/10/2014,0,0,0,1728,0,0,1728
27809,RM-1218,6/12/2014,0,0,0,1728,0,0,1728
27810,RM-1218,6/13/2014,0,0,0,1728,0,0,1728
27811,RM-1218,6/14/2014,0,0,0,1728,0,0,1728
27812,RM-1218,6/15/2014,0,0,0,1728,0,0,1728
27813,RM-1218,6/16/2014,0,0,0,1728,0,0,1728
27814,RM-1218,6/17/2014,0,0,0,1728,0,0,1728
27815,RM-1218,6/18/2014,0,0,0,1728,0,0,1728
27816,RM-1218,6/19/2014,0,0,0,1728,0,0,1728
27817,RM-1218,6/20/2014,0,0,0,1728,0,0,1728
27818,RM-1218,6/21/2014,0,0,0,1728,0,0,1728
27819,RM-1218,6/22/2014,0,0,0,1728,0,0,1728
27820,RM-1218,6/23/2014,0,0,0,1728,0,0,1728
27821,RM-1218,6/24/2014,0,0,0,1728,0,0,1728
27822,RM-1218,6/25/2014,0,0,0,1728,0,0,1728
27823,RM-1218,6/26/2014,0,0,0,1728,0,0,1728
27824,RM-1218,6/27/2014,0,0,0,1728,0,0,1728
27825,RM-1218,6/28/2014,0,0,0,1728,0,0,1728
27827,RM-1218,6/30/2014,0,0,0,1728,0,0,1728
27828,RM-1218,7/1/2014,0,0,0,1728,0,0,1728
29426,RM-1223,2/13/2015,864,0,864,0,0,0,1728
29432,RM-1223,2/19/2015,864,0,864,0,0,0,1728
29433,RM-1223,2/20/2015,864,0,864,0,0,0,1728
29438,RM-1223,2/25/2015,864,0,864,0,0,0,1728
29441,RM-1223,2/28/2015,864,0,864,0,0,0,1728
29798,RM-1224,4/4/2014,0,0,0,1728,0,0,1728
29799,RM-1224,4/5/2014,0,0,0,1728,0,0,1728
29800,RM-1224,4/6/2014,0,0,0,1728,0,0,1728
29801,RM-1224,4/7/2014,0,0,0,1728,0,0,1728
29802,RM-1224,4/8/2014,0,0,0,1728,0,0,1728
29803,RM-1224,4/9/2014,0,0,0,1728,0,0,1728
29804,RM-1224,4/10/2014,0,0,0,1728,0,0,1728
29805,RM-1224,4/11/2014,0,0,0,1728,0,0,1728
29806,RM-1224,4/12/2014,0,0,0,1728,0,0,1728
29807,RM-1224,4/13/2014,0,0,0,1728,0,0,1728
29808,RM-1224,4/14/2014,0,0,0,1728,0,0,1728
29809,RM-1224,4/15/2014,0,0,0,1728,0,0,1728
29810,RM-1224,4/16/2014,0,0,0,1728,0,0,1728
29811,RM-1224,4/17/2014,0,0,0,1728,0,0,1728
29812,RM-1224,4/18/2014,0,0,0,1728,0,0,1728
29813,RM-1224,4/19/2014,0,0,0,1728,0,0,1728
29814,RM-1224,4/20/2014,0,0,0,1728,0,0,1728
29815,RM-1224,4/21/2014,0,0,0,1728,0,0,1728
29816,RM-1224,4/22/2014,0,0,0,1728,0,0,1728
29817,RM-1224,4/23/2014,0,0,0,1728,0,0,1728
29818,RM-1224,4/24/2014,0,0,0,1728,0,0,1728
29819,RM-1224,4/25/2014,0,0,0,1728,0,0,1728
29820,RM-1224,4/26/2014,0,0,0,1728,0,0,1728
29821,RM-1224,4/27/2014,0,0,0,1728,0,0,1728
29822,RM-1224,4/28/2014,0,0,0,1728,0,0,1728
29823,RM-1224,4/29/2014,0,0,0,1728,0,0,1728
29824,RM-1224,4/30/2014,0,0,0,1728,0,0,1728
29825,RM-1224,5/1/2014,0,0,0,1728,0,0,1728
29826,RM-1224,5/2/2014,0,0,0,1728,0,0,1728
29827,RM-1224,5/3/2014,0,0,0,1728,0,0,1728
29828,RM-1224,5/4/2014,0,0,0,1728,0,0,1728
29842,RM-1224,5/18/2014,0,0,0,1728,0,0,1728
29843,RM-1224,5/19/2014,0,0,0,1728,0,0,1728
29844,RM-1224,5/20/2014,0,0,0,1728,0,0,1728
29845,RM-1224,5/21/2014,0,0,0,1728,0,0,1728
29846,RM-1224,5/22/2014,0,0,0,1728,0,0,1728
29847,RM-1224,5/23/2014,0,0,0,1728,0,0,1728
29848,RM-1224,5/24/2014,0,0,0,1728,0,0,1728
29849,RM-1224,5/25/2014,0,0,0,1728,0,0,1728
29850,RM-1224,5/26/2014,0,0,0,1728,0,0,1728
29851,RM-1224,5/27/2014,0,0,0,1728,0,0,1728
29852,RM-1224,5/28/2014,0,0,0,1728,0,0,1728
29853,RM-1224,5/29/2014,0,0,0,1728,0,0,1728
29854,RM-1224,5/30/2014,0,0,0,1728,0,0,1728
29855,RM-1224,5/31/2014,0,0,0,1728,0,0,1728
29856,RM-1224,6/1/2014,0,0,0,1728,0,0,1728
29857,RM-1224,6/2/2014,0,0,0,1728,0,0,1728
29858,RM-1224,6/3/2014,0,0,0,1728,0,0,1728
29859,RM-1224,6/4/2014,0,0,0,1728,0,0,1728
29860,RM-1224,6/5/2014,0,0,0,1728,0,0,1728
29861,RM-1224,6/6/2014,0,0,0,1728,0,0,1728
29862,RM-1224,6/7/2014,0,0,0,1728,0,0,1728
29863,RM-1224,6/8/2014,0,0,0,1728,0,0,1728
29864,RM-1224,6/9/2014,0,0,0,1728,0,0,1728
29865,RM-1224,6/10/2014,0,0,0,1728,0,0,1728
29867,RM-1224,6/12/2014,0,0,0,1728,0,0,1728
29868,RM-1224,6/13/2014,0,0,0,1728,0,0,1728
29869,RM-1224,6/14/2014,0,0,0,1728,0,0,1728
29870,RM-1224,6/15/2014,0,0,0,1728,0,0,1728
29871,RM-1224,6/16/2014,0,0,0,1728,0,0,1728
29872,RM-1224,6/17/2014,0,0,0,1728,0,0,1728
29873,RM-1224,6/18/2014,0,0,0,1728,0,0,1728
29874,RM-1224,6/19/2014,0,0,0,1728,0,0,1728
29875,RM-1224,6/20/2014,0,0,0,1728,0,0,1728
29876,RM-1224,6/21/2014,0,0,0,1728,0,0,1728
29877,RM-1224,6/22/2014,0,0,0,1728,0,0,1728
29878,RM-1224,6/23/2014,0,0,0,1728,0,0,1728
29879,RM-1224,6/24/2014,0,0,0,1728,0,0,1728
29880,RM-1224,6/25/2014,0,0,0,1728,0,0,1728
29881,RM-1224,6/26/2014,0,0,0,1728,0,0,1728
29882,RM-1224,6/27/2014,0,0,0,1728,0,0,1728
29883,RM-1224,6/28/2014,0,0,0,1728,0,0,1728
29885,RM-1224,6/30/2014,0,0,0,1728,0,0,1728
29886,RM-1224,7/1/2014,0,0,0,1728,0,0,1728
31145,RM-1230,4/11/2014,0,1728,0,0,0,0,1728
31146,RM-1230,4/12/2014,0,1728,0,0,0,0,1728
31147,RM-1230,4/13/2014,0,1728,0,0,0,0,1728
31148,RM-1230,4/14/2014,0,1728,0,0,0,0,1728
31149,RM-1230,4/15/2014,0,1728,0,0,0,0,1728
31150,RM-1230,4/16/2014,0,1728,0,0,0,0,1728
31151,RM-1230,4/17/2014,0,1728,0,0,0,0,1728
31152,RM-1230,4/18/2014,0,1728,0,0,0,0,1728
31153,RM-1230,4/19/2014,0,1728,0,0,0,0,1728
31154,RM-1230,4/20/2014,0,1728,0,0,0,0,1728
31155,RM-1230,4/21/2014,0,1728,0,0,0,0,1728
31156,RM-1230,4/22/2014,0,1728,0,0,0,0,1728
31157,RM-1230,4/23/2014,0,1728,0,0,0,0,1728
31158,RM-1230,4/24/2014,0,1728,0,0,0,0,1728
31159,RM-1230,4/25/2014,0,1728,0,0,0,0,1728
31160,RM-1230,4/26/2014,0,1728,0,0,0,0,1728
31161,RM-1230,4/27/2014,0,1728,0,0,0,0,1728
31162,RM-1230,4/28/2014,0,1728,0,0,0,0,1728
31163,RM-1230,4/29/2014,0,1728,0,0,0,0,1728
31164,RM-1230,4/30/2014,0,1728,0,0,0,0,1728
31165,RM-1230,5/1/2014,0,1728,0,0,0,0,1728
31166,RM-1230,5/2/2014,0,1728,0,0,0,0,1728
31167,RM-1230,5/3/2014,0,1728,0,0,0,0,1728
31168,RM-1230,5/4/2014,0,1728,0,0,0,0,1728
31182,RM-1230,5/18/2014,0,1728,0,0,0,0,1728
31183,RM-1230,5/19/2014,0,1728,0,0,0,0,1728
31184,RM-1230,5/20/2014,0,1728,0,0,0,0,1728
31185,RM-1230,5/21/2014,0,1728,0,0,0,0,1728
31186,RM-1230,5/22/2014,0,1728,0,0,0,0,1728
31187,RM-1230,5/23/2014,0,1728,0,0,0,0,1728
31188,RM-1230,5/24/2014,0,1728,0,0,0,0,1728
31189,RM-1230,5/25/2014,0,1728,0,0,0,0,1728
31190,RM-1230,5/26/2014,0,1728,0,0,0,0,1728
31191,RM-1230,5/27/2014,0,1728,0,0,0,0,1728
31192,RM-1230,5/28/2014,0,1728,0,0,0,0,1728
31193,RM-1230,5/29/2014,0,1728,0,0,0,0,1728
31194,RM-1230,5/30/2014,0,1728,0,0,0,0,1728
31195,RM-1230,5/31/2014,0,1728,0,0,0,0,1728
31196,RM-1230,6/1/2014,0,1728,0,0,0,0,1728
31197,RM-1230,6/2/2014,0,1728,0,0,0,0,1728
31198,RM-1230,6/3/2014,0,1728,0,0,0,0,1728
31199,RM-1230,6/4/2014,0,1728,0,0,0,0,1728
31200,RM-1230,6/5/2014,0,1728,0,0,0,0,1728
31201,RM-1230,6/6/2014,0,1728,0,0,0,0,1728
31202,RM-1230,6/7/2014,0,1728,0,0,0,0,1728
31203,RM-1230,6/8/2014,0,1728,0,0,0,0,1728
31204,RM-1230,6/9/2014,0,1728,0,0,0,0,1728
31205,RM-1230,6/10/2014,0,1728,0,0,0,0,1728
31207,RM-1230,6/12/2014,0,1728,0,0,0,0,1728
31208,RM-1230,6/13/2014,0,1728,0,0,0,0,1728
31209,RM-1230,6/14/2014,0,1728,0,0,0,0,1728
31210,RM-1230,6/15/2014,0,1728,0,0,0,0,1728
31211,RM-1230,6/16/2014,0,1728,0,0,0,0,1728
31212,RM-1230,6/17/2014,0,1728,0,0,0,0,1728
31213,RM-1230,6/18/2014,0,1728,0,0,0,0,1728
31214,RM-1230,6/19/2014,0,1728,0,0,0,0,1728
31215,RM-1230,6/20/2014,0,1728,0,0,0,0,1728
31216,RM-1230,6/21/2014,0,1728,0,0,0,0,1728
31217,RM-1230,6/22/2014,0,1728,0,0,0,0,1728
31218,RM-1230,6/23/2014,0,1728,0,0,0,0,1728
31219,RM-1230,6/24/2014,0,1728,0,0,0,0,1728
31220,RM-1230,6/25/2014,0,1728,0,0,0,0,1728
31221,RM-1230,6/26/2014,0,1728,0,0,0,0,1728
31222,RM-1230,6/27/2014,0,1728,0,0,0,0,1728
31223,RM-1230,6/28/2014,0,1728,0,0,0,0,1728
31225,RM-1230,6/30/2014,0,1728,0,0,0,0,1728
31226,RM-1230,7/1/2014,0,1728,0,0,0,0,1728
32550,RM-1236,5/11/2014,0,786,942,0,0,0,1728
32646,RM-1236,8/15/2014,864,0,864,0,0,0,1728
34385,RM-B103,1/17/2014,0,0,0,1728,0,0,1728
34387,RM-B103,1/19/2014,0,0,0,1728,0,0,1728
34391,RM-B103,1/23/2014,0,0,0,1728,0,0,1728
34392,RM-B103,1/24/2014,0,0,0,1728,0,0,1728
34397,RM-B103,1/29/2014,0,0,0,1728,0,0,1728
34401,RM-B103,2/2/2014,0,0,0,1728,0,0,1728
34402,RM-B103,2/3/2014,0,0,0,1728,0,0,1728
34403,RM-B103,2/4/2014,0,0,0,1728,0,0,1728
34404,RM-B103,2/5/2014,0,0,0,1728,0,0,1728
34405,RM-B103,2/6/2014,0,0,0,1728,0,0,1728
34407,RM-B103,2/8/2014,0,0,0,1728,0,0,1728
34408,RM-B103,2/9/2014,0,0,0,1728,0,0,1728
34409,RM-B103,2/10/2014,0,0,0,1728,0,0,1728
34410,RM-B103,2/11/2014,0,0,0,1728,0,0,1728
34413,RM-B103,2/14/2014,0,0,0,1728,0,0,1728
34414,RM-B103,2/15/2014,0,0,0,1728,0,0,1728
34415,RM-B103,2/16/2014,0,0,0,1728,0,0,1728
34416,RM-B103,2/17/2014,0,0,0,1728,0,0,1728
34417,RM-B103,2/18/2014,0,0,0,1728,0,0,1728
34418,RM-B103,2/19/2014,0,0,0,1728,0,0,1728
34419,RM-B103,2/20/2014,0,0,0,1728,0,0,1728
34420,RM-B103,2/21/2014,0,0,0,1728,0,0,1728
34421,RM-B103,2/22/2014,0,0,0,1728,0,0,1728
34422,RM-B103,2/23/2014,0,0,0,1728,0,0,1728
34423,RM-B103,2/24/2014,0,0,0,1728,0,0,1728
34424,RM-B103,2/25/2014,0,0,0,1728,0,0,1728
34425,RM-B103,2/26/2014,0,0,0,1728,0,0,1728
34426,RM-B103,2/27/2014,0,0,0,1728,0,0,1728
34427,RM-B103,2/28/2014,0,0,0,1728,0,0,1728
34428,RM-B103,3/1/2014,0,0,0,1728,0,0,1728
34431,RM-B103,3/4/2014,0,0,0,1728,0,0,1728
34432,RM-B103,3/5/2014,0,0,0,1728,0,0,1728
34433,RM-B103,3/6/2014,0,0,0,1728,0,0,1728
34434,RM-B103,3/7/2014,0,0,0,1728,0,0,1728
34438,RM-B103,3/11/2014,0,0,0,1728,0,0,1728
34439,RM-B103,3/12/2014,0,0,0,1728,0,0,1728
34440,RM-B103,3/13/2014,0,0,0,1728,0,0,1728
34441,RM-B103,3/14/2014,0,0,0,1728,0,0,1728
34442,RM-B103,3/15/2014,0,0,0,1728,0,0,1728
34443,RM-B103,3/16/2014,0,0,0,1728,0,0,1728
34444,RM-B103,3/17/2014,0,0,0,1728,0,0,1728
34445,RM-B103,3/18/2014,0,0,0,1728,0,0,1728
34446,RM-B103,3/19/2014,0,0,0,1728,0,0,1728
34544,RM-B103,6/26/2014,0,0,0,1728,0,0,1728
34545,RM-B103,6/27/2014,0,0,0,1728,0,0,1728
34548,RM-B103,6/30/2014,0,0,0,1728,0,0,1728
35201,RM-B103A,6/3/2014,0,0,0,1728,0,0,1728
35202,RM-B103A,6/4/2014,0,0,0,1728,0,0,1728
35204,RM-B103A,6/6/2014,0,0,0,1728,0,0,1728
35205,RM-B103A,6/7/2014,0,0,0,1728,0,0,1728
35206,RM-B103A,6/8/2014,0,0,0,1728,0,0,1728
35207,RM-B103A,6/9/2014,0,0,0,1728,0,0,1728
35208,RM-B103A,6/10/2014,0,0,0,1728,0,0,1728
35210,RM-B103A,6/12/2014,0,0,0,1728,0,0,1728
35211,RM-B103A,6/13/2014,0,0,0,1728,0,0,1728
35212,RM-B103A,6/14/2014,0,0,0,1728,0,0,1728
35213,RM-B103A,6/15/2014,0,0,0,1728,0,0,1728
35214,RM-B103A,6/16/2014,0,0,0,1728,0,0,1728
35215,RM-B103A,6/17/2014,0,0,0,1728,0,0,1728
35216,RM-B103A,6/18/2014,0,0,0,1728,0,0,1728
35217,RM-B103A,6/19/2014,0,0,0,1728,0,0,1728
35218,RM-B103A,6/20/2014,0,0,0,1728,0,0,1728
35219,RM-B103A,6/21/2014,0,0,0,1728,0,0,1728
35220,RM-B103A,6/22/2014,0,0,0,1728,0,0,1728
35221,RM-B103A,6/23/2014,0,0,0,1728,0,0,1728
35222,RM-B103A,6/24/2014,0,0,0,1728,0,0,1728
35223,RM-B103A,6/25/2014,0,0,0,1728,0,0,1728
35224,RM-B103A,6/26/2014,0,0,0,1728,0,0,1728
35225,RM-B103A,6/27/2014,0,0,0,1728,0,0,1728
35228,RM-B103A,6/30/2014,0,0,0,1728,0,0,1728
35613,RM-B109,1/17/2014,0,1728,0,0,0,0,1728
35708,RM-B109,4/22/2014,864,0,864,0,0,0,1728
35808,RM-B109,7/31/2014,864,0,864,0,0,0,1728
35823,RM-B109,8/15/2014,864,0,864,0,0,0,1728
35926,RM-B109,11/28/2014,864,0,864,0,0,0,1728
35927,RM-B109,11/29/2014,864,0,864,0,0,0,1728
35969,RM-B109,1/10/2015,864,0,864,0,0,0,1728
36003,RM-B109,2/13/2015,864,0,864,0,0,0,1728
36009,RM-B109,2/19/2015,864,0,864,0,0,0,1728
36010,RM-B109,2/20/2015,864,0,864,0,0,0,1728
36015,RM-B109,2/25/2015,864,0,864,0,0,0,1728
36018,RM-B109,2/28/2015,864,0,864,0,0,0,1728
36371,RM-B200B,3/29/2014,0,1728,0,0,0,0,1728
36372,RM-B200B,3/30/2014,0,1728,0,0,0,0,1728
36373,RM-B200B,3/31/2014,0,1728,0,0,0,0,1728
36374,RM-B200B,4/1/2014,0,1728,0,0,0,0,1728
36376,RM-B200B,4/3/2014,0,1728,0,0,0,0,1728
36377,RM-B200B,4/4/2014,0,1728,0,0,0,0,1728
36378,RM-B200B,4/5/2014,0,1728,0,0,0,0,1728
36379,RM-B200B,4/6/2014,0,1728,0,0,0,0,1728
36380,RM-B200B,4/7/2014,0,1728,0,0,0,0,1728
36381,RM-B200B,4/8/2014,0,1728,0,0,0,0,1728
36382,RM-B200B,4/9/2014,0,1728,0,0,0,0,1728
36383,RM-B200B,4/10/2014,0,1728,0,0,0,0,1728
36384,RM-B200B,4/11/2014,0,1728,0,0,0,0,1728
36385,RM-B200B,4/12/2014,0,1728,0,0,0,0,1728
36386,RM-B200B,4/13/2014,0,1728,0,0,0,0,1728
36387,RM-B200B,4/14/2014,0,1728,0,0,0,0,1728
36388,RM-B200B,4/15/2014,0,1728,0,0,0,0,1728
36389,RM-B200B,4/16/2014,0,1728,0,0,0,0,1728
36390,RM-B200B,4/17/2014,0,1728,0,0,0,0,1728
36391,RM-B200B,4/18/2014,0,1728,0,0,0,0,1728
36392,RM-B200B,4/19/2014,0,1728,0,0,0,0,1728
36393,RM-B200B,4/20/2014,0,1728,0,0,0,0,1728
36394,RM-B200B,4/21/2014,0,1728,0,0,0,0,1728
36395,RM-B200B,4/22/2014,0,1728,0,0,0,0,1728
36396,RM-B200B,4/23/2014,0,1728,0,0,0,0,1728
36397,RM-B200B,4/24/2014,0,1728,0,0,0,0,1728
36398,RM-B200B,4/25/2014,0,1728,0,0,0,0,1728
36399,RM-B200B,4/26/2014,0,1728,0,0,0,0,1728
36400,RM-B200B,4/27/2014,0,1728,0,0,0,0,1728
36401,RM-B200B,4/28/2014,0,1728,0,0,0,0,1728
36402,RM-B200B,4/29/2014,0,1728,0,0,0,0,1728
36403,RM-B200B,4/30/2014,0,1728,0,0,0,0,1728
36404,RM-B200B,5/1/2014,0,1728,0,0,0,0,1728
36405,RM-B200B,5/2/2014,0,1728,0,0,0,0,1728
36406,RM-B200B,5/3/2014,0,1728,0,0,0,0,1728
36407,RM-B200B,5/4/2014,0,1728,0,0,0,0,1728
36421,RM-B200B,5/18/2014,0,1728,0,0,0,0,1728
36422,RM-B200B,5/19/2014,0,1728,0,0,0,0,1728
36423,RM-B200B,5/20/2014,0,1728,0,0,0,0,1728
36424,RM-B200B,5/21/2014,0,1728,0,0,0,0,1728
36425,RM-B200B,5/22/2014,0,1728,0,0,0,0,1728
36426,RM-B200B,5/23/2014,0,1728,0,0,0,0,1728
36427,RM-B200B,5/24/2014,0,1728,0,0,0,0,1728
36428,RM-B200B,5/25/2014,0,1728,0,0,0,0,1728
36429,RM-B200B,5/26/2014,0,1728,0,0,0,0,1728
36430,RM-B200B,5/27/2014,0,1728,0,0,0,0,1728
36431,RM-B200B,5/28/2014,0,1728,0,0,0,0,1728
36432,RM-B200B,5/29/2014,0,1728,0,0,0,0,1728
36433,RM-B200B,5/30/2014,0,1728,0,0,0,0,1728
36434,RM-B200B,5/31/2014,0,1728,0,0,0,0,1728
36435,RM-B200B,6/1/2014,0,1728,0,0,0,0,1728
36436,RM-B200B,6/2/2014,0,1728,0,0,0,0,1728
36437,RM-B200B,6/3/2014,0,1728,0,0,0,0,1728
36438,RM-B200B,6/4/2014,0,1728,0,0,0,0,1728
36439,RM-B200B,6/5/2014,0,1728,0,0,0,0,1728
36440,RM-B200B,6/6/2014,0,1728,0,0,0,0,1728
36441,RM-B200B,6/7/2014,0,1728,0,0,0,0,1728
36442,RM-B200B,6/8/2014,0,1728,0,0,0,0,1728
36443,RM-B200B,6/9/2014,0,1728,0,0,0,0,1728
36444,RM-B200B,6/10/2014,0,1728,0,0,0,0,1728
36446,RM-B200B,6/12/2014,0,1728,0,0,0,0,1728
36447,RM-B200B,6/13/2014,0,1728,0,0,0,0,1728
36448,RM-B200B,6/14/2014,0,1728,0,0,0,0,1728
36449,RM-B200B,6/15/2014,0,1728,0,0,0,0,1728
36450,RM-B200B,6/16/2014,0,1728,0,0,0,0,1728
36451,RM-B200B,6/17/2014,0,1728,0,0,0,0,1728
36452,RM-B200B,6/18/2014,0,1728,0,0,0,0,1728
36453,RM-B200B,6/19/2014,0,1728,0,0,0,0,1728
36454,RM-B200B,6/20/2014,0,1728,0,0,0,0,1728
36455,RM-B200B,6/21/2014,0,1728,0,0,0,0,1728
36456,RM-B200B,6/22/2014,0,1728,0,0,0,0,1728
36457,RM-B200B,6/23/2014,0,1728,0,0,0,0,1728
36458,RM-B200B,6/24/2014,0,1728,0,0,0,0,1728
36459,RM-B200B,6/25/2014,0,1728,0,0,0,0,1728
36460,RM-B200B,6/26/2014,0,1728,0,0,0,0,1728
36461,RM-B200B,6/27/2014,0,1728,0,0,0,0,1728
37076,RM-B200C,4/22/2014,864,0,864,0,0,0,1728
41886,RM-B230,4/22/2014,864,0,864,0,0,0,1728
43727,RM-B240A,1/17/2014,0,1728,0,0,0,0,1728
43729,RM-B240A,1/19/2014,0,1728,0,0,0,0,1728
43733,RM-B240A,1/23/2014,0,1728,0,0,0,0,1728
43734,RM-B240A,1/24/2014,0,1728,0,0,0,0,1728
43739,RM-B240A,1/29/2014,0,1728,0,0,0,0,1728
43743,RM-B240A,2/2/2014,0,1728,0,0,0,0,1728
43744,RM-B240A,2/3/2014,0,1728,0,0,0,0,1728
43745,RM-B240A,2/4/2014,0,1728,0,0,0,0,1728
43746,RM-B240A,2/5/2014,0,1728,0,0,0,0,1728
43747,RM-B240A,2/6/2014,0,1728,0,0,0,0,1728
43749,RM-B240A,2/8/2014,0,1728,0,0,0,0,1728
43750,RM-B240A,2/9/2014,0,1728,0,0,0,0,1728
43751,RM-B240A,2/10/2014,0,1728,0,0,0,0,1728
43752,RM-B240A,2/11/2014,0,1728,0,0,0,0,1728
43755,RM-B240A,2/14/2014,0,1728,0,0,0,0,1728
43756,RM-B240A,2/15/2014,0,1728,0,0,0,0,1728
43757,RM-B240A,2/16/2014,0,1728,0,0,0,0,1728
43758,RM-B240A,2/17/2014,0,1728,0,0,0,0,1728
43759,RM-B240A,2/18/2014,0,1728,0,0,0,0,1728
43760,RM-B240A,2/19/2014,0,1728,0,0,0,0,1728
43761,RM-B240A,2/20/2014,0,1728,0,0,0,0,1728
43762,RM-B240A,2/21/2014,0,1728,0,0,0,0,1728
43763,RM-B240A,2/22/2014,0,1728,0,0,0,0,1728
43764,RM-B240A,2/23/2014,0,1728,0,0,0,0,1728
43765,RM-B240A,2/24/2014,0,1728,0,0,0,0,1728
43766,RM-B240A,2/25/2014,0,1728,0,0,0,0,1728
43767,RM-B240A,2/26/2014,0,1728,0,0,0,0,1728
43768,RM-B240A,2/27/2014,0,1728,0,0,0,0,1728
43769,RM-B240A,2/28/2014,0,1728,0,0,0,0,1728
43770,RM-B240A,3/1/2014,0,1728,0,0,0,0,1728
43773,RM-B240A,3/4/2014,0,1728,0,0,0,0,1728
43774,RM-B240A,3/5/2014,0,1728,0,0,0,0,1728
43824,RM-B240A,4/24/2014,0,1728,0,0,0,0,1728
43825,RM-B240A,4/25/2014,0,1728,0,0,0,0,1728
43826,RM-B240A,4/26/2014,0,1728,0,0,0,0,1728
43827,RM-B240A,4/27/2014,0,1728,0,0,0,0,1728
43828,RM-B240A,4/28/2014,0,1728,0,0,0,0,1728
43829,RM-B240A,4/29/2014,0,1728,0,0,0,0,1728
43830,RM-B240A,4/30/2014,0,1728,0,0,0,0,1728
43831,RM-B240A,5/1/2014,0,1728,0,0,0,0,1728
43832,RM-B240A,5/2/2014,0,1728,0,0,0,0,1728
43833,RM-B240A,5/3/2014,0,1728,0,0,0,0,1728
43834,RM-B240A,5/4/2014,0,1728,0,0,0,0,1728
43848,RM-B240A,5/18/2014,0,1728,0,0,0,0,1728
43849,RM-B240A,5/19/2014,0,1728,0,0,0,0,1728
43850,RM-B240A,5/20/2014,0,1728,0,0,0,0,1728
43851,RM-B240A,5/21/2014,0,1728,0,0,0,0,1728
43852,RM-B240A,5/22/2014,0,1728,0,0,0,0,1728
43853,RM-B240A,5/23/2014,0,1728,0,0,0,0,1728
43854,RM-B240A,5/24/2014,0,1728,0,0,0,0,1728
43855,RM-B240A,5/25/2014,0,1728,0,0,0,0,1728
43856,RM-B240A,5/26/2014,0,1728,0,0,0,0,1728
43857,RM-B240A,5/27/2014,0,1728,0,0,0,0,1728
43858,RM-B240A,5/28/2014,0,1728,0,0,0,0,1728
43859,RM-B240A,5/29/2014,0,1728,0,0,0,0,1728
43860,RM-B240A,5/30/2014,0,1728,0,0,0,0,1728
43861,RM-B240A,5/31/2014,0,1728,0,0,0,0,1728
43862,RM-B240A,6/1/2014,0,1728,0,0,0,0,1728
43863,RM-B240A,6/2/2014,0,1728,0,0,0,0,1728
43864,RM-B240A,6/3/2014,0,1728,0,0,0,0,1728
43865,RM-B240A,6/4/2014,0,1728,0,0,0,0,1728
43866,RM-B240A,6/5/2014,0,1728,0,0,0,0,1728
43867,RM-B240A,6/6/2014,0,1728,0,0,0,0,1728
43868,RM-B240A,6/7/2014,0,1728,0,0,0,0,1728
43869,RM-B240A,6/8/2014,0,1728,0,0,0,0,1728
43870,RM-B240A,6/9/2014,0,1728,0,0,0,0,1728
43871,RM-B240A,6/10/2014,0,1728,0,0,0,0,1728
43873,RM-B240A,6/12/2014,0,1728,0,0,0,0,1728
43874,RM-B240A,6/13/2014,0,1728,0,0,0,0,1728
43875,RM-B240A,6/14/2014,0,1728,0,0,0,0,1728
43876,RM-B240A,6/15/2014,0,1728,0,0,0,0,1728
43877,RM-B240A,6/16/2014,0,1728,0,0,0,0,1728
43878,RM-B240A,6/17/2014,0,1728,0,0,0,0,1728
43879,RM-B240A,6/18/2014,0,1728,0,0,0,0,1728
43880,RM-B240A,6/19/2014,0,1728,0,0,0,0,1728
43881,RM-B240A,6/20/2014,0,1728,0,0,0,0,1728
43882,RM-B240A,6/21/2014,0,1728,0,0,0,0,1728
43883,RM-B240A,6/22/2014,0,1728,0,0,0,0,1728
43884,RM-B240A,6/23/2014,0,1728,0,0,0,0,1728
43885,RM-B240A,6/24/2014,0,1728,0,0,0,0,1728
43886,RM-B240A,6/25/2014,0,1728,0,0,0,0,1728
43887,RM-B240A,6/26/2014,0,1728,0,0,0,0,1728
43888,RM-B240A,6/27/2014,0,1728,0,0,0,0,1728
43891,RM-B240A,6/30/2014,0,1728,0,0,0,0,1728
45708,RM-B260,1/19/2014,0,0,0,1728,0,0,1728
45712,RM-B260,1/23/2014,0,0,0,1728,0,0,1728
45713,RM-B260,1/24/2014,0,0,0,1728,0,0,1728
45718,RM-B260,1/29/2014,0,0,0,1728,0,0,1728
45722,RM-B260,2/2/2014,0,0,0,1728,0,0,1728
45723,RM-B260,2/3/2014,0,0,0,1728,0,0,1728
45724,RM-B260,2/4/2014,0,0,0,1728,0,0,1728
45725,RM-B260,2/5/2014,0,0,0,1728,0,0,1728
45726,RM-B260,2/6/2014,0,0,0,1728,0,0,1728
45728,RM-B260,2/8/2014,0,0,0,1728,0,0,1728
45729,RM-B260,2/9/2014,0,0,0,1728,0,0,1728
45730,RM-B260,2/10/2014,0,0,0,1728,0,0,1728
45731,RM-B260,2/11/2014,0,0,0,1728,0,0,1728
45734,RM-B260,2/14/2014,0,0,0,1728,0,0,1728
45735,RM-B260,2/15/2014,0,0,0,1728,0,0,1728
45736,RM-B260,2/16/2014,0,0,0,1728,0,0,1728
45737,RM-B260,2/17/2014,0,0,0,1728,0,0,1728
45738,RM-B260,2/18/2014,0,0,0,1728,0,0,1728
45739,RM-B260,2/19/2014,0,0,0,1728,0,0,1728
45740,RM-B260,2/20/2014,0,0,0,1728,0,0,1728
45741,RM-B260,2/21/2014,0,0,0,1728,0,0,1728
45742,RM-B260,2/22/2014,0,0,0,1728,0,0,1728
45743,RM-B260,2/23/2014,0,0,0,1728,0,0,1728
45744,RM-B260,2/24/2014,0,0,0,1728,0,0,1728
45745,RM-B260,2/25/2014,0,0,0,1728,0,0,1728
45746,RM-B260,2/26/2014,0,0,0,1728,0,0,1728
45747,RM-B260,2/27/2014,0,0,0,1728,0,0,1728
45748,RM-B260,2/28/2014,0,0,0,1728,0,0,1728
45749,RM-B260,3/1/2014,0,0,0,1728,0,0,1728
45752,RM-B260,3/4/2014,0,0,0,1728,0,0,1728
45753,RM-B260,3/5/2014,0,0,0,1728,0,0,1728
45754,RM-B260,3/6/2014,0,0,0,1728,0,0,1728
45755,RM-B260,3/7/2014,0,0,0,1728,0,0,1728
45759,RM-B260,3/11/2014,0,0,0,1728,0,0,1728
45760,RM-B260,3/12/2014,0,0,0,1728,0,0,1728
45761,RM-B260,3/13/2014,0,0,0,1728,0,0,1728
45762,RM-B260,3/14/2014,0,0,0,1728,0,0,1728
45763,RM-B260,3/15/2014,0,0,0,1728,0,0,1728
45764,RM-B260,3/16/2014,0,0,0,1728,0,0,1728
45765,RM-B260,3/17/2014,0,0,0,1728,0,0,1728
45766,RM-B260,3/18/2014,0,0,0,1728,0,0,1728
45767,RM-B260,3/19/2014,0,0,0,1728,0,0,1728
45768,RM-B260,3/20/2014,0,0,0,1728,0,0,1728
45769,RM-B260,3/21/2014,0,0,0,1728,0,0,1728
45770,RM-B260,3/22/2014,0,0,0,1728,0,0,1728
45771,RM-B260,3/23/2014,0,0,0,1728,0,0,1728
45772,RM-B260,3/24/2014,0,0,0,1728,0,0,1728
45773,RM-B260,3/25/2014,0,0,0,1728,0,0,1728
45774,RM-B260,3/26/2014,0,0,0,1728,0,0,1728
45776,RM-B260,3/28/2014,0,0,0,1728,0,0,1728
45777,RM-B260,3/29/2014,0,0,0,1728,0,0,1728
45778,RM-B260,3/30/2014,0,0,0,1728,0,0,1728
45779,RM-B260,3/31/2014,0,0,0,1728,0,0,1728
45780,RM-B260,4/1/2014,0,0,0,1728,0,0,1728
45782,RM-B260,4/3/2014,0,0,0,1728,0,0,1728
45783,RM-B260,4/4/2014,0,0,0,1728,0,0,1728
45784,RM-B260,4/5/2014,0,0,0,1728,0,0,1728
45785,RM-B260,4/6/2014,0,0,0,1728,0,0,1728
45786,RM-B260,4/7/2014,0,0,0,1728,0,0,1728
45787,RM-B260,4/8/2014,0,0,0,1728,0,0,1728
45788,RM-B260,4/9/2014,0,0,0,1728,0,0,1728
45789,RM-B260,4/10/2014,0,0,0,1728,0,0,1728
45790,RM-B260,4/11/2014,0,0,0,1728,0,0,1728
45791,RM-B260,4/12/2014,0,0,0,1728,0,0,1728
45792,RM-B260,4/13/2014,0,0,0,1728,0,0,1728
45793,RM-B260,4/14/2014,0,0,0,1728,0,0,1728
45794,RM-B260,4/15/2014,0,0,0,1728,0,0,1728
45795,RM-B260,4/16/2014,0,0,0,1728,0,0,1728
45796,RM-B260,4/17/2014,0,0,0,1728,0,0,1728
45797,RM-B260,4/18/2014,0,0,0,1728,0,0,1728
45798,RM-B260,4/19/2014,0,0,0,1728,0,0,1728
45799,RM-B260,4/20/2014,0,0,0,1728,0,0,1728
45800,RM-B260,4/21/2014,0,0,0,1728,0,0,1728
45801,RM-B260,4/22/2014,0,0,0,1728,0,0,1728
45802,RM-B260,4/23/2014,0,0,0,1728,0,0,1728
45803,RM-B260,4/24/2014,0,0,0,1728,0,0,1728
45804,RM-B260,4/25/2014,0,0,0,1728,0,0,1728
45805,RM-B260,4/26/2014,0,0,0,1728,0,0,1728
45806,RM-B260,4/27/2014,0,0,0,1728,0,0,1728
45807,RM-B260,4/28/2014,0,0,0,1728,0,0,1728
45808,RM-B260,4/29/2014,0,0,0,1728,0,0,1728
45809,RM-B260,4/30/2014,0,0,0,1728,0,0,1728
45810,RM-B260,5/1/2014,0,0,0,1728,0,0,1728
45811,RM-B260,5/2/2014,0,0,0,1728,0,0,1728
45812,RM-B260,5/3/2014,0,0,0,1728,0,0,1728
45813,RM-B260,5/4/2014,0,0,0,1728,0,0,1728
46019,RM-B260,11/28/2014,864,0,864,0,0,0,1728
46020,RM-B260,11/29/2014,864,0,864,0,0,0,1728
47168,RM-B270,4/19/2014,0,0,0,1728,0,0,1728
47169,RM-B270,4/20/2014,0,0,0,1728,0,0,1728
47170,RM-B270,4/21/2014,0,0,0,1728,0,0,1728
47171,RM-B270,4/22/2014,0,0,0,1728,0,0,1728
47172,RM-B270,4/23/2014,0,0,0,1728,0,0,1728
47173,RM-B270,4/24/2014,0,0,0,1728,0,0,1728
47174,RM-B270,4/25/2014,0,0,0,1728,0,0,1728
47175,RM-B270,4/26/2014,0,0,0,1728,0,0,1728
47176,RM-B270,4/27/2014,0,0,0,1728,0,0,1728
47177,RM-B270,4/28/2014,0,0,0,1728,0,0,1728
47178,RM-B270,4/29/2014,0,0,0,1728,0,0,1728
47179,RM-B270,4/30/2014,0,0,0,1728,0,0,1728
47180,RM-B270,5/1/2014,0,0,0,1728,0,0,1728
47181,RM-B270,5/2/2014,0,0,0,1728,0,0,1728
47182,RM-B270,5/3/2014,0,0,0,1728,0,0,1728
47183,RM-B270,5/4/2014,0,0,0,1728,0,0,1728
47197,RM-B270,5/18/2014,0,0,0,1728,0,0,1728
47198,RM-B270,5/19/2014,0,0,0,1728,0,0,1728
47199,RM-B270,5/20/2014,0,0,0,1728,0,0,1728
47200,RM-B270,5/21/2014,0,0,0,1728,0,0,1728
47201,RM-B270,5/22/2014,0,0,0,1728,0,0,1728
47202,RM-B270,5/23/2014,0,0,0,1728,0,0,1728
47203,RM-B270,5/24/2014,0,0,0,1728,0,0,1728
47204,RM-B270,5/25/2014,0,0,0,1728,0,0,1728
47205,RM-B270,5/26/2014,0,0,0,1728,0,0,1728
47206,RM-B270,5/27/2014,0,0,0,1728,0,0,1728
47207,RM-B270,5/28/2014,0,0,0,1728,0,0,1728
47208,RM-B270,5/29/2014,0,0,0,1728,0,0,1728
47209,RM-B270,5/30/2014,0,0,0,1728,0,0,1728
47210,RM-B270,5/31/2014,0,0,0,1728,0,0,1728
47211,RM-B270,6/1/2014,0,0,0,1728,0,0,1728
47212,RM-B270,6/2/2014,0,0,0,1728,0,0,1728
47213,RM-B270,6/3/2014,0,0,0,1728,0,0,1728
47214,RM-B270,6/4/2014,0,0,0,1728,0,0,1728
47216,RM-B270,6/6/2014,0,0,0,1728,0,0,1728
47217,RM-B270,6/7/2014,0,0,0,1728,0,0,1728
47218,RM-B270,6/8/2014,0,0,0,1728,0,0,1728
47219,RM-B270,6/9/2014,0,0,0,1728,0,0,1728
47220,RM-B270,6/10/2014,0,0,0,1728,0,0,1728
47222,RM-B270,6/12/2014,0,0,0,1728,0,0,1728
47223,RM-B270,6/13/2014,0,0,0,1728,0,0,1728
47224,RM-B270,6/14/2014,0,0,0,1728,0,0,1728
47225,RM-B270,6/15/2014,0,0,0,1728,0,0,1728
47226,RM-B270,6/16/2014,0,0,0,1728,0,0,1728
47227,RM-B270,6/17/2014,0,0,0,1728,0,0,1728
47228,RM-B270,6/18/2014,0,0,0,1728,0,0,1728
47229,RM-B270,6/19/2014,0,0,0,1728,0,0,1728
47230,RM-B270,6/20/2014,0,0,0,1728,0,0,1728
47231,RM-B270,6/21/2014,0,0,0,1728,0,0,1728
47232,RM-B270,6/22/2014,0,0,0,1728,0,0,1728
47233,RM-B270,6/23/2014,0,0,0,1728,0,0,1728
47234,RM-B270,6/24/2014,0,0,0,1728,0,0,1728
47235,RM-B270,6/25/2014,0,0,0,1728,0,0,1728
47236,RM-B270,6/26/2014,0,0,0,1728,0,0,1728
47237,RM-B270,6/27/2014,0,0,0,1728,0,0,1728
47240,RM-B270,6/30/2014,0,0,0,1728,0,0,1728
190,RM-1100A,1/17/2014,0,1722,0,0,0,0,1722
193,RM-1100A,1/20/2014,0,1722,0,0,0,0,1722
211,RM-1100A,2/7/2014,0,1722,0,0,0,0,1722
216,RM-1100A,2/12/2014,0,1722,0,0,0,0,1722
234,RM-1100A,3/2/2014,0,1722,0,0,0,0,1722
1014,RM-1100D,6/5/2014,0,0,0,1722,0,0,1722
1020,RM-1100D,6/11/2014,0,0,0,1722,0,0,1722
1037,RM-1100D,6/28/2014,0,0,0,1722,0,0,1722
1038,RM-1100D,6/29/2014,0,0,0,1722,0,0,1722
1040,RM-1100D,7/1/2014,0,0,0,1722,0,0,1722
2248,RM-1104,1/20/2014,0,1722,0,0,0,0,1722
2254,RM-1104,1/26/2014,0,1722,0,0,0,0,1722
2258,RM-1104,1/30/2014,0,1722,0,0,0,0,1722
2266,RM-1104,2/7/2014,0,1722,0,0,0,0,1722
2271,RM-1104,2/12/2014,0,1722,0,0,0,0,1722
2289,RM-1104,3/2/2014,0,1722,0,0,0,0,1722
2297,RM-1104,3/10/2014,0,1722,0,0,0,0,1722
3031,RM-1106,6/11/2014,0,0,0,1722,0,0,1722
3049,RM-1106,6/29/2014,0,0,0,1722,0,0,1722
4281,RM-1108,2/12/2014,0,1722,0,0,0,0,1722
4299,RM-1108,3/2/2014,0,1722,0,0,0,0,1722
4400,RM-1108,6/11/2014,0,1722,0,0,0,0,1722
4418,RM-1108,6/29/2014,0,1722,0,0,0,0,1722
6649,RM-1113,12/22/2014,861,0,861,0,0,0,1722
7024,RM-1115,3/11/2014,861,0,0,0,0,861,1722
8491,RM-1117,6/11/2014,0,1722,0,0,0,0,1722
8509,RM-1117,6/29/2014,0,1722,0,0,0,0,1722
9760,RM-1123,3/2/2014,0,1722,0,0,0,0,1722
13735,RM-1133,3/2/2014,0,1722,0,0,0,0,1722
13854,RM-1133,6/29/2014,0,1722,0,0,0,0,1722
16825,RM-1150,1/17/2014,0,0,0,1722,0,0,1722
16828,RM-1150,1/20/2014,0,0,0,1722,0,0,1722
16834,RM-1150,1/26/2014,0,0,0,1722,0,0,1722
16838,RM-1150,1/30/2014,0,0,0,1722,0,0,1722
16869,RM-1150,3/2/2014,0,0,0,1722,0,0,1722
16970,RM-1150,6/11/2014,0,0,0,1722,0,0,1722
16988,RM-1150,6/29/2014,0,0,0,1722,0,0,1722
17510,RM-1151,1/17/2014,0,0,0,1722,0,0,1722
17513,RM-1151,1/20/2014,0,0,0,1722,0,0,1722
17519,RM-1151,1/26/2014,0,0,0,1722,0,0,1722
17523,RM-1151,1/30/2014,0,0,0,1722,0,0,1722
17531,RM-1151,2/7/2014,0,0,0,1722,0,0,1722
17536,RM-1151,2/12/2014,0,0,0,1722,0,0,1722
18936,RM-1155,3/11/2014,861,0,0,0,0,861,1722
19612,RM-1156,3/11/2014,861,0,0,0,0,861,1722
19958,RM-1156,2/22/2015,861,0,861,0,0,0,1722
19962,RM-1156,2/26/2015,861,0,861,0,0,0,1722
19963,RM-1156,2/27/2015,861,0,861,0,0,0,1722
20029,RM-1156,5/4/2015,861,0,861,0,0,0,1722
20030,RM-1156,5/5/2015,861,0,861,0,0,0,1722
20213,RM-1200A,1/17/2014,0,0,0,1722,0,0,1722
20216,RM-1200A,1/20/2014,0,0,0,1722,0,0,1722
20226,RM-1200A,1/30/2014,0,0,0,1722,0,0,1722
20234,RM-1200A,2/7/2014,0,0,0,1722,0,0,1722
20239,RM-1200A,2/12/2014,0,0,0,1722,0,0,1722
20257,RM-1200A,3/2/2014,0,0,0,1722,0,0,1722
20352,RM-1200A,6/5/2014,0,0,0,1722,0,0,1722
20358,RM-1200A,6/11/2014,0,0,0,1722,0,0,1722
20897,RM-1200B,2/7/2014,0,1722,0,0,0,0,1722
20902,RM-1200B,2/12/2014,0,1722,0,0,0,0,1722
20920,RM-1200B,3/2/2014,0,1722,0,0,0,0,1722
21723,RM-1200C,6/28/2014,0,0,0,1722,0,0,1722
21724,RM-1200C,6/29/2014,0,0,0,1722,0,0,1722
21726,RM-1200C,7/1/2014,0,0,0,1722,0,0,1722
22930,RM-1207,3/11/2014,861,0,0,0,0,861,1722
24988,RM-1212,3/11/2014,861,0,861,0,0,0,1722
27663,RM-1218,1/17/2014,0,0,0,1722,0,0,1722
27666,RM-1218,1/20/2014,0,0,0,1722,0,0,1722
27672,RM-1218,1/26/2014,0,0,0,1722,0,0,1722
27676,RM-1218,1/30/2014,0,0,0,1722,0,0,1722
27684,RM-1218,2/7/2014,0,0,0,1722,0,0,1722
27689,RM-1218,2/12/2014,0,0,0,1722,0,0,1722
27808,RM-1218,6/11/2014,0,0,0,1722,0,0,1722
27826,RM-1218,6/29/2014,0,0,0,1722,0,0,1722
29435,RM-1223,2/22/2015,861,0,861,0,0,0,1722
29439,RM-1223,2/26/2015,861,0,861,0,0,0,1722
29440,RM-1223,2/27/2015,861,0,861,0,0,0,1722
29866,RM-1224,6/11/2014,0,0,0,1722,0,0,1722
29884,RM-1224,6/29/2014,0,0,0,1722,0,0,1722
31206,RM-1230,6/11/2014,0,1722,0,0,0,0,1722
31224,RM-1230,6/29/2014,0,1722,0,0,0,0,1722
34388,RM-B103,1/20/2014,0,0,0,1722,0,0,1722
34398,RM-B103,1/30/2014,0,0,0,1722,0,0,1722
34406,RM-B103,2/7/2014,0,0,0,1722,0,0,1722
34411,RM-B103,2/12/2014,0,0,0,1722,0,0,1722
34429,RM-B103,3/2/2014,0,0,0,1722,0,0,1722
34546,RM-B103,6/28/2014,0,0,0,1722,0,0,1722
34547,RM-B103,6/29/2014,0,0,0,1722,0,0,1722
34549,RM-B103,7/1/2014,0,0,0,1722,0,0,1722
35203,RM-B103A,6/5/2014,0,0,0,1722,0,0,1722
35209,RM-B103A,6/11/2014,0,0,0,1722,0,0,1722
35226,RM-B103A,6/28/2014,0,0,0,1722,0,0,1722
35227,RM-B103A,6/29/2014,0,0,0,1722,0,0,1722
35229,RM-B103A,7/1/2014,0,0,0,1722,0,0,1722
35950,RM-B109,12/22/2014,861,0,861,0,0,0,1722
36012,RM-B109,2/22/2015,861,0,861,0,0,0,1722
36016,RM-B109,2/26/2015,861,0,861,0,0,0,1722
36017,RM-B109,2/27/2015,861,0,861,0,0,0,1722
36083,RM-B109,5/4/2015,861,0,861,0,0,0,1722
36084,RM-B109,5/5/2015,861,0,861,0,0,0,1722
36445,RM-B200B,6/11/2014,0,1722,0,0,0,0,1722
36462,RM-B200B,6/28/2014,0,1722,0,0,0,0,1722
37034,RM-B200C,3/11/2014,861,0,861,0,0,0,1722
43730,RM-B240A,1/20/2014,0,1722,0,0,0,0,1722
43748,RM-B240A,2/7/2014,0,1722,0,0,0,0,1722
43753,RM-B240A,2/12/2014,0,1722,0,0,0,0,1722
43771,RM-B240A,3/2/2014,0,1722,0,0,0,0,1722
43872,RM-B240A,6/11/2014,0,1722,0,0,0,0,1722
43889,RM-B240A,6/28/2014,0,1722,0,0,0,0,1722
43890,RM-B240A,6/29/2014,0,1722,0,0,0,0,1722
43892,RM-B240A,7/1/2014,0,1722,0,0,0,0,1722
45709,RM-B260,1/20/2014,0,0,0,1722,0,0,1722
45719,RM-B260,1/30/2014,0,0,0,1722,0,0,1722
45727,RM-B260,2/7/2014,0,0,0,1722,0,0,1722
45732,RM-B260,2/12/2014,0,0,0,1722,0,0,1722
45750,RM-B260,3/2/2014,0,0,0,1722,0,0,1722
47215,RM-B270,6/5/2014,0,0,0,1722,0,0,1722
47221,RM-B270,6/11/2014,0,0,0,1722,0,0,1722
47238,RM-B270,6/28/2014,0,0,0,1722,0,0,1722
47239,RM-B270,6/29/2014,0,0,0,1722,0,0,1722
47241,RM-B270,7/1/2014,0,0,0,1722,0,0,1722
24946,RM-1212,1/28/2014,858,0,861,0,0,0,1719
28362,RM-1221,1/28/2014,0,0,861,0,0,858,1719
36992,RM-B200C,1/28/2014,858,0,861,0,0,0,1719
199,RM-1100A,1/26/2014,0,1716,0,0,0,0,1716
201,RM-1100A,1/28/2014,0,1716,0,0,0,0,1716
203,RM-1100A,1/30/2014,0,1716,0,0,0,0,1716
217,RM-1100A,2/13/2014,0,1716,0,0,0,0,1716
235,RM-1100A,3/3/2014,0,1716,0,0,0,0,1716
242,RM-1100A,3/10/2014,0,1716,0,0,0,0,1716
2253,RM-1104,1/25/2014,0,1716,0,0,0,0,1716
2256,RM-1104,1/28/2014,0,1716,0,0,0,0,1716
2272,RM-1104,2/13/2014,0,1716,0,0,0,0,1716
2290,RM-1104,3/3/2014,0,1716,0,0,0,0,1716
4282,RM-1108,2/13/2014,0,1716,0,0,0,0,1716
4300,RM-1108,3/3/2014,0,1716,0,0,0,0,1716
6693,RM-1113,2/4/2015,858,0,858,0,0,0,1716
9761,RM-1123,3/3/2014,0,1716,0,0,0,0,1716
9768,RM-1123,3/10/2014,0,1716,0,0,0,0,1716
13736,RM-1133,3/3/2014,0,1716,0,0,0,0,1716
13743,RM-1133,3/10/2014,0,1716,0,0,0,0,1716
16833,RM-1150,1/25/2014,0,0,0,1716,0,0,1716
16836,RM-1150,1/28/2014,0,0,0,1716,0,0,1716
16870,RM-1150,3/3/2014,0,0,0,1716,0,0,1716
16877,RM-1150,3/10/2014,0,0,0,1716,0,0,1716
17518,RM-1151,1/25/2014,0,0,0,1716,0,0,1716
17521,RM-1151,1/28/2014,0,0,0,1716,0,0,1716
17537,RM-1151,2/13/2014,0,0,0,1716,0,0,1716
19950,RM-1156,2/14/2015,858,0,858,0,0,0,1716
19957,RM-1156,2/21/2015,858,0,858,0,0,0,1716
19959,RM-1156,2/23/2015,858,0,858,0,0,0,1716
19960,RM-1156,2/24/2015,858,0,858,0,0,0,1716
20026,RM-1156,5/1/2015,858,0,858,0,0,0,1716
20034,RM-1156,5/9/2015,858,0,858,0,0,0,1716
20036,RM-1156,5/11/2015,858,0,858,0,0,0,1716
20038,RM-1156,5/13/2015,858,0,858,0,0,0,1716
20041,RM-1156,5/16/2015,858,0,858,0,0,0,1716
20050,RM-1156,5/25/2015,858,0,858,0,0,0,1716
20222,RM-1200A,1/26/2014,0,0,0,1716,0,0,1716
20224,RM-1200A,1/28/2014,0,0,0,1716,0,0,1716
20240,RM-1200A,2/13/2014,0,0,0,1716,0,0,1716
20258,RM-1200A,3/3/2014,0,0,0,1716,0,0,1716
20265,RM-1200A,3/10/2014,0,0,0,1716,0,0,1716
20903,RM-1200B,2/13/2014,0,1716,0,0,0,0,1716
20921,RM-1200B,3/3/2014,0,1716,0,0,0,0,1716
20928,RM-1200B,3/10/2014,0,1716,0,0,0,0,1716
22888,RM-1207,1/28/2014,858,0,0,0,0,858,1716
27671,RM-1218,1/25/2014,0,0,0,1716,0,0,1716
27674,RM-1218,1/28/2014,0,0,0,1716,0,0,1716
27690,RM-1218,2/13/2014,0,0,0,1716,0,0,1716
29417,RM-1223,2/4/2015,858,0,858,0,0,0,1716
29427,RM-1223,2/14/2015,858,0,858,0,0,0,1716
29434,RM-1223,2/21/2015,858,0,858,0,0,0,1716
29436,RM-1223,2/23/2015,858,0,858,0,0,0,1716
29437,RM-1223,2/24/2015,858,0,858,0,0,0,1716
32549,RM-1236,5/10/2014,0,756,960,0,0,0,1716
34394,RM-B103,1/26/2014,0,0,0,1716,0,0,1716
34396,RM-B103,1/28/2014,0,0,0,1716,0,0,1716
34412,RM-B103,2/13/2014,0,0,0,1716,0,0,1716
34430,RM-B103,3/3/2014,0,0,0,1716,0,0,1716
34437,RM-B103,3/10/2014,0,0,0,1716,0,0,1716
35777,RM-B109,6/30/2014,855,0,861,0,0,0,1716
35994,RM-B109,2/4/2015,858,0,858,0,0,0,1716
36004,RM-B109,2/14/2015,858,0,858,0,0,0,1716
36011,RM-B109,2/21/2015,858,0,858,0,0,0,1716
36013,RM-B109,2/23/2015,858,0,858,0,0,0,1716
36014,RM-B109,2/24/2015,858,0,858,0,0,0,1716
36080,RM-B109,5/1/2015,858,0,858,0,0,0,1716
36088,RM-B109,5/9/2015,858,0,858,0,0,0,1716
36090,RM-B109,5/11/2015,858,0,858,0,0,0,1716
36092,RM-B109,5/13/2015,858,0,858,0,0,0,1716
36095,RM-B109,5/16/2015,858,0,858,0,0,0,1716
36104,RM-B109,5/25/2015,858,0,858,0,0,0,1716
43736,RM-B240A,1/26/2014,0,1716,0,0,0,0,1716
43738,RM-B240A,1/28/2014,0,1716,0,0,0,0,1716
43740,RM-B240A,1/30/2014,0,1716,0,0,0,0,1716
43754,RM-B240A,2/13/2014,0,1716,0,0,0,0,1716
43772,RM-B240A,3/3/2014,0,1716,0,0,0,0,1716
45714,RM-B260,1/25/2014,0,0,0,1716,0,0,1716
45715,RM-B260,1/26/2014,0,0,0,1716,0,0,1716
45717,RM-B260,1/28/2014,0,0,0,1716,0,0,1716
45733,RM-B260,2/13/2014,0,0,0,1716,0,0,1716
45751,RM-B260,3/3/2014,0,0,0,1716,0,0,1716
45758,RM-B260,3/10/2014,0,0,0,1716,0,0,1716
191,RM-1100A,1/18/2014,0,1710,0,0,0,0,1710
194,RM-1100A,1/21/2014,0,1710,0,0,0,0,1710
198,RM-1100A,1/25/2014,0,1710,0,0,0,0,1710
2246,RM-1104,1/18/2014,0,1710,0,0,0,0,1710
2249,RM-1104,1/21/2014,0,1710,0,0,0,0,1710
6677,RM-1113,1/19/2015,855,0,855,0,0,0,1710
16826,RM-1150,1/18/2014,0,0,0,1710,0,0,1710
16829,RM-1150,1/21/2014,0,0,0,1710,0,0,1710
17511,RM-1151,1/18/2014,0,0,0,1710,0,0,1710
17514,RM-1151,1/21/2014,0,0,0,1710,0,0,1710
19951,RM-1156,2/15/2015,855,0,855,0,0,0,1710
19953,RM-1156,2/17/2015,855,0,855,0,0,0,1710
19965,RM-1156,3/1/2015,855,0,855,0,0,0,1710
20022,RM-1156,4/27/2015,855,0,855,0,0,0,1710
20027,RM-1156,5/2/2015,855,0,855,0,0,0,1710
20031,RM-1156,5/6/2015,855,0,855,0,0,0,1710
20035,RM-1156,5/10/2015,855,0,855,0,0,0,1710
20037,RM-1156,5/12/2015,855,0,855,0,0,0,1710
20052,RM-1156,5/27/2015,855,0,855,0,0,0,1710
20054,RM-1156,5/29/2015,855,0,855,0,0,0,1710
20214,RM-1200A,1/18/2014,0,0,0,1710,0,0,1710
20217,RM-1200A,1/21/2014,0,0,0,1710,0,0,1710
20221,RM-1200A,1/25/2014,0,0,0,1710,0,0,1710
20755,RM-1200B,9/15/2013,0,0,0,0,0,1710,1710
27664,RM-1218,1/18/2014,0,0,0,1710,0,0,1710
27667,RM-1218,1/21/2014,0,0,0,1710,0,0,1710
29401,RM-1223,1/19/2015,855,0,855,0,0,0,1710
29428,RM-1223,2/15/2015,855,0,855,0,0,0,1710
29430,RM-1223,2/17/2015,855,0,855,0,0,0,1710
29442,RM-1223,3/1/2015,855,0,855,0,0,0,1710
34386,RM-B103,1/18/2014,0,0,0,1710,0,0,1710
34389,RM-B103,1/21/2014,0,0,0,1710,0,0,1710
34393,RM-B103,1/25/2014,0,0,0,1710,0,0,1710
35614,RM-B109,1/18/2014,0,1710,0,0,0,0,1710
35978,RM-B109,1/19/2015,855,0,855,0,0,0,1710
36005,RM-B109,2/15/2015,855,0,855,0,0,0,1710
36007,RM-B109,2/17/2015,855,0,855,0,0,0,1710
36019,RM-B109,3/1/2015,855,0,855,0,0,0,1710
36076,RM-B109,4/27/2015,855,0,855,0,0,0,1710
36081,RM-B109,5/2/2015,855,0,855,0,0,0,1710
36085,RM-B109,5/6/2015,855,0,855,0,0,0,1710
36089,RM-B109,5/10/2015,855,0,855,0,0,0,1710
36091,RM-B109,5/12/2015,855,0,855,0,0,0,1710
43728,RM-B240A,1/18/2014,0,1710,0,0,0,0,1710
43731,RM-B240A,1/21/2014,0,1710,0,0,0,0,1710
43735,RM-B240A,1/25/2014,0,1710,0,0,0,0,1710
45710,RM-B260,1/21/2014,0,0,0,1710,0,0,1710
2765,RM-1106,9/15/2013,0,0,0,0,0,1707,1707
3450,RM-1107,9/15/2013,0,0,1707,0,0,0,1707
6191,RM-1113,9/15/2013,0,0,1707,0,0,0,1707
6221,RM-1113,10/15/2013,852,0,855,0,0,0,1707
8910,RM-1122,9/15/2013,0,0,1707,0,0,0,1707
8940,RM-1122,10/15/2013,0,0,855,0,0,852,1707
9595,RM-1123,9/15/2013,0,0,1707,0,0,0,1707
12198,RM-1130,9/15/2013,0,0,0,0,0,1707,1707
13570,RM-1133,9/15/2013,0,0,1707,0,0,0,1707
15362,RM-1144,9/15/2013,0,0,0,0,0,1707,1707
18792,RM-1155,10/15/2013,852,0,855,0,0,0,1707
26854,RM-1217,9/15/2013,1707,0,0,0,0,0,1707
31625,RM-1231,9/15/2013,0,0,0,0,0,1707,1707
32345,RM-1236,10/15/2013,852,0,855,0,0,0,1707
34943,RM-B103A,9/15/2013,0,0,0,0,0,1707,1707
35182,RM-B103A,5/15/2014,873,0,0,834,0,0,1707
36179,RM-B200B,9/15/2013,0,0,0,0,0,1707,1707
40297,RM-B224,9/15/2013,0,0,0,0,0,1707,1707
40985,RM-B225,9/15/2013,0,0,0,0,0,1707,1707
42355,RM-B230A,9/15/2013,0,0,0,0,0,1707,1707
43606,RM-B240A,9/15/2013,0,0,0,0,0,1707,1707
44216,RM-B250,9/15/2013,1707,0,0,0,0,0,1707
44246,RM-B250,10/15/2013,852,0,855,0,0,0,1707
46955,RM-B270,9/15/2013,0,0,1707,0,0,0,1707
47653,RM-B275,10/15/2013,0,0,855,0,0,852,1707
944,RM-1100D,3/27/2014,0,0,0,1704,0,0,1704
2314,RM-1104,3/27/2014,0,1704,0,0,0,0,1704
6674,RM-1113,1/16/2015,852,0,852,0,0,0,1704
9785,RM-1123,3/27/2014,0,1704,0,0,0,0,1704
13760,RM-1133,3/27/2014,0,1704,0,0,0,0,1704
16894,RM-1150,3/27/2014,0,0,0,1704,0,0,1704
19972,RM-1156,3/8/2015,852,0,852,0,0,0,1704
20020,RM-1156,4/25/2015,852,0,852,0,0,0,1704
20021,RM-1156,4/26/2015,852,0,852,0,0,0,1704
20025,RM-1156,4/30/2015,852,0,852,0,0,0,1704
20032,RM-1156,5/7/2015,852,0,852,0,0,0,1704
20033,RM-1156,5/8/2015,852,0,852,0,0,0,1704
20039,RM-1156,5/14/2015,852,0,852,0,0,0,1704
20040,RM-1156,5/15/2015,852,0,852,0,0,0,1704
20042,RM-1156,5/17/2015,852,0,852,0,0,0,1704
20049,RM-1156,5/24/2015,852,0,852,0,0,0,1704
20055,RM-1156,5/30/2015,852,0,852,0,0,0,1704
20282,RM-1200A,3/27/2014,0,0,0,1704,0,0,1704
20945,RM-1200B,3/27/2014,0,1704,0,0,0,0,1704
23471,RM-1208,10/15/2013,852,0,0,0,0,852,1704
29398,RM-1223,1/16/2015,852,0,852,0,0,0,1704
35975,RM-B109,1/16/2015,852,0,852,0,0,0,1704
36020,RM-B109,3/2/2015,852,0,852,0,0,0,1704
36026,RM-B109,3/8/2015,852,0,852,0,0,0,1704
36074,RM-B109,4/25/2015,852,0,852,0,0,0,1704
36075,RM-B109,4/26/2015,852,0,852,0,0,0,1704
36079,RM-B109,4/30/2015,852,0,852,0,0,0,1704
36086,RM-B109,5/7/2015,852,0,852,0,0,0,1704
36087,RM-B109,5/8/2015,852,0,852,0,0,0,1704
36093,RM-B109,5/14/2015,852,0,852,0,0,0,1704
36094,RM-B109,5/15/2015,852,0,852,0,0,0,1704
36096,RM-B109,5/17/2015,852,0,852,0,0,0,1704
36103,RM-B109,5/24/2015,852,0,852,0,0,0,1704
38266,RM-B215,10/15/2013,852,0,0,0,0,852,1704
45775,RM-B260,3/27/2014,0,0,0,1704,0,0,1704
205,RM-1100A,2/1/2014,0,1698,0,0,0,0,1698
241,RM-1100A,3/9/2014,0,1698,0,0,0,0,1698
2260,RM-1104,2/1/2014,0,1698,0,0,0,0,1698
2296,RM-1104,3/9/2014,0,1698,0,0,0,0,1698
4306,RM-1108,3/9/2014,0,1698,0,0,0,0,1698
9767,RM-1123,3/9/2014,0,1698,0,0,0,0,1698
13742,RM-1133,3/9/2014,0,1698,0,0,0,0,1698
16840,RM-1150,2/1/2014,0,0,0,1698,0,0,1698
16876,RM-1150,3/9/2014,0,0,0,1698,0,0,1698
17525,RM-1151,2/1/2014,0,0,0,1698,0,0,1698
19952,RM-1156,2/16/2015,849,0,849,0,0,0,1698
19954,RM-1156,2/18/2015,849,0,849,0,0,0,1698
19966,RM-1156,3/2/2015,849,0,849,0,0,0,1698
19968,RM-1156,3/4/2015,849,0,849,0,0,0,1698
19970,RM-1156,3/6/2015,849,0,849,0,0,0,1698
19971,RM-1156,3/7/2015,849,0,849,0,0,0,1698
19973,RM-1156,3/9/2015,849,0,849,0,0,0,1698
20006,RM-1156,4/11/2015,849,0,849,0,0,0,1698
20008,RM-1156,4/13/2015,849,0,849,0,0,0,1698
20023,RM-1156,4/28/2015,849,0,849,0,0,0,1698
20024,RM-1156,4/29/2015,849,0,849,0,0,0,1698
20044,RM-1156,5/19/2015,849,0,849,0,0,0,1698
20046,RM-1156,5/21/2015,849,0,849,0,0,0,1698
20047,RM-1156,5/22/2015,849,0,849,0,0,0,1698
20048,RM-1156,5/23/2015,849,0,849,0,0,0,1698
20051,RM-1156,5/26/2015,849,0,849,0,0,0,1698
20053,RM-1156,5/28/2015,849,0,849,0,0,0,1698
20228,RM-1200A,2/1/2014,0,0,0,1698,0,0,1698
20264,RM-1200A,3/9/2014,0,0,0,1698,0,0,1698
20927,RM-1200B,3/9/2014,0,1698,0,0,0,0,1698
27678,RM-1218,2/1/2014,0,0,0,1698,0,0,1698
29429,RM-1223,2/16/2015,849,0,849,0,0,0,1698
29431,RM-1223,2/18/2015,849,0,849,0,0,0,1698
34400,RM-B103,2/1/2014,0,0,0,1698,0,0,1698
34436,RM-B103,3/9/2014,0,0,0,1698,0,0,1698
36006,RM-B109,2/16/2015,849,0,849,0,0,0,1698
36008,RM-B109,2/18/2015,849,0,849,0,0,0,1698
36022,RM-B109,3/4/2015,849,0,849,0,0,0,1698
36024,RM-B109,3/6/2015,849,0,849,0,0,0,1698
36025,RM-B109,3/7/2015,849,0,849,0,0,0,1698
36027,RM-B109,3/9/2015,849,0,849,0,0,0,1698
36060,RM-B109,4/11/2015,849,0,849,0,0,0,1698
36062,RM-B109,4/13/2015,849,0,849,0,0,0,1698
36077,RM-B109,4/28/2015,849,0,849,0,0,0,1698
36078,RM-B109,4/29/2015,849,0,849,0,0,0,1698
36098,RM-B109,5/19/2015,849,0,849,0,0,0,1698
36100,RM-B109,5/21/2015,849,0,849,0,0,0,1698
36101,RM-B109,5/22/2015,849,0,849,0,0,0,1698
36102,RM-B109,5/23/2015,849,0,849,0,0,0,1698
43742,RM-B240A,2/1/2014,0,1698,0,0,0,0,1698
45721,RM-B260,2/1/2014,0,0,0,1698,0,0,1698
45757,RM-B260,3/9/2014,0,0,0,1698,0,0,1698
3427,RM-1107,8/14/2013,0,0,1695,0,0,0,1695
6168,RM-1113,8/14/2013,0,0,1695,0,0,0,1695
8887,RM-1122,8/14/2013,0,0,1695,0,0,0,1695
9572,RM-1123,8/14/2013,0,0,1695,0,0,0,1695
12175,RM-1130,8/14/2013,0,0,0,0,0,1695,1695
13122,RM-1132,5/13/2014,0,0,837,858,0,0,1695
13547,RM-1133,8/14/2013,0,0,1695,0,0,0,1695
15339,RM-1144,8/14/2013,0,0,0,0,0,1695,1695
18051,RM-1154,8/14/2013,1695,0,0,0,0,0,1695
20732,RM-1200B,8/14/2013,0,0,0,0,0,1695,1695
25461,RM-1213,8/14/2013,0,0,1695,0,0,0,1695
26146,RM-1213A,8/14/2013,0,0,0,0,0,1695,1695
26831,RM-1217,8/14/2013,1695,0,0,0,0,0,1695
31602,RM-1231,8/14/2013,0,0,0,0,0,1695,1695
33704,RM-B102C,8/14/2013,0,0,1695,0,0,0,1695
34920,RM-B103A,8/14/2013,0,0,0,0,0,1695,1695
40962,RM-B225,8/14/2013,0,0,0,0,0,1695,1695
42332,RM-B230A,8/14/2013,0,0,0,0,0,1695,1695
43583,RM-B240A,8/14/2013,0,0,0,0,0,1695,1695
44193,RM-B250,8/14/2013,1695,0,0,0,0,0,1695
46932,RM-B270,8/14/2013,0,0,1695,0,0,0,1695
2250,RM-1104,1/22/2014,0,1692,0,0,0,0,1692
16830,RM-1150,1/22/2014,0,0,0,1692,0,0,1692
17515,RM-1151,1/22/2014,0,0,0,1692,0,0,1692
19967,RM-1156,3/3/2015,846,0,846,0,0,0,1692
19969,RM-1156,3/5/2015,846,0,846,0,0,0,1692
19974,RM-1156,3/10/2015,846,0,846,0,0,0,1692
19975,RM-1156,3/11/2015,846,0,846,0,0,0,1692
19976,RM-1156,3/12/2015,846,0,846,0,0,0,1692
19984,RM-1156,3/20/2015,846,0,846,0,0,0,1692
20007,RM-1156,4/12/2015,846,0,846,0,0,0,1692
20011,RM-1156,4/16/2015,846,0,846,0,0,0,1692
20019,RM-1156,4/24/2015,846,0,846,0,0,0,1692
21680,RM-1200C,5/16/2014,0,834,0,858,0,0,1692
27668,RM-1218,1/22/2014,0,0,0,1692,0,0,1692
36023,RM-B109,3/5/2015,846,0,846,0,0,0,1692
36028,RM-B109,3/10/2015,846,0,846,0,0,0,1692
36029,RM-B109,3/11/2015,846,0,846,0,0,0,1692
36030,RM-B109,3/12/2015,846,0,846,0,0,0,1692
36038,RM-B109,3/20/2015,846,0,846,0,0,0,1692
36061,RM-B109,4/12/2015,846,0,846,0,0,0,1692
36065,RM-B109,4/16/2015,846,0,846,0,0,0,1692
36073,RM-B109,4/24/2015,846,0,846,0,0,0,1692
240,RM-1100A,3/8/2014,0,1686,0,0,0,0,1686
2295,RM-1104,3/8/2014,0,1686,0,0,0,0,1686
4305,RM-1108,3/8/2014,0,1686,0,0,0,0,1686
9766,RM-1123,3/8/2014,0,1686,0,0,0,0,1686
13741,RM-1133,3/8/2014,0,1686,0,0,0,0,1686
16875,RM-1150,3/8/2014,0,0,0,1686,0,0,1686
19977,RM-1156,3/13/2015,843,0,843,0,0,0,1686
19986,RM-1156,3/22/2015,843,0,843,0,0,0,1686
20005,RM-1156,4/10/2015,843,0,843,0,0,0,1686
20009,RM-1156,4/14/2015,843,0,843,0,0,0,1686
20018,RM-1156,4/23/2015,843,0,843,0,0,0,1686
20043,RM-1156,5/18/2015,843,0,843,0,0,0,1686
20045,RM-1156,5/20/2015,843,0,843,0,0,0,1686
20263,RM-1200A,3/8/2014,0,0,0,1686,0,0,1686
20926,RM-1200B,3/8/2014,0,1686,0,0,0,0,1686
34435,RM-B103,3/8/2014,0,0,0,1686,0,0,1686
35709,RM-B109,4/23/2014,843,0,843,0,0,0,1686
36021,RM-B109,3/3/2015,843,0,843,0,0,0,1686
36031,RM-B109,3/13/2015,843,0,843,0,0,0,1686
36040,RM-B109,3/22/2015,843,0,843,0,0,0,1686
36059,RM-B109,4/10/2015,843,0,843,0,0,0,1686
36063,RM-B109,4/14/2015,843,0,843,0,0,0,1686
36072,RM-B109,4/23/2015,843,0,843,0,0,0,1686
36097,RM-B109,5/18/2015,843,0,843,0,0,0,1686
36099,RM-B109,5/20/2015,843,0,843,0,0,0,1686
37077,RM-B200C,4/23/2014,843,0,843,0,0,0,1686
41887,RM-B230,4/23/2014,843,0,843,0,0,0,1686
45756,RM-B260,3/8/2014,0,0,0,1686,0,0,1686
195,RM-1100A,1/22/2014,0,1680,0,0,0,0,1680
2243,RM-1104,1/15/2014,0,1680,0,0,0,0,1680
2255,RM-1104,1/27/2014,0,1680,0,0,0,0,1680
3412,RM-1107,7/30/2013,0,0,1680,0,0,0,1680
6153,RM-1113,7/30/2013,0,0,1680,0,0,0,1680
6692,RM-1113,2/3/2015,840,0,840,0,0,0,1680
8872,RM-1122,7/30/2013,0,0,1680,0,0,0,1680
12185,RM-1130,8/28/2013,0,0,0,0,0,1680,1680
13532,RM-1133,7/30/2013,0,0,1680,0,0,0,1680
15349,RM-1144,8/28/2013,0,0,0,0,0,1680,1680
16835,RM-1150,1/27/2014,0,0,0,1680,0,0,1680
17520,RM-1151,1/27/2014,0,0,0,1680,0,0,1680
18061,RM-1154,8/28/2013,1680,0,0,0,0,0,1680
19982,RM-1156,3/18/2015,840,0,840,0,0,0,1680
19985,RM-1156,3/21/2015,840,0,840,0,0,0,1680
19992,RM-1156,3/28/2015,840,0,840,0,0,0,1680
20010,RM-1156,4/15/2015,840,0,840,0,0,0,1680
20056,RM-1156,5/31/2015,840,0,840,0,0,0,1680
20218,RM-1200A,1/22/2014,0,0,0,1680,0,0,1680
20742,RM-1200B,8/28/2013,0,0,0,0,0,1680,1680
25446,RM-1213,7/30/2013,0,0,1680,0,0,0,1680
26841,RM-1217,8/28/2013,1680,0,0,0,0,0,1680
27673,RM-1218,1/27/2014,0,0,0,1680,0,0,1680
29416,RM-1223,2/3/2015,840,0,840,0,0,0,1680
31059,RM-1230,1/15/2014,0,1680,0,0,0,0,1680
31612,RM-1231,8/28/2013,0,0,0,0,0,1680,1680
33689,RM-B102C,7/30/2013,0,0,1680,0,0,0,1680
34390,RM-B103,1/22/2014,0,0,0,1680,0,0,1680
34930,RM-B103A,8/28/2013,0,0,0,0,0,1680,1680
35993,RM-B109,2/3/2015,840,0,840,0,0,0,1680
36036,RM-B109,3/18/2015,840,0,840,0,0,0,1680
36039,RM-B109,3/21/2015,840,0,840,0,0,0,1680
36046,RM-B109,3/28/2015,840,0,840,0,0,0,1680
36064,RM-B109,4/15/2015,840,0,840,0,0,0,1680
36066,RM-B109,4/17/2015,840,0,840,0,0,0,1680
37510,RM-B210,7/30/2013,0,0,1680,0,0,0,1680
40972,RM-B225,8/28/2013,0,0,0,0,0,1680,1680
42342,RM-B230A,8/28/2013,0,0,0,0,0,1680,1680
43593,RM-B240A,8/28/2013,0,0,0,0,0,1680,1680
43732,RM-B240A,1/22/2014,0,1680,0,0,0,0,1680
44203,RM-B250,8/28/2013,1680,0,0,0,0,0,1680
45711,RM-B260,1/22/2014,0,0,0,1680,0,0,1680
46917,RM-B270,7/30/2013,0,0,1680,0,0,0,1680
47585,RM-B275,7/30/2013,0,0,1680,0,0,0,1680
3437,RM-1107,8/28/2013,0,0,1677,0,0,0,1677
6178,RM-1113,8/28/2013,0,0,1677,0,0,0,1677
8897,RM-1122,8/28/2013,0,0,1677,0,0,0,1677
9582,RM-1123,8/28/2013,0,0,1677,0,0,0,1677
13557,RM-1133,8/28/2013,0,0,1677,0,0,0,1677
20717,RM-1200B,7/30/2013,0,0,0,0,0,1677,1677
24983,RM-1212,3/6/2014,837,0,840,0,0,0,1677
25471,RM-1213,8/28/2013,0,0,1677,0,0,0,1677
33714,RM-B102C,8/28/2013,0,0,1677,0,0,0,1677
37029,RM-B200C,3/6/2014,837,0,840,0,0,0,1677
46942,RM-B270,8/28/2013,0,0,1677,0,0,0,1677
2727,RM-1106,7/30/2013,1674,0,0,0,0,0,1674
5469,RM-1110,7/30/2013,0,0,0,0,0,1674,1674
7019,RM-1115,3/6/2014,837,0,0,0,0,837,1674
12160,RM-1130,7/30/2013,0,0,0,0,0,1674,1674
18036,RM-1154,7/30/2013,1674,0,0,0,0,0,1674
18931,RM-1155,3/6/2014,837,0,0,0,0,837,1674
19607,RM-1156,3/6/2014,837,0,0,0,0,837,1674
19948,RM-1156,2/12/2015,837,0,837,0,0,0,1674
19978,RM-1156,3/14/2015,837,0,837,0,0,0,1674
19981,RM-1156,3/17/2015,837,0,837,0,0,0,1674
19988,RM-1156,3/24/2015,837,0,837,0,0,0,1674
19991,RM-1156,3/27/2015,837,0,837,0,0,0,1674
20004,RM-1156,4/9/2015,837,0,837,0,0,0,1674
20012,RM-1156,4/17/2015,837,0,837,0,0,0,1674
20014,RM-1156,4/19/2015,837,0,837,0,0,0,1674
21559,RM-1200C,1/15/2014,0,1674,0,0,0,0,1674
22889,RM-1207,1/29/2014,837,0,0,0,0,837,1674
22925,RM-1207,3/6/2014,837,0,0,0,0,837,1674
24947,RM-1212,1/29/2014,837,0,837,0,0,0,1674
26131,RM-1213A,7/30/2013,0,0,0,0,0,1674,1674
28192,RM-1221,7/30/2013,0,0,0,0,0,1674,1674
28363,RM-1221,1/29/2014,0,0,837,0,0,837,1674
29425,RM-1223,2/12/2015,837,0,837,0,0,0,1674
31587,RM-1231,7/30/2013,0,0,0,0,0,1674,1674
34383,RM-B103,1/15/2014,0,0,0,1674,0,0,1674
34905,RM-B103A,7/30/2013,0,0,0,0,0,1674,1674
35611,RM-B109,1/15/2014,0,1674,0,0,0,0,1674
35729,RM-B109,5/13/2014,837,0,837,0,0,0,1674
36002,RM-B109,2/12/2015,837,0,837,0,0,0,1674
36032,RM-B109,3/14/2015,837,0,837,0,0,0,1674
36035,RM-B109,3/17/2015,837,0,837,0,0,0,1674
36045,RM-B109,3/27/2015,837,0,837,0,0,0,1674
36058,RM-B109,4/9/2015,837,0,837,0,0,0,1674
36068,RM-B109,4/19/2015,837,0,837,0,0,0,1674
36993,RM-B200C,1/29/2014,837,0,837,0,0,0,1674
37097,RM-B200C,5/13/2014,837,0,837,0,0,0,1674
40947,RM-B225,7/30/2013,0,0,0,0,0,1674,1674
41907,RM-B230,5/13/2014,837,0,837,0,0,0,1674
42317,RM-B230A,7/30/2013,0,0,0,0,0,1674,1674
43568,RM-B240A,7/30/2013,0,0,0,0,0,1674,1674
43725,RM-B240A,1/15/2014,0,1674,0,0,0,0,1674
45704,RM-B260,1/15/2014,0,0,0,1674,0,0,1674
23512,RM-1208,11/28/2013,834,0,0,0,0,837,1671
30359,RM-1229,11/28/2013,0,0,834,0,0,837,1671
35752,RM-B109,6/5/2014,834,0,837,0,0,0,1671
200,RM-1100A,1/27/2014,0,1668,0,0,0,0,1668
6262,RM-1113,11/28/2013,834,0,834,0,0,0,1668
8296,RM-1117,11/28/2013,834,0,834,0,0,0,1668
9826,RM-1123,5/7/2014,0,1668,0,0,0,0,1668
18833,RM-1155,11/28/2013,834,0,834,0,0,0,1668
19979,RM-1156,3/15/2015,834,0,834,0,0,0,1668
19989,RM-1156,3/25/2015,834,0,834,0,0,0,1668
19990,RM-1156,3/26/2015,834,0,834,0,0,0,1668
19993,RM-1156,3/29/2015,834,0,834,0,0,0,1668
19999,RM-1156,4/4/2015,834,0,834,0,0,0,1668
20000,RM-1156,4/5/2015,834,0,834,0,0,0,1668
20017,RM-1156,4/22/2015,834,0,834,0,0,0,1668
20223,RM-1200A,1/27/2014,0,0,0,1668,0,0,1668
34395,RM-B103,1/27/2014,0,0,0,1668,0,0,1668
36033,RM-B109,3/15/2015,834,0,834,0,0,0,1668
36042,RM-B109,3/24/2015,834,0,834,0,0,0,1668
36043,RM-B109,3/25/2015,834,0,834,0,0,0,1668
36044,RM-B109,3/26/2015,834,0,834,0,0,0,1668
36047,RM-B109,3/29/2015,834,0,834,0,0,0,1668
36053,RM-B109,4/4/2015,834,0,834,0,0,0,1668
36054,RM-B109,4/5/2015,834,0,834,0,0,0,1668
36071,RM-B109,4/22/2015,834,0,834,0,0,0,1668
43737,RM-B240A,1/27/2014,0,1668,0,0,0,0,1668
44287,RM-B250,11/28/2013,834,0,834,0,0,0,1668
45716,RM-B260,1/27/2014,0,0,0,1668,0,0,1668
3415,RM-1107,8/2/2013,0,0,1665,0,0,0,1665
6156,RM-1113,8/2/2013,0,0,1665,0,0,0,1665
8875,RM-1122,8/2/2013,0,0,1665,0,0,0,1665
13123,RM-1132,5/14/2014,0,0,831,834,0,0,1665
13535,RM-1133,8/2/2013,0,0,1665,0,0,0,1665
23400,RM-1208,7/27/2013,147,0,0,0,0,1518,1665
24919,RM-1212,1/1/2014,561,0,1104,0,0,0,1665
25449,RM-1213,8/2/2013,0,0,1665,0,0,0,1665
33692,RM-B102C,8/2/2013,0,0,1665,0,0,0,1665
35180,RM-B103A,5/13/2014,837,0,0,828,0,0,1665
37513,RM-B210,8/2/2013,0,0,1665,0,0,0,1665
46920,RM-B270,8/2/2013,0,0,1665,0,0,0,1665
47588,RM-B275,8/2/2013,0,0,1665,0,0,0,1665
2365,RM-1104,5/17/2014,0,1662,0,0,0,0,1662
3006,RM-1106,5/17/2014,0,0,0,1662,0,0,1662
4375,RM-1108,5/17/2014,0,1662,0,0,0,0,1662
20003,RM-1156,4/8/2015,831,0,831,0,0,0,1662
22871,RM-1207,1/11/2014,831,0,0,0,0,831,1662
24929,RM-1212,1/11/2014,831,0,831,0,0,0,1662
28345,RM-1221,1/11/2014,0,0,831,0,0,831,1662
30403,RM-1229,1/11/2014,0,0,831,0,0,831,1662
35058,RM-B103A,1/11/2014,831,0,0,0,0,831,1662
35730,RM-B109,5/14/2014,831,0,831,0,0,0,1662
36057,RM-B109,4/8/2015,831,0,831,0,0,0,1662
36975,RM-B200C,1/11/2014,831,0,831,0,0,0,1662
37098,RM-B200C,5/14/2014,831,0,831,0,0,0,1662
38351,RM-B215,1/11/2014,0,0,831,0,0,831,1662
41908,RM-B230,5/14/2014,831,0,831,0,0,0,1662
2730,RM-1106,8/2/2013,1659,0,0,0,0,0,1659
18039,RM-1154,8/2/2013,1659,0,0,0,0,0,1659
6689,RM-1113,1/31/2015,828,0,828,0,0,0,1656
8339,RM-1117,1/10/2014,549,0,915,192,0,0,1656
8930,RM-1122,10/5/2013,0,0,1155,0,0,501,1656
9833,RM-1123,5/14/2014,0,1656,0,0,0,0,1656
12163,RM-1130,8/2/2013,0,0,0,0,0,1656,1656
15327,RM-1144,8/2/2013,0,0,0,0,0,1656,1656
19996,RM-1156,4/1/2015,828,0,828,0,0,0,1656
20001,RM-1156,4/6/2015,828,0,828,0,0,0,1656
20002,RM-1156,4/7/2015,828,0,828,0,0,0,1656
20013,RM-1156,4/18/2015,828,0,828,0,0,0,1656
20720,RM-1200B,8/2/2013,0,0,0,0,0,1656,1656
26134,RM-1213A,8/2/2013,0,0,0,0,0,1656,1656
28195,RM-1221,8/2/2013,0,0,0,0,0,1656,1656
29413,RM-1223,1/31/2015,828,0,828,0,0,0,1656
31590,RM-1231,8/2/2013,0,0,0,0,0,1656,1656
34908,RM-B103A,8/2/2013,0,0,0,0,0,1656,1656
35990,RM-B109,1/31/2015,828,0,828,0,0,0,1656
36050,RM-B109,4/1/2015,828,0,828,0,0,0,1656
36055,RM-B109,4/6/2015,828,0,828,0,0,0,1656
36056,RM-B109,4/7/2015,828,0,828,0,0,0,1656
40950,RM-B225,8/2/2013,0,0,0,0,0,1656,1656
42320,RM-B230A,8/2/2013,0,0,0,0,0,1656,1656
43571,RM-B240A,8/2/2013,0,0,0,0,0,1656,1656
45962,RM-B260,10/2/2014,828,0,828,0,0,0,1656
35015,RM-B103A,11/29/2013,546,0,0,0,0,1107,1653
3428,RM-1107,8/15/2013,0,0,1650,0,0,0,1650
6169,RM-1113,8/15/2013,0,0,1650,0,0,0,1650
6643,RM-1113,12/16/2014,825,0,825,0,0,0,1650
6678,RM-1113,1/20/2015,825,0,825,0,0,0,1650
6694,RM-1113,2/5/2015,879,0,771,0,0,0,1650
8888,RM-1122,8/15/2013,0,0,1650,0,0,0,1650
9573,RM-1123,8/15/2013,0,0,1650,0,0,0,1650
12176,RM-1130,8/15/2013,0,0,0,0,0,1650,1650
13548,RM-1133,8/15/2013,0,0,1650,0,0,0,1650
15340,RM-1144,8/15/2013,0,0,0,0,0,1650,1650
18052,RM-1154,8/15/2013,1650,0,0,0,0,0,1650
19980,RM-1156,3/16/2015,825,0,825,0,0,0,1650
19997,RM-1156,4/2/2015,825,0,825,0,0,0,1650
19998,RM-1156,4/3/2015,825,0,825,0,0,0,1650
20015,RM-1156,4/20/2015,825,0,825,0,0,0,1650
20016,RM-1156,4/21/2015,825,0,825,0,0,0,1650
20733,RM-1200B,8/15/2013,0,0,0,0,0,1650,1650
25462,RM-1213,8/15/2013,0,0,1650,0,0,0,1650
26147,RM-1213A,8/15/2013,0,0,0,0,0,1650,1650
26832,RM-1217,8/15/2013,1650,0,0,0,0,0,1650
29402,RM-1223,1/20/2015,825,0,825,0,0,0,1650
31603,RM-1231,8/15/2013,0,0,0,0,0,1650,1650
33705,RM-B102C,8/15/2013,0,0,1650,0,0,0,1650
34921,RM-B103A,8/15/2013,0,0,0,0,0,1650,1650
35868,RM-B109,10/1/2014,825,0,825,0,0,0,1650
35869,RM-B109,10/2/2014,825,0,825,0,0,0,1650
35944,RM-B109,12/16/2014,825,0,825,0,0,0,1650
35979,RM-B109,1/20/2015,825,0,825,0,0,0,1650
36034,RM-B109,3/16/2015,825,0,825,0,0,0,1650
36051,RM-B109,4/2/2015,825,0,825,0,0,0,1650
36052,RM-B109,4/3/2015,825,0,825,0,0,0,1650
36067,RM-B109,4/18/2015,825,0,825,0,0,0,1650
36069,RM-B109,4/20/2015,825,0,825,0,0,0,1650
36070,RM-B109,4/21/2015,825,0,825,0,0,0,1650
40963,RM-B225,8/15/2013,0,0,0,0,0,1650,1650
42333,RM-B230A,8/15/2013,0,0,0,0,0,1650,1650
43584,RM-B240A,8/15/2013,0,0,0,0,0,1650,1650
44194,RM-B250,8/15/2013,1650,0,0,0,0,0,1650
45961,RM-B260,10/1/2014,825,0,825,0,0,0,1650
46933,RM-B270,8/15/2013,0,0,1650,0,0,0,1650
2766,RM-1106,9/16/2013,0,0,0,0,0,1647,1647
3451,RM-1107,9/16/2013,0,0,1647,0,0,0,1647
6192,RM-1113,9/16/2013,0,0,1647,0,0,0,1647
8911,RM-1122,9/16/2013,0,0,1647,0,0,0,1647
9596,RM-1123,9/16/2013,0,0,1647,0,0,0,1647
12170,RM-1130,8/9/2013,0,0,0,0,0,1647,1647
12199,RM-1130,9/16/2013,0,0,0,0,0,1647,1647
13571,RM-1133,9/16/2013,0,0,1647,0,0,0,1647
15334,RM-1144,8/9/2013,0,0,0,0,0,1647,1647
15363,RM-1144,9/16/2013,0,0,0,0,0,1647,1647
20756,RM-1200B,9/16/2013,0,0,0,0,0,1647,1647
26141,RM-1213A,8/9/2013,0,0,0,0,0,1647,1647
26855,RM-1217,9/16/2013,1647,0,0,0,0,0,1647
31597,RM-1231,8/9/2013,0,0,0,0,0,1647,1647
31626,RM-1231,9/16/2013,0,0,0,0,0,1647,1647
34915,RM-B103A,8/9/2013,0,0,0,0,0,1647,1647
34944,RM-B103A,9/16/2013,0,0,0,0,0,1647,1647
36180,RM-B200B,9/16/2013,0,0,0,0,0,1647,1647
40298,RM-B224,9/16/2013,0,0,0,0,0,1647,1647
40957,RM-B225,8/9/2013,0,0,0,0,0,1647,1647
40986,RM-B225,9/16/2013,0,0,0,0,0,1647,1647
42327,RM-B230A,8/9/2013,0,0,0,0,0,1647,1647
42356,RM-B230A,9/16/2013,0,0,0,0,0,1647,1647
43578,RM-B240A,8/9/2013,0,0,0,0,0,1647,1647
43607,RM-B240A,9/16/2013,0,0,0,0,0,1647,1647
44217,RM-B250,9/16/2013,1647,0,0,0,0,0,1647
46956,RM-B270,9/16/2013,0,0,1647,0,0,0,1647
2736,RM-1106,8/8/2013,1644,0,0,0,0,0,1644
2737,RM-1106,8/9/2013,1644,0,0,0,0,0,1644
3420,RM-1107,8/7/2013,0,0,1644,0,0,0,1644
3421,RM-1107,8/8/2013,0,0,1644,0,0,0,1644
3422,RM-1107,8/9/2013,0,0,1644,0,0,0,1644
6161,RM-1113,8/7/2013,0,0,1644,0,0,0,1644
6162,RM-1113,8/8/2013,0,0,1644,0,0,0,1644
6163,RM-1113,8/9/2013,0,0,1644,0,0,0,1644
8880,RM-1122,8/7/2013,0,0,1644,0,0,0,1644
8881,RM-1122,8/8/2013,0,0,1644,0,0,0,1644
8882,RM-1122,8/9/2013,0,0,1644,0,0,0,1644
9566,RM-1123,8/8/2013,0,0,1644,0,0,0,1644
9567,RM-1123,8/9/2013,0,0,1644,0,0,0,1644
12168,RM-1130,8/7/2013,0,0,0,0,0,1644,1644
13116,RM-1132,5/7/2014,0,0,888,756,0,0,1644
13540,RM-1133,8/7/2013,0,0,1644,0,0,0,1644
13541,RM-1133,8/8/2013,0,0,1644,0,0,0,1644
13542,RM-1133,8/9/2013,0,0,1644,0,0,0,1644
15332,RM-1144,8/7/2013,0,0,0,0,0,1644,1644
16945,RM-1150,5/17/2014,0,0,0,1644,0,0,1644
18045,RM-1154,8/8/2013,1644,0,0,0,0,0,1644
18046,RM-1154,8/9/2013,1644,0,0,0,0,0,1644
20726,RM-1200B,8/8/2013,0,0,0,0,0,1644,1644
20727,RM-1200B,8/9/2013,0,0,0,0,0,1644,1644
25454,RM-1213,8/7/2013,0,0,1644,0,0,0,1644
25455,RM-1213,8/8/2013,0,0,1644,0,0,0,1644
25456,RM-1213,8/9/2013,0,0,1644,0,0,0,1644
26139,RM-1213A,8/7/2013,0,0,0,0,0,1644,1644
26825,RM-1217,8/8/2013,1644,0,0,0,0,0,1644
26826,RM-1217,8/9/2013,1644,0,0,0,0,0,1644
28200,RM-1221,8/7/2013,0,0,0,0,0,1644,1644
31595,RM-1231,8/7/2013,0,0,0,0,0,1644,1644
33697,RM-B102C,8/7/2013,0,0,1644,0,0,0,1644
33698,RM-B102C,8/8/2013,0,0,1644,0,0,0,1644
33699,RM-B102C,8/9/2013,0,0,1644,0,0,0,1644
34913,RM-B103A,8/7/2013,0,0,0,0,0,1644,1644
35867,RM-B109,9/30/2014,822,0,822,0,0,0,1644
36041,RM-B109,3/23/2015,822,0,822,0,0,0,1644
37518,RM-B210,8/7/2013,0,0,1644,0,0,0,1644
37519,RM-B210,8/8/2013,0,0,1644,0,0,0,1644
37520,RM-B210,8/9/2013,0,0,1644,0,0,0,1644
39564,RM-B222,7/23/2013,1629,0,15,0,0,0,1644
40955,RM-B225,8/7/2013,0,0,0,0,0,1644,1644
42325,RM-B230A,8/7/2013,0,0,0,0,0,1644,1644
43576,RM-B240A,8/7/2013,0,0,0,0,0,1644,1644
45960,RM-B260,9/30/2014,822,0,822,0,0,0,1644
46925,RM-B270,8/7/2013,0,0,1644,0,0,0,1644
46926,RM-B270,8/8/2013,0,0,1644,0,0,0,1644
46927,RM-B270,8/9/2013,0,0,1644,0,0,0,1644
47593,RM-B275,8/7/2013,0,0,1644,0,0,0,1644
47594,RM-B275,8/8/2013,0,0,1644,0,0,0,1644
47595,RM-B275,8/9/2013,0,0,1644,0,0,0,1644
2735,RM-1106,8/7/2013,1641,0,0,0,0,0,1641
12169,RM-1130,8/8/2013,0,0,0,0,0,1641,1641
15333,RM-1144,8/8/2013,0,0,0,0,0,1641,1641
18044,RM-1154,8/7/2013,1641,0,0,0,0,0,1641
20725,RM-1200B,8/7/2013,0,0,0,0,0,1641,1641
26140,RM-1213A,8/8/2013,0,0,0,0,0,1641,1641
26824,RM-1217,8/7/2013,1641,0,0,0,0,0,1641
27090,RM-1217,5/12/2014,915,726,0,0,0,0,1641
31596,RM-1231,8/8/2013,0,0,0,0,0,1641,1641
34914,RM-B103A,8/8/2013,0,0,0,0,0,1641,1641
40956,RM-B225,8/8/2013,0,0,0,0,0,1641,1641
42326,RM-B230A,8/8/2013,0,0,0,0,0,1641,1641
43577,RM-B240A,8/8/2013,0,0,0,0,0,1641,1641
7023,RM-1115,3/10/2014,819,0,0,0,0,819,1638
8466,RM-1117,5/17/2014,0,1638,0,0,0,0,1638
18925,RM-1155,2/28/2014,819,0,0,0,0,819,1638
18935,RM-1155,3/10/2014,819,0,0,0,0,819,1638
19601,RM-1156,2/28/2014,819,0,0,0,0,819,1638
19611,RM-1156,3/10/2014,819,0,0,0,0,819,1638
19987,RM-1156,3/23/2015,819,0,819,0,0,0,1638
19995,RM-1156,3/31/2015,819,0,819,0,0,0,1638
20996,RM-1200B,5/17/2014,0,1638,0,0,0,0,1638
22929,RM-1207,3/10/2014,819,0,0,0,0,819,1638
24987,RM-1212,3/10/2014,819,0,819,0,0,0,1638
25009,RM-1212,4/1/2014,816,0,822,0,0,0,1638
27783,RM-1218,5/17/2014,0,0,0,1638,0,0,1638
29841,RM-1224,5/17/2014,0,0,0,1638,0,0,1638
35866,RM-B109,9/29/2014,819,0,819,0,0,0,1638
36049,RM-B109,3/31/2015,819,0,819,0,0,0,1638
36420,RM-B200B,5/17/2014,0,1638,0,0,0,0,1638
37023,RM-B200C,2/28/2014,819,0,819,0,0,0,1638
37033,RM-B200C,3/10/2014,819,0,819,0,0,0,1638
37055,RM-B200C,4/1/2014,816,0,822,0,0,0,1638
41865,RM-B230,4/1/2014,816,0,822,0,0,0,1638
45959,RM-B260,9/29/2014,819,0,819,0,0,0,1638
3405,RM-1107,7/23/2013,0,0,1635,0,0,0,1635
6146,RM-1113,7/23/2013,0,0,1635,0,0,0,1635
7013,RM-1115,2/28/2014,816,0,0,0,0,819,1635
8865,RM-1122,7/23/2013,0,0,1635,0,0,0,1635
13525,RM-1133,7/23/2013,0,0,1635,0,0,0,1635
22919,RM-1207,2/28/2014,816,0,0,0,0,819,1635
24977,RM-1212,2/28/2014,816,0,819,0,0,0,1635
25439,RM-1213,7/23/2013,0,0,1635,0,0,0,1635
33682,RM-B102C,7/23/2013,0,0,1635,0,0,0,1635
37503,RM-B210,7/23/2013,0,0,1635,0,0,0,1635
46030,RM-B260,12/9/2014,819,0,816,0,0,0,1635
46910,RM-B270,7/23/2013,0,0,1635,0,0,0,1635
47578,RM-B275,7/23/2013,0,0,1635,0,0,0,1635
995,RM-1100D,5/17/2014,0,0,0,1632,0,0,1632
5462,RM-1110,7/23/2013,0,0,0,0,0,1632,1632
6636,RM-1113,12/9/2014,816,0,816,0,0,0,1632
12153,RM-1130,7/23/2013,0,0,0,0,0,1632,1632
19994,RM-1156,3/30/2015,816,0,816,0,0,0,1632
20333,RM-1200A,5/17/2014,0,0,0,1632,0,0,1632
23396,RM-1208,7/23/2013,0,0,0,0,0,1632,1632
24444,RM-1208B,7/30/2014,816,0,816,0,0,0,1632
26124,RM-1213A,7/23/2013,0,0,0,0,0,1632,1632
28185,RM-1221,7/23/2013,0,0,0,0,0,1632,1632
31181,RM-1230,5/17/2014,0,1632,0,0,0,0,1632
34898,RM-B103A,7/23/2013,0,0,0,0,0,1632,1632
35807,RM-B109,7/30/2014,816,0,816,0,0,0,1632
35937,RM-B109,12/9/2014,816,0,816,0,0,0,1632
36048,RM-B109,3/30/2015,816,0,816,0,0,0,1632
40940,RM-B225,7/23/2013,0,0,0,0,0,1632,1632
42310,RM-B230A,7/23/2013,0,0,0,0,0,1632,1632
43561,RM-B240A,7/23/2013,0,0,0,0,0,1632,1632
43847,RM-B240A,5/17/2014,0,1632,0,0,0,0,1632
47196,RM-B270,5/17/2014,0,0,0,1632,0,0,1632
24,RM-1100A,7/23/2013,1629,0,0,0,0,0,1629
2720,RM-1106,7/23/2013,1629,0,0,0,0,0,1629
12840,RM-1132,7/23/2013,1629,0,0,0,0,0,1629
6691,RM-1113,2/2/2015,813,0,813,0,0,0,1626
24449,RM-1208B,8/4/2014,813,0,813,0,0,0,1626
24463,RM-1208B,8/18/2014,813,0,813,0,0,0,1626
29415,RM-1223,2/2/2015,813,0,813,0,0,0,1626
32635,RM-1236,8/4/2014,813,0,813,0,0,0,1626
32649,RM-1236,8/18/2014,813,0,813,0,0,0,1626
35812,RM-B109,8/4/2014,813,0,813,0,0,0,1626
35826,RM-B109,8/18/2014,813,0,813,0,0,0,1626
35992,RM-B109,2/2/2015,813,0,813,0,0,0,1626
45826,RM-B260,5/17/2014,0,0,0,1626,0,0,1626
27093,RM-1217,5/15/2014,873,750,0,0,0,0,1623
6622,RM-1113,11/25/2014,810,0,810,0,0,0,1620
21675,RM-1200C,5/11/2014,0,798,0,822,0,0,1620
24464,RM-1208B,8/19/2014,810,0,810,0,0,0,1620
32551,RM-1236,5/12/2014,0,702,918,0,0,0,1620
32650,RM-1236,8/19/2014,810,0,810,0,0,0,1620
35827,RM-B109,8/19/2014,810,0,810,0,0,0,1620
35922,RM-B109,11/24/2014,810,0,810,0,0,0,1620
35923,RM-B109,11/25/2014,810,0,810,0,0,0,1620
46015,RM-B260,11/24/2014,810,0,810,0,0,0,1620
46016,RM-B260,11/25/2014,810,0,810,0,0,0,1620
3438,RM-1107,8/29/2013,0,0,1617,0,0,0,1617
6179,RM-1113,8/29/2013,0,0,1617,0,0,0,1617
6194,RM-1113,9/18/2013,0,0,1617,0,0,0,1617
8898,RM-1122,8/29/2013,0,0,1617,0,0,0,1617
8913,RM-1122,9/18/2013,0,0,1617,0,0,0,1617
9583,RM-1123,8/29/2013,0,0,1617,0,0,0,1617
9598,RM-1123,9/18/2013,0,0,1617,0,0,0,1617
13558,RM-1133,8/29/2013,0,0,1617,0,0,0,1617
13573,RM-1133,9/18/2013,0,0,1617,0,0,0,1617
20758,RM-1200B,9/18/2013,0,0,0,0,0,1617,1617
25472,RM-1213,8/29/2013,0,0,1617,0,0,0,1617
26857,RM-1217,9/18/2013,1617,0,0,0,0,0,1617
33715,RM-B102C,8/29/2013,0,0,1617,0,0,0,1617
35174,RM-B103A,5/7/2014,891,0,0,726,0,0,1617
39612,RM-B222,9/18/2013,1617,0,0,0,0,0,1617
44219,RM-B250,9/18/2013,1617,0,0,0,0,0,1617
46943,RM-B270,8/29/2013,0,0,1617,0,0,0,1617
46958,RM-B270,9/18/2013,0,0,1617,0,0,0,1617
2768,RM-1106,9/18/2013,0,0,0,0,0,1614,1614
6686,RM-1113,1/28/2015,807,0,807,0,0,0,1614
12186,RM-1130,8/29/2013,0,0,0,0,0,1614,1614
12201,RM-1130,9/18/2013,0,0,0,0,0,1614,1614
15350,RM-1144,8/29/2013,0,0,0,0,0,1614,1614
15365,RM-1144,9/18/2013,0,0,0,0,0,1614,1614
18062,RM-1154,8/29/2013,1614,0,0,0,0,0,1614
20743,RM-1200B,8/29/2013,0,0,0,0,0,1614,1614
22759,RM-1207,9/18/2013,0,0,0,0,0,1614,1614
26842,RM-1217,8/29/2013,1614,0,0,0,0,0,1614
29410,RM-1223,1/28/2015,807,0,807,0,0,0,1614
30524,RM-1229,5/12/2014,0,0,918,696,0,0,1614
31613,RM-1231,8/29/2013,0,0,0,0,0,1614,1614
31628,RM-1231,9/18/2013,0,0,0,0,0,1614,1614
34931,RM-B103A,8/29/2013,0,0,0,0,0,1614,1614
34946,RM-B103A,9/18/2013,0,0,0,0,0,1614,1614
35987,RM-B109,1/28/2015,807,0,807,0,0,0,1614
36167,RM-B200B,8/29/2013,0,0,0,0,0,1614,1614
36182,RM-B200B,9/18/2013,0,0,0,0,0,1614,1614
40300,RM-B224,9/18/2013,0,0,0,0,0,1614,1614
40973,RM-B225,8/29/2013,0,0,0,0,0,1614,1614
40988,RM-B225,9/18/2013,0,0,0,0,0,1614,1614
42343,RM-B230A,8/29/2013,0,0,0,0,0,1614,1614
42358,RM-B230A,9/18/2013,0,0,0,0,0,1614,1614
43594,RM-B240A,8/29/2013,0,0,0,0,0,1614,1614
43609,RM-B240A,9/18/2013,0,0,0,0,0,1614,1614
44204,RM-B250,8/29/2013,1614,0,0,0,0,0,1614
950,RM-1100D,4/2/2014,0,0,0,1608,0,0,1608
2320,RM-1104,4/2/2014,0,1608,0,0,0,0,1608
2961,RM-1106,4/2/2014,0,0,0,1608,0,0,1608
4330,RM-1108,4/2/2014,0,1608,0,0,0,0,1608
6690,RM-1113,2/1/2015,804,0,804,0,0,0,1608
9791,RM-1123,4/2/2014,0,1608,0,0,0,0,1608
13766,RM-1133,4/2/2014,0,1608,0,0,0,0,1608
16900,RM-1150,4/2/2014,0,0,0,1608,0,0,1608
19945,RM-1156,2/9/2015,804,0,804,0,0,0,1608
20288,RM-1200A,4/2/2014,0,0,0,1608,0,0,1608
20951,RM-1200B,4/2/2014,0,1608,0,0,0,0,1608
29414,RM-1223,2/1/2015,804,0,804,0,0,0,1608
29419,RM-1223,2/6/2015,804,0,804,0,0,0,1608
29422,RM-1223,2/9/2015,804,0,804,0,0,0,1608
35919,RM-B109,11/21/2014,804,0,804,0,0,0,1608
35920,RM-B109,11/22/2014,804,0,804,0,0,0,1608
35921,RM-B109,11/23/2014,804,0,804,0,0,0,1608
35991,RM-B109,2/1/2015,804,0,804,0,0,0,1608
35996,RM-B109,2/6/2015,804,0,804,0,0,0,1608
35999,RM-B109,2/9/2015,804,0,804,0,0,0,1608
36375,RM-B200B,4/2/2014,0,1608,0,0,0,0,1608
45781,RM-B260,4/2/2014,0,0,0,1608,0,0,1608
46012,RM-B260,11/21/2014,804,0,804,0,0,0,1608
46013,RM-B260,11/22/2014,804,0,804,0,0,0,1608
46014,RM-B260,11/23/2014,804,0,804,0,0,0,1608
19946,RM-1156,2/10/2015,801,0,801,0,0,0,1602
29423,RM-1223,2/10/2015,801,0,801,0,0,0,1602
35917,RM-B109,11/19/2014,801,0,801,0,0,0,1602
36000,RM-B109,2/10/2015,801,0,801,0,0,0,1602
46010,RM-B260,11/19/2014,801,0,801,0,0,0,1602
3429,RM-1107,8/16/2013,0,0,1599,0,0,0,1599
6170,RM-1113,8/16/2013,0,0,1599,0,0,0,1599
8889,RM-1122,8/16/2013,0,0,1599,0,0,0,1599
9574,RM-1123,8/16/2013,0,0,1599,0,0,0,1599
12177,RM-1130,8/16/2013,0,0,0,0,0,1599,1599
13549,RM-1133,8/16/2013,0,0,1599,0,0,0,1599
15341,RM-1144,8/16/2013,0,0,0,0,0,1599,1599
18053,RM-1154,8/16/2013,1599,0,0,0,0,0,1599
20734,RM-1200B,8/16/2013,0,0,0,0,0,1599,1599
25463,RM-1213,8/16/2013,0,0,1599,0,0,0,1599
26148,RM-1213A,8/16/2013,0,0,0,0,0,1599,1599
26833,RM-1217,8/16/2013,1599,0,0,0,0,0,1599
31604,RM-1231,8/16/2013,0,0,0,0,0,1599,1599
33706,RM-B102C,8/16/2013,0,0,1599,0,0,0,1599
34922,RM-B103A,8/16/2013,0,0,0,0,0,1599,1599
40964,RM-B225,8/16/2013,0,0,0,0,0,1599,1599
42334,RM-B230A,8/16/2013,0,0,0,0,0,1599,1599
43585,RM-B240A,8/16/2013,0,0,0,0,0,1599,1599
44195,RM-B250,8/16/2013,1599,0,0,0,0,0,1599
46934,RM-B270,8/16/2013,0,0,1599,0,0,0,1599
19947,RM-1156,2/11/2015,798,0,798,0,0,0,1596
29424,RM-1223,2/11/2015,798,0,798,0,0,0,1596
35914,RM-B109,11/16/2014,798,0,798,0,0,0,1596
35916,RM-B109,11/18/2014,798,0,798,0,0,0,1596
35918,RM-B109,11/20/2014,798,0,798,0,0,0,1596
36001,RM-B109,2/11/2015,798,0,798,0,0,0,1596
46009,RM-B260,11/18/2014,798,0,798,0,0,0,1596
46011,RM-B260,11/20/2014,798,0,798,0,0,0,1596
30526,RM-1229,5/14/2014,0,0,831,762,0,0,1593
35183,RM-B103A,5/16/2014,717,0,0,876,0,0,1593
19944,RM-1156,2/8/2015,795,0,795,0,0,0,1590
29421,RM-1223,2/8/2015,795,0,795,0,0,0,1590
35998,RM-B109,2/8/2015,795,0,795,0,0,0,1590
46006,RM-B260,11/15/2014,795,0,795,0,0,0,1590
46007,RM-B260,11/16/2014,795,0,795,0,0,0,1590
6685,RM-1113,1/27/2015,792,0,792,0,0,0,1584
19943,RM-1156,2/7/2015,792,0,792,0,0,0,1584
21560,RM-1200C,1/16/2014,0,1578,0,6,0,0,1584
28370,RM-1221,2/5/2014,0,0,102,0,0,1482,1584
29409,RM-1223,1/27/2015,792,0,792,0,0,0,1584
29420,RM-1223,2/7/2015,792,0,792,0,0,0,1584
31060,RM-1230,1/16/2014,0,1584,0,0,0,0,1584
35912,RM-B109,11/14/2014,792,0,792,0,0,0,1584
35913,RM-B109,11/15/2014,792,0,792,0,0,0,1584
35915,RM-B109,11/17/2014,792,0,792,0,0,0,1584
35986,RM-B109,1/27/2015,792,0,792,0,0,0,1584
35997,RM-B109,2/7/2015,792,0,792,0,0,0,1584
46005,RM-B260,11/14/2014,792,0,792,0,0,0,1584
46008,RM-B260,11/17/2014,792,0,792,0,0,0,1584
2244,RM-1104,1/16/2014,0,1578,0,0,0,0,1578
2353,RM-1104,5/5/2014,0,1578,0,0,0,0,1578
2994,RM-1106,5/5/2014,0,0,0,1578,0,0,1578
4363,RM-1108,5/5/2014,0,1578,0,0,0,0,1578
8454,RM-1117,5/5/2014,0,1578,0,0,0,0,1578
16933,RM-1150,5/5/2014,0,0,0,1578,0,0,1578
21679,RM-1200C,5/15/2014,0,774,0,804,0,0,1578
27771,RM-1218,5/5/2014,0,0,0,1578,0,0,1578
29829,RM-1224,5/5/2014,0,0,0,1578,0,0,1578
31169,RM-1230,5/5/2014,0,1578,0,0,0,0,1578
35612,RM-B109,1/16/2014,0,1578,0,0,0,0,1578
43726,RM-B240A,1/16/2014,0,1578,0,0,0,0,1578
27092,RM-1217,5/14/2014,831,744,0,0,0,0,1575
983,RM-1100D,5/5/2014,0,0,0,1572,0,0,1572
4959,RM-1109,2/2/2014,0,0,0,0,0,1572,1572
6328,RM-1113,2/2/2014,0,0,1572,0,0,0,1572
6987,RM-1115,2/2/2014,0,0,0,0,0,1572,1572
7674,RM-1116,2/2/2014,1572,0,0,0,0,0,1572
9047,RM-1122,2/2/2014,0,0,0,0,0,1572,1572
10417,RM-1124,2/2/2014,0,0,0,0,0,1572,1572
15499,RM-1144,2/2/2014,0,0,1572,0,0,0,1572
16184,RM-1145,2/2/2014,0,0,0,0,0,1572,1572
19575,RM-1156,2/2/2014,1572,0,0,0,0,0,1572
20321,RM-1200A,5/5/2014,0,0,0,1572,0,0,1572
20984,RM-1200B,5/5/2014,0,1572,0,0,0,0,1572
21676,RM-1200C,5/12/2014,0,768,0,804,0,0,1572
25621,RM-1213,2/2/2014,0,0,0,0,0,1572,1572
26306,RM-1213A,2/2/2014,0,0,1572,0,0,0,1572
30527,RM-1229,5/15/2014,0,0,870,702,0,0,1572
31762,RM-1231,2/2/2014,0,0,0,0,0,1572,1572
32452,RM-1236,2/2/2014,0,0,1572,0,0,0,1572
36408,RM-B200B,5/5/2014,0,1572,0,0,0,0,1572
38373,RM-B215,2/2/2014,0,0,1572,0,0,0,1572
39058,RM-B220,2/2/2014,1572,0,0,0,0,0,1572
40434,RM-B224,2/2/2014,0,0,0,0,0,1572,1572
41122,RM-B225,2/2/2014,0,0,0,0,0,1572,1572
42492,RM-B230A,2/2/2014,0,0,0,0,0,1572,1572
43835,RM-B240A,5/5/2014,0,1572,0,0,0,0,1572
44353,RM-B250,2/2/2014,0,0,1572,0,0,0,1572
45814,RM-B260,5/5/2014,0,0,0,1572,0,0,1572
47184,RM-B270,5/5/2014,0,0,0,1572,0,0,1572
47760,RM-B275,2/2/2014,0,0,0,0,0,1572,1572
24471,RM-1208B,8/26/2014,783,0,783,0,0,0,1566
35834,RM-B109,8/26/2014,783,0,783,0,0,0,1566
4960,RM-1109,2/3/2014,0,0,0,0,0,1563,1563
6329,RM-1113,2/3/2014,0,0,1563,0,0,0,1563
6988,RM-1115,2/3/2014,0,0,0,0,0,1563,1563
7675,RM-1116,2/3/2014,1563,0,0,0,0,0,1563
9048,RM-1122,2/3/2014,0,0,0,0,0,1563,1563
10418,RM-1124,2/3/2014,0,0,0,0,0,1563,1563
15500,RM-1144,2/3/2014,0,0,1563,0,0,0,1563
16185,RM-1145,2/3/2014,0,0,0,0,0,1563,1563
19576,RM-1156,2/3/2014,1563,0,0,0,0,0,1563
25622,RM-1213,2/3/2014,0,0,0,0,0,1563,1563
26307,RM-1213A,2/3/2014,0,0,1563,0,0,0,1563
31763,RM-1231,2/3/2014,0,0,0,0,0,1563,1563
32453,RM-1236,2/3/2014,0,0,1563,0,0,0,1563
35753,RM-B109,6/6/2014,783,0,780,0,0,0,1563
38374,RM-B215,2/3/2014,0,0,1563,0,0,0,1563
39059,RM-B220,2/3/2014,1563,0,0,0,0,0,1563
40435,RM-B224,2/3/2014,0,0,0,0,0,1563,1563
41123,RM-B225,2/3/2014,0,0,0,0,0,1563,1563
42493,RM-B230A,2/3/2014,0,0,0,0,0,1563,1563
44354,RM-B250,2/3/2014,0,0,1563,0,0,0,1563
47761,RM-B275,2/3/2014,0,0,0,0,0,1563,1563
21677,RM-1200C,5/13/2014,0,786,0,774,0,0,1560
24462,RM-1208B,8/17/2014,780,0,780,0,0,0,1560
24475,RM-1208B,8/30/2014,780,0,780,0,0,0,1560
24487,RM-1208B,9/11/2014,780,0,780,0,0,0,1560
32648,RM-1236,8/17/2014,780,0,780,0,0,0,1560
35710,RM-B109,4/24/2014,780,0,780,0,0,0,1560
35825,RM-B109,8/17/2014,780,0,780,0,0,0,1560
35838,RM-B109,8/30/2014,780,0,780,0,0,0,1560
35850,RM-B109,9/11/2014,780,0,780,0,0,0,1560
35902,RM-B109,11/4/2014,780,0,780,0,0,0,1560
35903,RM-B109,11/5/2014,780,0,780,0,0,0,1560
35907,RM-B109,11/9/2014,780,0,780,0,0,0,1560
35911,RM-B109,11/13/2014,780,0,780,0,0,0,1560
37078,RM-B200C,4/24/2014,780,0,780,0,0,0,1560
41888,RM-B230,4/24/2014,780,0,780,0,0,0,1560
45943,RM-B260,9/11/2014,780,0,780,0,0,0,1560
45995,RM-B260,11/4/2014,780,0,780,0,0,0,1560
45996,RM-B260,11/5/2014,780,0,780,0,0,0,1560
46000,RM-B260,11/9/2014,780,0,780,0,0,0,1560
46004,RM-B260,11/13/2014,780,0,780,0,0,0,1560
13125,RM-1132,5/16/2014,0,0,714,840,0,0,1554
24465,RM-1208B,8/20/2014,777,0,777,0,0,0,1554
24476,RM-1208B,8/31/2014,777,0,777,0,0,0,1554
24478,RM-1208B,9/2/2014,777,0,777,0,0,0,1554
24479,RM-1208B,9/3/2014,777,0,777,0,0,0,1554
32554,RM-1236,5/15/2014,0,684,870,0,0,0,1554
32651,RM-1236,8/20/2014,777,0,777,0,0,0,1554
35828,RM-B109,8/20/2014,777,0,777,0,0,0,1554
35839,RM-B109,8/31/2014,777,0,777,0,0,0,1554
35840,RM-B109,9/1/2014,777,0,777,0,0,0,1554
35842,RM-B109,9/3/2014,777,0,777,0,0,0,1554
35904,RM-B109,11/6/2014,777,0,777,0,0,0,1554
35905,RM-B109,11/7/2014,777,0,777,0,0,0,1554
45997,RM-B260,11/6/2014,777,0,777,0,0,0,1554
45998,RM-B260,11/7/2014,777,0,777,0,0,0,1554
5471,RM-1110,8/1/2013,0,0,0,0,0,1551,1551
12162,RM-1130,8/1/2013,0,0,0,0,0,1551,1551
15326,RM-1144,8/1/2013,0,0,0,0,0,1551,1551
26133,RM-1213A,8/1/2013,0,0,0,0,0,1551,1551
28194,RM-1221,8/1/2013,0,0,0,0,0,1551,1551
30423,RM-1229,1/31/2014,0,0,153,1248,0,150,1551
31589,RM-1231,8/1/2013,0,0,0,0,0,1551,1551
34907,RM-B103A,8/1/2013,0,0,0,0,0,1551,1551
35848,RM-B109,9/9/2014,777,0,774,0,0,0,1551
40949,RM-B225,8/1/2013,0,0,0,0,0,1551,1551
42319,RM-B230A,8/1/2013,0,0,0,0,0,1551,1551
43570,RM-B240A,8/1/2013,0,0,0,0,0,1551,1551
2729,RM-1106,8/1/2013,1548,0,0,0,0,0,1548
3414,RM-1107,8/1/2013,0,0,1548,0,0,0,1548
6155,RM-1113,8/1/2013,0,0,1548,0,0,0,1548
8874,RM-1122,8/1/2013,0,0,1548,0,0,0,1548
13534,RM-1133,8/1/2013,0,0,1548,0,0,0,1548
18038,RM-1154,8/1/2013,1548,0,0,0,0,0,1548
19983,RM-1156,3/19/2015,774,0,774,0,0,0,1548
20719,RM-1200B,8/1/2013,0,0,0,0,0,1548,1548
23576,RM-1208,1/31/2014,150,1248,0,0,0,150,1548
24466,RM-1208B,8/21/2014,774,0,774,0,0,0,1548
24473,RM-1208B,8/28/2014,774,0,774,0,0,0,1548
24477,RM-1208B,9/1/2014,774,0,774,0,0,0,1548
24481,RM-1208B,9/5/2014,774,0,774,0,0,0,1548
24483,RM-1208B,9/7/2014,774,0,774,0,0,0,1548
24484,RM-1208B,9/8/2014,774,0,774,0,0,0,1548
24485,RM-1208B,9/9/2014,774,0,774,0,0,0,1548
25448,RM-1213,8/1/2013,0,0,1548,0,0,0,1548
32652,RM-1236,8/21/2014,774,0,774,0,0,0,1548
33691,RM-B102C,8/1/2013,0,0,1548,0,0,0,1548
35829,RM-B109,8/21/2014,774,0,774,0,0,0,1548
35836,RM-B109,8/28/2014,774,0,774,0,0,0,1548
35841,RM-B109,9/2/2014,774,0,774,0,0,0,1548
35844,RM-B109,9/5/2014,774,0,774,0,0,0,1548
35846,RM-B109,9/7/2014,774,0,774,0,0,0,1548
35847,RM-B109,9/8/2014,774,0,774,0,0,0,1548
35906,RM-B109,11/8/2014,774,0,774,0,0,0,1548
35908,RM-B109,11/10/2014,774,0,774,0,0,0,1548
36037,RM-B109,3/19/2015,774,0,774,0,0,0,1548
37512,RM-B210,8/1/2013,0,0,1548,0,0,0,1548
45999,RM-B260,11/8/2014,774,0,774,0,0,0,1548
46001,RM-B260,11/10/2014,774,0,774,0,0,0,1548
46919,RM-B270,8/1/2013,0,0,1548,0,0,0,1548
47587,RM-B275,8/1/2013,0,0,1548,0,0,0,1548
4961,RM-1109,2/4/2014,0,0,0,0,0,1542,1542
6330,RM-1113,2/4/2014,0,0,1542,0,0,0,1542
9049,RM-1122,2/4/2014,0,0,0,0,0,1542,1542
10419,RM-1124,2/4/2014,0,0,0,0,0,1542,1542
15501,RM-1144,2/4/2014,0,0,1542,0,0,0,1542
16186,RM-1145,2/4/2014,0,0,0,0,0,1542,1542
24470,RM-1208B,8/25/2014,771,0,771,0,0,0,1542
24488,RM-1208B,9/12/2014,771,0,771,0,0,0,1542
25623,RM-1213,2/4/2014,0,0,0,0,0,1542,1542
26308,RM-1213A,2/4/2014,0,0,1542,0,0,0,1542
31764,RM-1231,2/4/2014,0,0,0,0,0,1542,1542
32454,RM-1236,2/4/2014,0,0,1542,0,0,0,1542
35833,RM-B109,8/25/2014,771,0,771,0,0,0,1542
35851,RM-B109,9/12/2014,771,0,771,0,0,0,1542
38375,RM-B215,2/4/2014,0,0,1542,0,0,0,1542
39060,RM-B220,2/4/2014,1542,0,0,0,0,0,1542
40436,RM-B224,2/4/2014,0,0,0,0,0,1542,1542
41124,RM-B225,2/4/2014,0,0,0,0,0,1542,1542
42494,RM-B230A,2/4/2014,0,0,0,0,0,1542,1542
44355,RM-B250,2/4/2014,0,0,1542,0,0,0,1542
45944,RM-B260,9/12/2014,771,0,771,0,0,0,1542
47762,RM-B275,2/4/2014,0,0,0,0,0,1542,1542
7676,RM-1116,2/4/2014,1539,0,0,0,0,0,1539
19577,RM-1156,2/4/2014,1539,0,0,0,0,0,1539
21672,RM-1200C,5/8/2014,0,744,0,792,0,0,1536
21673,RM-1200C,5/9/2014,0,768,0,768,0,0,1536
24467,RM-1208B,8/22/2014,768,0,768,0,0,0,1536
24468,RM-1208B,8/23/2014,768,0,768,0,0,0,1536
24469,RM-1208B,8/24/2014,768,0,768,0,0,0,1536
24472,RM-1208B,8/27/2014,768,0,768,0,0,0,1536
24474,RM-1208B,8/29/2014,768,0,768,0,0,0,1536
24480,RM-1208B,9/4/2014,768,0,768,0,0,0,1536
24486,RM-1208B,9/10/2014,768,0,768,0,0,0,1536
32653,RM-1236,8/22/2014,768,0,768,0,0,0,1536
32654,RM-1236,8/23/2014,768,0,768,0,0,0,1536
32655,RM-1236,8/24/2014,768,0,768,0,0,0,1536
35830,RM-B109,8/22/2014,768,0,768,0,0,0,1536
35831,RM-B109,8/23/2014,768,0,768,0,0,0,1536
35832,RM-B109,8/24/2014,768,0,768,0,0,0,1536
35835,RM-B109,8/27/2014,768,0,768,0,0,0,1536
35837,RM-B109,8/29/2014,768,0,768,0,0,0,1536
35843,RM-B109,9/4/2014,768,0,768,0,0,0,1536
38377,RM-B215,2/6/2014,123,0,1413,0,0,0,1536
21674,RM-1200C,5/10/2014,0,768,0,762,0,0,1530
35849,RM-B109,9/10/2014,762,0,765,0,0,0,1527
3413,RM-1107,7/31/2013,0,0,1524,0,0,0,1524
6154,RM-1113,7/31/2013,0,0,1524,0,0,0,1524
8873,RM-1122,7/31/2013,0,0,1524,0,0,0,1524
13533,RM-1133,7/31/2013,0,0,1524,0,0,0,1524
24482,RM-1208B,9/6/2014,762,0,762,0,0,0,1524
25447,RM-1213,7/31/2013,0,0,1524,0,0,0,1524
33690,RM-B102C,7/31/2013,0,0,1524,0,0,0,1524
35845,RM-B109,9/6/2014,762,0,762,0,0,0,1524
37511,RM-B210,7/31/2013,0,0,1524,0,0,0,1524
46918,RM-B270,7/31/2013,0,0,1524,0,0,0,1524
47586,RM-B275,7/31/2013,0,0,1524,0,0,0,1524
2728,RM-1106,7/31/2013,1521,0,0,0,0,0,1521
5470,RM-1110,7/31/2013,0,0,0,0,0,1521,1521
12161,RM-1130,7/31/2013,0,0,0,0,0,1521,1521
15325,RM-1144,7/31/2013,0,0,0,0,0,1521,1521
18037,RM-1154,7/31/2013,1521,0,0,0,0,0,1521
20718,RM-1200B,7/31/2013,0,0,0,0,0,1521,1521
26132,RM-1213A,7/31/2013,0,0,0,0,0,1521,1521
28193,RM-1221,7/31/2013,0,0,0,0,0,1521,1521
31588,RM-1231,7/31/2013,0,0,0,0,0,1521,1521
34906,RM-B103A,7/31/2013,0,0,0,0,0,1521,1521
40948,RM-B225,7/31/2013,0,0,0,0,0,1521,1521
42318,RM-B230A,7/31/2013,0,0,0,0,0,1521,1521
43569,RM-B240A,7/31/2013,0,0,0,0,0,1521,1521
2724,RM-1106,7/27/2013,1518,0,0,0,0,0,1518
3409,RM-1107,7/27/2013,0,0,1518,0,0,0,1518
5466,RM-1110,7/27/2013,0,0,0,0,0,1518,1518
6150,RM-1113,7/27/2013,0,0,1518,0,0,0,1518
8869,RM-1122,7/27/2013,0,0,1518,0,0,0,1518
12157,RM-1130,7/27/2013,0,0,0,0,0,1518,1518
12844,RM-1132,7/27/2013,1518,0,0,0,0,0,1518
13529,RM-1133,7/27/2013,0,0,1518,0,0,0,1518
18033,RM-1154,7/27/2013,1518,0,0,0,0,0,1518
20714,RM-1200B,7/27/2013,0,0,0,0,0,1518,1518
25443,RM-1213,7/27/2013,0,0,1518,0,0,0,1518
26128,RM-1213A,7/27/2013,0,0,0,0,0,1518,1518
28189,RM-1221,7/27/2013,0,0,0,0,0,1518,1518
31584,RM-1231,7/27/2013,0,0,0,0,0,1518,1518
33686,RM-B102C,7/27/2013,0,0,1518,0,0,0,1518
34902,RM-B103A,7/27/2013,0,0,0,0,0,1518,1518
37507,RM-B210,7/27/2013,0,0,1518,0,0,0,1518
40944,RM-B225,7/27/2013,0,0,0,0,0,1518,1518
42314,RM-B230A,7/27/2013,0,0,0,0,0,1518,1518
43565,RM-B240A,7/27/2013,0,0,0,0,0,1518,1518
46914,RM-B270,7/27/2013,0,0,1518,0,0,0,1518
47582,RM-B275,7/27/2013,0,0,1518,0,0,0,1518
32553,RM-1236,5/14/2014,0,684,831,0,0,0,1515
27091,RM-1217,5/13/2014,837,672,0,0,0,0,1509
9642,RM-1123,11/1/2013,0,0,1506,0,0,0,1506
13617,RM-1133,11/1/2013,0,0,1506,0,0,0,1506
28277,RM-1221,11/1/2013,0,0,1506,0,0,0,1506
47002,RM-B270,11/1/2013,0,0,1506,0,0,0,1506
2812,RM-1106,11/1/2013,0,0,0,0,0,1503,1503
4869,RM-1109,11/1/2013,0,0,0,0,0,1503,1503
10327,RM-1124,11/1/2013,0,0,0,0,0,1503,1503
12245,RM-1130,11/1/2013,0,0,0,0,0,1503,1503
12932,RM-1132,11/1/2013,0,0,1503,0,0,0,1503
15409,RM-1144,11/1/2013,0,0,0,0,0,1503,1503
16094,RM-1145,11/1/2013,0,0,0,0,0,1503,1503
20802,RM-1200B,11/1/2013,0,0,0,0,0,1503,1503
22803,RM-1207,11/1/2013,0,0,0,0,0,1503,1503
25531,RM-1213,11/1/2013,0,0,0,0,0,1503,1503
26901,RM-1217,11/1/2013,1503,0,0,0,0,0,1503
31672,RM-1231,11/1/2013,0,0,0,0,0,1503,1503
34990,RM-B103A,11/1/2013,0,0,0,0,0,1503,1503
36226,RM-B200B,11/1/2013,0,0,0,0,0,1503,1503
39656,RM-B222,11/1/2013,1503,0,0,0,0,0,1503
40344,RM-B224,11/1/2013,0,0,0,0,0,1503,1503
41032,RM-B225,11/1/2013,0,0,0,0,0,1503,1503
42402,RM-B230A,11/1/2013,0,0,0,0,0,1503,1503
35910,RM-B109,11/12/2014,750,0,750,0,0,0,1500
46003,RM-B260,11/12/2014,750,0,750,0,0,0,1500
7479,RM-1116,7/9/2013,0,0,753,0,0,744,1497
18704,RM-1155,7/9/2013,744,0,753,0,0,0,1497
25008,RM-1212,3/31/2014,747,0,750,0,0,0,1497
30525,RM-1229,5/13/2014,0,0,837,660,0,0,1497
32257,RM-1236,7/9/2013,744,0,753,0,0,0,1497
36802,RM-B200C,7/9/2013,0,0,753,0,0,744,1497
37054,RM-B200C,3/31/2014,747,0,750,0,0,0,1497
40239,RM-B224,7/9/2013,0,0,753,0,0,744,1497
41864,RM-B230,3/31/2014,747,0,750,0,0,0,1497
22892,RM-1207,2/1/2014,747,0,0,0,0,747,1494
24489,RM-1208B,9/13/2014,747,0,747,0,0,0,1494
24950,RM-1212,2/1/2014,747,0,747,0,0,0,1494
28366,RM-1221,2/1/2014,0,0,747,0,0,747,1494
35852,RM-B109,9/13/2014,747,0,747,0,0,0,1494
36996,RM-B200C,2/1/2014,747,0,747,0,0,0,1494
45945,RM-B260,9/13/2014,747,0,747,0,0,0,1494
32552,RM-1236,5/13/2014,0,654,837,0,0,0,1491
8167,RM-1117,7/9/2013,744,0,0,0,0,744,1488
6331,RM-1113,2/5/2014,0,0,1485,0,0,0,1485
7677,RM-1116,2/5/2014,1485,0,0,0,0,0,1485
15502,RM-1144,2/5/2014,0,0,1485,0,0,0,1485
26309,RM-1213A,2/5/2014,0,0,1485,0,0,0,1485
32455,RM-1236,2/5/2014,0,0,1485,0,0,0,1485
38376,RM-B215,2/5/2014,0,0,1485,0,0,0,1485
44356,RM-B250,2/5/2014,0,0,1485,0,0,0,1485
3406,RM-1107,7/24/2013,0,0,1482,0,0,0,1482
4962,RM-1109,2/5/2014,0,0,0,0,0,1482,1482
6147,RM-1113,7/24/2013,0,0,1482,0,0,0,1482
8866,RM-1122,7/24/2013,0,0,1482,0,0,0,1482
9050,RM-1122,2/5/2014,0,0,0,0,0,1482,1482
10420,RM-1124,2/5/2014,0,0,0,0,0,1482,1482
13526,RM-1133,7/24/2013,0,0,1482,0,0,0,1482
16187,RM-1145,2/5/2014,0,0,0,0,0,1482,1482
25440,RM-1213,7/24/2013,0,0,1482,0,0,0,1482
25624,RM-1213,2/5/2014,0,0,0,0,0,1482,1482
31765,RM-1231,2/5/2014,0,0,0,0,0,1482,1482
33683,RM-B102C,7/24/2013,0,0,1482,0,0,0,1482
37504,RM-B210,7/24/2013,0,0,1482,0,0,0,1482
39061,RM-B220,2/5/2014,1482,0,0,0,0,0,1482
40437,RM-B224,2/5/2014,0,0,0,0,0,1482,1482
41125,RM-B225,2/5/2014,0,0,0,0,0,1482,1482
42495,RM-B230A,2/5/2014,0,0,0,0,0,1482,1482
45701,RM-B260,1/12/2014,0,0,0,1482,0,0,1482
46911,RM-B270,7/24/2013,0,0,1482,0,0,0,1482
47579,RM-B275,7/24/2013,0,0,1482,0,0,0,1482
47763,RM-B275,2/5/2014,0,0,0,0,0,1482,1482
5463,RM-1110,7/24/2013,0,0,0,0,0,1479,1479
12154,RM-1130,7/24/2013,0,0,0,0,0,1479,1479
23397,RM-1208,7/24/2013,0,0,0,0,0,1479,1479
26125,RM-1213A,7/24/2013,0,0,0,0,0,1479,1479
28186,RM-1221,7/24/2013,0,0,0,0,0,1479,1479
34899,RM-B103A,7/24/2013,0,0,0,0,0,1479,1479
40941,RM-B225,7/24/2013,0,0,0,0,0,1479,1479
42311,RM-B230A,7/24/2013,0,0,0,0,0,1479,1479
43562,RM-B240A,7/24/2013,0,0,0,0,0,1479,1479
45115,RM-B250A,4/20/2014,891,0,0,588,0,0,1479
25,RM-1100A,7/24/2013,1476,0,0,0,0,0,1476
2240,RM-1104,1/12/2014,0,1476,0,0,0,0,1476
2721,RM-1106,7/24/2013,1476,0,0,0,0,0,1476
3452,RM-1107,9/17/2013,0,0,1476,0,0,0,1476
6193,RM-1113,9/17/2013,0,0,1476,0,0,0,1476
8912,RM-1122,9/17/2013,0,0,1476,0,0,0,1476
9597,RM-1123,9/17/2013,0,0,1476,0,0,0,1476
12841,RM-1132,7/24/2013,1476,0,0,0,0,0,1476
13572,RM-1133,9/17/2013,0,0,1476,0,0,0,1476
18030,RM-1154,7/24/2013,1476,0,0,0,0,0,1476
20711,RM-1200B,7/24/2013,0,0,0,0,0,1476,1476
31056,RM-1230,1/12/2014,0,1476,0,0,0,0,1476
34380,RM-B103,1/12/2014,0,0,0,1476,0,0,1476
46957,RM-B270,9/17/2013,0,0,1476,0,0,0,1476
35181,RM-B103A,5/14/2014,831,0,0,642,0,0,1473
21556,RM-1200C,1/12/2014,0,1470,0,0,0,0,1470
34543,RM-B103,6/25/2014,0,0,0,1470,0,0,1470
35608,RM-B109,1/12/2014,0,1470,0,0,0,0,1470
43722,RM-B240A,1/12/2014,0,1470,0,0,0,0,1470
44392,RM-B250,3/13/2014,0,78,1392,0,0,0,1470
6475,RM-1113,6/29/2014,0,0,1467,0,0,0,1467
16304,RM-1145,6/29/2014,0,0,1467,0,0,0,1467
26453,RM-1213A,6/29/2014,0,0,1467,0,0,0,1467
28514,RM-1221,6/29/2014,0,0,1467,0,0,0,1467
43205,RM-B240,6/29/2014,0,0,1467,0,0,0,1467
15646,RM-1144,6/29/2014,0,0,1464,0,0,0,1464
29443,RM-1223,3/2/2015,612,0,849,0,0,0,1461
2767,RM-1106,9/17/2013,0,0,0,0,0,1458,1458
5790,RM-1110,6/29/2014,0,0,1458,0,0,0,1458
12200,RM-1130,9/17/2013,0,0,0,0,0,1458,1458
12931,RM-1132,10/31/2013,0,0,1458,0,0,0,1458
14376,RM-1134,6/29/2014,1458,0,0,0,0,0,1458
15364,RM-1144,9/17/2013,0,0,0,0,0,1458,1458
19046,RM-1155,6/29/2014,1458,0,0,0,0,0,1458
20801,RM-1200B,10/31/2013,0,0,0,0,0,1458,1458
23040,RM-1207,6/29/2014,1458,0,0,0,0,0,1458
25098,RM-1212,6/29/2014,1458,0,0,0,0,0,1458
26900,RM-1217,10/31/2013,1458,0,0,0,0,0,1458
29199,RM-1223,6/29/2014,1458,0,0,0,0,0,1458
31627,RM-1231,9/17/2013,0,0,0,0,0,1458,1458
34945,RM-B103A,9/17/2013,0,0,0,0,0,1458,1458
36181,RM-B200B,9/17/2013,0,0,0,0,0,1458,1458
37144,RM-B200C,6/29/2014,1458,0,0,0,0,0,1458
39205,RM-B220,6/29/2014,1458,0,0,0,0,0,1458
39655,RM-B222,10/31/2013,1458,0,0,0,0,0,1458
40299,RM-B224,9/17/2013,0,0,0,0,0,1458,1458
40987,RM-B225,9/17/2013,0,0,0,0,0,1458,1458
41954,RM-B230,6/29/2014,1458,0,0,0,0,0,1458
42357,RM-B230A,9/17/2013,0,0,0,0,0,1458,1458
43608,RM-B240A,9/17/2013,0,0,0,0,0,1458,1458
45184,RM-B250A,6/29/2014,1458,0,0,0,0,0,1458
2811,RM-1106,10/31/2013,0,0,0,0,0,1455,1455
4868,RM-1109,10/31/2013,0,0,0,0,0,1455,1455
9641,RM-1123,10/31/2013,0,0,1455,0,0,0,1455
10326,RM-1124,10/31/2013,0,0,0,0,0,1455,1455
12244,RM-1130,10/31/2013,0,0,0,0,0,1455,1455
13616,RM-1133,10/31/2013,0,0,1455,0,0,0,1455
15408,RM-1144,10/31/2013,0,0,0,0,0,1455,1455
16093,RM-1145,10/31/2013,0,0,0,0,0,1455,1455
22802,RM-1207,10/31/2013,0,0,0,0,0,1455,1455
25530,RM-1213,10/31/2013,0,0,0,0,0,1455,1455
28276,RM-1221,10/31/2013,0,0,1455,0,0,0,1455
31671,RM-1231,10/31/2013,0,0,0,0,0,1455,1455
34989,RM-B103A,10/31/2013,0,0,0,0,0,1455,1455
36225,RM-B200B,10/31/2013,0,0,0,0,0,1455,1455
40343,RM-B224,10/31/2013,0,0,0,0,0,1455,1455
41031,RM-B225,10/31/2013,0,0,0,0,0,1455,1455
42401,RM-B230A,10/31/2013,0,0,0,0,0,1455,1455
47001,RM-B270,10/31/2013,0,0,1455,0,0,0,1455
26856,RM-1217,9/17/2013,1452,0,0,0,0,0,1452
39611,RM-B222,9/17/2013,1452,0,0,0,0,0,1452
44218,RM-B250,9/17/2013,1452,0,0,0,0,0,1452
20757,RM-1200B,9/17/2013,0,0,0,0,0,1449,1449
35700,RM-B109,4/14/2014,399,0,1047,0,0,0,1446
3411,RM-1107,7/29/2013,0,0,1440,0,0,0,1440
4967,RM-1109,2/10/2014,0,0,0,0,0,1440,1440
6152,RM-1113,7/29/2013,0,0,1440,0,0,0,1440
6336,RM-1113,2/10/2014,0,0,1440,0,0,0,1440
7682,RM-1116,2/10/2014,1440,0,0,0,0,0,1440
8871,RM-1122,7/29/2013,0,0,1440,0,0,0,1440
9055,RM-1122,2/10/2014,0,0,0,0,0,1440,1440
13531,RM-1133,7/29/2013,0,0,1440,0,0,0,1440
15507,RM-1144,2/10/2014,0,0,1440,0,0,0,1440
16192,RM-1145,2/10/2014,0,0,0,0,0,1440,1440
25445,RM-1213,7/29/2013,0,0,1440,0,0,0,1440
25629,RM-1213,2/10/2014,0,0,0,0,0,1440,1440
26314,RM-1213A,2/10/2014,0,0,1440,0,0,0,1440
28375,RM-1221,2/10/2014,0,0,0,0,0,1440,1440
31770,RM-1231,2/10/2014,0,0,0,0,0,1440,1440
32460,RM-1236,2/10/2014,0,0,1440,0,0,0,1440
33688,RM-B102C,7/29/2013,0,0,1440,0,0,0,1440
37509,RM-B210,7/29/2013,0,0,1440,0,0,0,1440
38381,RM-B215,2/10/2014,0,0,1440,0,0,0,1440
39066,RM-B220,2/10/2014,1440,0,0,0,0,0,1440
40442,RM-B224,2/10/2014,0,0,0,0,0,1440,1440
42500,RM-B230A,2/10/2014,0,0,0,0,0,1440,1440
44361,RM-B250,2/10/2014,0,0,1440,0,0,0,1440
45046,RM-B250A,2/10/2014,1440,0,0,0,0,0,1440
46916,RM-B270,7/29/2013,0,0,1440,0,0,0,1440
47584,RM-B275,7/29/2013,0,0,1440,0,0,0,1440
47768,RM-B275,2/10/2014,0,0,0,0,0,1440,1440
3453,RM-1107,9/18/2013,0,0,1437,0,0,0,1437
5468,RM-1110,7/29/2013,0,0,0,0,0,1437,1437
12159,RM-1130,7/29/2013,0,0,0,0,0,1437,1437
27094,RM-1217,5/16/2014,717,720,0,0,0,0,1437
32376,RM-1236,11/15/2013,324,0,1113,0,0,0,1437
34904,RM-B103A,7/29/2013,0,0,0,0,0,1437,1437
40946,RM-B225,7/29/2013,0,0,0,0,0,1437,1437
42316,RM-B230A,7/29/2013,0,0,0,0,0,1437,1437
43567,RM-B240A,7/29/2013,0,0,0,0,0,1437,1437
2726,RM-1106,7/29/2013,1434,0,0,0,0,0,1434
12846,RM-1132,7/29/2013,1434,0,0,0,0,0,1434
18035,RM-1154,7/29/2013,1434,0,0,0,0,0,1434
26130,RM-1213A,7/29/2013,0,0,0,0,0,1434,1434
28191,RM-1221,7/29/2013,0,0,0,0,0,1434,1434
31586,RM-1231,7/29/2013,0,0,0,0,0,1434,1434
35732,RM-B109,5/16/2014,717,0,717,0,0,0,1434
37100,RM-B200C,5/16/2014,717,0,717,0,0,0,1434
41910,RM-B230,5/16/2014,717,0,717,0,0,0,1434
20716,RM-1200B,7/29/2013,0,0,0,0,0,1428,1428
41915,RM-B230,5/21/2014,1272,0,156,0,0,0,1428
46036,RM-B260,12/15/2014,552,0,876,0,0,0,1428
44329,RM-B250,1/9/2014,486,0,939,0,0,0,1425
21671,RM-1200C,5/7/2014,0,714,0,708,0,0,1422
2734,RM-1106,8/6/2013,1416,0,0,0,0,0,1416
4963,RM-1109,2/6/2014,0,0,0,0,0,1416,1416
7678,RM-1116,2/6/2014,1416,0,0,0,0,0,1416
9051,RM-1122,2/6/2014,0,0,0,0,0,1416,1416
10421,RM-1124,2/6/2014,0,0,0,0,0,1416,1416
12167,RM-1130,8/6/2013,0,0,0,0,0,1416,1416
15331,RM-1144,8/6/2013,0,0,0,0,0,1416,1416
16188,RM-1145,2/6/2014,0,0,0,0,0,1416,1416
18043,RM-1154,8/6/2013,1416,0,0,0,0,0,1416
20724,RM-1200B,8/6/2013,0,0,0,0,0,1416,1416
25625,RM-1213,2/6/2014,0,0,0,0,0,1416,1416
26138,RM-1213A,8/6/2013,0,0,0,0,0,1416,1416
26823,RM-1217,8/6/2013,1416,0,0,0,0,0,1416
28199,RM-1221,8/6/2013,0,0,0,0,0,1416,1416
28371,RM-1221,2/6/2014,0,0,0,0,0,1416,1416
31594,RM-1231,8/6/2013,0,0,0,0,0,1416,1416
31766,RM-1231,2/6/2014,0,0,0,0,0,1416,1416
34912,RM-B103A,8/6/2013,0,0,0,0,0,1416,1416
39062,RM-B220,2/6/2014,1416,0,0,0,0,0,1416
40438,RM-B224,2/6/2014,0,0,0,0,0,1416,1416
40954,RM-B225,8/6/2013,0,0,0,0,0,1416,1416
41126,RM-B225,2/6/2014,0,0,0,0,0,1416,1416
42324,RM-B230A,8/6/2013,0,0,0,0,0,1416,1416
42496,RM-B230A,2/6/2014,0,0,0,0,0,1416,1416
43575,RM-B240A,8/6/2013,0,0,0,0,0,1416,1416
47764,RM-B275,2/6/2014,0,0,0,0,0,1416,1416
3419,RM-1107,8/6/2013,0,0,1413,0,0,0,1413
3440,RM-1107,9/4/2013,0,0,1413,0,0,0,1413
6160,RM-1113,8/6/2013,0,0,1413,0,0,0,1413
6181,RM-1113,9/4/2013,0,0,1413,0,0,0,1413
6332,RM-1113,2/6/2014,0,0,1413,0,0,0,1413
8879,RM-1122,8/6/2013,0,0,1413,0,0,0,1413
8900,RM-1122,9/4/2013,0,0,1413,0,0,0,1413
9585,RM-1123,9/4/2013,0,0,1413,0,0,0,1413
13539,RM-1133,8/6/2013,0,0,1413,0,0,0,1413
13560,RM-1133,9/4/2013,0,0,1413,0,0,0,1413
15503,RM-1144,2/6/2014,0,0,1413,0,0,0,1413
25453,RM-1213,8/6/2013,0,0,1413,0,0,0,1413
25474,RM-1213,9/4/2013,0,0,1413,0,0,0,1413
26310,RM-1213A,2/6/2014,0,0,1413,0,0,0,1413
27004,RM-1217,2/15/2014,1197,0,0,216,0,0,1413
32456,RM-1236,2/6/2014,0,0,1413,0,0,0,1413
33696,RM-B102C,8/6/2013,0,0,1413,0,0,0,1413
33717,RM-B102C,9/4/2013,0,0,1413,0,0,0,1413
37517,RM-B210,8/6/2013,0,0,1413,0,0,0,1413
44357,RM-B250,2/6/2014,0,0,1413,0,0,0,1413
46924,RM-B270,8/6/2013,0,0,1413,0,0,0,1413
46945,RM-B270,9/4/2013,0,0,1413,0,0,0,1413
47592,RM-B275,8/6/2013,0,0,1413,0,0,0,1413
12188,RM-1130,9/4/2013,0,0,0,0,0,1410,1410
15352,RM-1144,9/4/2013,0,0,0,0,0,1410,1410
18064,RM-1154,9/4/2013,1410,0,0,0,0,0,1410
20745,RM-1200B,9/4/2013,0,0,0,0,0,1410,1410
26844,RM-1217,9/4/2013,1410,0,0,0,0,0,1410
31615,RM-1231,9/4/2013,0,0,0,0,0,1410,1410
34933,RM-B103A,9/4/2013,0,0,0,0,0,1410,1410
36169,RM-B200B,9/4/2013,0,0,0,0,0,1410,1410
40287,RM-B224,9/4/2013,0,0,0,0,0,1410,1410
40975,RM-B225,9/4/2013,0,0,0,0,0,1410,1410
42345,RM-B230A,9/4/2013,0,0,0,0,0,1410,1410
43596,RM-B240A,9/4/2013,0,0,0,0,0,1410,1410
44206,RM-B250,9/4/2013,1410,0,0,0,0,0,1410
37051,RM-B200C,3/28/2014,693,0,714,0,0,0,1407
2771,RM-1106,9/21/2013,0,0,0,0,0,1404,1404
6197,RM-1113,9/21/2013,0,0,1404,0,0,0,1404
8916,RM-1122,9/21/2013,0,0,1404,0,0,0,1404
9601,RM-1123,9/21/2013,0,0,1404,0,0,0,1404
12204,RM-1130,9/21/2013,0,0,0,0,0,1404,1404
12891,RM-1132,9/21/2013,0,0,1404,0,0,0,1404
13576,RM-1133,9/21/2013,0,0,1404,0,0,0,1404
15368,RM-1144,9/21/2013,0,0,0,0,0,1404,1404
20761,RM-1200B,9/21/2013,0,0,0,0,0,1404,1404
22762,RM-1207,9/21/2013,0,0,0,0,0,1404,1404
25005,RM-1212,3/28/2014,693,0,711,0,0,0,1404
26860,RM-1217,9/21/2013,1404,0,0,0,0,0,1404
31631,RM-1231,9/21/2013,0,0,0,0,0,1404,1404
34949,RM-B103A,9/21/2013,0,0,0,0,0,1404,1404
36185,RM-B200B,9/21/2013,0,0,0,0,0,1404,1404
39615,RM-B222,9/21/2013,1404,0,0,0,0,0,1404
40303,RM-B224,9/21/2013,0,0,0,0,0,1404,1404
40991,RM-B225,9/21/2013,0,0,0,0,0,1404,1404
42361,RM-B230A,9/21/2013,0,0,0,0,0,1404,1404
43612,RM-B240A,9/21/2013,0,0,0,0,0,1404,1404
44222,RM-B250,9/21/2013,1404,0,0,0,0,0,1404
46961,RM-B270,9/21/2013,0,0,1404,0,0,0,1404
30528,RM-1229,5/16/2014,0,0,717,684,0,0,1401
32555,RM-1236,5/16/2014,0,684,717,0,0,0,1401
36314,RM-B200B,1/31/2014,0,1248,0,0,0,150,1398
7041,RM-1115,3/28/2014,693,0,0,0,0,702,1395
7713,RM-1116,3/13/2014,1395,0,0,0,0,0,1395
18953,RM-1155,3/28/2014,693,0,0,0,0,702,1395
19629,RM-1156,3/28/2014,693,0,0,0,0,702,1395
22947,RM-1207,3/28/2014,693,0,0,0,0,702,1395
25660,RM-1213,3/13/2014,0,0,0,0,0,1395,1395
27030,RM-1217,3/13/2014,1395,0,0,0,0,0,1395
28406,RM-1221,3/13/2014,0,0,0,0,0,1395,1395
31801,RM-1231,3/13/2014,0,0,0,0,0,1395,1395
39097,RM-B220,3/13/2014,1395,0,0,0,0,0,1395
45077,RM-B250A,3/13/2014,1395,0,0,0,0,0,1395
4998,RM-1109,3/13/2014,0,0,0,0,0,1392,1392
6268,RM-1113,12/4/2013,696,0,696,0,0,0,1392
6367,RM-1113,3/13/2014,0,0,1392,0,0,0,1392
8302,RM-1117,12/4/2013,696,0,696,0,0,0,1392
9086,RM-1122,3/13/2014,0,0,0,0,0,1392,1392
15538,RM-1144,3/13/2014,0,0,1392,0,0,0,1392
16223,RM-1145,3/13/2014,0,0,0,0,0,1392,1392
18839,RM-1155,12/4/2013,696,0,696,0,0,0,1392
26345,RM-1213A,3/13/2014,0,0,1392,0,0,0,1392
32491,RM-1236,3/13/2014,0,0,1392,0,0,0,1392
35668,RM-B109,3/13/2014,0,0,1392,0,0,0,1392
38412,RM-B215,3/13/2014,0,0,1392,0,0,0,1392
40473,RM-B224,3/13/2014,0,0,0,0,0,1392,1392
42531,RM-B230A,3/13/2014,0,0,0,0,0,1392,1392
43097,RM-B240,3/13/2014,0,0,1392,0,0,0,1392
44293,RM-B250,12/4/2013,696,0,696,0,0,0,1392
47691,RM-B275,11/25/2013,0,0,381,0,0,1011,1392
47799,RM-B275,3/13/2014,0,0,0,0,0,1392,1392
7614,RM-1116,12/4/2013,696,0,0,0,0,693,1389
23518,RM-1208,12/4/2013,696,0,0,0,0,693,1389
30365,RM-1229,12/4/2013,0,0,696,0,0,693,1389
35020,RM-B103A,12/4/2013,696,0,0,0,0,693,1389
3447,RM-1107,9/12/2013,0,0,1383,0,0,0,1383
6188,RM-1113,9/12/2013,0,0,1383,0,0,0,1383
6196,RM-1113,9/20/2013,0,0,1383,0,0,0,1383
8907,RM-1122,9/12/2013,0,0,1383,0,0,0,1383
8915,RM-1122,9/20/2013,0,0,1383,0,0,0,1383
9592,RM-1123,9/12/2013,0,0,1383,0,0,0,1383
9600,RM-1123,9/20/2013,0,0,1383,0,0,0,1383
12890,RM-1132,9/20/2013,0,0,1383,0,0,0,1383
13567,RM-1133,9/12/2013,0,0,1383,0,0,0,1383
13575,RM-1133,9/20/2013,0,0,1383,0,0,0,1383
20760,RM-1200B,9/20/2013,0,0,0,0,0,1383,1383
25481,RM-1213,9/12/2013,0,0,1383,0,0,0,1383
26859,RM-1217,9/20/2013,1383,0,0,0,0,0,1383
39614,RM-B222,9/20/2013,1383,0,0,0,0,0,1383
44221,RM-B250,9/20/2013,1383,0,0,0,0,0,1383
46952,RM-B270,9/12/2013,0,0,1383,0,0,0,1383
46960,RM-B270,9/20/2013,0,0,1383,0,0,0,1383
2770,RM-1106,9/20/2013,0,0,0,0,0,1380,1380
2772,RM-1106,9/22/2013,0,0,0,0,0,1380,1380
12195,RM-1130,9/12/2013,0,0,0,0,0,1380,1380
12203,RM-1130,9/20/2013,0,0,0,0,0,1380,1380
12205,RM-1130,9/22/2013,0,0,0,0,0,1380,1380
15359,RM-1144,9/12/2013,0,0,0,0,0,1380,1380
15367,RM-1144,9/20/2013,0,0,0,0,0,1380,1380
15369,RM-1144,9/22/2013,0,0,0,0,0,1380,1380
20752,RM-1200B,9/12/2013,0,0,0,0,0,1380,1380
22761,RM-1207,9/20/2013,0,0,0,0,0,1380,1380
22763,RM-1207,9/22/2013,0,0,0,0,0,1380,1380
26851,RM-1217,9/12/2013,1380,0,0,0,0,0,1380
31622,RM-1231,9/12/2013,0,0,0,0,0,1380,1380
31630,RM-1231,9/20/2013,0,0,0,0,0,1380,1380
31632,RM-1231,9/22/2013,0,0,0,0,0,1380,1380
34940,RM-B103A,9/12/2013,0,0,0,0,0,1380,1380
34948,RM-B103A,9/20/2013,0,0,0,0,0,1380,1380
34950,RM-B103A,9/22/2013,0,0,0,0,0,1380,1380
35901,RM-B109,11/3/2014,690,0,690,0,0,0,1380
36176,RM-B200B,9/12/2013,0,0,0,0,0,1380,1380
36184,RM-B200B,9/20/2013,0,0,0,0,0,1380,1380
36186,RM-B200B,9/22/2013,0,0,0,0,0,1380,1380
40294,RM-B224,9/12/2013,0,0,0,0,0,1380,1380
40302,RM-B224,9/20/2013,0,0,0,0,0,1380,1380
40304,RM-B224,9/22/2013,0,0,0,0,0,1380,1380
40982,RM-B225,9/12/2013,0,0,0,0,0,1380,1380
40990,RM-B225,9/20/2013,0,0,0,0,0,1380,1380
40992,RM-B225,9/22/2013,0,0,0,0,0,1380,1380
42352,RM-B230A,9/12/2013,0,0,0,0,0,1380,1380
42360,RM-B230A,9/20/2013,0,0,0,0,0,1380,1380
42362,RM-B230A,9/22/2013,0,0,0,0,0,1380,1380
43603,RM-B240A,9/12/2013,0,0,0,0,0,1380,1380
43611,RM-B240A,9/20/2013,0,0,0,0,0,1380,1380
43613,RM-B240A,9/22/2013,0,0,0,0,0,1380,1380
44213,RM-B250,9/12/2013,1380,0,0,0,0,0,1380
45994,RM-B260,11/3/2014,690,0,690,0,0,0,1380
6198,RM-1113,9/22/2013,0,0,1377,0,0,0,1377
8917,RM-1122,9/22/2013,0,0,1377,0,0,0,1377
9602,RM-1123,9/22/2013,0,0,1377,0,0,0,1377
12892,RM-1132,9/22/2013,0,0,1377,0,0,0,1377
13577,RM-1133,9/22/2013,0,0,1377,0,0,0,1377
20762,RM-1200B,9/22/2013,0,0,0,0,0,1377,1377
26861,RM-1217,9/22/2013,1377,0,0,0,0,0,1377
39616,RM-B222,9/22/2013,1377,0,0,0,0,0,1377
44223,RM-B250,9/22/2013,1377,0,0,0,0,0,1377
46962,RM-B270,9/22/2013,0,0,1377,0,0,0,1377
8336,RM-1117,1/7/2014,684,0,687,0,0,0,1371
18873,RM-1155,1/7/2014,684,0,687,0,0,0,1371
24925,RM-1212,1/7/2014,684,0,687,0,0,0,1371
28341,RM-1221,1/7/2014,0,0,687,0,0,684,1371
30399,RM-1229,1/7/2014,0,0,687,0,0,684,1371
30519,RM-1229,5/7/2014,0,0,897,474,0,0,1371
36971,RM-B200C,1/7/2014,684,0,687,0,0,0,1371
38347,RM-B215,1/7/2014,0,0,687,0,0,684,1371
44327,RM-B250,1/7/2014,684,0,687,0,0,0,1371
22867,RM-1207,1/7/2014,684,0,0,0,0,684,1368
23552,RM-1208,1/7/2014,684,0,0,0,0,684,1368
27085,RM-1217,5/7/2014,888,480,0,0,0,0,1368
35054,RM-B103A,1/7/2014,684,0,0,0,0,684,1368
942,RM-1100D,3/25/2014,0,0,0,1362,0,0,1362
3418,RM-1107,8/5/2013,0,0,1356,0,0,0,1356
6159,RM-1113,8/5/2013,0,0,1356,0,0,0,1356
8878,RM-1122,8/5/2013,0,0,1356,0,0,0,1356
9825,RM-1123,5/6/2014,0,1356,0,0,0,0,1356
13538,RM-1133,8/5/2013,0,0,1356,0,0,0,1356
20723,RM-1200B,8/5/2013,0,0,0,0,0,1356,1356
25452,RM-1213,8/5/2013,0,0,1356,0,0,0,1356
33695,RM-B102C,8/5/2013,0,0,1356,0,0,0,1356
37516,RM-B210,8/5/2013,0,0,1356,0,0,0,1356
46923,RM-B270,8/5/2013,0,0,1356,0,0,0,1356
47591,RM-B275,8/5/2013,0,0,1356,0,0,0,1356
2733,RM-1106,8/5/2013,1353,0,0,0,0,0,1353
12166,RM-1130,8/5/2013,0,0,0,0,0,1353,1353
15330,RM-1144,8/5/2013,0,0,0,0,0,1353,1353
18042,RM-1154,8/5/2013,1353,0,0,0,0,0,1353
26137,RM-1213A,8/5/2013,0,0,0,0,0,1353,1353
26822,RM-1217,8/5/2013,1353,0,0,0,0,0,1353
28198,RM-1221,8/5/2013,0,0,0,0,0,1353,1353
31593,RM-1231,8/5/2013,0,0,0,0,0,1353,1353
34911,RM-B103A,8/5/2013,0,0,0,0,0,1353,1353
40953,RM-B225,8/5/2013,0,0,0,0,0,1353,1353
42323,RM-B230A,8/5/2013,0,0,0,0,0,1353,1353
43574,RM-B240A,8/5/2013,0,0,0,0,0,1353,1353
2804,RM-1106,10/24/2013,0,0,0,0,0,1350,1350
4861,RM-1109,10/24/2013,0,0,0,0,0,1350,1350
9634,RM-1123,10/24/2013,0,0,1350,0,0,0,1350
10319,RM-1124,10/24/2013,0,0,0,0,0,1350,1350
12237,RM-1130,10/24/2013,0,0,0,0,0,1350,1350
12924,RM-1132,10/24/2013,0,0,1350,0,0,0,1350
13609,RM-1133,10/24/2013,0,0,1350,0,0,0,1350
15401,RM-1144,10/24/2013,0,0,0,0,0,1350,1350
16086,RM-1145,10/24/2013,0,0,0,0,0,1350,1350
18755,RM-1155,9/7/2013,675,0,675,0,0,0,1350
20794,RM-1200B,10/24/2013,0,0,0,0,0,1350,1350
22795,RM-1207,10/24/2013,0,0,0,0,0,1350,1350
25523,RM-1213,10/24/2013,0,0,0,0,0,1350,1350
28269,RM-1221,10/24/2013,0,0,1350,0,0,0,1350
30407,RM-1229,1/15/2014,0,0,675,0,0,675,1350
31664,RM-1231,10/24/2013,0,0,0,0,0,1350,1350
32308,RM-1236,9/7/2013,675,0,675,0,0,0,1350
34982,RM-B103A,10/24/2013,0,0,0,0,0,1350,1350
36218,RM-B200B,10/24/2013,0,0,0,0,0,1350,1350
38355,RM-B215,1/15/2014,0,0,675,0,0,675,1350
40336,RM-B224,10/24/2013,0,0,0,0,0,1350,1350
41024,RM-B225,10/24/2013,0,0,0,0,0,1350,1350
42394,RM-B230A,10/24/2013,0,0,0,0,0,1350,1350
46994,RM-B270,10/24/2013,0,0,1350,0,0,0,1350
2758,RM-1106,9/7/2013,675,0,0,0,0,672,1347
7530,RM-1116,9/7/2013,0,0,675,0,0,672,1347
8218,RM-1117,9/7/2013,675,0,0,0,0,672,1347
22875,RM-1207,1/15/2014,672,0,0,0,0,675,1347
23434,RM-1208,9/7/2013,675,0,0,0,0,672,1347
24933,RM-1212,1/15/2014,672,0,675,0,0,0,1347
26893,RM-1217,10/24/2013,1347,0,0,0,0,0,1347
28349,RM-1221,1/15/2014,0,0,675,0,0,672,1347
35062,RM-B103A,1/15/2014,672,0,0,0,0,675,1347
36853,RM-B200C,9/7/2013,0,0,675,0,0,672,1347
36979,RM-B200C,1/15/2014,672,0,675,0,0,0,1347
39602,RM-B222,9/7/2013,672,0,675,0,0,0,1347
39648,RM-B222,10/24/2013,1347,0,0,0,0,0,1347
47616,RM-B275,9/7/2013,0,0,675,0,0,672,1347
38229,RM-B215,9/7/2013,672,0,0,0,0,672,1344
45705,RM-B260,1/16/2014,0,0,0,1344,0,0,1344
6199,RM-1113,9/23/2013,0,0,1341,0,0,0,1341
8918,RM-1122,9/23/2013,0,0,1341,0,0,0,1341
9603,RM-1123,9/23/2013,0,0,1341,0,0,0,1341
12893,RM-1132,9/23/2013,0,0,1341,0,0,0,1341
13578,RM-1133,9/23/2013,0,0,1341,0,0,0,1341
20763,RM-1200B,9/23/2013,0,0,0,0,0,1341,1341
26862,RM-1217,9/23/2013,1341,0,0,0,0,0,1341
28324,RM-1221,12/21/2013,0,0,1188,0,0,153,1341
39617,RM-B222,9/23/2013,1341,0,0,0,0,0,1341
44224,RM-B250,9/23/2013,1341,0,0,0,0,0,1341
46963,RM-B270,9/23/2013,0,0,1341,0,0,0,1341
311,RM-1100A,5/18/2014,1338,0,0,0,0,0,1338
1681,RM-1102,5/18/2014,1338,0,0,0,0,0,1338
2773,RM-1106,9/23/2013,0,0,0,0,0,1338,1338
5748,RM-1110,5/18/2014,0,0,1338,0,0,0,1338
6433,RM-1113,5/18/2014,0,0,1338,0,0,0,1338
7092,RM-1115,5/18/2014,1338,0,0,0,0,0,1338
7779,RM-1116,5/18/2014,1338,0,0,0,0,0,1338
12206,RM-1130,9/23/2013,0,0,0,0,0,1338,1338
14334,RM-1134,5/18/2014,1338,0,0,0,0,0,1338
15370,RM-1144,9/23/2013,0,0,0,0,0,1338,1338
15604,RM-1144,5/18/2014,0,0,1338,0,0,0,1338
16262,RM-1145,5/18/2014,0,0,1338,0,0,0,1338
19004,RM-1155,5/18/2014,1338,0,0,0,0,0,1338
22764,RM-1207,9/23/2013,0,0,0,0,0,1338,1338
22998,RM-1207,5/18/2014,1338,0,0,0,0,0,1338
25056,RM-1212,5/18/2014,1338,0,0,0,0,0,1338
26411,RM-1213A,5/18/2014,0,0,1338,0,0,0,1338
29157,RM-1223,5/18/2014,1338,0,0,0,0,0,1338
31633,RM-1231,9/23/2013,0,0,0,0,0,1338,1338
33724,RM-B102C,9/12/2013,0,0,1338,0,0,0,1338
34384,RM-B103,1/16/2014,0,0,0,1338,0,0,1338
34951,RM-B103A,9/23/2013,0,0,0,0,0,1338,1338
36187,RM-B200B,9/23/2013,0,0,0,0,0,1338,1338
37102,RM-B200C,5/18/2014,1338,0,0,0,0,0,1338
38478,RM-B215,5/18/2014,0,0,1338,0,0,0,1338
39163,RM-B220,5/18/2014,1338,0,0,0,0,0,1338
39851,RM-B222,5/18/2014,1338,0,0,0,0,0,1338
40305,RM-B224,9/23/2013,0,0,0,0,0,1338,1338
40993,RM-B225,9/23/2013,0,0,0,0,0,1338,1338
42363,RM-B230A,9/23/2013,0,0,0,0,0,1338,1338
43163,RM-B240,5/18/2014,0,0,1338,0,0,0,1338
43614,RM-B240A,9/23/2013,0,0,0,0,0,1338,1338
45142,RM-B250A,5/18/2014,1338,0,0,0,0,0,1338
313,RM-1100A,5/20/2014,1335,0,0,0,0,0,1335
1683,RM-1102,5/20/2014,1335,0,0,0,0,0,1335
5750,RM-1110,5/20/2014,0,0,1335,0,0,0,1335
6435,RM-1113,5/20/2014,0,0,1335,0,0,0,1335
7781,RM-1116,5/20/2014,1335,0,0,0,0,0,1335
14336,RM-1134,5/20/2014,1335,0,0,0,0,0,1335
15606,RM-1144,5/20/2014,0,0,1335,0,0,0,1335
16264,RM-1145,5/20/2014,0,0,1335,0,0,0,1335
19006,RM-1155,5/20/2014,1335,0,0,0,0,0,1335
23000,RM-1207,5/20/2014,1335,0,0,0,0,0,1335
25058,RM-1212,5/20/2014,1335,0,0,0,0,0,1335
26413,RM-1213A,5/20/2014,0,0,1335,0,0,0,1335
28474,RM-1221,5/20/2014,0,0,1335,0,0,0,1335
29159,RM-1223,5/20/2014,1335,0,0,0,0,0,1335
32546,RM-1236,5/7/2014,0,438,897,0,0,0,1335
37104,RM-B200C,5/20/2014,1335,0,0,0,0,0,1335
38480,RM-B215,5/20/2014,0,0,1335,0,0,0,1335
39165,RM-B220,5/20/2014,1335,0,0,0,0,0,1335
39853,RM-B222,5/20/2014,1335,0,0,0,0,0,1335
43165,RM-B240,5/20/2014,0,0,1335,0,0,0,1335
45144,RM-B250A,5/20/2014,1335,0,0,0,0,0,1335
3431,RM-1107,8/18/2013,0,0,1332,0,0,0,1332
6172,RM-1113,8/18/2013,0,0,1332,0,0,0,1332
8891,RM-1122,8/18/2013,0,0,1332,0,0,0,1332
9576,RM-1123,8/18/2013,0,0,1332,0,0,0,1332
13551,RM-1133,8/18/2013,0,0,1332,0,0,0,1332
20736,RM-1200B,8/18/2013,0,0,0,0,0,1332,1332
25465,RM-1213,8/18/2013,0,0,1332,0,0,0,1332
33708,RM-B102C,8/18/2013,0,0,1332,0,0,0,1332
46936,RM-B270,8/18/2013,0,0,1332,0,0,0,1332
12179,RM-1130,8/18/2013,0,0,0,0,0,1329,1329
15343,RM-1144,8/18/2013,0,0,0,0,0,1329,1329
18055,RM-1154,8/18/2013,1329,0,0,0,0,0,1329
22890,RM-1207,1/30/2014,663,0,0,0,0,666,1329
26150,RM-1213A,8/18/2013,0,0,0,0,0,1329,1329
26835,RM-1217,8/18/2013,1329,0,0,0,0,0,1329
28364,RM-1221,1/30/2014,0,0,663,0,0,666,1329
31606,RM-1231,8/18/2013,0,0,0,0,0,1329,1329
34924,RM-B103A,8/18/2013,0,0,0,0,0,1329,1329
40966,RM-B225,8/18/2013,0,0,0,0,0,1329,1329
42336,RM-B230A,8/18/2013,0,0,0,0,0,1329,1329
43587,RM-B240A,8/18/2013,0,0,0,0,0,1329,1329
44197,RM-B250,8/18/2013,1329,0,0,0,0,0,1329
7648,RM-1116,1/7/2014,684,0,0,0,0,642,1326
24948,RM-1212,1/30/2014,663,0,663,0,0,0,1326
36994,RM-B200C,1/30/2014,663,0,663,0,0,0,1326
32656,RM-1236,8/25/2014,771,0,552,0,0,0,1323
35063,RM-B103A,1/16/2014,660,0,0,6,0,657,1323
2725,RM-1106,7/28/2013,1320,0,0,0,0,0,1320
2802,RM-1106,10/22/2013,0,0,0,0,0,1320,1320
3410,RM-1107,7/28/2013,0,0,1320,0,0,0,1320
4859,RM-1109,10/22/2013,0,0,0,0,0,1320,1320
5467,RM-1110,7/28/2013,0,0,0,0,0,1320,1320
6151,RM-1113,7/28/2013,0,0,1320,0,0,0,1320
8870,RM-1122,7/28/2013,0,0,1320,0,0,0,1320
9632,RM-1123,10/22/2013,0,0,1320,0,0,0,1320
10317,RM-1124,10/22/2013,0,0,0,0,0,1320,1320
12158,RM-1130,7/28/2013,0,0,0,0,0,1320,1320
12235,RM-1130,10/22/2013,0,0,0,0,0,1320,1320
12845,RM-1132,7/28/2013,1320,0,0,0,0,0,1320
12922,RM-1132,10/22/2013,0,0,1320,0,0,0,1320
13530,RM-1133,7/28/2013,0,0,1320,0,0,0,1320
13607,RM-1133,10/22/2013,0,0,1320,0,0,0,1320
15399,RM-1144,10/22/2013,0,0,0,0,0,1320,1320
16084,RM-1145,10/22/2013,0,0,0,0,0,1320,1320
18034,RM-1154,7/28/2013,1320,0,0,0,0,0,1320
20715,RM-1200B,7/28/2013,0,0,0,0,0,1320,1320
20792,RM-1200B,10/22/2013,0,0,0,0,0,1320,1320
22793,RM-1207,10/22/2013,0,0,0,0,0,1320,1320
25444,RM-1213,7/28/2013,0,0,1320,0,0,0,1320
25521,RM-1213,10/22/2013,0,0,0,0,0,1320,1320
26129,RM-1213A,7/28/2013,0,0,0,0,0,1320,1320
26891,RM-1217,10/22/2013,1320,0,0,0,0,0,1320
28190,RM-1221,7/28/2013,0,0,0,0,0,1320,1320
28267,RM-1221,10/22/2013,0,0,1320,0,0,0,1320
30408,RM-1229,1/16/2014,0,0,657,6,0,657,1320
31585,RM-1231,7/28/2013,0,0,0,0,0,1320,1320
31662,RM-1231,10/22/2013,0,0,0,0,0,1320,1320
33687,RM-B102C,7/28/2013,0,0,1320,0,0,0,1320
34903,RM-B103A,7/28/2013,0,0,0,0,0,1320,1320
34980,RM-B103A,10/22/2013,0,0,0,0,0,1320,1320
36216,RM-B200B,10/22/2013,0,0,0,0,0,1320,1320
37508,RM-B210,7/28/2013,0,0,1320,0,0,0,1320
39646,RM-B222,10/22/2013,1320,0,0,0,0,0,1320
40334,RM-B224,10/22/2013,0,0,0,0,0,1320,1320
40945,RM-B225,7/28/2013,0,0,0,0,0,1320,1320
41022,RM-B225,10/22/2013,0,0,0,0,0,1320,1320
42315,RM-B230A,7/28/2013,0,0,0,0,0,1320,1320
42392,RM-B230A,10/22/2013,0,0,0,0,0,1320,1320
43566,RM-B240A,7/28/2013,0,0,0,0,0,1320,1320
46915,RM-B270,7/28/2013,0,0,1320,0,0,0,1320
46992,RM-B270,10/22/2013,0,0,1320,0,0,0,1320
47583,RM-B275,7/28/2013,0,0,1320,0,0,0,1320
22876,RM-1207,1/16/2014,660,0,0,0,0,657,1317
24934,RM-1212,1/16/2014,660,0,657,0,0,0,1317
28350,RM-1221,1/16/2014,0,0,657,0,0,660,1317
32632,RM-1236,8/1/2014,450,0,867,0,0,0,1317
36980,RM-B200C,1/16/2014,660,0,657,0,0,0,1317
2723,RM-1106,7/26/2013,1314,0,0,0,0,0,1314
3408,RM-1107,7/26/2013,0,0,1314,0,0,0,1314
5465,RM-1110,7/26/2013,0,0,0,0,0,1314,1314
6149,RM-1113,7/26/2013,0,0,1314,0,0,0,1314
8868,RM-1122,7/26/2013,0,0,1314,0,0,0,1314
12156,RM-1130,7/26/2013,0,0,0,0,0,1314,1314
12843,RM-1132,7/26/2013,1314,0,0,0,0,0,1314
13528,RM-1133,7/26/2013,0,0,1314,0,0,0,1314
18032,RM-1154,7/26/2013,1314,0,0,0,0,0,1314
20713,RM-1200B,7/26/2013,0,0,0,0,0,1314,1314
23399,RM-1208,7/26/2013,0,0,0,0,0,1314,1314
25442,RM-1213,7/26/2013,0,0,1314,0,0,0,1314
26127,RM-1213A,7/26/2013,0,0,0,0,0,1314,1314
28188,RM-1221,7/26/2013,0,0,0,0,0,1314,1314
31583,RM-1231,7/26/2013,0,0,0,0,0,1314,1314
33685,RM-B102C,7/26/2013,0,0,1314,0,0,0,1314
34901,RM-B103A,7/26/2013,0,0,0,0,0,1314,1314
37506,RM-B210,7/26/2013,0,0,1314,0,0,0,1314
38356,RM-B215,1/16/2014,0,0,657,0,0,657,1314
40943,RM-B225,7/26/2013,0,0,0,0,0,1314,1314
42313,RM-B230A,7/26/2013,0,0,0,0,0,1314,1314
43564,RM-B240A,7/26/2013,0,0,0,0,0,1314,1314
46913,RM-B270,7/26/2013,0,0,1314,0,0,0,1314
47581,RM-B275,7/26/2013,0,0,1314,0,0,0,1314
6333,RM-1113,2/7/2014,0,0,1311,0,0,0,1311
15504,RM-1144,2/7/2014,0,0,1311,0,0,0,1311
26311,RM-1213A,2/7/2014,0,0,1311,0,0,0,1311
32457,RM-1236,2/7/2014,0,0,1311,0,0,0,1311
36166,RM-B200B,8/28/2013,0,0,0,0,0,1311,1311
38378,RM-B215,2/7/2014,0,0,1311,0,0,0,1311
44358,RM-B250,2/7/2014,0,0,1311,0,0,0,1311
4964,RM-1109,2/7/2014,0,0,0,0,0,1308,1308
6335,RM-1113,2/9/2014,0,0,1308,0,0,0,1308
7679,RM-1116,2/7/2014,1308,0,0,0,0,0,1308
9052,RM-1122,2/7/2014,0,0,0,0,0,1308,1308
10422,RM-1124,2/7/2014,0,0,0,0,0,1308,1308
15506,RM-1144,2/9/2014,0,0,1308,0,0,0,1308
16189,RM-1145,2/7/2014,0,0,0,0,0,1308,1308
25626,RM-1213,2/7/2014,0,0,0,0,0,1308,1308
26313,RM-1213A,2/9/2014,0,0,1308,0,0,0,1308
28372,RM-1221,2/7/2014,0,0,0,0,0,1308,1308
31767,RM-1231,2/7/2014,0,0,0,0,0,1308,1308
32459,RM-1236,2/9/2014,0,0,1308,0,0,0,1308
35756,RM-B109,6/9/2014,654,0,654,0,0,0,1308
35870,RM-B109,10/3/2014,654,0,654,0,0,0,1308
38380,RM-B215,2/9/2014,0,0,1308,0,0,0,1308
39063,RM-B220,2/7/2014,1308,0,0,0,0,0,1308
40439,RM-B224,2/7/2014,0,0,0,0,0,1308,1308
41127,RM-B225,2/7/2014,0,0,0,0,0,1308,1308
42497,RM-B230A,2/7/2014,0,0,0,0,0,1308,1308
44360,RM-B250,2/9/2014,0,0,1308,0,0,0,1308
47765,RM-B275,2/7/2014,0,0,0,0,0,1308,1308
4966,RM-1109,2/9/2014,0,0,0,0,0,1305,1305
7681,RM-1116,2/9/2014,1305,0,0,0,0,0,1305
9054,RM-1122,2/9/2014,0,0,0,0,0,1305,1305
16191,RM-1145,2/9/2014,0,0,0,0,0,1305,1305
25628,RM-1213,2/9/2014,0,0,0,0,0,1305,1305
28374,RM-1221,2/9/2014,0,0,0,0,0,1305,1305
31769,RM-1231,2/9/2014,0,0,0,0,0,1305,1305
39065,RM-B220,2/9/2014,1305,0,0,0,0,0,1305
40441,RM-B224,2/9/2014,0,0,0,0,0,1305,1305
42499,RM-B230A,2/9/2014,0,0,0,0,0,1305,1305
47767,RM-B275,2/9/2014,0,0,0,0,0,1305,1305
2774,RM-1106,9/24/2013,0,0,0,0,0,1302,1302
6200,RM-1113,9/24/2013,0,0,1302,0,0,0,1302
8919,RM-1122,9/24/2013,0,0,1302,0,0,0,1302
9604,RM-1123,9/24/2013,0,0,1302,0,0,0,1302
12207,RM-1130,9/24/2013,0,0,0,0,0,1302,1302
12894,RM-1132,9/24/2013,0,0,1302,0,0,0,1302
13579,RM-1133,9/24/2013,0,0,1302,0,0,0,1302
15371,RM-1144,9/24/2013,0,0,0,0,0,1302,1302
16864,RM-1150,2/25/2014,0,0,0,1302,0,0,1302
20764,RM-1200B,9/24/2013,0,0,0,0,0,1302,1302
22765,RM-1207,9/24/2013,0,0,0,0,0,1302,1302
25027,RM-1212,4/19/2014,918,0,384,0,0,0,1302
26863,RM-1217,9/24/2013,1302,0,0,0,0,0,1302
31634,RM-1231,9/24/2013,0,0,0,0,0,1302,1302
34952,RM-B103A,9/24/2013,0,0,0,0,0,1302,1302
36188,RM-B200B,9/24/2013,0,0,0,0,0,1302,1302
38422,RM-B215,3/23/2014,99,0,1203,0,0,0,1302
39618,RM-B222,9/24/2013,1302,0,0,0,0,0,1302
40306,RM-B224,9/24/2013,0,0,0,0,0,1302,1302
40994,RM-B225,9/24/2013,0,0,0,0,0,1302,1302
42364,RM-B230A,9/24/2013,0,0,0,0,0,1302,1302
43615,RM-B240A,9/24/2013,0,0,0,0,0,1302,1302
44225,RM-B250,9/24/2013,1302,0,0,0,0,0,1302
45963,RM-B260,10/3/2014,651,0,651,0,0,0,1302
46964,RM-B270,9/24/2013,0,0,1302,0,0,0,1302
16843,RM-1150,2/4/2014,0,0,0,1296,0,0,1296
315,RM-1100A,5/22/2014,1293,0,0,0,0,0,1293
1685,RM-1102,5/22/2014,1293,0,0,0,0,0,1293
5752,RM-1110,5/22/2014,0,0,1293,0,0,0,1293
6437,RM-1113,5/22/2014,0,0,1293,0,0,0,1293
7783,RM-1116,5/22/2014,1293,0,0,0,0,0,1293
14338,RM-1134,5/22/2014,1293,0,0,0,0,0,1293
15608,RM-1144,5/22/2014,0,0,1293,0,0,0,1293
16266,RM-1145,5/22/2014,0,0,1293,0,0,0,1293
19008,RM-1155,5/22/2014,1293,0,0,0,0,0,1293
23002,RM-1207,5/22/2014,1293,0,0,0,0,0,1293
25060,RM-1212,5/22/2014,1293,0,0,0,0,0,1293
26415,RM-1213A,5/22/2014,0,0,1293,0,0,0,1293
28476,RM-1221,5/22/2014,0,0,1293,0,0,0,1293
29161,RM-1223,5/22/2014,1293,0,0,0,0,0,1293
37106,RM-B200C,5/22/2014,1293,0,0,0,0,0,1293
38482,RM-B215,5/22/2014,0,0,1293,0,0,0,1293
39167,RM-B220,5/22/2014,1293,0,0,0,0,0,1293
39855,RM-B222,5/22/2014,1293,0,0,0,0,0,1293
41916,RM-B230,5/22/2014,1293,0,0,0,0,0,1293
43167,RM-B240,5/22/2014,0,0,1293,0,0,0,1293
45146,RM-B250A,5/22/2014,1293,0,0,0,0,0,1293
5000,RM-1109,3/15/2014,0,0,0,0,0,1290,1290
7715,RM-1116,3/15/2014,1290,0,0,0,0,0,1290
9088,RM-1122,3/15/2014,0,0,0,0,0,1290,1290
16225,RM-1145,3/15/2014,0,0,0,0,0,1290,1290
25662,RM-1213,3/15/2014,0,0,0,0,0,1290,1290
27032,RM-1217,3/15/2014,1290,0,0,0,0,0,1290
28408,RM-1221,3/15/2014,0,0,0,0,0,1290,1290
31803,RM-1231,3/15/2014,0,0,0,0,0,1290,1290
39099,RM-B220,3/15/2014,1290,0,0,0,0,0,1290
40475,RM-B224,3/15/2014,0,0,0,0,0,1290,1290
42533,RM-B230A,3/15/2014,0,0,0,0,0,1290,1290
45079,RM-B250A,3/15/2014,1290,0,0,0,0,0,1290
47801,RM-B275,3/15/2014,0,0,0,0,0,1290,1290
6369,RM-1113,3/15/2014,0,0,1287,0,0,0,1287
15540,RM-1144,3/15/2014,0,0,1287,0,0,0,1287
26347,RM-1213A,3/15/2014,0,0,1287,0,0,0,1287
29377,RM-1223,12/26/2014,891,0,396,0,0,0,1287
32493,RM-1236,3/15/2014,0,0,1287,0,0,0,1287
35670,RM-B109,3/15/2014,0,0,1287,0,0,0,1287
38414,RM-B215,3/15/2014,0,0,1287,0,0,0,1287
43099,RM-B240,3/15/2014,0,0,1287,0,0,0,1287
2239,RM-1104,1/11/2014,0,1284,0,0,0,0,1284
2780,RM-1106,9/30/2013,0,0,0,0,0,1284,1284
4965,RM-1109,2/8/2014,0,0,0,0,0,1284,1284
7680,RM-1116,2/8/2014,1284,0,0,0,0,0,1284
9053,RM-1122,2/8/2014,0,0,0,0,0,1284,1284
10423,RM-1124,2/8/2014,0,0,0,0,0,1284,1284
12213,RM-1130,9/30/2013,0,0,0,0,0,1284,1284
12900,RM-1132,9/30/2013,0,0,1284,0,0,0,1284
15377,RM-1144,9/30/2013,0,0,0,0,0,1284,1284
16190,RM-1145,2/8/2014,0,0,0,0,0,1284,1284
20770,RM-1200B,9/30/2013,0,0,0,0,0,1284,1284
22771,RM-1207,9/30/2013,0,0,0,0,0,1284,1284
25627,RM-1213,2/8/2014,0,0,0,0,0,1284,1284
26869,RM-1217,9/30/2013,1284,0,0,0,0,0,1284
28373,RM-1221,2/8/2014,0,0,0,0,0,1284,1284
31055,RM-1230,1/11/2014,0,1284,0,0,0,0,1284
31640,RM-1231,9/30/2013,0,0,0,0,0,1284,1284
31768,RM-1231,2/8/2014,0,0,0,0,0,1284,1284
34958,RM-B103A,9/30/2013,0,0,0,0,0,1284,1284
36194,RM-B200B,9/30/2013,0,0,0,0,0,1284,1284
39064,RM-B220,2/8/2014,1284,0,0,0,0,0,1284
39624,RM-B222,9/30/2013,1284,0,0,0,0,0,1284
40312,RM-B224,9/30/2013,0,0,0,0,0,1284,1284
40440,RM-B224,2/8/2014,0,0,0,0,0,1284,1284
41000,RM-B225,9/30/2013,0,0,0,0,0,1284,1284
42370,RM-B230A,9/30/2013,0,0,0,0,0,1284,1284
42498,RM-B230A,2/8/2014,0,0,0,0,0,1284,1284
44231,RM-B250,9/30/2013,1284,0,0,0,0,0,1284
47766,RM-B275,2/8/2014,0,0,0,0,0,1284,1284
6334,RM-1113,2/8/2014,0,0,1281,0,0,0,1281
6439,RM-1113,5/24/2014,0,0,1281,0,0,0,1281
8925,RM-1122,9/30/2013,0,0,1281,0,0,0,1281
9610,RM-1123,9/30/2013,0,0,1281,0,0,0,1281
13585,RM-1133,9/30/2013,0,0,1281,0,0,0,1281
15505,RM-1144,2/8/2014,0,0,1281,0,0,0,1281
15610,RM-1144,5/24/2014,0,0,1281,0,0,0,1281
16268,RM-1145,5/24/2014,0,0,1281,0,0,0,1281
26312,RM-1213A,2/8/2014,0,0,1281,0,0,0,1281
26417,RM-1213A,5/24/2014,0,0,1281,0,0,0,1281
28478,RM-1221,5/24/2014,0,0,1281,0,0,0,1281
32458,RM-1236,2/8/2014,0,0,1281,0,0,0,1281
38379,RM-B215,2/8/2014,0,0,1281,0,0,0,1281
38484,RM-B215,5/24/2014,0,0,1281,0,0,0,1281
43169,RM-B240,5/24/2014,0,0,1281,0,0,0,1281
44359,RM-B250,2/8/2014,0,0,1281,0,0,0,1281
46970,RM-B270,9/30/2013,0,0,1281,0,0,0,1281
317,RM-1100A,5/24/2014,1278,0,0,0,0,0,1278
1687,RM-1102,5/24/2014,1278,0,0,0,0,0,1278
3404,RM-1107,7/22/2013,0,0,1278,0,0,0,1278
5754,RM-1110,5/24/2014,0,0,1278,0,0,0,1278
6145,RM-1113,7/22/2013,0,0,1278,0,0,0,1278
7785,RM-1116,5/24/2014,1278,0,0,0,0,0,1278
8864,RM-1122,7/22/2013,0,0,1278,0,0,0,1278
9635,RM-1123,10/25/2013,0,0,1278,0,0,0,1278
12925,RM-1132,10/25/2013,0,0,1278,0,0,0,1278
13524,RM-1133,7/22/2013,0,0,1278,0,0,0,1278
13610,RM-1133,10/25/2013,0,0,1278,0,0,0,1278
14340,RM-1134,5/24/2014,1278,0,0,0,0,0,1278
19010,RM-1155,5/24/2014,1278,0,0,0,0,0,1278
20795,RM-1200B,10/25/2013,0,0,0,0,0,1278,1278
21555,RM-1200C,1/11/2014,0,1278,0,0,0,0,1278
22843,RM-1207,12/14/2013,120,0,0,0,0,1158,1278
23004,RM-1207,5/24/2014,1278,0,0,0,0,0,1278
25062,RM-1212,5/24/2014,1278,0,0,0,0,0,1278
25438,RM-1213,7/22/2013,0,0,1278,0,0,0,1278
26894,RM-1217,10/25/2013,1278,0,0,0,0,0,1278
28270,RM-1221,10/25/2013,0,0,1278,0,0,0,1278
29163,RM-1223,5/24/2014,1278,0,0,0,0,0,1278
33681,RM-B102C,7/22/2013,0,0,1278,0,0,0,1278
34379,RM-B103,1/11/2014,0,0,0,1278,0,0,1278
35607,RM-B109,1/11/2014,0,1278,0,0,0,0,1278
37108,RM-B200C,5/24/2014,1278,0,0,0,0,0,1278
37502,RM-B210,7/22/2013,0,0,1278,0,0,0,1278
39169,RM-B220,5/24/2014,1278,0,0,0,0,0,1278
39649,RM-B222,10/25/2013,1278,0,0,0,0,0,1278
39857,RM-B222,5/24/2014,1278,0,0,0,0,0,1278
41918,RM-B230,5/24/2014,1278,0,0,0,0,0,1278
43721,RM-B240A,1/11/2014,0,1278,0,0,0,0,1278
45148,RM-B250A,5/24/2014,1278,0,0,0,0,0,1278
45700,RM-B260,1/11/2014,0,0,0,1278,0,0,1278
46909,RM-B270,7/22/2013,0,0,1278,0,0,0,1278
46995,RM-B270,10/25/2013,0,0,1278,0,0,0,1278
47577,RM-B275,7/22/2013,0,0,1278,0,0,0,1278
2805,RM-1106,10/25/2013,0,0,0,0,0,1275,1275
4862,RM-1109,10/25/2013,0,0,0,0,0,1275,1275
4970,RM-1109,2/13/2014,0,0,0,0,0,1275,1275
6434,RM-1113,5/19/2014,0,0,1275,0,0,0,1275
7685,RM-1116,2/13/2014,1275,0,0,0,0,0,1275
9058,RM-1122,2/13/2014,0,0,0,0,0,1275,1275
10320,RM-1124,10/25/2013,0,0,0,0,0,1275,1275
12238,RM-1130,10/25/2013,0,0,0,0,0,1275,1275
15402,RM-1144,10/25/2013,0,0,0,0,0,1275,1275
15605,RM-1144,5/19/2014,0,0,1275,0,0,0,1275
16087,RM-1145,10/25/2013,0,0,0,0,0,1275,1275
16195,RM-1145,2/13/2014,0,0,0,0,0,1275,1275
16263,RM-1145,5/19/2014,0,0,1275,0,0,0,1275
22796,RM-1207,10/25/2013,0,0,0,0,0,1275,1275
25524,RM-1213,10/25/2013,0,0,0,0,0,1275,1275
25632,RM-1213,2/13/2014,0,0,0,0,0,1275,1275
26412,RM-1213A,5/19/2014,0,0,1275,0,0,0,1275
28378,RM-1221,2/13/2014,0,0,0,0,0,1275,1275
28473,RM-1221,5/19/2014,0,0,1275,0,0,0,1275
31665,RM-1231,10/25/2013,0,0,0,0,0,1275,1275
31773,RM-1231,2/13/2014,0,0,0,0,0,1275,1275
34983,RM-B103A,10/25/2013,0,0,0,0,0,1275,1275
36219,RM-B200B,10/25/2013,0,0,0,0,0,1275,1275
38479,RM-B215,5/19/2014,0,0,1275,0,0,0,1275
39069,RM-B220,2/13/2014,1275,0,0,0,0,0,1275
40337,RM-B224,10/25/2013,0,0,0,0,0,1275,1275
40445,RM-B224,2/13/2014,0,0,0,0,0,1275,1275
41025,RM-B225,10/25/2013,0,0,0,0,0,1275,1275
42395,RM-B230A,10/25/2013,0,0,0,0,0,1275,1275
42503,RM-B230A,2/13/2014,0,0,0,0,0,1275,1275
43164,RM-B240,5/19/2014,0,0,1275,0,0,0,1275
45049,RM-B250A,2/13/2014,1275,0,0,0,0,0,1275
47771,RM-B275,2/13/2014,0,0,0,0,0,1275,1275
23,RM-1100A,7/22/2013,1272,0,0,0,0,0,1272
314,RM-1100A,5/21/2014,1272,0,0,0,0,0,1272
1684,RM-1102,5/21/2014,1272,0,0,0,0,0,1272
2719,RM-1106,7/22/2013,1272,0,0,0,0,0,1272
2813,RM-1106,11/2/2013,0,0,0,0,0,1272,1272
4870,RM-1109,11/2/2013,0,0,0,0,0,1272,1272
5461,RM-1110,7/22/2013,0,0,0,0,0,1272,1272
5751,RM-1110,5/21/2014,0,0,1272,0,0,0,1272
6339,RM-1113,2/13/2014,0,0,1272,0,0,0,1272
6436,RM-1113,5/21/2014,0,0,1272,0,0,0,1272
7782,RM-1116,5/21/2014,1272,0,0,0,0,0,1272
10328,RM-1124,11/2/2013,0,0,0,0,0,1272,1272
12152,RM-1130,7/22/2013,0,0,0,0,0,1272,1272
12246,RM-1130,11/2/2013,0,0,0,0,0,1272,1272
12839,RM-1132,7/22/2013,1272,0,0,0,0,0,1272
14337,RM-1134,5/21/2014,1272,0,0,0,0,0,1272
15410,RM-1144,11/2/2013,0,0,0,0,0,1272,1272
15510,RM-1144,2/13/2014,0,0,1272,0,0,0,1272
15607,RM-1144,5/21/2014,0,0,1272,0,0,0,1272
16095,RM-1145,11/2/2013,0,0,0,0,0,1272,1272
16265,RM-1145,5/21/2014,0,0,1272,0,0,0,1272
19007,RM-1155,5/21/2014,1272,0,0,0,0,0,1272
22804,RM-1207,11/2/2013,0,0,0,0,0,1272,1272
23001,RM-1207,5/21/2014,1272,0,0,0,0,0,1272
23395,RM-1208,7/22/2013,0,0,0,0,0,1272,1272
24490,RM-1208B,9/14/2014,636,0,636,0,0,0,1272
24492,RM-1208B,9/16/2014,636,0,636,0,0,0,1272
25059,RM-1212,5/21/2014,1272,0,0,0,0,0,1272
25532,RM-1213,11/2/2013,0,0,0,0,0,1272,1272
26123,RM-1213A,7/22/2013,0,0,0,0,0,1272,1272
26317,RM-1213A,2/13/2014,0,0,1272,0,0,0,1272
26414,RM-1213A,5/21/2014,0,0,1272,0,0,0,1272
26902,RM-1217,11/2/2013,1272,0,0,0,0,0,1272
28184,RM-1221,7/22/2013,0,0,0,0,0,1272,1272
28475,RM-1221,5/21/2014,0,0,1272,0,0,0,1272
29160,RM-1223,5/21/2014,1272,0,0,0,0,0,1272
31673,RM-1231,11/2/2013,0,0,0,0,0,1272,1272
32463,RM-1236,2/13/2014,0,0,1272,0,0,0,1272
34897,RM-B103A,7/22/2013,0,0,0,0,0,1272,1272
34991,RM-B103A,11/2/2013,0,0,0,0,0,1272,1272
35853,RM-B109,9/14/2014,636,0,636,0,0,0,1272
35854,RM-B109,9/15/2014,636,0,636,0,0,0,1272
36227,RM-B200B,11/2/2013,0,0,0,0,0,1272,1272
37105,RM-B200C,5/21/2014,1272,0,0,0,0,0,1272
38384,RM-B215,2/13/2014,0,0,1272,0,0,0,1272
38481,RM-B215,5/21/2014,0,0,1272,0,0,0,1272
39166,RM-B220,5/21/2014,1272,0,0,0,0,0,1272
39563,RM-B222,7/22/2013,1272,0,0,0,0,0,1272
39657,RM-B222,11/2/2013,1272,0,0,0,0,0,1272
39854,RM-B222,5/21/2014,1272,0,0,0,0,0,1272
40345,RM-B224,11/2/2013,0,0,0,0,0,1272,1272
40939,RM-B225,7/22/2013,0,0,0,0,0,1272,1272
41033,RM-B225,11/2/2013,0,0,0,0,0,1272,1272
42309,RM-B230A,7/22/2013,0,0,0,0,0,1272,1272
42403,RM-B230A,11/2/2013,0,0,0,0,0,1272,1272
43166,RM-B240,5/21/2014,0,0,1272,0,0,0,1272
43560,RM-B240A,7/22/2013,0,0,0,0,0,1272,1272
44364,RM-B250,2/13/2014,0,0,1272,0,0,0,1272
45145,RM-B250A,5/21/2014,1272,0,0,0,0,0,1272
45946,RM-B260,9/14/2014,636,0,636,0,0,0,1272
45947,RM-B260,9/15/2014,636,0,636,0,0,0,1272
312,RM-1100A,5/19/2014,1269,0,0,0,0,0,1269
1682,RM-1102,5/19/2014,1269,0,0,0,0,0,1269
2769,RM-1106,9/19/2013,0,0,0,0,0,1269,1269
2775,RM-1106,9/25/2013,0,0,0,0,0,1269,1269
5749,RM-1110,5/19/2014,0,0,1269,0,0,0,1269
6195,RM-1113,9/19/2013,0,0,1269,0,0,0,1269
7093,RM-1115,5/19/2014,1269,0,0,0,0,0,1269
7780,RM-1116,5/19/2014,1269,0,0,0,0,0,1269
8914,RM-1122,9/19/2013,0,0,1269,0,0,0,1269
8920,RM-1122,9/25/2013,0,0,1269,0,0,0,1269
9599,RM-1123,9/19/2013,0,0,1269,0,0,0,1269
9605,RM-1123,9/25/2013,0,0,1269,0,0,0,1269
9643,RM-1123,11/2/2013,0,0,1269,0,0,0,1269
12202,RM-1130,9/19/2013,0,0,0,0,0,1269,1269
12208,RM-1130,9/25/2013,0,0,0,0,0,1269,1269
12895,RM-1132,9/25/2013,0,0,1269,0,0,0,1269
12933,RM-1132,11/2/2013,0,0,1269,0,0,0,1269
13574,RM-1133,9/19/2013,0,0,1269,0,0,0,1269
13580,RM-1133,9/25/2013,0,0,1269,0,0,0,1269
13618,RM-1133,11/2/2013,0,0,1269,0,0,0,1269
14335,RM-1134,5/19/2014,1269,0,0,0,0,0,1269
15366,RM-1144,9/19/2013,0,0,0,0,0,1269,1269
15372,RM-1144,9/25/2013,0,0,0,0,0,1269,1269
19005,RM-1155,5/19/2014,1269,0,0,0,0,0,1269
20765,RM-1200B,9/25/2013,0,0,0,0,0,1269,1269
20803,RM-1200B,11/2/2013,0,0,0,0,0,1269,1269
22760,RM-1207,9/19/2013,0,0,0,0,0,1269,1269
22766,RM-1207,9/25/2013,0,0,0,0,0,1269,1269
22999,RM-1207,5/19/2014,1269,0,0,0,0,0,1269
25057,RM-1212,5/19/2014,1269,0,0,0,0,0,1269
26864,RM-1217,9/25/2013,1269,0,0,0,0,0,1269
28278,RM-1221,11/2/2013,0,0,1269,0,0,0,1269
29158,RM-1223,5/19/2014,1269,0,0,0,0,0,1269
31629,RM-1231,9/19/2013,0,0,0,0,0,1269,1269
31635,RM-1231,9/25/2013,0,0,0,0,0,1269,1269
34947,RM-B103A,9/19/2013,0,0,0,0,0,1269,1269
34953,RM-B103A,9/25/2013,0,0,0,0,0,1269,1269
36183,RM-B200B,9/19/2013,0,0,0,0,0,1269,1269
36189,RM-B200B,9/25/2013,0,0,0,0,0,1269,1269
37103,RM-B200C,5/19/2014,1269,0,0,0,0,0,1269
39164,RM-B220,5/19/2014,1269,0,0,0,0,0,1269
39619,RM-B222,9/25/2013,1269,0,0,0,0,0,1269
39852,RM-B222,5/19/2014,1269,0,0,0,0,0,1269
40301,RM-B224,9/19/2013,0,0,0,0,0,1269,1269
40307,RM-B224,9/25/2013,0,0,0,0,0,1269,1269
40989,RM-B225,9/19/2013,0,0,0,0,0,1269,1269
40995,RM-B225,9/25/2013,0,0,0,0,0,1269,1269
42359,RM-B230A,9/19/2013,0,0,0,0,0,1269,1269
42365,RM-B230A,9/25/2013,0,0,0,0,0,1269,1269
43610,RM-B240A,9/19/2013,0,0,0,0,0,1269,1269
43616,RM-B240A,9/25/2013,0,0,0,0,0,1269,1269
44226,RM-B250,9/25/2013,1269,0,0,0,0,0,1269
45143,RM-B250A,5/19/2014,1269,0,0,0,0,0,1269
46959,RM-B270,9/19/2013,0,0,1269,0,0,0,1269
46965,RM-B270,9/25/2013,0,0,1269,0,0,0,1269
47003,RM-B270,11/2/2013,0,0,1269,0,0,0,1269
12889,RM-1132,9/19/2013,0,0,1266,0,0,0,1266
20759,RM-1200B,9/19/2013,0,0,0,0,0,1266,1266
24491,RM-1208B,9/15/2014,633,0,633,0,0,0,1266
26858,RM-1217,9/19/2013,1266,0,0,0,0,0,1266
35855,RM-B109,9/16/2014,633,0,633,0,0,0,1266
39613,RM-B222,9/19/2013,1266,0,0,0,0,0,1266
44220,RM-B250,9/19/2013,1266,0,0,0,0,0,1266
45948,RM-B260,9/16/2014,633,0,633,0,0,0,1266
4977,RM-1109,2/20/2014,0,0,0,0,0,1263,1263
9065,RM-1122,2/20/2014,0,0,0,0,0,1263,1263
16202,RM-1145,2/20/2014,0,0,0,0,0,1263,1263
25639,RM-1213,2/20/2014,0,0,0,0,0,1263,1263
28385,RM-1221,2/20/2014,0,0,0,0,0,1263,1263
31780,RM-1231,2/20/2014,0,0,0,0,0,1263,1263
40452,RM-B224,2/20/2014,0,0,0,0,0,1263,1263
42510,RM-B230A,2/20/2014,0,0,0,0,0,1263,1263
47778,RM-B275,2/20/2014,0,0,0,0,0,1263,1263
6338,RM-1113,2/12/2014,0,0,1260,0,0,0,1260
6346,RM-1113,2/20/2014,0,0,1260,0,0,0,1260
7488,RM-1116,7/19/2013,0,0,630,0,0,630,1260
7692,RM-1116,2/20/2014,1260,0,0,0,0,0,1260
8176,RM-1117,7/19/2013,630,0,0,0,0,630,1260
8926,RM-1122,10/1/2013,0,0,1260,0,0,0,1260
9611,RM-1123,10/1/2013,0,0,1260,0,0,0,1260
13586,RM-1133,10/1/2013,0,0,1260,0,0,0,1260
15509,RM-1144,2/12/2014,0,0,1260,0,0,0,1260
15517,RM-1144,2/20/2014,0,0,1260,0,0,0,1260
18713,RM-1155,7/19/2013,630,0,630,0,0,0,1260
26316,RM-1213A,2/12/2014,0,0,1260,0,0,0,1260
26324,RM-1213A,2/20/2014,0,0,1260,0,0,0,1260
27009,RM-1217,2/20/2014,1260,0,0,0,0,0,1260
32266,RM-1236,7/19/2013,630,0,630,0,0,0,1260
32462,RM-1236,2/12/2014,0,0,1260,0,0,0,1260
32470,RM-1236,2/20/2014,0,0,1260,0,0,0,1260
35647,RM-B109,2/20/2014,0,0,1260,0,0,0,1260
36811,RM-B200C,7/19/2013,0,0,630,0,0,630,1260
38187,RM-B215,7/19/2013,630,0,0,0,0,630,1260
38383,RM-B215,2/12/2014,0,0,1260,0,0,0,1260
38391,RM-B215,2/20/2014,0,0,1260,0,0,0,1260
39076,RM-B220,2/20/2014,1260,0,0,0,0,0,1260
40248,RM-B224,7/19/2013,0,0,630,0,0,630,1260
43076,RM-B240,2/20/2014,0,0,1260,0,0,0,1260
44167,RM-B250,7/19/2013,630,0,0,0,0,630,1260
44363,RM-B250,2/12/2014,0,0,1260,0,0,0,1260
44371,RM-B250,2/20/2014,0,0,1260,0,0,0,1260
45056,RM-B250A,2/20/2014,1260,0,0,0,0,0,1260
46971,RM-B270,10/1/2013,0,0,1260,0,0,0,1260
2781,RM-1106,10/1/2013,0,0,0,0,0,1257,1257
2806,RM-1106,10/26/2013,0,0,0,0,0,1257,1257
4838,RM-1109,10/1/2013,0,0,0,0,0,1257,1257
4863,RM-1109,10/26/2013,0,0,0,0,0,1257,1257
5001,RM-1109,3/16/2014,0,0,0,0,0,1257,1257
6370,RM-1113,3/16/2014,0,0,1257,0,0,0,1257
7716,RM-1116,3/16/2014,1257,0,0,0,0,0,1257
9089,RM-1122,3/16/2014,0,0,0,0,0,1257,1257
9678,RM-1123,12/10/2013,0,0,1257,0,0,0,1257
10321,RM-1124,10/26/2013,0,0,0,0,0,1257,1257
12214,RM-1130,10/1/2013,0,0,0,0,0,1257,1257
12239,RM-1130,10/26/2013,0,0,0,0,0,1257,1257
12901,RM-1132,10/1/2013,0,0,1257,0,0,0,1257
13653,RM-1133,12/10/2013,0,0,1257,0,0,0,1257
14272,RM-1134,3/16/2014,1257,0,0,0,0,0,1257
15378,RM-1144,10/1/2013,0,0,0,0,0,1257,1257
15403,RM-1144,10/26/2013,0,0,0,0,0,1257,1257
15541,RM-1144,3/16/2014,0,0,1257,0,0,0,1257
16088,RM-1145,10/26/2013,0,0,0,0,0,1257,1257
16226,RM-1145,3/16/2014,0,0,0,0,0,1257,1257
20771,RM-1200B,10/1/2013,0,0,0,0,0,1257,1257
22772,RM-1207,10/1/2013,0,0,0,0,0,1257,1257
22797,RM-1207,10/26/2013,0,0,0,0,0,1257,1257
24212,RM-1208B,12/10/2013,0,0,1257,0,0,0,1257
24897,RM-1212,12/10/2013,0,0,1257,0,0,0,1257
25525,RM-1213,10/26/2013,0,0,0,0,0,1257,1257
25663,RM-1213,3/16/2014,0,0,0,0,0,1257,1257
26348,RM-1213A,3/16/2014,0,0,1257,0,0,0,1257
26870,RM-1217,10/1/2013,1257,0,0,0,0,0,1257
27033,RM-1217,3/16/2014,1257,0,0,0,0,0,1257
28313,RM-1221,12/10/2013,0,0,1257,0,0,0,1257
28409,RM-1221,3/16/2014,0,0,0,0,0,1257,1257
31641,RM-1231,10/1/2013,0,0,0,0,0,1257,1257
31666,RM-1231,10/26/2013,0,0,0,0,0,1257,1257
31804,RM-1231,3/16/2014,0,0,0,0,0,1257,1257
32398,RM-1236,12/10/2013,0,0,1257,0,0,0,1257
32494,RM-1236,3/16/2014,0,0,1257,0,0,0,1257
34959,RM-B103A,10/1/2013,0,0,0,0,0,1257,1257
34984,RM-B103A,10/26/2013,0,0,0,0,0,1257,1257
35671,RM-B109,3/16/2014,0,0,1257,0,0,0,1257
36195,RM-B200B,10/1/2013,0,0,0,0,0,1257,1257
36220,RM-B200B,10/26/2013,0,0,0,0,0,1257,1257
38415,RM-B215,3/16/2014,0,0,1257,0,0,0,1257
39100,RM-B220,3/16/2014,1257,0,0,0,0,0,1257
39625,RM-B222,10/1/2013,1257,0,0,0,0,0,1257
40313,RM-B224,10/1/2013,0,0,0,0,0,1257,1257
40338,RM-B224,10/26/2013,0,0,0,0,0,1257,1257
40476,RM-B224,3/16/2014,0,0,0,0,0,1257,1257
41001,RM-B225,10/1/2013,0,0,0,0,0,1257,1257
41026,RM-B225,10/26/2013,0,0,0,0,0,1257,1257
42371,RM-B230A,10/1/2013,0,0,0,0,0,1257,1257
42396,RM-B230A,10/26/2013,0,0,0,0,0,1257,1257
42534,RM-B230A,3/16/2014,0,0,0,0,0,1257,1257
43100,RM-B240,3/16/2014,0,0,1257,0,0,0,1257
44232,RM-B250,10/1/2013,1257,0,0,0,0,0,1257
45080,RM-B250A,3/16/2014,1257,0,0,0,0,0,1257
47802,RM-B275,3/16/2014,0,0,0,0,0,1257,1257
289,RM-1100A,4/26/2014,1254,0,0,0,0,0,1254
1659,RM-1102,4/26/2014,1254,0,0,0,0,0,1254
4969,RM-1109,2/12/2014,0,0,0,0,0,1254,1254
5727,RM-1110,4/26/2014,0,0,1254,0,0,0,1254
6411,RM-1113,4/26/2014,0,0,1254,0,0,0,1254
7070,RM-1115,4/26/2014,1254,0,0,0,0,0,1254
7684,RM-1116,2/12/2014,1254,0,0,0,0,0,1254
7757,RM-1116,4/26/2014,1254,0,0,0,0,0,1254
9057,RM-1122,2/12/2014,0,0,0,0,0,1254,1254
9636,RM-1123,10/26/2013,0,0,1254,0,0,0,1254
12180,RM-1130,8/19/2013,0,0,0,0,0,1254,1254
12926,RM-1132,10/26/2013,0,0,1254,0,0,0,1254
13611,RM-1133,10/26/2013,0,0,1254,0,0,0,1254
14313,RM-1134,4/26/2014,1254,0,0,0,0,0,1254
15344,RM-1144,8/19/2013,0,0,0,0,0,1254,1254
15582,RM-1144,4/26/2014,0,0,1254,0,0,0,1254
16194,RM-1145,2/12/2014,0,0,0,0,0,1254,1254
16240,RM-1145,4/26/2014,0,0,1254,0,0,0,1254
18056,RM-1154,8/19/2013,1254,0,0,0,0,0,1254
18982,RM-1155,4/26/2014,1254,0,0,0,0,0,1254
20737,RM-1200B,8/19/2013,0,0,0,0,0,1254,1254
20796,RM-1200B,10/26/2013,0,0,0,0,0,1254,1254
22976,RM-1207,4/26/2014,1254,0,0,0,0,0,1254
25034,RM-1212,4/26/2014,1254,0,0,0,0,0,1254
25631,RM-1213,2/12/2014,0,0,0,0,0,1254,1254
26151,RM-1213A,8/19/2013,0,0,0,0,0,1254,1254
26389,RM-1213A,4/26/2014,0,0,1254,0,0,0,1254
26836,RM-1217,8/19/2013,1254,0,0,0,0,0,1254
26895,RM-1217,10/26/2013,1254,0,0,0,0,0,1254
28271,RM-1221,10/26/2013,0,0,1254,0,0,0,1254
28377,RM-1221,2/12/2014,0,0,0,0,0,1254,1254
31607,RM-1231,8/19/2013,0,0,0,0,0,1254,1254
31772,RM-1231,2/12/2014,0,0,0,0,0,1254,1254
34925,RM-B103A,8/19/2013,0,0,0,0,0,1254,1254
38456,RM-B215,4/26/2014,0,0,1254,0,0,0,1254
39068,RM-B220,2/12/2014,1254,0,0,0,0,0,1254
39141,RM-B220,4/26/2014,1254,0,0,0,0,0,1254
39650,RM-B222,10/26/2013,1254,0,0,0,0,0,1254
39829,RM-B222,4/26/2014,1254,0,0,0,0,0,1254
40444,RM-B224,2/12/2014,0,0,0,0,0,1254,1254
40967,RM-B225,8/19/2013,0,0,0,0,0,1254,1254
42337,RM-B230A,8/19/2013,0,0,0,0,0,1254,1254
42502,RM-B230A,2/12/2014,0,0,0,0,0,1254,1254
43141,RM-B240,4/26/2014,0,0,1254,0,0,0,1254
43588,RM-B240A,8/19/2013,0,0,0,0,0,1254,1254
44198,RM-B250,8/19/2013,1254,0,0,0,0,0,1254
45048,RM-B250A,2/12/2014,1254,0,0,0,0,0,1254
45121,RM-B250A,4/26/2014,1254,0,0,0,0,0,1254
46996,RM-B270,10/26/2013,0,0,1254,0,0,0,1254
47770,RM-B275,2/12/2014,0,0,0,0,0,1254,1254
2848,RM-1106,12/10/2013,0,0,0,0,0,1251,1251
3432,RM-1107,8/19/2013,0,0,1251,0,0,0,1251
4905,RM-1109,12/10/2013,0,0,0,0,0,1251,1251
6173,RM-1113,8/19/2013,0,0,1251,0,0,0,1251
8892,RM-1122,8/19/2013,0,0,1251,0,0,0,1251
8993,RM-1122,12/10/2013,0,0,0,0,0,1251,1251
9577,RM-1123,8/19/2013,0,0,1251,0,0,0,1251
10363,RM-1124,12/10/2013,0,0,0,0,0,1251,1251
12281,RM-1130,12/10/2013,0,0,0,0,0,1251,1251
12968,RM-1132,12/10/2013,0,0,1251,0,0,0,1251
13552,RM-1133,8/19/2013,0,0,1251,0,0,0,1251
16130,RM-1145,12/10/2013,0,0,0,0,0,1251,1251
22839,RM-1207,12/10/2013,0,0,0,0,0,1251,1251
25466,RM-1213,8/19/2013,0,0,1251,0,0,0,1251
25567,RM-1213,12/10/2013,0,0,0,0,0,1251,1251
31708,RM-1231,12/10/2013,0,0,0,0,0,1251,1251
33709,RM-B102C,8/19/2013,0,0,1251,0,0,0,1251
36262,RM-B200B,12/10/2013,0,0,0,0,0,1251,1251
40380,RM-B224,12/10/2013,0,0,0,0,0,1251,1251
41068,RM-B225,12/10/2013,0,0,0,0,0,1251,1251
42438,RM-B230A,12/10/2013,0,0,0,0,0,1251,1251
46937,RM-B270,8/19/2013,0,0,1251,0,0,0,1251
47706,RM-B275,12/10/2013,0,0,0,0,0,1251,1251
12189,RM-1130,9/5/2013,0,0,0,0,0,1248,1248
15353,RM-1144,9/5/2013,0,0,0,0,0,1248,1248
20890,RM-1200B,1/31/2014,0,624,0,624,0,0,1248
21575,RM-1200C,1/31/2014,0,624,0,624,0,0,1248
26937,RM-1217,12/10/2013,1248,0,0,0,0,0,1248
29735,RM-1224,1/31/2014,0,0,0,1248,0,0,1248
31075,RM-1230,1/31/2014,0,1248,0,0,0,0,1248
31616,RM-1231,9/5/2013,0,0,0,0,0,1248,1248
34934,RM-B103A,9/5/2013,0,0,0,0,0,1248,1248
36170,RM-B200B,9/5/2013,0,0,0,0,0,1248,1248
39004,RM-B220,12/10/2013,1248,0,0,0,0,0,1248
39692,RM-B222,12/10/2013,1248,0,0,0,0,0,1248
40288,RM-B224,9/5/2013,0,0,0,0,0,1248,1248
40976,RM-B225,9/5/2013,0,0,0,0,0,1248,1248
42346,RM-B230A,9/5/2013,0,0,0,0,0,1248,1248
43597,RM-B240A,9/5/2013,0,0,0,0,0,1248,1248
2776,RM-1106,9/26/2013,0,0,0,0,0,1245,1245
3441,RM-1107,9/5/2013,0,0,1245,0,0,0,1245
6182,RM-1113,9/5/2013,0,0,1245,0,0,0,1245
8901,RM-1122,9/5/2013,0,0,1245,0,0,0,1245
8921,RM-1122,9/26/2013,0,0,1245,0,0,0,1245
9586,RM-1123,9/5/2013,0,0,1245,0,0,0,1245
9606,RM-1123,9/26/2013,0,0,1245,0,0,0,1245
12209,RM-1130,9/26/2013,0,0,0,0,0,1245,1245
12896,RM-1132,9/26/2013,0,0,1245,0,0,0,1245
13561,RM-1133,9/5/2013,0,0,1245,0,0,0,1245
13581,RM-1133,9/26/2013,0,0,1245,0,0,0,1245
15373,RM-1144,9/26/2013,0,0,0,0,0,1245,1245
18065,RM-1154,9/5/2013,1245,0,0,0,0,0,1245
20746,RM-1200B,9/5/2013,0,0,0,0,0,1245,1245
20766,RM-1200B,9/26/2013,0,0,0,0,0,1245,1245
22767,RM-1207,9/26/2013,0,0,0,0,0,1245,1245
25475,RM-1213,9/5/2013,0,0,1245,0,0,0,1245
26845,RM-1217,9/5/2013,1245,0,0,0,0,0,1245
26865,RM-1217,9/26/2013,1245,0,0,0,0,0,1245
31636,RM-1231,9/26/2013,0,0,0,0,0,1245,1245
33718,RM-B102C,9/5/2013,0,0,1245,0,0,0,1245
34954,RM-B103A,9/26/2013,0,0,0,0,0,1245,1245
36190,RM-B200B,9/26/2013,0,0,0,0,0,1245,1245
39620,RM-B222,9/26/2013,1245,0,0,0,0,0,1245
40308,RM-B224,9/26/2013,0,0,0,0,0,1245,1245
40996,RM-B225,9/26/2013,0,0,0,0,0,1245,1245
42366,RM-B230A,9/26/2013,0,0,0,0,0,1245,1245
44207,RM-B250,9/5/2013,1245,0,0,0,0,0,1245
44227,RM-B250,9/26/2013,1245,0,0,0,0,0,1245
46946,RM-B270,9/5/2013,0,0,1245,0,0,0,1245
46966,RM-B270,9/26/2013,0,0,1245,0,0,0,1245
2810,RM-1106,10/30/2013,0,0,0,0,0,1242,1242
4867,RM-1109,10/30/2013,0,0,0,0,0,1242,1242
10325,RM-1124,10/30/2013,0,0,0,0,0,1242,1242
12243,RM-1130,10/30/2013,0,0,0,0,0,1242,1242
15407,RM-1144,10/30/2013,0,0,0,0,0,1242,1242
16092,RM-1145,10/30/2013,0,0,0,0,0,1242,1242
22801,RM-1207,10/30/2013,0,0,0,0,0,1242,1242
25529,RM-1213,10/30/2013,0,0,0,0,0,1242,1242
31670,RM-1231,10/30/2013,0,0,0,0,0,1242,1242
34988,RM-B103A,10/30/2013,0,0,0,0,0,1242,1242
36224,RM-B200B,10/30/2013,0,0,0,0,0,1242,1242
40342,RM-B224,10/30/2013,0,0,0,0,0,1242,1242
41030,RM-B225,10/30/2013,0,0,0,0,0,1242,1242
42400,RM-B230A,10/30/2013,0,0,0,0,0,1242,1242
2779,RM-1106,9/29/2013,0,0,0,0,0,1239,1239
8924,RM-1122,9/29/2013,0,0,1239,0,0,0,1239
9609,RM-1123,9/29/2013,0,0,1239,0,0,0,1239
9640,RM-1123,10/30/2013,0,0,1239,0,0,0,1239
12212,RM-1130,9/29/2013,0,0,0,0,0,1239,1239
12899,RM-1132,9/29/2013,0,0,1239,0,0,0,1239
12930,RM-1132,10/30/2013,0,0,1239,0,0,0,1239
13584,RM-1133,9/29/2013,0,0,1239,0,0,0,1239
13615,RM-1133,10/30/2013,0,0,1239,0,0,0,1239
15376,RM-1144,9/29/2013,0,0,0,0,0,1239,1239
20769,RM-1200B,9/29/2013,0,0,0,0,0,1239,1239
20800,RM-1200B,10/30/2013,0,0,0,0,0,1239,1239
22770,RM-1207,9/29/2013,0,0,0,0,0,1239,1239
26868,RM-1217,9/29/2013,1239,0,0,0,0,0,1239
26899,RM-1217,10/30/2013,1239,0,0,0,0,0,1239
28275,RM-1221,10/30/2013,0,0,1239,0,0,0,1239
31639,RM-1231,9/29/2013,0,0,0,0,0,1239,1239
34957,RM-B103A,9/29/2013,0,0,0,0,0,1239,1239
36193,RM-B200B,9/29/2013,0,0,0,0,0,1239,1239
39623,RM-B222,9/29/2013,1239,0,0,0,0,0,1239
39654,RM-B222,10/30/2013,1239,0,0,0,0,0,1239
40311,RM-B224,9/29/2013,0,0,0,0,0,1239,1239
40999,RM-B225,9/29/2013,0,0,0,0,0,1239,1239
42369,RM-B230A,9/29/2013,0,0,0,0,0,1239,1239
44230,RM-B250,9/29/2013,1239,0,0,0,0,0,1239
46969,RM-B270,9/29/2013,0,0,1239,0,0,0,1239
47000,RM-B270,10/30/2013,0,0,1239,0,0,0,1239
2850,RM-1106,12/12/2013,0,0,0,0,0,1236,1236
4907,RM-1109,12/12/2013,0,0,0,0,0,1236,1236
8995,RM-1122,12/12/2013,0,0,0,0,0,1236,1236
9680,RM-1123,12/12/2013,0,0,1236,0,0,0,1236
10365,RM-1124,12/12/2013,0,0,0,0,0,1236,1236
12283,RM-1130,12/12/2013,0,0,0,0,0,1236,1236
12970,RM-1132,12/12/2013,0,0,1236,0,0,0,1236
13655,RM-1133,12/12/2013,0,0,1236,0,0,0,1236
16132,RM-1145,12/12/2013,0,0,0,0,0,1236,1236
22841,RM-1207,12/12/2013,0,0,0,0,0,1236,1236
24214,RM-1208B,12/12/2013,0,0,1236,0,0,0,1236
24899,RM-1212,12/12/2013,0,0,1236,0,0,0,1236
25569,RM-1213,12/12/2013,0,0,0,0,0,1236,1236
26939,RM-1217,12/12/2013,1236,0,0,0,0,0,1236
28315,RM-1221,12/12/2013,0,0,1236,0,0,0,1236
31710,RM-1231,12/12/2013,0,0,0,0,0,1236,1236
32400,RM-1236,12/12/2013,0,0,1236,0,0,0,1236
36264,RM-B200B,12/12/2013,0,0,0,0,0,1236,1236
39006,RM-B220,12/12/2013,1236,0,0,0,0,0,1236
39694,RM-B222,12/12/2013,1236,0,0,0,0,0,1236
40382,RM-B224,12/12/2013,0,0,0,0,0,1236,1236
41070,RM-B225,12/12/2013,0,0,0,0,0,1236,1236
42440,RM-B230A,12/12/2013,0,0,0,0,0,1236,1236
47708,RM-B275,12/12/2013,0,0,0,0,0,1236,1236
318,RM-1100A,5/25/2014,1233,0,0,0,0,0,1233
1688,RM-1102,5/25/2014,1233,0,0,0,0,0,1233
2777,RM-1106,9/27/2013,0,0,0,0,0,1233,1233
5755,RM-1110,5/25/2014,0,0,1233,0,0,0,1233
6340,RM-1113,2/14/2014,0,0,1233,0,0,0,1233
6440,RM-1113,5/25/2014,0,0,1233,0,0,0,1233
7786,RM-1116,5/25/2014,1233,0,0,0,0,0,1233
8922,RM-1122,9/27/2013,0,0,1233,0,0,0,1233
9607,RM-1123,9/27/2013,0,0,1233,0,0,0,1233
12210,RM-1130,9/27/2013,0,0,0,0,0,1233,1233
12897,RM-1132,9/27/2013,0,0,1233,0,0,0,1233
12927,RM-1132,10/27/2013,0,0,1233,0,0,0,1233
13582,RM-1133,9/27/2013,0,0,1233,0,0,0,1233
14341,RM-1134,5/25/2014,1233,0,0,0,0,0,1233
15374,RM-1144,9/27/2013,0,0,0,0,0,1233,1233
15511,RM-1144,2/14/2014,0,0,1233,0,0,0,1233
15611,RM-1144,5/25/2014,0,0,1233,0,0,0,1233
16269,RM-1145,5/25/2014,0,0,1233,0,0,0,1233
19011,RM-1155,5/25/2014,1233,0,0,0,0,0,1233
20767,RM-1200B,9/27/2013,0,0,0,0,0,1233,1233
20797,RM-1200B,10/27/2013,0,0,0,0,0,1233,1233
22768,RM-1207,9/27/2013,0,0,0,0,0,1233,1233
23005,RM-1207,5/25/2014,1233,0,0,0,0,0,1233
25063,RM-1212,5/25/2014,1233,0,0,0,0,0,1233
26318,RM-1213A,2/14/2014,0,0,1233,0,0,0,1233
26418,RM-1213A,5/25/2014,0,0,1233,0,0,0,1233
26866,RM-1217,9/27/2013,1233,0,0,0,0,0,1233
26896,RM-1217,10/27/2013,1233,0,0,0,0,0,1233
28479,RM-1221,5/25/2014,0,0,1233,0,0,0,1233
29164,RM-1223,5/25/2014,1233,0,0,0,0,0,1233
31637,RM-1231,9/27/2013,0,0,0,0,0,1233,1233
32464,RM-1236,2/14/2014,0,0,1233,0,0,0,1233
34955,RM-B103A,9/27/2013,0,0,0,0,0,1233,1233
36191,RM-B200B,9/27/2013,0,0,0,0,0,1233,1233
37109,RM-B200C,5/25/2014,1233,0,0,0,0,0,1233
38385,RM-B215,2/14/2014,0,0,1233,0,0,0,1233
38485,RM-B215,5/25/2014,0,0,1233,0,0,0,1233
39170,RM-B220,5/25/2014,1233,0,0,0,0,0,1233
39621,RM-B222,9/27/2013,1233,0,0,0,0,0,1233
39651,RM-B222,10/27/2013,1233,0,0,0,0,0,1233
40309,RM-B224,9/27/2013,0,0,0,0,0,1233,1233
40997,RM-B225,9/27/2013,0,0,0,0,0,1233,1233
41919,RM-B230,5/25/2014,1233,0,0,0,0,0,1233
42367,RM-B230A,9/27/2013,0,0,0,0,0,1233,1233
43170,RM-B240,5/25/2014,0,0,1233,0,0,0,1233
44208,RM-B250,9/6/2013,1233,0,0,0,0,0,1233
44228,RM-B250,9/27/2013,1233,0,0,0,0,0,1233
44365,RM-B250,2/14/2014,0,0,1233,0,0,0,1233
45149,RM-B250A,5/25/2014,1233,0,0,0,0,0,1233
46967,RM-B270,9/27/2013,0,0,1233,0,0,0,1233
2807,RM-1106,10/27/2013,0,0,0,0,0,1230,1230
3442,RM-1107,9/6/2013,0,0,1230,0,0,0,1230
4864,RM-1109,10/27/2013,0,0,0,0,0,1230,1230
4971,RM-1109,2/14/2014,0,0,0,0,0,1230,1230
6183,RM-1113,9/6/2013,0,0,1230,0,0,0,1230
6368,RM-1113,3/14/2014,0,0,1230,0,0,0,1230
7686,RM-1116,2/14/2014,1230,0,0,0,0,0,1230
8902,RM-1122,9/6/2013,0,0,1230,0,0,0,1230
9059,RM-1122,2/14/2014,0,0,0,0,0,1230,1230
9587,RM-1123,9/6/2013,0,0,1230,0,0,0,1230
9637,RM-1123,10/27/2013,0,0,1230,0,0,0,1230
10322,RM-1124,10/27/2013,0,0,0,0,0,1230,1230
12190,RM-1130,9/6/2013,0,0,0,0,0,1230,1230
12240,RM-1130,10/27/2013,0,0,0,0,0,1230,1230
13562,RM-1133,9/6/2013,0,0,1230,0,0,0,1230
13612,RM-1133,10/27/2013,0,0,1230,0,0,0,1230
15354,RM-1144,9/6/2013,0,0,0,0,0,1230,1230
15404,RM-1144,10/27/2013,0,0,0,0,0,1230,1230
15539,RM-1144,3/14/2014,0,0,1230,0,0,0,1230
16089,RM-1145,10/27/2013,0,0,0,0,0,1230,1230
16196,RM-1145,2/14/2014,0,0,0,0,0,1230,1230
18066,RM-1154,9/6/2013,1230,0,0,0,0,0,1230
20747,RM-1200B,9/6/2013,0,0,0,0,0,1230,1230
22798,RM-1207,10/27/2013,0,0,0,0,0,1230,1230
25476,RM-1213,9/6/2013,0,0,1230,0,0,0,1230
25526,RM-1213,10/27/2013,0,0,0,0,0,1230,1230
25633,RM-1213,2/14/2014,0,0,0,0,0,1230,1230
26346,RM-1213A,3/14/2014,0,0,1230,0,0,0,1230
26846,RM-1217,9/6/2013,1230,0,0,0,0,0,1230
28272,RM-1221,10/27/2013,0,0,1230,0,0,0,1230
28379,RM-1221,2/14/2014,0,0,0,0,0,1230,1230
31617,RM-1231,9/6/2013,0,0,0,0,0,1230,1230
31667,RM-1231,10/27/2013,0,0,0,0,0,1230,1230
31774,RM-1231,2/14/2014,0,0,0,0,0,1230,1230
32492,RM-1236,3/14/2014,0,0,1230,0,0,0,1230
33719,RM-B102C,9/6/2013,0,0,1230,0,0,0,1230
34935,RM-B103A,9/6/2013,0,0,0,0,0,1230,1230
34985,RM-B103A,10/27/2013,0,0,0,0,0,1230,1230
35669,RM-B109,3/14/2014,0,0,1230,0,0,0,1230
36171,RM-B200B,9/6/2013,0,0,0,0,0,1230,1230
36221,RM-B200B,10/27/2013,0,0,0,0,0,1230,1230
38413,RM-B215,3/14/2014,0,0,1230,0,0,0,1230
39070,RM-B220,2/14/2014,1230,0,0,0,0,0,1230
40289,RM-B224,9/6/2013,0,0,0,0,0,1230,1230
40339,RM-B224,10/27/2013,0,0,0,0,0,1230,1230
40446,RM-B224,2/14/2014,0,0,0,0,0,1230,1230
40977,RM-B225,9/6/2013,0,0,0,0,0,1230,1230
41027,RM-B225,10/27/2013,0,0,0,0,0,1230,1230
42347,RM-B230A,9/6/2013,0,0,0,0,0,1230,1230
42397,RM-B230A,10/27/2013,0,0,0,0,0,1230,1230
42504,RM-B230A,2/14/2014,0,0,0,0,0,1230,1230
43098,RM-B240,3/14/2014,0,0,1230,0,0,0,1230
43598,RM-B240A,9/6/2013,0,0,0,0,0,1230,1230
45050,RM-B250A,2/14/2014,1230,0,0,0,0,0,1230
46947,RM-B270,9/6/2013,0,0,1230,0,0,0,1230
46997,RM-B270,10/27/2013,0,0,1230,0,0,0,1230
47772,RM-B275,2/14/2014,0,0,0,0,0,1230,1230
46002,RM-B260,11/11/2014,615,0,612,0,0,0,1227
2849,RM-1106,12/11/2013,0,0,0,0,0,1224,1224
4906,RM-1109,12/11/2013,0,0,0,0,0,1224,1224
8994,RM-1122,12/11/2013,0,0,0,0,0,1224,1224
9644,RM-1123,11/3/2013,0,0,1224,0,0,0,1224
9679,RM-1123,12/11/2013,0,0,1224,0,0,0,1224
10364,RM-1124,12/11/2013,0,0,0,0,0,1224,1224
12282,RM-1130,12/11/2013,0,0,0,0,0,1224,1224
12934,RM-1132,11/3/2013,0,0,1224,0,0,0,1224
12969,RM-1132,12/11/2013,0,0,1224,0,0,0,1224
13619,RM-1133,11/3/2013,0,0,1224,0,0,0,1224
13654,RM-1133,12/11/2013,0,0,1224,0,0,0,1224
16131,RM-1145,12/11/2013,0,0,0,0,0,1224,1224
20804,RM-1200B,11/3/2013,0,0,0,0,0,1224,1224
22840,RM-1207,12/11/2013,0,0,0,0,0,1224,1224
24213,RM-1208B,12/11/2013,0,0,1224,0,0,0,1224
24898,RM-1212,12/11/2013,0,0,1224,0,0,0,1224
25568,RM-1213,12/11/2013,0,0,0,0,0,1224,1224
26938,RM-1217,12/11/2013,1224,0,0,0,0,0,1224
28279,RM-1221,11/3/2013,0,0,1224,0,0,0,1224
28314,RM-1221,12/11/2013,0,0,1224,0,0,0,1224
31709,RM-1231,12/11/2013,0,0,0,0,0,1224,1224
32399,RM-1236,12/11/2013,0,0,1224,0,0,0,1224
35909,RM-B109,11/11/2014,612,0,612,0,0,0,1224
36263,RM-B200B,12/11/2013,0,0,0,0,0,1224,1224
39005,RM-B220,12/11/2013,1224,0,0,0,0,0,1224
39693,RM-B222,12/11/2013,1224,0,0,0,0,0,1224
40381,RM-B224,12/11/2013,0,0,0,0,0,1224,1224
41069,RM-B225,12/11/2013,0,0,0,0,0,1224,1224
42439,RM-B230A,12/11/2013,0,0,0,0,0,1224,1224
47004,RM-B270,11/3/2013,0,0,1224,0,0,0,1224
47707,RM-B275,12/11/2013,0,0,0,0,0,1224,1224
2814,RM-1106,11/3/2013,0,0,0,0,0,1221,1221
4871,RM-1109,11/3/2013,0,0,0,0,0,1221,1221
7047,RM-1115,4/3/2014,1221,0,0,0,0,0,1221
7734,RM-1116,4/3/2014,1221,0,0,0,0,0,1221
10329,RM-1124,11/3/2013,0,0,0,0,0,1221,1221
12247,RM-1130,11/3/2013,0,0,0,0,0,1221,1221
14290,RM-1134,4/3/2014,1221,0,0,0,0,0,1221
15411,RM-1144,11/3/2013,0,0,0,0,0,1221,1221
16096,RM-1145,11/3/2013,0,0,0,0,0,1221,1221
18959,RM-1155,4/3/2014,1221,0,0,0,0,0,1221
19635,RM-1156,4/3/2014,1221,0,0,0,0,0,1221
22805,RM-1207,11/3/2013,0,0,0,0,0,1221,1221
22953,RM-1207,4/3/2014,1221,0,0,0,0,0,1221
25533,RM-1213,11/3/2013,0,0,0,0,0,1221,1221
26903,RM-1217,11/3/2013,1221,0,0,0,0,0,1221
27051,RM-1217,4/3/2014,1221,0,0,0,0,0,1221
28472,RM-1221,5/18/2014,0,0,1221,0,0,0,1221
31674,RM-1231,11/3/2013,0,0,0,0,0,1221,1221
34992,RM-B103A,11/3/2013,0,0,0,0,0,1221,1221
36228,RM-B200B,11/3/2013,0,0,0,0,0,1221,1221
39118,RM-B220,4/3/2014,1221,0,0,0,0,0,1221
39658,RM-B222,11/3/2013,1221,0,0,0,0,0,1221
40346,RM-B224,11/3/2013,0,0,0,0,0,1221,1221
41034,RM-B225,11/3/2013,0,0,0,0,0,1221,1221
42404,RM-B230A,11/3/2013,0,0,0,0,0,1221,1221
2815,RM-1106,11/4/2013,0,0,0,0,0,1218,1218
4872,RM-1109,11/4/2013,0,0,0,0,0,1218,1218
4999,RM-1109,3/14/2014,0,0,0,0,0,1218,1218
5704,RM-1110,4/3/2014,0,0,1218,0,0,0,1218
6388,RM-1113,4/3/2014,0,0,1218,0,0,0,1218
6438,RM-1113,5/23/2014,0,0,1218,0,0,0,1218
7714,RM-1116,3/14/2014,1218,0,0,0,0,0,1218
9087,RM-1122,3/14/2014,0,0,0,0,0,1218,1218
10330,RM-1124,11/4/2013,0,0,0,0,0,1218,1218
12248,RM-1130,11/4/2013,0,0,0,0,0,1218,1218
12935,RM-1132,11/4/2013,0,0,1218,0,0,0,1218
15412,RM-1144,11/4/2013,0,0,0,0,0,1218,1218
15559,RM-1144,4/3/2014,0,0,1218,0,0,0,1218
15609,RM-1144,5/23/2014,0,0,1218,0,0,0,1218
16097,RM-1145,11/4/2013,0,0,0,0,0,1218,1218
16224,RM-1145,3/14/2014,0,0,0,0,0,1218,1218
16267,RM-1145,5/23/2014,0,0,1218,0,0,0,1218
20805,RM-1200B,11/4/2013,0,0,0,0,0,1218,1218
22806,RM-1207,11/4/2013,0,0,0,0,0,1218,1218
25534,RM-1213,11/4/2013,0,0,0,0,0,1218,1218
25661,RM-1213,3/14/2014,0,0,0,0,0,1218,1218
26366,RM-1213A,4/3/2014,0,0,1218,0,0,0,1218
26416,RM-1213A,5/23/2014,0,0,1218,0,0,0,1218
26904,RM-1217,11/4/2013,1218,0,0,0,0,0,1218
27031,RM-1217,3/14/2014,1218,0,0,0,0,0,1218
28407,RM-1221,3/14/2014,0,0,0,0,0,1218,1218
28477,RM-1221,5/23/2014,0,0,1218,0,0,0,1218
31675,RM-1231,11/4/2013,0,0,0,0,0,1218,1218
31802,RM-1231,3/14/2014,0,0,0,0,0,1218,1218
32512,RM-1236,4/3/2014,0,0,1218,0,0,0,1218
34993,RM-B103A,11/4/2013,0,0,0,0,0,1218,1218
35689,RM-B109,4/3/2014,0,0,1218,0,0,0,1218
36229,RM-B200B,11/4/2013,0,0,0,0,0,1218,1218
38433,RM-B215,4/3/2014,0,0,1218,0,0,0,1218
38483,RM-B215,5/23/2014,0,0,1218,0,0,0,1218
39098,RM-B220,3/14/2014,1218,0,0,0,0,0,1218
39659,RM-B222,11/4/2013,1218,0,0,0,0,0,1218
40347,RM-B224,11/4/2013,0,0,0,0,0,1218,1218
40474,RM-B224,3/14/2014,0,0,0,0,0,1218,1218
41035,RM-B225,11/4/2013,0,0,0,0,0,1218,1218
42405,RM-B230A,11/4/2013,0,0,0,0,0,1218,1218
42532,RM-B230A,3/14/2014,0,0,0,0,0,1218,1218
43118,RM-B240,4/3/2014,0,0,1218,0,0,0,1218
43168,RM-B240,5/23/2014,0,0,1218,0,0,0,1218
45078,RM-B250A,3/14/2014,1218,0,0,0,0,0,1218
47800,RM-B275,3/14/2014,0,0,0,0,0,1218,1218
9645,RM-1123,11/4/2013,0,0,1215,0,0,0,1215
13620,RM-1133,11/4/2013,0,0,1215,0,0,0,1215
28280,RM-1221,11/4/2013,0,0,1215,0,0,0,1215
35754,RM-B109,6/7/2014,600,0,615,0,0,0,1215
47005,RM-B270,11/4/2013,0,0,1215,0,0,0,1215
6371,RM-1113,3/17/2014,0,0,1212,0,0,0,1212
15542,RM-1144,3/17/2014,0,0,1212,0,0,0,1212
26349,RM-1213A,3/17/2014,0,0,1212,0,0,0,1212
32495,RM-1236,3/17/2014,0,0,1212,0,0,0,1212
35672,RM-B109,3/17/2014,0,0,1212,0,0,0,1212
38416,RM-B215,3/17/2014,0,0,1212,0,0,0,1212
43101,RM-B240,3/17/2014,0,0,1212,0,0,0,1212
2783,RM-1106,10/3/2013,0,0,0,0,0,1209,1209
4840,RM-1109,10/3/2013,0,0,0,0,0,1209,1209
5002,RM-1109,3/17/2014,0,0,0,0,0,1209,1209
7717,RM-1116,3/17/2014,1209,0,0,0,0,0,1209
9090,RM-1122,3/17/2014,0,0,0,0,0,1209,1209
12216,RM-1130,10/3/2013,0,0,0,0,0,1209,1209
12903,RM-1132,10/3/2013,0,0,1209,0,0,0,1209
14273,RM-1134,3/17/2014,1209,0,0,0,0,0,1209
15380,RM-1144,10/3/2013,0,0,0,0,0,1209,1209
16227,RM-1145,3/17/2014,0,0,0,0,0,1209,1209
20773,RM-1200B,10/3/2013,0,0,0,0,0,1209,1209
22774,RM-1207,10/3/2013,0,0,0,0,0,1209,1209
25664,RM-1213,3/17/2014,0,0,0,0,0,1209,1209
26872,RM-1217,10/3/2013,1209,0,0,0,0,0,1209
27034,RM-1217,3/17/2014,1209,0,0,0,0,0,1209
28410,RM-1221,3/17/2014,0,0,0,0,0,1209,1209
31643,RM-1231,10/3/2013,0,0,0,0,0,1209,1209
31805,RM-1231,3/17/2014,0,0,0,0,0,1209,1209
34961,RM-B103A,10/3/2013,0,0,0,0,0,1209,1209
36197,RM-B200B,10/3/2013,0,0,0,0,0,1209,1209
39101,RM-B220,3/17/2014,1209,0,0,0,0,0,1209
39627,RM-B222,10/3/2013,1209,0,0,0,0,0,1209
40315,RM-B224,10/3/2013,0,0,0,0,0,1209,1209
40477,RM-B224,3/17/2014,0,0,0,0,0,1209,1209
41003,RM-B225,10/3/2013,0,0,0,0,0,1209,1209
42373,RM-B230A,10/3/2013,0,0,0,0,0,1209,1209
42535,RM-B230A,3/17/2014,0,0,0,0,0,1209,1209
44234,RM-B250,10/3/2013,1209,0,0,0,0,0,1209
45081,RM-B250A,3/17/2014,1209,0,0,0,0,0,1209
47803,RM-B275,3/17/2014,0,0,0,0,0,1209,1209
2359,RM-1104,5/11/2014,0,1206,0,0,0,0,1206
2778,RM-1106,9/28/2013,0,0,0,0,0,1206,1206
2858,RM-1106,12/20/2013,0,0,0,0,0,1206,1206
3004,RM-1106,5/15/2014,0,0,0,1206,0,0,1206
4915,RM-1109,12/20/2013,0,0,0,0,0,1206,1206
8923,RM-1122,9/28/2013,0,0,1206,0,0,0,1206
8928,RM-1122,10/3/2013,0,0,1206,0,0,0,1206
9003,RM-1122,12/20/2013,0,0,0,0,0,1206,1206
9608,RM-1123,9/28/2013,0,0,1206,0,0,0,1206
9613,RM-1123,10/3/2013,0,0,1206,0,0,0,1206
9688,RM-1123,12/20/2013,0,0,1206,0,0,0,1206
10373,RM-1124,12/20/2013,0,0,0,0,0,1206,1206
12211,RM-1130,9/28/2013,0,0,0,0,0,1206,1206
12291,RM-1130,12/20/2013,0,0,0,0,0,1206,1206
12898,RM-1132,9/28/2013,0,0,1206,0,0,0,1206
12978,RM-1132,12/20/2013,0,0,1206,0,0,0,1206
13583,RM-1133,9/28/2013,0,0,1206,0,0,0,1206
13588,RM-1133,10/3/2013,0,0,1206,0,0,0,1206
13663,RM-1133,12/20/2013,0,0,1206,0,0,0,1206
15375,RM-1144,9/28/2013,0,0,0,0,0,1206,1206
16140,RM-1145,12/20/2013,0,0,0,0,0,1206,1206
20768,RM-1200B,9/28/2013,0,0,0,0,0,1206,1206
22769,RM-1207,9/28/2013,0,0,0,0,0,1206,1206
24222,RM-1208B,12/20/2013,0,0,1206,0,0,0,1206
24493,RM-1208B,9/17/2014,603,0,603,0,0,0,1206
24907,RM-1212,12/20/2013,0,0,1206,0,0,0,1206
25577,RM-1213,12/20/2013,0,0,0,0,0,1206,1206
26867,RM-1217,9/28/2013,1206,0,0,0,0,0,1206
26947,RM-1217,12/20/2013,1206,0,0,0,0,0,1206
28323,RM-1221,12/20/2013,0,0,1206,0,0,0,1206
31638,RM-1231,9/28/2013,0,0,0,0,0,1206,1206
31718,RM-1231,12/20/2013,0,0,0,0,0,1206,1206
32408,RM-1236,12/20/2013,0,0,1206,0,0,0,1206
34956,RM-B103A,9/28/2013,0,0,0,0,0,1206,1206
35856,RM-B109,9/17/2014,603,0,603,0,0,0,1206
36192,RM-B200B,9/28/2013,0,0,0,0,0,1206,1206
36272,RM-B200B,12/20/2013,0,0,0,0,0,1206,1206
39014,RM-B220,12/20/2013,1206,0,0,0,0,0,1206
39622,RM-B222,9/28/2013,1206,0,0,0,0,0,1206
39702,RM-B222,12/20/2013,1206,0,0,0,0,0,1206
40310,RM-B224,9/28/2013,0,0,0,0,0,1206,1206
40390,RM-B224,12/20/2013,0,0,0,0,0,1206,1206
40998,RM-B225,9/28/2013,0,0,0,0,0,1206,1206
41078,RM-B225,12/20/2013,0,0,0,0,0,1206,1206
42368,RM-B230A,9/28/2013,0,0,0,0,0,1206,1206
42448,RM-B230A,12/20/2013,0,0,0,0,0,1206,1206
44229,RM-B250,9/28/2013,1206,0,0,0,0,0,1206
45949,RM-B260,9/17/2014,603,0,603,0,0,0,1206
46968,RM-B270,9/28/2013,0,0,1206,0,0,0,1206
46973,RM-B270,10/3/2013,0,0,1206,0,0,0,1206
47716,RM-B275,12/20/2013,0,0,0,0,0,1206,1206
5008,RM-1109,3/23/2014,0,0,0,0,0,1203,1203
6377,RM-1113,3/23/2014,0,0,1203,0,0,0,1203
7723,RM-1116,3/23/2014,1203,0,0,0,0,0,1203
9096,RM-1122,3/23/2014,0,0,0,0,0,1203,1203
14279,RM-1134,3/23/2014,1203,0,0,0,0,0,1203
15548,RM-1144,3/23/2014,0,0,1203,0,0,0,1203
16233,RM-1145,3/23/2014,0,0,0,0,0,1203,1203
25670,RM-1213,3/23/2014,0,0,0,0,0,1203,1203
26355,RM-1213A,3/23/2014,0,0,1203,0,0,0,1203
27040,RM-1217,3/23/2014,1203,0,0,0,0,0,1203
28416,RM-1221,3/23/2014,0,0,0,0,0,1203,1203
31811,RM-1231,3/23/2014,0,0,0,0,0,1203,1203
32501,RM-1236,3/23/2014,0,0,1203,0,0,0,1203
35678,RM-B109,3/23/2014,0,0,1203,0,0,0,1203
39107,RM-B220,3/23/2014,1203,0,0,0,0,0,1203
40483,RM-B224,3/23/2014,0,0,0,0,0,1203,1203
42541,RM-B230A,3/23/2014,0,0,0,0,0,1203,1203
43107,RM-B240,3/23/2014,0,0,1203,0,0,0,1203
45087,RM-B250A,3/23/2014,1203,0,0,0,0,0,1203
47809,RM-B275,3/23/2014,0,0,0,0,0,1203,1203
290,RM-1100A,4/27/2014,1200,0,0,0,0,0,1200
1660,RM-1102,4/27/2014,1200,0,0,0,0,0,1200
2363,RM-1104,5/15/2014,0,1200,0,0,0,0,1200
4972,RM-1109,2/15/2014,0,0,0,0,0,1200,1200
5728,RM-1110,4/27/2014,0,0,1200,0,0,0,1200
6412,RM-1113,4/27/2014,0,0,1200,0,0,0,1200
7071,RM-1115,4/27/2014,1200,0,0,0,0,0,1200
7758,RM-1116,4/27/2014,1200,0,0,0,0,0,1200
9060,RM-1122,2/15/2014,0,0,0,0,0,1200,1200
14314,RM-1134,4/27/2014,1200,0,0,0,0,0,1200
15583,RM-1144,4/27/2014,0,0,1200,0,0,0,1200
16197,RM-1145,2/15/2014,0,0,0,0,0,1200,1200
16241,RM-1145,4/27/2014,0,0,1200,0,0,0,1200
18983,RM-1155,4/27/2014,1200,0,0,0,0,0,1200
22977,RM-1207,4/27/2014,1200,0,0,0,0,0,1200
25035,RM-1212,4/27/2014,1200,0,0,0,0,0,1200
25634,RM-1213,2/15/2014,0,0,0,0,0,1200,1200
26390,RM-1213A,4/27/2014,0,0,1200,0,0,0,1200
28380,RM-1221,2/15/2014,0,0,0,0,0,1200,1200
29136,RM-1223,4/27/2014,1200,0,0,0,0,0,1200
31775,RM-1231,2/15/2014,0,0,0,0,0,1200,1200
38457,RM-B215,4/27/2014,0,0,1200,0,0,0,1200
39142,RM-B220,4/27/2014,1200,0,0,0,0,0,1200
39830,RM-B222,4/27/2014,1200,0,0,0,0,0,1200
40447,RM-B224,2/15/2014,0,0,0,0,0,1200,1200
42505,RM-B230A,2/15/2014,0,0,0,0,0,1200,1200
43142,RM-B240,4/27/2014,0,0,1200,0,0,0,1200
45122,RM-B250A,4/27/2014,1200,0,0,0,0,0,1200
47773,RM-B275,2/15/2014,0,0,0,0,0,1200,1200
3433,RM-1107,8/20/2013,0,0,1197,0,0,0,1197
6174,RM-1113,8/20/2013,0,0,1197,0,0,0,1197
6341,RM-1113,2/15/2014,0,0,1197,0,0,0,1197
7687,RM-1116,2/15/2014,1197,0,0,0,0,0,1197
8893,RM-1122,8/20/2013,0,0,1197,0,0,0,1197
9578,RM-1123,8/20/2013,0,0,1197,0,0,0,1197
9646,RM-1123,11/5/2013,0,0,1197,0,0,0,1197
13553,RM-1133,8/20/2013,0,0,1197,0,0,0,1197
13621,RM-1133,11/5/2013,0,0,1197,0,0,0,1197
15512,RM-1144,2/15/2014,0,0,1197,0,0,0,1197
25467,RM-1213,8/20/2013,0,0,1197,0,0,0,1197
26319,RM-1213A,2/15/2014,0,0,1197,0,0,0,1197
28281,RM-1221,11/5/2013,0,0,1197,0,0,0,1197
32465,RM-1236,2/15/2014,0,0,1197,0,0,0,1197
33710,RM-B102C,8/20/2013,0,0,1197,0,0,0,1197
35642,RM-B109,2/15/2014,0,0,1197,0,0,0,1197
38386,RM-B215,2/15/2014,0,0,1197,0,0,0,1197
39071,RM-B220,2/15/2014,1197,0,0,0,0,0,1197
44366,RM-B250,2/15/2014,0,0,1197,0,0,0,1197
45051,RM-B250A,2/15/2014,1197,0,0,0,0,0,1197
46938,RM-B270,8/20/2013,0,0,1197,0,0,0,1197
47006,RM-B270,11/5/2013,0,0,1197,0,0,0,1197
2809,RM-1106,10/29/2013,0,0,0,0,0,1194,1194
2816,RM-1106,11/5/2013,0,0,0,0,0,1194,1194
3005,RM-1106,5/16/2014,0,0,0,1194,0,0,1194
4866,RM-1109,10/29/2013,0,0,0,0,0,1194,1194
4873,RM-1109,11/5/2013,0,0,0,0,0,1194,1194
9638,RM-1123,10/28/2013,0,0,1194,0,0,0,1194
9639,RM-1123,10/29/2013,0,0,1194,0,0,0,1194
9653,RM-1123,11/12/2013,0,0,1194,0,0,0,1194
10324,RM-1124,10/29/2013,0,0,0,0,0,1194,1194
10331,RM-1124,11/5/2013,0,0,0,0,0,1194,1194
12181,RM-1130,8/20/2013,0,0,0,0,0,1194,1194
12242,RM-1130,10/29/2013,0,0,0,0,0,1194,1194
12249,RM-1130,11/5/2013,0,0,0,0,0,1194,1194
12929,RM-1132,10/29/2013,0,0,1194,0,0,0,1194
12936,RM-1132,11/5/2013,0,0,1194,0,0,0,1194
13613,RM-1133,10/28/2013,0,0,1194,0,0,0,1194
13614,RM-1133,10/29/2013,0,0,1194,0,0,0,1194
13628,RM-1133,11/12/2013,0,0,1194,0,0,0,1194
15345,RM-1144,8/20/2013,0,0,0,0,0,1194,1194
15406,RM-1144,10/29/2013,0,0,0,0,0,1194,1194
15413,RM-1144,11/5/2013,0,0,0,0,0,1194,1194
16091,RM-1145,10/29/2013,0,0,0,0,0,1194,1194
16098,RM-1145,11/5/2013,0,0,0,0,0,1194,1194
18057,RM-1154,8/20/2013,1194,0,0,0,0,0,1194
20738,RM-1200B,8/20/2013,0,0,0,0,0,1194,1194
20799,RM-1200B,10/29/2013,0,0,0,0,0,1194,1194
20806,RM-1200B,11/5/2013,0,0,0,0,0,1194,1194
22800,RM-1207,10/29/2013,0,0,0,0,0,1194,1194
22807,RM-1207,11/5/2013,0,0,0,0,0,1194,1194
24872,RM-1212,11/12/2013,0,0,1194,0,0,0,1194
25528,RM-1213,10/29/2013,0,0,0,0,0,1194,1194
25535,RM-1213,11/5/2013,0,0,0,0,0,1194,1194
26837,RM-1217,8/20/2013,1194,0,0,0,0,0,1194
26898,RM-1217,10/29/2013,1194,0,0,0,0,0,1194
26905,RM-1217,11/5/2013,1194,0,0,0,0,0,1194
28273,RM-1221,10/28/2013,0,0,1194,0,0,0,1194
28274,RM-1221,10/29/2013,0,0,1194,0,0,0,1194
28288,RM-1221,11/12/2013,0,0,1194,0,0,0,1194
31608,RM-1231,8/20/2013,0,0,0,0,0,1194,1194
31669,RM-1231,10/29/2013,0,0,0,0,0,1194,1194
31676,RM-1231,11/5/2013,0,0,0,0,0,1194,1194
34926,RM-B103A,8/20/2013,0,0,0,0,0,1194,1194
34987,RM-B103A,10/29/2013,0,0,0,0,0,1194,1194
34994,RM-B103A,11/5/2013,0,0,0,0,0,1194,1194
36223,RM-B200B,10/29/2013,0,0,0,0,0,1194,1194
36230,RM-B200B,11/5/2013,0,0,0,0,0,1194,1194
39653,RM-B222,10/29/2013,1194,0,0,0,0,0,1194
39660,RM-B222,11/5/2013,1194,0,0,0,0,0,1194
40341,RM-B224,10/29/2013,0,0,0,0,0,1194,1194
40348,RM-B224,11/5/2013,0,0,0,0,0,1194,1194
40968,RM-B225,8/20/2013,0,0,0,0,0,1194,1194
41029,RM-B225,10/29/2013,0,0,0,0,0,1194,1194
41036,RM-B225,11/5/2013,0,0,0,0,0,1194,1194
42338,RM-B230A,8/20/2013,0,0,0,0,0,1194,1194
42399,RM-B230A,10/29/2013,0,0,0,0,0,1194,1194
42406,RM-B230A,11/5/2013,0,0,0,0,0,1194,1194
43589,RM-B240A,8/20/2013,0,0,0,0,0,1194,1194
44199,RM-B250,8/20/2013,1194,0,0,0,0,0,1194
46998,RM-B270,10/28/2013,0,0,1194,0,0,0,1194
46999,RM-B270,10/29/2013,0,0,1194,0,0,0,1194
47013,RM-B270,11/12/2013,0,0,1194,0,0,0,1194
316,RM-1100A,5/23/2014,1191,0,0,0,0,0,1191
1686,RM-1102,5/23/2014,1191,0,0,0,0,0,1191
2782,RM-1106,10/2/2013,0,0,0,0,0,1191,1191
2808,RM-1106,10/28/2013,0,0,0,0,0,1191,1191
2823,RM-1106,11/12/2013,0,0,0,0,0,1191,1191
4839,RM-1109,10/2/2013,0,0,0,0,0,1191,1191
4865,RM-1109,10/28/2013,0,0,0,0,0,1191,1191
4880,RM-1109,11/12/2013,0,0,0,0,0,1191,1191
7784,RM-1116,5/23/2014,1191,0,0,0,0,0,1191
8927,RM-1122,10/2/2013,0,0,1191,0,0,0,1191
9612,RM-1123,10/2/2013,0,0,1191,0,0,0,1191
10323,RM-1124,10/28/2013,0,0,0,0,0,1191,1191
10338,RM-1124,11/12/2013,0,0,0,0,0,1191,1191
12215,RM-1130,10/2/2013,0,0,0,0,0,1191,1191
12241,RM-1130,10/28/2013,0,0,0,0,0,1191,1191
12256,RM-1130,11/12/2013,0,0,0,0,0,1191,1191
12902,RM-1132,10/2/2013,0,0,1191,0,0,0,1191
12928,RM-1132,10/28/2013,0,0,1191,0,0,0,1191
12943,RM-1132,11/12/2013,0,0,1191,0,0,0,1191
13587,RM-1133,10/2/2013,0,0,1191,0,0,0,1191
14339,RM-1134,5/23/2014,1191,0,0,0,0,0,1191
15379,RM-1144,10/2/2013,0,0,0,0,0,1191,1191
15405,RM-1144,10/28/2013,0,0,0,0,0,1191,1191
15420,RM-1144,11/12/2013,0,0,0,0,0,1191,1191
16090,RM-1145,10/28/2013,0,0,0,0,0,1191,1191
16105,RM-1145,11/12/2013,0,0,0,0,0,1191,1191
19009,RM-1155,5/23/2014,1191,0,0,0,0,0,1191
20772,RM-1200B,10/2/2013,0,0,0,0,0,1191,1191
20798,RM-1200B,10/28/2013,0,0,0,0,0,1191,1191
22773,RM-1207,10/2/2013,0,0,0,0,0,1191,1191
22799,RM-1207,10/28/2013,0,0,0,0,0,1191,1191
22814,RM-1207,11/12/2013,0,0,0,0,0,1191,1191
23003,RM-1207,5/23/2014,1191,0,0,0,0,0,1191
25061,RM-1212,5/23/2014,1191,0,0,0,0,0,1191
25527,RM-1213,10/28/2013,0,0,0,0,0,1191,1191
25542,RM-1213,11/12/2013,0,0,0,0,0,1191,1191
26871,RM-1217,10/2/2013,1191,0,0,0,0,0,1191
26897,RM-1217,10/28/2013,1191,0,0,0,0,0,1191
26912,RM-1217,11/12/2013,1191,0,0,0,0,0,1191
29162,RM-1223,5/23/2014,1191,0,0,0,0,0,1191
31642,RM-1231,10/2/2013,0,0,0,0,0,1191,1191
31668,RM-1231,10/28/2013,0,0,0,0,0,1191,1191
31683,RM-1231,11/12/2013,0,0,0,0,0,1191,1191
34960,RM-B103A,10/2/2013,0,0,0,0,0,1191,1191
34986,RM-B103A,10/28/2013,0,0,0,0,0,1191,1191
35001,RM-B103A,11/12/2013,0,0,0,0,0,1191,1191
36196,RM-B200B,10/2/2013,0,0,0,0,0,1191,1191
36222,RM-B200B,10/28/2013,0,0,0,0,0,1191,1191
36237,RM-B200B,11/12/2013,0,0,0,0,0,1191,1191
37107,RM-B200C,5/23/2014,1191,0,0,0,0,0,1191
38461,RM-B215,5/1/2014,96,0,1095,0,0,0,1191
39168,RM-B220,5/23/2014,1191,0,0,0,0,0,1191
39626,RM-B222,10/2/2013,1191,0,0,0,0,0,1191
39652,RM-B222,10/28/2013,1191,0,0,0,0,0,1191
39667,RM-B222,11/12/2013,1191,0,0,0,0,0,1191
39856,RM-B222,5/23/2014,1191,0,0,0,0,0,1191
40314,RM-B224,10/2/2013,0,0,0,0,0,1191,1191
40340,RM-B224,10/28/2013,0,0,0,0,0,1191,1191
40355,RM-B224,11/12/2013,0,0,0,0,0,1191,1191
41002,RM-B225,10/2/2013,0,0,0,0,0,1191,1191
41028,RM-B225,10/28/2013,0,0,0,0,0,1191,1191
41043,RM-B225,11/12/2013,0,0,0,0,0,1191,1191
41917,RM-B230,5/23/2014,1191,0,0,0,0,0,1191
42372,RM-B230A,10/2/2013,0,0,0,0,0,1191,1191
42398,RM-B230A,10/28/2013,0,0,0,0,0,1191,1191
42413,RM-B230A,11/12/2013,0,0,0,0,0,1191,1191
44233,RM-B250,10/2/2013,1191,0,0,0,0,0,1191
45147,RM-B250A,5/23/2014,1191,0,0,0,0,0,1191
46972,RM-B270,10/2/2013,0,0,1191,0,0,0,1191
2859,RM-1106,12/21/2013,0,0,0,0,0,1188,1188
3000,RM-1106,5/11/2014,0,0,0,1188,0,0,1188
4916,RM-1109,12/21/2013,0,0,0,0,0,1188,1188
5753,RM-1110,5/23/2014,0,0,1188,0,0,0,1188
6285,RM-1113,12/21/2013,0,0,1188,0,0,0,1188
9004,RM-1122,12/21/2013,0,0,0,0,0,1188,1188
9689,RM-1123,12/21/2013,0,0,1188,0,0,0,1188
10374,RM-1124,12/21/2013,0,0,0,0,0,1188,1188
12292,RM-1130,12/21/2013,0,0,0,0,0,1188,1188
12979,RM-1132,12/21/2013,0,0,1188,0,0,0,1188
13664,RM-1133,12/21/2013,0,0,1188,0,0,0,1188
16141,RM-1145,12/21/2013,0,0,0,0,0,1188,1188
24223,RM-1208B,12/21/2013,0,0,1188,0,0,0,1188
24496,RM-1208B,9/20/2014,594,0,594,0,0,0,1188
24908,RM-1212,12/21/2013,0,0,1188,0,0,0,1188
25578,RM-1213,12/21/2013,0,0,0,0,0,1188,1188
26948,RM-1217,12/21/2013,1188,0,0,0,0,0,1188
31719,RM-1231,12/21/2013,0,0,0,0,0,1188,1188
32409,RM-1236,12/21/2013,0,0,1188,0,0,0,1188
35859,RM-B109,9/20/2014,594,0,594,0,0,0,1188
35860,RM-B109,9/21/2014,594,0,594,0,0,0,1188
36273,RM-B200B,12/21/2013,0,0,0,0,0,1188,1188
39015,RM-B220,12/21/2013,1188,0,0,0,0,0,1188
39703,RM-B222,12/21/2013,1188,0,0,0,0,0,1188
40391,RM-B224,12/21/2013,0,0,0,0,0,1188,1188
41079,RM-B225,12/21/2013,0,0,0,0,0,1188,1188
42449,RM-B230A,12/21/2013,0,0,0,0,0,1188,1188
45952,RM-B260,9/20/2014,594,0,594,0,0,0,1188
45953,RM-B260,9/21/2014,594,0,594,0,0,0,1188
47717,RM-B275,12/21/2013,0,0,0,0,0,1188,1188
2790,RM-1106,10/10/2013,0,0,0,0,0,1185,1185
4847,RM-1109,10/10/2013,0,0,0,0,0,1185,1185
6432,RM-1113,5/17/2014,0,0,1185,0,0,0,1185
12223,RM-1130,10/10/2013,0,0,0,0,0,1185,1185
12910,RM-1132,10/10/2013,0,0,1185,0,0,0,1185
15387,RM-1144,10/10/2013,0,0,0,0,0,1185,1185
15603,RM-1144,5/17/2014,0,0,1185,0,0,0,1185
16261,RM-1145,5/17/2014,0,0,1185,0,0,0,1185
20780,RM-1200B,10/10/2013,0,0,0,0,0,1185,1185
22781,RM-1207,10/10/2013,0,0,0,0,0,1185,1185
25509,RM-1213,10/10/2013,0,0,0,0,0,1185,1185
26410,RM-1213A,5/17/2014,0,0,1185,0,0,0,1185
26879,RM-1217,10/10/2013,1185,0,0,0,0,0,1185
31650,RM-1231,10/10/2013,0,0,0,0,0,1185,1185
34968,RM-B103A,10/10/2013,0,0,0,0,0,1185,1185
36204,RM-B200B,10/10/2013,0,0,0,0,0,1185,1185
38477,RM-B215,5/17/2014,0,0,1185,0,0,0,1185
39634,RM-B222,10/10/2013,1185,0,0,0,0,0,1185
40322,RM-B224,10/10/2013,0,0,0,0,0,1185,1185
41010,RM-B225,10/10/2013,0,0,0,0,0,1185,1185
42380,RM-B230A,10/10/2013,0,0,0,0,0,1185,1185
43162,RM-B240,5/17/2014,0,0,1185,0,0,0,1185
2356,RM-1104,5/8/2014,0,1182,0,0,0,0,1182
2364,RM-1104,5/16/2014,0,1182,0,0,0,0,1182
9620,RM-1123,10/10/2013,0,0,1182,0,0,0,1182
13595,RM-1133,10/10/2013,0,0,1182,0,0,0,1182
35757,RM-B109,6/10/2014,588,0,594,0,0,0,1182
35861,RM-B109,9/22/2014,591,0,591,0,0,0,1182
45954,RM-B260,9/22/2014,591,0,591,0,0,0,1182
46980,RM-B270,10/10/2013,0,0,1182,0,0,0,1182
2822,RM-1106,11/11/2013,0,0,0,0,0,1179,1179
2824,RM-1106,11/13/2013,0,0,0,0,0,1179,1179
4879,RM-1109,11/11/2013,0,0,0,0,0,1179,1179
4881,RM-1109,11/13/2013,0,0,0,0,0,1179,1179
7693,RM-1116,2/21/2014,1179,0,0,0,0,0,1179
8929,RM-1122,10/4/2013,0,0,1179,0,0,0,1179
9614,RM-1123,10/4/2013,0,0,1179,0,0,0,1179
9652,RM-1123,11/11/2013,0,0,1179,0,0,0,1179
10337,RM-1124,11/11/2013,0,0,0,0,0,1179,1179
10339,RM-1124,11/13/2013,0,0,0,0,0,1179,1179
12255,RM-1130,11/11/2013,0,0,0,0,0,1179,1179
12257,RM-1130,11/13/2013,0,0,0,0,0,1179,1179
12942,RM-1132,11/11/2013,0,0,1179,0,0,0,1179
12944,RM-1132,11/13/2013,0,0,1179,0,0,0,1179
13589,RM-1133,10/4/2013,0,0,1179,0,0,0,1179
13627,RM-1133,11/11/2013,0,0,1179,0,0,0,1179
15419,RM-1144,11/11/2013,0,0,0,0,0,1179,1179
15421,RM-1144,11/13/2013,0,0,0,0,0,1179,1179
16104,RM-1145,11/11/2013,0,0,0,0,0,1179,1179
16106,RM-1145,11/13/2013,0,0,0,0,0,1179,1179
22813,RM-1207,11/11/2013,0,0,0,0,0,1179,1179
22815,RM-1207,11/13/2013,0,0,0,0,0,1179,1179
24871,RM-1212,11/11/2013,0,0,1179,0,0,0,1179
25541,RM-1213,11/11/2013,0,0,0,0,0,1179,1179
25543,RM-1213,11/13/2013,0,0,0,0,0,1179,1179
26911,RM-1217,11/11/2013,1179,0,0,0,0,0,1179
26913,RM-1217,11/13/2013,1179,0,0,0,0,0,1179
27010,RM-1217,2/21/2014,1179,0,0,0,0,0,1179
28287,RM-1221,11/11/2013,0,0,1179,0,0,0,1179
31682,RM-1231,11/11/2013,0,0,0,0,0,1179,1179
31684,RM-1231,11/13/2013,0,0,0,0,0,1179,1179
35000,RM-B103A,11/11/2013,0,0,0,0,0,1179,1179
35002,RM-B103A,11/13/2013,0,0,0,0,0,1179,1179
36236,RM-B200B,11/11/2013,0,0,0,0,0,1179,1179
36238,RM-B200B,11/13/2013,0,0,0,0,0,1179,1179
39077,RM-B220,2/21/2014,1179,0,0,0,0,0,1179
39666,RM-B222,11/11/2013,1179,0,0,0,0,0,1179
39668,RM-B222,11/13/2013,1179,0,0,0,0,0,1179
40354,RM-B224,11/11/2013,0,0,0,0,0,1179,1179
40356,RM-B224,11/13/2013,0,0,0,0,0,1179,1179
41042,RM-B225,11/11/2013,0,0,0,0,0,1179,1179
41044,RM-B225,11/13/2013,0,0,0,0,0,1179,1179
42412,RM-B230A,11/11/2013,0,0,0,0,0,1179,1179
42414,RM-B230A,11/13/2013,0,0,0,0,0,1179,1179
45057,RM-B250A,2/21/2014,1179,0,0,0,0,0,1179
46974,RM-B270,10/4/2013,0,0,1179,0,0,0,1179
47012,RM-B270,11/11/2013,0,0,1179,0,0,0,1179
2784,RM-1106,10/4/2013,0,0,0,0,0,1176,1176
2817,RM-1106,11/6/2013,0,0,0,0,0,1176,1176
4841,RM-1109,10/4/2013,0,0,0,0,0,1176,1176
4874,RM-1109,11/6/2013,0,0,0,0,0,1176,1176
4978,RM-1109,2/21/2014,0,0,0,0,0,1176,1176
6347,RM-1113,2/21/2014,0,0,1176,0,0,0,1176
9066,RM-1122,2/21/2014,0,0,0,0,0,1176,1176
9654,RM-1123,11/13/2013,0,0,1176,0,0,0,1176
10332,RM-1124,11/6/2013,0,0,0,0,0,1176,1176
12217,RM-1130,10/4/2013,0,0,0,0,0,1176,1176
12250,RM-1130,11/6/2013,0,0,0,0,0,1176,1176
12904,RM-1132,10/4/2013,0,0,1176,0,0,0,1176
13629,RM-1133,11/13/2013,0,0,1176,0,0,0,1176
15381,RM-1144,10/4/2013,0,0,0,0,0,1176,1176
15414,RM-1144,11/6/2013,0,0,0,0,0,1176,1176
15518,RM-1144,2/21/2014,0,0,1176,0,0,0,1176
16099,RM-1145,11/6/2013,0,0,0,0,0,1176,1176
16203,RM-1145,2/21/2014,0,0,0,0,0,1176,1176
20774,RM-1200B,10/4/2013,0,0,0,0,0,1176,1176
22775,RM-1207,10/4/2013,0,0,0,0,0,1176,1176
22808,RM-1207,11/6/2013,0,0,0,0,0,1176,1176
24494,RM-1208B,9/18/2014,588,0,588,0,0,0,1176
24495,RM-1208B,9/19/2014,588,0,588,0,0,0,1176
24873,RM-1212,11/13/2013,0,0,1176,0,0,0,1176
25536,RM-1213,11/6/2013,0,0,0,0,0,1176,1176
25640,RM-1213,2/21/2014,0,0,0,0,0,1176,1176
26325,RM-1213A,2/21/2014,0,0,1176,0,0,0,1176
26873,RM-1217,10/4/2013,1176,0,0,0,0,0,1176
26906,RM-1217,11/6/2013,1176,0,0,0,0,0,1176
28289,RM-1221,11/13/2013,0,0,1176,0,0,0,1176
28386,RM-1221,2/21/2014,0,0,0,0,0,1176,1176
31644,RM-1231,10/4/2013,0,0,0,0,0,1176,1176
31677,RM-1231,11/6/2013,0,0,0,0,0,1176,1176
31781,RM-1231,2/21/2014,0,0,0,0,0,1176,1176
32471,RM-1236,2/21/2014,0,0,1176,0,0,0,1176
34962,RM-B103A,10/4/2013,0,0,0,0,0,1176,1176
34995,RM-B103A,11/6/2013,0,0,0,0,0,1176,1176
35648,RM-B109,2/21/2014,0,0,1176,0,0,0,1176
35857,RM-B109,9/18/2014,588,0,588,0,0,0,1176
35858,RM-B109,9/19/2014,588,0,588,0,0,0,1176
35862,RM-B109,9/23/2014,588,0,588,0,0,0,1176
36198,RM-B200B,10/4/2013,0,0,0,0,0,1176,1176
36231,RM-B200B,11/6/2013,0,0,0,0,0,1176,1176
38392,RM-B215,2/21/2014,0,0,1176,0,0,0,1176
39628,RM-B222,10/4/2013,1176,0,0,0,0,0,1176
39661,RM-B222,11/6/2013,1176,0,0,0,0,0,1176
40316,RM-B224,10/4/2013,0,0,0,0,0,1176,1176
40349,RM-B224,11/6/2013,0,0,0,0,0,1176,1176
40453,RM-B224,2/21/2014,0,0,0,0,0,1176,1176
41004,RM-B225,10/4/2013,0,0,0,0,0,1176,1176
41037,RM-B225,11/6/2013,0,0,0,0,0,1176,1176
42374,RM-B230A,10/4/2013,0,0,0,0,0,1176,1176
42407,RM-B230A,11/6/2013,0,0,0,0,0,1176,1176
42511,RM-B230A,2/21/2014,0,0,0,0,0,1176,1176
43077,RM-B240,2/21/2014,0,0,1176,0,0,0,1176
44372,RM-B250,2/21/2014,0,0,1176,0,0,0,1176
45950,RM-B260,9/18/2014,588,0,588,0,0,0,1176
45951,RM-B260,9/19/2014,588,0,588,0,0,0,1176
45955,RM-B260,9/23/2014,588,0,588,0,0,0,1176
47779,RM-B275,2/21/2014,0,0,0,0,0,1176,1176
9647,RM-1123,11/6/2013,0,0,1173,0,0,0,1173
12937,RM-1132,11/6/2013,0,0,1173,0,0,0,1173
13622,RM-1133,11/6/2013,0,0,1173,0,0,0,1173
20807,RM-1200B,11/6/2013,0,0,0,0,0,1173,1173
28282,RM-1221,11/6/2013,0,0,1173,0,0,0,1173
47007,RM-B270,11/6/2013,0,0,1173,0,0,0,1173
2358,RM-1104,5/10/2014,0,1170,0,0,0,0,1170
2860,RM-1106,12/22/2013,0,0,0,0,0,1170,1170
2997,RM-1106,5/8/2014,0,0,0,1170,0,0,1170
4917,RM-1109,12/22/2013,0,0,0,0,0,1170,1170
5705,RM-1110,4/4/2014,0,0,1170,0,0,0,1170
6389,RM-1113,4/4/2014,0,0,1170,0,0,0,1170
9005,RM-1122,12/22/2013,0,0,0,0,0,1170,1170
10375,RM-1124,12/22/2013,0,0,0,0,0,1170,1170
12293,RM-1130,12/22/2013,0,0,0,0,0,1170,1170
12980,RM-1132,12/22/2013,0,0,1170,0,0,0,1170
15560,RM-1144,4/4/2014,0,0,1170,0,0,0,1170
16142,RM-1145,12/22/2013,0,0,0,0,0,1170,1170
21678,RM-1200C,5/14/2014,0,582,0,588,0,0,1170
25579,RM-1213,12/22/2013,0,0,0,0,0,1170,1170
26367,RM-1213A,4/4/2014,0,0,1170,0,0,0,1170
26949,RM-1217,12/22/2013,1170,0,0,0,0,0,1170
31720,RM-1231,12/22/2013,0,0,0,0,0,1170,1170
32513,RM-1236,4/4/2014,0,0,1170,0,0,0,1170
35690,RM-B109,4/4/2014,0,0,1170,0,0,0,1170
36274,RM-B200B,12/22/2013,0,0,0,0,0,1170,1170
38434,RM-B215,4/4/2014,0,0,1170,0,0,0,1170
39016,RM-B220,12/22/2013,1170,0,0,0,0,0,1170
39704,RM-B222,12/22/2013,1170,0,0,0,0,0,1170
40392,RM-B224,12/22/2013,0,0,0,0,0,1170,1170
41080,RM-B225,12/22/2013,0,0,0,0,0,1170,1170
42450,RM-B230A,12/22/2013,0,0,0,0,0,1170,1170
43119,RM-B240,4/4/2014,0,0,1170,0,0,0,1170
45956,RM-B260,9/24/2014,585,0,585,0,0,0,1170
47167,RM-B270,4/18/2014,0,0,0,1170,0,0,1170
47718,RM-B275,12/22/2013,0,0,0,0,0,1170,1170
1680,RM-1102,5/17/2014,1167,0,0,0,0,0,1167
6286,RM-1113,12/22/2013,0,0,1167,0,0,0,1167
7048,RM-1115,4/4/2014,1167,0,0,0,0,0,1167
7735,RM-1116,4/4/2014,1167,0,0,0,0,0,1167
9690,RM-1123,12/22/2013,0,0,1167,0,0,0,1167
13665,RM-1133,12/22/2013,0,0,1167,0,0,0,1167
14291,RM-1134,4/4/2014,1167,0,0,0,0,0,1167
18960,RM-1155,4/4/2014,1167,0,0,0,0,0,1167
19636,RM-1156,4/4/2014,1167,0,0,0,0,0,1167
22954,RM-1207,4/4/2014,1167,0,0,0,0,0,1167
24224,RM-1208B,12/22/2013,0,0,1167,0,0,0,1167
24909,RM-1212,12/22/2013,0,0,1167,0,0,0,1167
25055,RM-1212,5/17/2014,1167,0,0,0,0,0,1167
27052,RM-1217,4/4/2014,1167,0,0,0,0,0,1167
29156,RM-1223,5/17/2014,1167,0,0,0,0,0,1167
32410,RM-1236,12/22/2013,0,0,1167,0,0,0,1167
39119,RM-B220,4/4/2014,1167,0,0,0,0,0,1167
310,RM-1100A,5/17/2014,1164,0,0,0,0,0,1164
5747,RM-1110,5/17/2014,0,0,1164,0,0,0,1164
7091,RM-1115,5/17/2014,1164,0,0,0,0,0,1164
7778,RM-1116,5/17/2014,1164,0,0,0,0,0,1164
14271,RM-1134,3/15/2014,1164,0,0,0,0,0,1164
14333,RM-1134,5/17/2014,1164,0,0,0,0,0,1164
19003,RM-1155,5/17/2014,1164,0,0,0,0,0,1164
22997,RM-1207,5/17/2014,1164,0,0,0,0,0,1164
35863,RM-B109,9/24/2014,582,0,582,0,0,0,1164
39162,RM-B220,5/17/2014,1164,0,0,0,0,0,1164
39850,RM-B222,5/17/2014,1164,0,0,0,0,0,1164
45141,RM-B250A,5/17/2014,1164,0,0,0,0,0,1164
2851,RM-1106,12/13/2013,0,0,0,0,0,1161,1161
4908,RM-1109,12/13/2013,0,0,0,0,0,1161,1161
6378,RM-1113,3/24/2014,0,0,1161,0,0,0,1161
8996,RM-1122,12/13/2013,0,0,0,0,0,1161,1161
9633,RM-1123,10/23/2013,0,0,1161,0,0,0,1161
10366,RM-1124,12/13/2013,0,0,0,0,0,1161,1161
12284,RM-1130,12/13/2013,0,0,0,0,0,1161,1161
13608,RM-1133,10/23/2013,0,0,1161,0,0,0,1161
15549,RM-1144,3/24/2014,0,0,1161,0,0,0,1161
16133,RM-1145,12/13/2013,0,0,0,0,0,1161,1161
22842,RM-1207,12/13/2013,0,0,0,0,0,1161,1161
25570,RM-1213,12/13/2013,0,0,0,0,0,1161,1161
26356,RM-1213A,3/24/2014,0,0,1161,0,0,0,1161
26941,RM-1217,12/14/2013,1161,0,0,0,0,0,1161
28268,RM-1221,10/23/2013,0,0,1161,0,0,0,1161
31711,RM-1231,12/13/2013,0,0,0,0,0,1161,1161
32502,RM-1236,3/24/2014,0,0,1161,0,0,0,1161
35679,RM-B109,3/24/2014,0,0,1161,0,0,0,1161
36265,RM-B200B,12/13/2013,0,0,0,0,0,1161,1161
38423,RM-B215,3/24/2014,0,0,1161,0,0,0,1161
39007,RM-B220,12/13/2013,1161,0,0,0,0,0,1161
39695,RM-B222,12/13/2013,1161,0,0,0,0,0,1161
40383,RM-B224,12/13/2013,0,0,0,0,0,1161,1161
41071,RM-B225,12/13/2013,0,0,0,0,0,1161,1161
42441,RM-B230A,12/13/2013,0,0,0,0,0,1161,1161
43108,RM-B240,3/24/2014,0,0,1161,0,0,0,1161
46993,RM-B270,10/23/2013,0,0,1161,0,0,0,1161
47709,RM-B275,12/13/2013,0,0,0,0,0,1161,1161
291,RM-1100A,4/28/2014,1158,0,0,0,0,0,1158
1661,RM-1102,4/28/2014,1158,0,0,0,0,0,1158
2785,RM-1106,10/5/2013,0,0,0,0,0,1158,1158
2803,RM-1106,10/23/2013,0,0,0,0,0,1158,1158
2825,RM-1106,11/14/2013,0,0,0,0,0,1158,1158
2852,RM-1106,12/14/2013,0,0,0,0,0,1158,1158
3446,RM-1107,9/11/2013,0,0,1158,0,0,0,1158
4842,RM-1109,10/5/2013,0,0,0,0,0,1158,1158
4860,RM-1109,10/23/2013,0,0,0,0,0,1158,1158
4882,RM-1109,11/14/2013,0,0,0,0,0,1158,1158
4909,RM-1109,12/14/2013,0,0,0,0,0,1158,1158
5007,RM-1109,3/22/2014,0,0,0,0,0,1158,1158
5009,RM-1109,3/24/2014,0,0,0,0,0,1158,1158
6187,RM-1113,9/11/2013,0,0,1158,0,0,0,1158
6342,RM-1113,2/16/2014,0,0,1158,0,0,0,1158
7072,RM-1115,4/28/2014,1158,0,0,0,0,0,1158
7688,RM-1116,2/16/2014,1158,0,0,0,0,0,1158
7722,RM-1116,3/22/2014,1158,0,0,0,0,0,1158
7724,RM-1116,3/24/2014,1158,0,0,0,0,0,1158
7759,RM-1116,4/28/2014,1158,0,0,0,0,0,1158
8906,RM-1122,9/11/2013,0,0,1158,0,0,0,1158
8997,RM-1122,12/14/2013,0,0,0,0,0,1158,1158
9095,RM-1122,3/22/2014,0,0,0,0,0,1158,1158
9097,RM-1122,3/24/2014,0,0,0,0,0,1158,1158
9591,RM-1123,9/11/2013,0,0,1158,0,0,0,1158
9655,RM-1123,11/14/2013,0,0,1158,0,0,0,1158
9681,RM-1123,12/13/2013,0,0,1158,0,0,0,1158
9682,RM-1123,12/14/2013,0,0,1158,0,0,0,1158
10318,RM-1124,10/23/2013,0,0,0,0,0,1158,1158
10340,RM-1124,11/14/2013,0,0,0,0,0,1158,1158
10367,RM-1124,12/14/2013,0,0,0,0,0,1158,1158
12194,RM-1130,9/11/2013,0,0,0,0,0,1158,1158
12218,RM-1130,10/5/2013,0,0,0,0,0,1158,1158
12236,RM-1130,10/23/2013,0,0,0,0,0,1158,1158
12258,RM-1130,11/14/2013,0,0,0,0,0,1158,1158
12285,RM-1130,12/14/2013,0,0,0,0,0,1158,1158
12923,RM-1132,10/23/2013,0,0,1158,0,0,0,1158
12945,RM-1132,11/14/2013,0,0,1158,0,0,0,1158
12971,RM-1132,12/13/2013,0,0,1158,0,0,0,1158
12972,RM-1132,12/14/2013,0,0,1158,0,0,0,1158
13566,RM-1133,9/11/2013,0,0,1158,0,0,0,1158
13630,RM-1133,11/14/2013,0,0,1158,0,0,0,1158
13656,RM-1133,12/13/2013,0,0,1158,0,0,0,1158
13657,RM-1133,12/14/2013,0,0,1158,0,0,0,1158
14278,RM-1134,3/22/2014,1158,0,0,0,0,0,1158
14280,RM-1134,3/24/2014,1158,0,0,0,0,0,1158
14315,RM-1134,4/28/2014,1158,0,0,0,0,0,1158
15358,RM-1144,9/11/2013,0,0,0,0,0,1158,1158
15382,RM-1144,10/5/2013,0,0,0,0,0,1158,1158
15400,RM-1144,10/23/2013,0,0,0,0,0,1158,1158
15422,RM-1144,11/14/2013,0,0,0,0,0,1158,1158
15513,RM-1144,2/16/2014,0,0,1158,0,0,0,1158
16085,RM-1145,10/23/2013,0,0,0,0,0,1158,1158
16107,RM-1145,11/14/2013,0,0,0,0,0,1158,1158
16134,RM-1145,12/14/2013,0,0,0,0,0,1158,1158
16232,RM-1145,3/22/2014,0,0,0,0,0,1158,1158
16234,RM-1145,3/24/2014,0,0,0,0,0,1158,1158
18070,RM-1154,9/11/2013,1158,0,0,0,0,0,1158
18984,RM-1155,4/28/2014,1158,0,0,0,0,0,1158
20751,RM-1200B,9/11/2013,0,0,0,0,0,1158,1158
20793,RM-1200B,10/23/2013,0,0,0,0,0,1158,1158
22776,RM-1207,10/5/2013,0,0,0,0,0,1158,1158
22794,RM-1207,10/23/2013,0,0,0,0,0,1158,1158
22816,RM-1207,11/14/2013,0,0,0,0,0,1158,1158
22978,RM-1207,4/28/2014,1158,0,0,0,0,0,1158
24215,RM-1208B,12/13/2013,0,0,1158,0,0,0,1158
24216,RM-1208B,12/14/2013,0,0,1158,0,0,0,1158
24874,RM-1212,11/14/2013,0,0,1158,0,0,0,1158
24900,RM-1212,12/13/2013,0,0,1158,0,0,0,1158
24901,RM-1212,12/14/2013,0,0,1158,0,0,0,1158
25036,RM-1212,4/28/2014,1158,0,0,0,0,0,1158
25480,RM-1213,9/11/2013,0,0,1158,0,0,0,1158
25522,RM-1213,10/23/2013,0,0,0,0,0,1158,1158
25544,RM-1213,11/14/2013,0,0,0,0,0,1158,1158
25571,RM-1213,12/14/2013,0,0,0,0,0,1158,1158
25669,RM-1213,3/22/2014,0,0,0,0,0,1158,1158
25671,RM-1213,3/24/2014,0,0,0,0,0,1158,1158
26320,RM-1213A,2/16/2014,0,0,1158,0,0,0,1158
26850,RM-1217,9/11/2013,1158,0,0,0,0,0,1158
26892,RM-1217,10/23/2013,1158,0,0,0,0,0,1158
26914,RM-1217,11/14/2013,1158,0,0,0,0,0,1158
26940,RM-1217,12/13/2013,1158,0,0,0,0,0,1158
27005,RM-1217,2/16/2014,1158,0,0,0,0,0,1158
27039,RM-1217,3/22/2014,1158,0,0,0,0,0,1158
27041,RM-1217,3/24/2014,1158,0,0,0,0,0,1158
28290,RM-1221,11/14/2013,0,0,1158,0,0,0,1158
28316,RM-1221,12/13/2013,0,0,1158,0,0,0,1158
28317,RM-1221,12/14/2013,0,0,1158,0,0,0,1158
28415,RM-1221,3/22/2014,0,0,0,0,0,1158,1158
28417,RM-1221,3/24/2014,0,0,0,0,0,1158,1158
29137,RM-1223,4/28/2014,1158,0,0,0,0,0,1158
31621,RM-1231,9/11/2013,0,0,0,0,0,1158,1158
31645,RM-1231,10/5/2013,0,0,0,0,0,1158,1158
31663,RM-1231,10/23/2013,0,0,0,0,0,1158,1158
31685,RM-1231,11/14/2013,0,0,0,0,0,1158,1158
31712,RM-1231,12/14/2013,0,0,0,0,0,1158,1158
31810,RM-1231,3/22/2014,0,0,0,0,0,1158,1158
31812,RM-1231,3/24/2014,0,0,0,0,0,1158,1158
32401,RM-1236,12/13/2013,0,0,1158,0,0,0,1158
32402,RM-1236,12/14/2013,0,0,1158,0,0,0,1158
32466,RM-1236,2/16/2014,0,0,1158,0,0,0,1158
33723,RM-B102C,9/11/2013,0,0,1158,0,0,0,1158
34939,RM-B103A,9/11/2013,0,0,0,0,0,1158,1158
34963,RM-B103A,10/5/2013,0,0,0,0,0,1158,1158
34981,RM-B103A,10/23/2013,0,0,0,0,0,1158,1158
35003,RM-B103A,11/14/2013,0,0,0,0,0,1158,1158
35643,RM-B109,2/16/2014,0,0,1158,0,0,0,1158
36175,RM-B200B,9/11/2013,0,0,0,0,0,1158,1158
36199,RM-B200B,10/5/2013,0,0,0,0,0,1158,1158
36217,RM-B200B,10/23/2013,0,0,0,0,0,1158,1158
36239,RM-B200B,11/14/2013,0,0,0,0,0,1158,1158
36266,RM-B200B,12/14/2013,0,0,0,0,0,1158,1158
38387,RM-B215,2/16/2014,0,0,1158,0,0,0,1158
39008,RM-B220,12/14/2013,1158,0,0,0,0,0,1158
39072,RM-B220,2/16/2014,1158,0,0,0,0,0,1158
39106,RM-B220,3/22/2014,1158,0,0,0,0,0,1158
39108,RM-B220,3/24/2014,1158,0,0,0,0,0,1158
39143,RM-B220,4/28/2014,1158,0,0,0,0,0,1158
39629,RM-B222,10/5/2013,1158,0,0,0,0,0,1158
39647,RM-B222,10/23/2013,1158,0,0,0,0,0,1158
39669,RM-B222,11/14/2013,1158,0,0,0,0,0,1158
39696,RM-B222,12/14/2013,1158,0,0,0,0,0,1158
39831,RM-B222,4/28/2014,1158,0,0,0,0,0,1158
40293,RM-B224,9/11/2013,0,0,0,0,0,1158,1158
40317,RM-B224,10/5/2013,0,0,0,0,0,1158,1158
40335,RM-B224,10/23/2013,0,0,0,0,0,1158,1158
40357,RM-B224,11/14/2013,0,0,0,0,0,1158,1158
40384,RM-B224,12/14/2013,0,0,0,0,0,1158,1158
40482,RM-B224,3/22/2014,0,0,0,0,0,1158,1158
40484,RM-B224,3/24/2014,0,0,0,0,0,1158,1158
40981,RM-B225,9/11/2013,0,0,0,0,0,1158,1158
41005,RM-B225,10/5/2013,0,0,0,0,0,1158,1158
41023,RM-B225,10/23/2013,0,0,0,0,0,1158,1158
41045,RM-B225,11/14/2013,0,0,0,0,0,1158,1158
41072,RM-B225,12/14/2013,0,0,0,0,0,1158,1158
42351,RM-B230A,9/11/2013,0,0,0,0,0,1158,1158
42375,RM-B230A,10/5/2013,0,0,0,0,0,1158,1158
42393,RM-B230A,10/23/2013,0,0,0,0,0,1158,1158
42415,RM-B230A,11/14/2013,0,0,0,0,0,1158,1158
42442,RM-B230A,12/14/2013,0,0,0,0,0,1158,1158
42540,RM-B230A,3/22/2014,0,0,0,0,0,1158,1158
42542,RM-B230A,3/24/2014,0,0,0,0,0,1158,1158
43602,RM-B240A,9/11/2013,0,0,0,0,0,1158,1158
44212,RM-B250,9/11/2013,1158,0,0,0,0,0,1158
44367,RM-B250,2/16/2014,0,0,1158,0,0,0,1158
45052,RM-B250A,2/16/2014,1158,0,0,0,0,0,1158
45086,RM-B250A,3/22/2014,1158,0,0,0,0,0,1158
45088,RM-B250A,3/24/2014,1158,0,0,0,0,0,1158
45123,RM-B250A,4/28/2014,1158,0,0,0,0,0,1158
46951,RM-B270,9/11/2013,0,0,1158,0,0,0,1158
47710,RM-B275,12/14/2013,0,0,0,0,0,1158,1158
47808,RM-B275,3/22/2014,0,0,0,0,0,1158,1158
47810,RM-B275,3/24/2014,0,0,0,0,0,1158,1158
4973,RM-1109,2/16/2014,0,0,0,0,0,1155,1155
5729,RM-1110,4/28/2014,0,0,1155,0,0,0,1155
6376,RM-1113,3/22/2014,0,0,1155,0,0,0,1155
6413,RM-1113,4/28/2014,0,0,1155,0,0,0,1155
9061,RM-1122,2/16/2014,0,0,0,0,0,1155,1155
9615,RM-1123,10/5/2013,0,0,1155,0,0,0,1155
12905,RM-1132,10/5/2013,0,0,1155,0,0,0,1155
13590,RM-1133,10/5/2013,0,0,1155,0,0,0,1155
15547,RM-1144,3/22/2014,0,0,1155,0,0,0,1155
15584,RM-1144,4/28/2014,0,0,1155,0,0,0,1155
16198,RM-1145,2/16/2014,0,0,0,0,0,1155,1155
16242,RM-1145,4/28/2014,0,0,1155,0,0,0,1155
20775,RM-1200B,10/5/2013,0,0,0,0,0,1155,1155
25635,RM-1213,2/16/2014,0,0,0,0,0,1155,1155
26354,RM-1213A,3/22/2014,0,0,1155,0,0,0,1155
26391,RM-1213A,4/28/2014,0,0,1155,0,0,0,1155
26874,RM-1217,10/5/2013,1155,0,0,0,0,0,1155
28381,RM-1221,2/16/2014,0,0,0,0,0,1155,1155
31776,RM-1231,2/16/2014,0,0,0,0,0,1155,1155
32500,RM-1236,3/22/2014,0,0,1155,0,0,0,1155
35677,RM-B109,3/22/2014,0,0,1155,0,0,0,1155
38421,RM-B215,3/22/2014,0,0,1155,0,0,0,1155
38458,RM-B215,4/28/2014,0,0,1155,0,0,0,1155
40448,RM-B224,2/16/2014,0,0,0,0,0,1155,1155
42506,RM-B230A,2/16/2014,0,0,0,0,0,1155,1155
43106,RM-B240,3/22/2014,0,0,1155,0,0,0,1155
43143,RM-B240,4/28/2014,0,0,1155,0,0,0,1155
46975,RM-B270,10/5/2013,0,0,1155,0,0,0,1155
47774,RM-B275,2/16/2014,0,0,0,0,0,1155,1155
2786,RM-1106,10/6/2013,0,0,0,0,0,1149,1149
3445,RM-1107,9/10/2013,0,0,1149,0,0,0,1149
4837,RM-1109,9/30/2013,0,0,0,0,0,1149,1149
4843,RM-1109,10/6/2013,0,0,0,0,0,1149,1149
4979,RM-1109,2/22/2014,0,0,0,0,0,1149,1149
5759,RM-1110,5/29/2014,0,0,1149,0,0,0,1149
6186,RM-1113,9/10/2013,0,0,1149,0,0,0,1149
6348,RM-1113,2/22/2014,0,0,1149,0,0,0,1149
6444,RM-1113,5/29/2014,0,0,1149,0,0,0,1149
7790,RM-1116,5/29/2014,1149,0,0,0,0,0,1149
8905,RM-1122,9/10/2013,0,0,1149,0,0,0,1149
9067,RM-1122,2/22/2014,0,0,0,0,0,1149,1149
9590,RM-1123,9/10/2013,0,0,1149,0,0,0,1149
9616,RM-1123,10/6/2013,0,0,1149,0,0,0,1149
12193,RM-1130,9/10/2013,0,0,0,0,0,1149,1149
12219,RM-1130,10/6/2013,0,0,0,0,0,1149,1149
12906,RM-1132,10/6/2013,0,0,1149,0,0,0,1149
13565,RM-1133,9/10/2013,0,0,1149,0,0,0,1149
13591,RM-1133,10/6/2013,0,0,1149,0,0,0,1149
14345,RM-1134,5/29/2014,1149,0,0,0,0,0,1149
15357,RM-1144,9/10/2013,0,0,0,0,0,1149,1149
15383,RM-1144,10/6/2013,0,0,0,0,0,1149,1149
15519,RM-1144,2/22/2014,0,0,1149,0,0,0,1149
15615,RM-1144,5/29/2014,0,0,1149,0,0,0,1149
16204,RM-1145,2/22/2014,0,0,0,0,0,1149,1149
16273,RM-1145,5/29/2014,0,0,1149,0,0,0,1149
18069,RM-1154,9/10/2013,1149,0,0,0,0,0,1149
19015,RM-1155,5/29/2014,1149,0,0,0,0,0,1149
20750,RM-1200B,9/10/2013,0,0,0,0,0,1149,1149
20776,RM-1200B,10/6/2013,0,0,0,0,0,1149,1149
22777,RM-1207,10/6/2013,0,0,0,0,0,1149,1149
23009,RM-1207,5/29/2014,1149,0,0,0,0,0,1149
25067,RM-1212,5/29/2014,1149,0,0,0,0,0,1149
25479,RM-1213,9/10/2013,0,0,1149,0,0,0,1149
25641,RM-1213,2/22/2014,0,0,0,0,0,1149,1149
26326,RM-1213A,2/22/2014,0,0,1149,0,0,0,1149
26422,RM-1213A,5/29/2014,0,0,1149,0,0,0,1149
26849,RM-1217,9/10/2013,1149,0,0,0,0,0,1149
26875,RM-1217,10/6/2013,1149,0,0,0,0,0,1149
28387,RM-1221,2/22/2014,0,0,0,0,0,1149,1149
28483,RM-1221,5/29/2014,0,0,1149,0,0,0,1149
29168,RM-1223,5/29/2014,1149,0,0,0,0,0,1149
31620,RM-1231,9/10/2013,0,0,0,0,0,1149,1149
31646,RM-1231,10/6/2013,0,0,0,0,0,1149,1149
31782,RM-1231,2/22/2014,0,0,0,0,0,1149,1149
32472,RM-1236,2/22/2014,0,0,1149,0,0,0,1149
33722,RM-B102C,9/10/2013,0,0,1149,0,0,0,1149
34938,RM-B103A,9/10/2013,0,0,0,0,0,1149,1149
34964,RM-B103A,10/6/2013,0,0,0,0,0,1149,1149
35649,RM-B109,2/22/2014,0,0,1149,0,0,0,1149
36174,RM-B200B,9/10/2013,0,0,0,0,0,1149,1149
36200,RM-B200B,10/6/2013,0,0,0,0,0,1149,1149
37113,RM-B200C,5/29/2014,1149,0,0,0,0,0,1149
38393,RM-B215,2/22/2014,0,0,1149,0,0,0,1149
38489,RM-B215,5/29/2014,0,0,1149,0,0,0,1149
39174,RM-B220,5/29/2014,1149,0,0,0,0,0,1149
40292,RM-B224,9/10/2013,0,0,0,0,0,1149,1149
40318,RM-B224,10/6/2013,0,0,0,0,0,1149,1149
40454,RM-B224,2/22/2014,0,0,0,0,0,1149,1149
40980,RM-B225,9/10/2013,0,0,0,0,0,1149,1149
41006,RM-B225,10/6/2013,0,0,0,0,0,1149,1149
41923,RM-B230,5/29/2014,1149,0,0,0,0,0,1149
42350,RM-B230A,9/10/2013,0,0,0,0,0,1149,1149
42376,RM-B230A,10/6/2013,0,0,0,0,0,1149,1149
42512,RM-B230A,2/22/2014,0,0,0,0,0,1149,1149
43078,RM-B240,2/22/2014,0,0,1149,0,0,0,1149
43174,RM-B240,5/29/2014,0,0,1149,0,0,0,1149
43601,RM-B240A,9/10/2013,0,0,0,0,0,1149,1149
44211,RM-B250,9/10/2013,1149,0,0,0,0,0,1149
44373,RM-B250,2/22/2014,0,0,1149,0,0,0,1149
45153,RM-B250A,5/29/2014,1149,0,0,0,0,0,1149
46950,RM-B270,9/10/2013,0,0,1149,0,0,0,1149
46976,RM-B270,10/6/2013,0,0,1149,0,0,0,1149
47780,RM-B275,2/22/2014,0,0,0,0,0,1149,1149
319,RM-1100A,5/26/2014,1146,0,0,0,0,0,1146
1689,RM-1102,5/26/2014,1146,0,0,0,0,0,1146
5003,RM-1109,3/18/2014,0,0,0,0,0,1146,1146
5706,RM-1110,4/5/2014,0,0,1146,0,0,0,1146
5756,RM-1110,5/26/2014,0,0,1146,0,0,0,1146
5760,RM-1110,5/30/2014,0,0,1146,0,0,0,1146
6372,RM-1113,3/18/2014,0,0,1146,0,0,0,1146
6441,RM-1113,5/26/2014,0,0,1146,0,0,0,1146
6445,RM-1113,5/30/2014,0,0,1146,0,0,0,1146
7049,RM-1115,4/5/2014,1146,0,0,0,0,0,1146
7694,RM-1116,2/22/2014,1146,0,0,0,0,0,1146
7718,RM-1116,3/18/2014,1146,0,0,0,0,0,1146
7736,RM-1116,4/5/2014,1146,0,0,0,0,0,1146
7787,RM-1116,5/26/2014,1146,0,0,0,0,0,1146
7791,RM-1116,5/30/2014,1146,0,0,0,0,0,1146
9091,RM-1122,3/18/2014,0,0,0,0,0,1146,1146
14274,RM-1134,3/18/2014,1146,0,0,0,0,0,1146
14292,RM-1134,4/5/2014,1146,0,0,0,0,0,1146
14342,RM-1134,5/26/2014,1146,0,0,0,0,0,1146
14346,RM-1134,5/30/2014,1146,0,0,0,0,0,1146
15543,RM-1144,3/18/2014,0,0,1146,0,0,0,1146
15612,RM-1144,5/26/2014,0,0,1146,0,0,0,1146
15616,RM-1144,5/30/2014,0,0,1146,0,0,0,1146
16228,RM-1145,3/18/2014,0,0,0,0,0,1146,1146
16270,RM-1145,5/26/2014,0,0,1146,0,0,0,1146
16274,RM-1145,5/30/2014,0,0,1146,0,0,0,1146
18961,RM-1155,4/5/2014,1146,0,0,0,0,0,1146
19012,RM-1155,5/26/2014,1146,0,0,0,0,0,1146
19016,RM-1155,5/30/2014,1146,0,0,0,0,0,1146
19637,RM-1156,4/5/2014,1146,0,0,0,0,0,1146
22955,RM-1207,4/5/2014,1146,0,0,0,0,0,1146
23006,RM-1207,5/26/2014,1146,0,0,0,0,0,1146
23010,RM-1207,5/30/2014,1146,0,0,0,0,0,1146
25064,RM-1212,5/26/2014,1146,0,0,0,0,0,1146
25068,RM-1212,5/30/2014,1146,0,0,0,0,0,1146
25665,RM-1213,3/18/2014,0,0,0,0,0,1146,1146
26350,RM-1213A,3/18/2014,0,0,1146,0,0,0,1146
26419,RM-1213A,5/26/2014,0,0,1146,0,0,0,1146
26423,RM-1213A,5/30/2014,0,0,1146,0,0,0,1146
27011,RM-1217,2/22/2014,1146,0,0,0,0,0,1146
27035,RM-1217,3/18/2014,1146,0,0,0,0,0,1146
27053,RM-1217,4/5/2014,1146,0,0,0,0,0,1146
28411,RM-1221,3/18/2014,0,0,0,0,0,1146,1146
28480,RM-1221,5/26/2014,0,0,1146,0,0,0,1146
28484,RM-1221,5/30/2014,0,0,1146,0,0,0,1146
29165,RM-1223,5/26/2014,1146,0,0,0,0,0,1146
29169,RM-1223,5/30/2014,1146,0,0,0,0,0,1146
31806,RM-1231,3/18/2014,0,0,0,0,0,1146,1146
32496,RM-1236,3/18/2014,0,0,1146,0,0,0,1146
35673,RM-B109,3/18/2014,0,0,1146,0,0,0,1146
35884,RM-B109,10/17/2014,573,0,573,0,0,0,1146
37110,RM-B200C,5/26/2014,1146,0,0,0,0,0,1146
37114,RM-B200C,5/30/2014,1146,0,0,0,0,0,1146
38417,RM-B215,3/18/2014,0,0,1146,0,0,0,1146
38486,RM-B215,5/26/2014,0,0,1146,0,0,0,1146
38490,RM-B215,5/30/2014,0,0,1146,0,0,0,1146
39078,RM-B220,2/22/2014,1146,0,0,0,0,0,1146
39102,RM-B220,3/18/2014,1146,0,0,0,0,0,1146
39120,RM-B220,4/5/2014,1146,0,0,0,0,0,1146
39171,RM-B220,5/26/2014,1146,0,0,0,0,0,1146
39175,RM-B220,5/30/2014,1146,0,0,0,0,0,1146
39630,RM-B222,10/6/2013,1146,0,0,0,0,0,1146
40478,RM-B224,3/18/2014,0,0,0,0,0,1146,1146
41920,RM-B230,5/26/2014,1146,0,0,0,0,0,1146
41924,RM-B230,5/30/2014,1146,0,0,0,0,0,1146
42536,RM-B230A,3/18/2014,0,0,0,0,0,1146,1146
43102,RM-B240,3/18/2014,0,0,1146,0,0,0,1146
43171,RM-B240,5/26/2014,0,0,1146,0,0,0,1146
43175,RM-B240,5/30/2014,0,0,1146,0,0,0,1146
45058,RM-B250A,2/22/2014,1146,0,0,0,0,0,1146
45082,RM-B250A,3/18/2014,1146,0,0,0,0,0,1146
45150,RM-B250A,5/26/2014,1146,0,0,0,0,0,1146
45154,RM-B250A,5/30/2014,1146,0,0,0,0,0,1146
45977,RM-B260,10/17/2014,573,0,573,0,0,0,1146
47804,RM-B275,3/18/2014,0,0,0,0,0,1146,1146
2861,RM-1106,12/23/2013,0,0,0,0,0,1143,1143
4918,RM-1109,12/23/2013,0,0,0,0,0,1143,1143
6287,RM-1113,12/23/2013,0,0,1143,0,0,0,1143
6390,RM-1113,4/5/2014,0,0,1143,0,0,0,1143
9006,RM-1122,12/23/2013,0,0,0,0,0,1143,1143
9691,RM-1123,12/23/2013,0,0,1143,0,0,0,1143
10376,RM-1124,12/23/2013,0,0,0,0,0,1143,1143
12294,RM-1130,12/23/2013,0,0,0,0,0,1143,1143
13666,RM-1133,12/23/2013,0,0,1143,0,0,0,1143
15561,RM-1144,4/5/2014,0,0,1143,0,0,0,1143
16143,RM-1145,12/23/2013,0,0,0,0,0,1143,1143
24225,RM-1208B,12/23/2013,0,0,1143,0,0,0,1143
24910,RM-1212,12/23/2013,0,0,1143,0,0,0,1143
25580,RM-1213,12/23/2013,0,0,0,0,0,1143,1143
26368,RM-1213A,4/5/2014,0,0,1143,0,0,0,1143
26950,RM-1217,12/23/2013,1143,0,0,0,0,0,1143
31721,RM-1231,12/23/2013,0,0,0,0,0,1143,1143
32411,RM-1236,12/23/2013,0,0,1143,0,0,0,1143
32514,RM-1236,4/5/2014,0,0,1143,0,0,0,1143
35691,RM-B109,4/5/2014,0,0,1143,0,0,0,1143
36275,RM-B200B,12/23/2013,0,0,0,0,0,1143,1143
38435,RM-B215,4/5/2014,0,0,1143,0,0,0,1143
39017,RM-B220,12/23/2013,1143,0,0,0,0,0,1143
39705,RM-B222,12/23/2013,1143,0,0,0,0,0,1143
40393,RM-B224,12/23/2013,0,0,0,0,0,1143,1143
41081,RM-B225,12/23/2013,0,0,0,0,0,1143,1143
42451,RM-B230A,12/23/2013,0,0,0,0,0,1143,1143
43120,RM-B240,4/5/2014,0,0,1143,0,0,0,1143
47719,RM-B275,12/23/2013,0,0,0,0,0,1143,1143
2853,RM-1106,12/15/2013,0,0,0,0,0,1140,1140
4910,RM-1109,12/15/2013,0,0,0,0,0,1140,1140
8998,RM-1122,12/15/2013,0,0,0,0,0,1140,1140
9683,RM-1123,12/15/2013,0,0,1140,0,0,0,1140
10368,RM-1124,12/15/2013,0,0,0,0,0,1140,1140
12286,RM-1130,12/15/2013,0,0,0,0,0,1140,1140
12973,RM-1132,12/15/2013,0,0,1140,0,0,0,1140
12981,RM-1132,12/23/2013,0,0,1140,0,0,0,1140
13658,RM-1133,12/15/2013,0,0,1140,0,0,0,1140
16135,RM-1145,12/15/2013,0,0,0,0,0,1140,1140
24217,RM-1208B,12/15/2013,0,0,1140,0,0,0,1140
24441,RM-1208B,7/27/2014,570,0,570,0,0,0,1140
24902,RM-1212,12/15/2013,0,0,1140,0,0,0,1140
25572,RM-1213,12/15/2013,0,0,0,0,0,1140,1140
28318,RM-1221,12/15/2013,0,0,1140,0,0,0,1140
31713,RM-1231,12/15/2013,0,0,0,0,0,1140,1140
32403,RM-1236,12/15/2013,0,0,1140,0,0,0,1140
35804,RM-B109,7/27/2014,570,0,570,0,0,0,1140
36267,RM-B200B,12/15/2013,0,0,0,0,0,1140,1140
40385,RM-B224,12/15/2013,0,0,0,0,0,1140,1140
41073,RM-B225,12/15/2013,0,0,0,0,0,1140,1140
42443,RM-B230A,12/15/2013,0,0,0,0,0,1140,1140
47711,RM-B275,12/15/2013,0,0,0,0,0,1140,1140
7522,RM-1116,8/22/2013,0,0,570,0,0,567,1137
18747,RM-1155,8/22/2013,567,0,570,0,0,0,1137
26942,RM-1217,12/15/2013,1137,0,0,0,0,0,1137
30273,RM-1229,8/22/2013,567,0,570,0,0,0,1137
32300,RM-1236,8/22/2013,567,0,570,0,0,0,1137
36845,RM-B200C,8/22/2013,0,0,570,0,0,567,1137
39009,RM-B220,12/15/2013,1137,0,0,0,0,0,1137
39697,RM-B222,12/15/2013,1137,0,0,0,0,0,1137
40282,RM-B224,8/22/2013,0,0,570,0,0,567,1137
47608,RM-B275,8/22/2013,0,0,570,0,0,567,1137
2750,RM-1106,8/22/2013,567,0,0,0,0,567,1134
4369,RM-1108,5/11/2014,0,1134,0,0,0,0,1134
7695,RM-1116,2/23/2014,1134,0,0,0,0,0,1134
8210,RM-1117,8/22/2013,567,0,0,0,0,567,1134
23426,RM-1208,8/22/2013,567,0,0,0,0,567,1134
27012,RM-1217,2/23/2014,1134,0,0,0,0,0,1134
38221,RM-B215,8/22/2013,567,0,0,0,0,567,1134
39079,RM-B220,2/23/2014,1134,0,0,0,0,0,1134
39594,RM-B222,8/22/2013,567,0,567,0,0,0,1134
45059,RM-B250A,2/23/2014,1134,0,0,0,0,0,1134
4980,RM-1109,2/23/2014,0,0,0,0,0,1131,1131
6349,RM-1113,2/23/2014,0,0,1131,0,0,0,1131
9068,RM-1122,2/23/2014,0,0,0,0,0,1131,1131
15520,RM-1144,2/23/2014,0,0,1131,0,0,0,1131
16205,RM-1145,2/23/2014,0,0,0,0,0,1131,1131
25642,RM-1213,2/23/2014,0,0,0,0,0,1131,1131
26327,RM-1213A,2/23/2014,0,0,1131,0,0,0,1131
28388,RM-1221,2/23/2014,0,0,0,0,0,1131,1131
31783,RM-1231,2/23/2014,0,0,0,0,0,1131,1131
32473,RM-1236,2/23/2014,0,0,1131,0,0,0,1131
35650,RM-B109,2/23/2014,0,0,1131,0,0,0,1131
38394,RM-B215,2/23/2014,0,0,1131,0,0,0,1131
40455,RM-B224,2/23/2014,0,0,0,0,0,1131,1131
42513,RM-B230A,2/23/2014,0,0,0,0,0,1131,1131
43079,RM-B240,2/23/2014,0,0,1131,0,0,0,1131
44374,RM-B250,2/23/2014,0,0,1131,0,0,0,1131
47781,RM-B275,2/23/2014,0,0,0,0,0,1131,1131
320,RM-1100A,5/27/2014,1128,0,0,0,0,0,1128
1690,RM-1102,5/27/2014,1128,0,0,0,0,0,1128
2792,RM-1106,10/12/2013,0,0,0,0,0,1128,1128
4373,RM-1108,5/15/2014,0,1128,0,0,0,0,1128
4849,RM-1109,10/12/2013,0,0,0,0,0,1128,1128
6442,RM-1113,5/27/2014,0,0,1128,0,0,0,1128
7788,RM-1116,5/27/2014,1128,0,0,0,0,0,1128
9622,RM-1123,10/12/2013,0,0,1128,0,0,0,1128
12225,RM-1130,10/12/2013,0,0,0,0,0,1128,1128
13597,RM-1133,10/12/2013,0,0,1128,0,0,0,1128
14343,RM-1134,5/27/2014,1128,0,0,0,0,0,1128
15389,RM-1144,10/12/2013,0,0,0,0,0,1128,1128
15613,RM-1144,5/27/2014,0,0,1128,0,0,0,1128
16271,RM-1145,5/27/2014,0,0,1128,0,0,0,1128
19013,RM-1155,5/27/2014,1128,0,0,0,0,0,1128
23007,RM-1207,5/27/2014,1128,0,0,0,0,0,1128
25065,RM-1212,5/27/2014,1128,0,0,0,0,0,1128
26420,RM-1213A,5/27/2014,0,0,1128,0,0,0,1128
28481,RM-1221,5/27/2014,0,0,1128,0,0,0,1128
29166,RM-1223,5/27/2014,1128,0,0,0,0,0,1128
34970,RM-B103A,10/12/2013,0,0,0,0,0,1128,1128
36206,RM-B200B,10/12/2013,0,0,0,0,0,1128,1128
37111,RM-B200C,5/27/2014,1128,0,0,0,0,0,1128
38487,RM-B215,5/27/2014,0,0,1128,0,0,0,1128
39172,RM-B220,5/27/2014,1128,0,0,0,0,0,1128
40324,RM-B224,10/12/2013,0,0,0,0,0,1128,1128
41012,RM-B225,10/12/2013,0,0,0,0,0,1128,1128
41921,RM-B230,5/27/2014,1128,0,0,0,0,0,1128
42382,RM-B230A,10/12/2013,0,0,0,0,0,1128,1128
43172,RM-B240,5/27/2014,0,0,1128,0,0,0,1128
45151,RM-B250A,5/27/2014,1128,0,0,0,0,0,1128
46982,RM-B270,10/12/2013,0,0,1128,0,0,0,1128
5761,RM-1110,5/31/2014,0,0,1125,0,0,0,1125
6295,RM-1113,12/31/2013,0,0,1125,0,0,0,1125
7792,RM-1116,5/31/2014,1125,0,0,0,0,0,1125
9699,RM-1123,12/31/2013,0,0,1125,0,0,0,1125
12912,RM-1132,10/12/2013,0,0,1125,0,0,0,1125
12989,RM-1132,12/31/2013,0,0,1125,0,0,0,1125
13674,RM-1133,12/31/2013,0,0,1125,0,0,0,1125
14347,RM-1134,5/31/2014,1125,0,0,0,0,0,1125
19017,RM-1155,5/31/2014,1125,0,0,0,0,0,1125
20782,RM-1200B,10/12/2013,0,0,0,0,0,1125,1125
22783,RM-1207,10/12/2013,0,0,0,0,0,1125,1125
23011,RM-1207,5/31/2014,1125,0,0,0,0,0,1125
24233,RM-1208B,12/31/2013,0,0,1125,0,0,0,1125
24918,RM-1212,12/31/2013,0,0,1125,0,0,0,1125
25069,RM-1212,5/31/2014,1125,0,0,0,0,0,1125
25511,RM-1213,10/12/2013,0,0,0,0,0,1125,1125
26881,RM-1217,10/12/2013,1125,0,0,0,0,0,1125
26958,RM-1217,12/31/2013,1125,0,0,0,0,0,1125
29170,RM-1223,5/31/2014,1125,0,0,0,0,0,1125
31652,RM-1231,10/12/2013,0,0,0,0,0,1125,1125
32419,RM-1236,12/31/2013,0,0,1125,0,0,0,1125
37115,RM-B200C,5/31/2014,1125,0,0,0,0,0,1125
39025,RM-B220,12/31/2013,1125,0,0,0,0,0,1125
39176,RM-B220,5/31/2014,1125,0,0,0,0,0,1125
39636,RM-B222,10/12/2013,1125,0,0,0,0,0,1125
39713,RM-B222,12/31/2013,1125,0,0,0,0,0,1125
41774,RM-B230,12/31/2013,0,0,1125,0,0,0,1125
41925,RM-B230,5/31/2014,1125,0,0,0,0,0,1125
45155,RM-B250A,5/31/2014,1125,0,0,0,0,0,1125
293,RM-1100A,4/30/2014,1122,0,0,0,0,0,1122
1663,RM-1102,4/30/2014,1122,0,0,0,0,0,1122
2835,RM-1106,11/27/2013,0,0,0,0,0,1122,1122
2857,RM-1106,12/19/2013,0,0,0,0,0,1122,1122
2869,RM-1106,12/31/2013,0,0,0,0,0,1122,1122
3002,RM-1106,5/13/2014,0,0,0,1122,0,0,1122
4892,RM-1109,11/27/2013,0,0,0,0,0,1122,1122
4914,RM-1109,12/19/2013,0,0,0,0,0,1122,1122
4926,RM-1109,12/31/2013,0,0,0,0,0,1122,1122
5731,RM-1110,4/30/2014,0,0,1122,0,0,0,1122
5757,RM-1110,5/27/2014,0,0,1122,0,0,0,1122
5764,RM-1110,6/3/2014,0,0,1122,0,0,0,1122
6415,RM-1113,4/30/2014,0,0,1122,0,0,0,1122
6446,RM-1113,5/31/2014,0,0,1122,0,0,0,1122
6449,RM-1113,6/3/2014,0,0,1122,0,0,0,1122
7074,RM-1115,4/30/2014,1122,0,0,0,0,0,1122
7486,RM-1116,7/17/2013,0,0,561,0,0,561,1122
7761,RM-1116,4/30/2014,1122,0,0,0,0,0,1122
7795,RM-1116,6/3/2014,1122,0,0,0,0,0,1122
8174,RM-1117,7/17/2013,561,0,0,0,0,561,1122
8980,RM-1122,11/27/2013,0,0,0,0,0,1122,1122
9002,RM-1122,12/19/2013,0,0,0,0,0,1122,1122
9014,RM-1122,12/31/2013,0,0,0,0,0,1122,1122
9665,RM-1123,11/27/2013,0,0,1122,0,0,0,1122
9687,RM-1123,12/19/2013,0,0,1122,0,0,0,1122
10350,RM-1124,11/27/2013,0,0,0,0,0,1122,1122
10372,RM-1124,12/19/2013,0,0,0,0,0,1122,1122
10384,RM-1124,12/31/2013,0,0,0,0,0,1122,1122
12268,RM-1130,11/27/2013,0,0,0,0,0,1122,1122
12290,RM-1130,12/19/2013,0,0,0,0,0,1122,1122
12955,RM-1132,11/27/2013,0,0,1122,0,0,0,1122
12977,RM-1132,12/19/2013,0,0,1122,0,0,0,1122
13640,RM-1133,11/27/2013,0,0,1122,0,0,0,1122
13662,RM-1133,12/19/2013,0,0,1122,0,0,0,1122
14317,RM-1134,4/30/2014,1122,0,0,0,0,0,1122
14350,RM-1134,6/3/2014,1122,0,0,0,0,0,1122
15586,RM-1144,4/30/2014,0,0,1122,0,0,0,1122
15617,RM-1144,5/31/2014,0,0,1122,0,0,0,1122
15620,RM-1144,6/3/2014,0,0,1122,0,0,0,1122
16117,RM-1145,11/27/2013,0,0,0,0,0,1122,1122
16139,RM-1145,12/19/2013,0,0,0,0,0,1122,1122
16151,RM-1145,12/31/2013,0,0,0,0,0,1122,1122
16244,RM-1145,4/30/2014,0,0,1122,0,0,0,1122
16275,RM-1145,5/31/2014,0,0,1122,0,0,0,1122
16278,RM-1145,6/3/2014,0,0,1122,0,0,0,1122
18711,RM-1155,7/17/2013,561,0,561,0,0,0,1122
18986,RM-1155,4/30/2014,1122,0,0,0,0,0,1122
19020,RM-1155,6/3/2014,1122,0,0,0,0,0,1122
21000,RM-1200B,5/21/2014,0,1122,0,0,0,0,1122
22826,RM-1207,11/27/2013,0,0,0,0,0,1122,1122
22980,RM-1207,4/30/2014,1122,0,0,0,0,0,1122
23014,RM-1207,6/3/2014,1122,0,0,0,0,0,1122
24221,RM-1208B,12/19/2013,0,0,1122,0,0,0,1122
24884,RM-1212,11/27/2013,0,0,1122,0,0,0,1122
24906,RM-1212,12/19/2013,0,0,1122,0,0,0,1122
25038,RM-1212,4/30/2014,1122,0,0,0,0,0,1122
25072,RM-1212,6/3/2014,1122,0,0,0,0,0,1122
25554,RM-1213,11/27/2013,0,0,0,0,0,1122,1122
25576,RM-1213,12/19/2013,0,0,0,0,0,1122,1122
25588,RM-1213,12/31/2013,0,0,0,0,0,1122,1122
26393,RM-1213A,4/30/2014,0,0,1122,0,0,0,1122
26424,RM-1213A,5/31/2014,0,0,1122,0,0,0,1122
26427,RM-1213A,6/3/2014,0,0,1122,0,0,0,1122
26924,RM-1217,11/27/2013,1122,0,0,0,0,0,1122
26946,RM-1217,12/19/2013,1122,0,0,0,0,0,1122
28300,RM-1221,11/27/2013,0,0,1122,0,0,0,1122
28322,RM-1221,12/19/2013,0,0,1122,0,0,0,1122
28485,RM-1221,5/31/2014,0,0,1122,0,0,0,1122
28488,RM-1221,6/3/2014,0,0,1122,0,0,0,1122
29139,RM-1223,4/30/2014,1122,0,0,0,0,0,1122
29173,RM-1223,6/3/2014,1122,0,0,0,0,0,1122
31695,RM-1231,11/27/2013,0,0,0,0,0,1122,1122
31717,RM-1231,12/19/2013,0,0,0,0,0,1122,1122
31729,RM-1231,12/31/2013,0,0,0,0,0,1122,1122
32264,RM-1236,7/17/2013,561,0,561,0,0,0,1122
32385,RM-1236,11/27/2013,0,0,1122,0,0,0,1122
32407,RM-1236,12/19/2013,0,0,1122,0,0,0,1122
35013,RM-B103A,11/27/2013,0,0,0,0,0,1122,1122
35883,RM-B109,10/16/2014,561,0,561,0,0,0,1122
35885,RM-B109,10/18/2014,561,0,561,0,0,0,1122
36249,RM-B200B,11/27/2013,0,0,0,0,0,1122,1122
36271,RM-B200B,12/19/2013,0,0,0,0,0,1122,1122
36283,RM-B200B,12/31/2013,0,0,0,0,0,1122,1122
36809,RM-B200C,7/17/2013,0,0,561,0,0,561,1122
37118,RM-B200C,6/3/2014,1122,0,0,0,0,0,1122
38185,RM-B215,7/17/2013,561,0,0,0,0,561,1122
38460,RM-B215,4/30/2014,0,0,1122,0,0,0,1122
38491,RM-B215,5/31/2014,0,0,1122,0,0,0,1122
38494,RM-B215,6/3/2014,0,0,1122,0,0,0,1122
39013,RM-B220,12/19/2013,1122,0,0,0,0,0,1122
39145,RM-B220,4/30/2014,1122,0,0,0,0,0,1122
39179,RM-B220,6/3/2014,1122,0,0,0,0,0,1122
39679,RM-B222,11/27/2013,1122,0,0,0,0,0,1122
39701,RM-B222,12/19/2013,1122,0,0,0,0,0,1122
39833,RM-B222,4/30/2014,1122,0,0,0,0,0,1122
40246,RM-B224,7/17/2013,0,0,561,0,0,561,1122
40367,RM-B224,11/27/2013,0,0,0,0,0,1122,1122
40389,RM-B224,12/19/2013,0,0,0,0,0,1122,1122
40401,RM-B224,12/31/2013,0,0,0,0,0,1122,1122
41055,RM-B225,11/27/2013,0,0,0,0,0,1122,1122
41077,RM-B225,12/19/2013,0,0,0,0,0,1122,1122
41089,RM-B225,12/31/2013,0,0,0,0,0,1122,1122
41928,RM-B230,6/3/2014,1122,0,0,0,0,0,1122
42425,RM-B230A,11/27/2013,0,0,0,0,0,1122,1122
42447,RM-B230A,12/19/2013,0,0,0,0,0,1122,1122
42459,RM-B230A,12/31/2013,0,0,0,0,0,1122,1122
43145,RM-B240,4/30/2014,0,0,1122,0,0,0,1122
43176,RM-B240,5/31/2014,0,0,1122,0,0,0,1122
43179,RM-B240,6/3/2014,0,0,1122,0,0,0,1122
44165,RM-B250,7/17/2013,561,0,0,0,0,561,1122
45125,RM-B250A,4/30/2014,1122,0,0,0,0,0,1122
45158,RM-B250A,6/3/2014,1122,0,0,0,0,0,1122
45976,RM-B260,10/16/2014,561,0,561,0,0,0,1122
45978,RM-B260,10/18/2014,561,0,561,0,0,0,1122
47693,RM-B275,11/27/2013,0,0,0,0,0,1122,1122
47715,RM-B275,12/19/2013,0,0,0,0,0,1122,1122
47727,RM-B275,12/31/2013,0,0,0,0,0,1122,1122
12182,RM-1130,8/21/2013,0,0,0,0,0,1119,1119
15346,RM-1144,8/21/2013,0,0,0,0,0,1119,1119
18058,RM-1154,8/21/2013,1119,0,0,0,0,0,1119
20739,RM-1200B,8/21/2013,0,0,0,0,0,1119,1119
26838,RM-1217,8/21/2013,1119,0,0,0,0,0,1119
31609,RM-1231,8/21/2013,0,0,0,0,0,1119,1119
34927,RM-B103A,8/21/2013,0,0,0,0,0,1119,1119
40969,RM-B225,8/21/2013,0,0,0,0,0,1119,1119
42339,RM-B230A,8/21/2013,0,0,0,0,0,1119,1119
43590,RM-B240A,8/21/2013,0,0,0,0,0,1119,1119
44200,RM-B250,8/21/2013,1119,0,0,0,0,0,1119
3434,RM-1107,8/21/2013,0,0,1116,0,0,0,1116
4374,RM-1108,5/16/2014,0,1116,0,0,0,0,1116
5700,RM-1110,3/30/2014,0,0,1116,0,0,0,1116
6175,RM-1113,8/21/2013,0,0,1116,0,0,0,1116
7043,RM-1115,3/30/2014,1116,0,0,0,0,0,1116
7730,RM-1116,3/30/2014,1116,0,0,0,0,0,1116
8894,RM-1122,8/21/2013,0,0,1116,0,0,0,1116
9579,RM-1123,8/21/2013,0,0,1116,0,0,0,1116
12913,RM-1132,10/13/2013,0,0,1116,0,0,0,1116
13554,RM-1133,8/21/2013,0,0,1116,0,0,0,1116
14286,RM-1134,3/30/2014,1116,0,0,0,0,0,1116
18955,RM-1155,3/30/2014,1116,0,0,0,0,0,1116
19631,RM-1156,3/30/2014,1116,0,0,0,0,0,1116
20783,RM-1200B,10/13/2013,0,0,0,0,0,1116,1116
22784,RM-1207,10/13/2013,0,0,0,0,0,1116,1116
22949,RM-1207,3/30/2014,1116,0,0,0,0,0,1116
25468,RM-1213,8/21/2013,0,0,1116,0,0,0,1116
25512,RM-1213,10/13/2013,0,0,0,0,0,1116,1116
26876,RM-1217,10/7/2013,1116,0,0,0,0,0,1116
26882,RM-1217,10/13/2013,1116,0,0,0,0,0,1116
27047,RM-1217,3/30/2014,1116,0,0,0,0,0,1116
31653,RM-1231,10/13/2013,0,0,0,0,0,1116,1116
33711,RM-B102C,8/21/2013,0,0,1116,0,0,0,1116
35879,RM-B109,10/12/2014,558,0,558,0,0,0,1116
35880,RM-B109,10/13/2014,558,0,558,0,0,0,1116
35882,RM-B109,10/15/2014,558,0,558,0,0,0,1116
35886,RM-B109,10/19/2014,558,0,558,0,0,0,1116
36293,RM-B200B,1/10/2014,0,198,0,0,0,918,1116
39114,RM-B220,3/30/2014,1116,0,0,0,0,0,1116
39631,RM-B222,10/7/2013,1116,0,0,0,0,0,1116
39637,RM-B222,10/13/2013,1116,0,0,0,0,0,1116
45094,RM-B250A,3/30/2014,1116,0,0,0,0,0,1116
45972,RM-B260,10/12/2014,558,0,558,0,0,0,1116
45973,RM-B260,10/13/2014,558,0,558,0,0,0,1116
45975,RM-B260,10/15/2014,558,0,558,0,0,0,1116
45979,RM-B260,10/19/2014,558,0,558,0,0,0,1116
46939,RM-B270,8/21/2013,0,0,1116,0,0,0,1116
47737,RM-B275,1/10/2014,0,198,0,0,0,918,1116
2787,RM-1106,10/7/2013,0,0,0,0,0,1113,1113
2793,RM-1106,10/13/2013,0,0,0,0,0,1113,1113
4844,RM-1109,10/7/2013,0,0,0,0,0,1113,1113
4850,RM-1109,10/13/2013,0,0,0,0,0,1113,1113
6384,RM-1113,3/30/2014,0,0,1113,0,0,0,1113
9617,RM-1123,10/7/2013,0,0,1113,0,0,0,1113
9623,RM-1123,10/13/2013,0,0,1113,0,0,0,1113
9656,RM-1123,11/15/2013,0,0,1113,0,0,0,1113
12220,RM-1130,10/7/2013,0,0,0,0,0,1113,1113
12226,RM-1130,10/13/2013,0,0,0,0,0,1113,1113
12907,RM-1132,10/7/2013,0,0,1113,0,0,0,1113
13592,RM-1133,10/7/2013,0,0,1113,0,0,0,1113
13598,RM-1133,10/13/2013,0,0,1113,0,0,0,1113
13631,RM-1133,11/15/2013,0,0,1113,0,0,0,1113
13684,RM-1133,1/10/2014,0,198,915,0,0,0,1113
15384,RM-1144,10/7/2013,0,0,0,0,0,1113,1113
15390,RM-1144,10/13/2013,0,0,0,0,0,1113,1113
15555,RM-1144,3/30/2014,0,0,1113,0,0,0,1113
20777,RM-1200B,10/7/2013,0,0,0,0,0,1113,1113
22778,RM-1207,10/7/2013,0,0,0,0,0,1113,1113
24875,RM-1212,11/15/2013,0,0,1113,0,0,0,1113
26362,RM-1213A,3/30/2014,0,0,1113,0,0,0,1113
28291,RM-1221,11/15/2013,0,0,1113,0,0,0,1113
31647,RM-1231,10/7/2013,0,0,0,0,0,1113,1113
32508,RM-1236,3/30/2014,0,0,1113,0,0,0,1113
34965,RM-B103A,10/7/2013,0,0,0,0,0,1113,1113
34971,RM-B103A,10/13/2013,0,0,0,0,0,1113,1113
35685,RM-B109,3/30/2014,0,0,1113,0,0,0,1113
36201,RM-B200B,10/7/2013,0,0,0,0,0,1113,1113
36207,RM-B200B,10/13/2013,0,0,0,0,0,1113,1113
38429,RM-B215,3/30/2014,0,0,1113,0,0,0,1113
40319,RM-B224,10/7/2013,0,0,0,0,0,1113,1113
40325,RM-B224,10/13/2013,0,0,0,0,0,1113,1113
41007,RM-B225,10/7/2013,0,0,0,0,0,1113,1113
41013,RM-B225,10/13/2013,0,0,0,0,0,1113,1113
41784,RM-B230,1/10/2014,0,198,915,0,0,0,1113
42377,RM-B230A,10/7/2013,0,0,0,0,0,1113,1113
42383,RM-B230A,10/13/2013,0,0,0,0,0,1113,1113
43114,RM-B240,3/30/2014,0,0,1113,0,0,0,1113
46977,RM-B270,10/7/2013,0,0,1113,0,0,0,1113
46983,RM-B270,10/13/2013,0,0,1113,0,0,0,1113
2826,RM-1106,11/15/2013,0,0,0,0,0,1110,1110
2999,RM-1106,5/10/2014,0,0,0,1110,0,0,1110
4883,RM-1109,11/15/2013,0,0,0,0,0,1110,1110
10341,RM-1124,11/15/2013,0,0,0,0,0,1110,1110
12259,RM-1130,11/15/2013,0,0,0,0,0,1110,1110
12946,RM-1132,11/15/2013,0,0,1110,0,0,0,1110
15423,RM-1144,11/15/2013,0,0,0,0,0,1110,1110
16108,RM-1145,11/15/2013,0,0,0,0,0,1110,1110
22817,RM-1207,11/15/2013,0,0,0,0,0,1110,1110
24442,RM-1208B,7/28/2014,555,0,555,0,0,0,1110
25545,RM-1213,11/15/2013,0,0,0,0,0,1110,1110
26915,RM-1217,11/15/2013,1110,0,0,0,0,0,1110
26926,RM-1217,11/29/2013,1110,0,0,0,0,0,1110
26968,RM-1217,1/10/2014,918,0,0,192,0,0,1110
31686,RM-1231,11/15/2013,0,0,0,0,0,1110,1110
35004,RM-B103A,11/15/2013,0,0,0,0,0,1110,1110
35805,RM-B109,7/28/2014,555,0,555,0,0,0,1110
35874,RM-B109,10/7/2014,555,0,555,0,0,0,1110
35881,RM-B109,10/14/2014,555,0,555,0,0,0,1110
36240,RM-B200B,11/15/2013,0,0,0,0,0,1110,1110
39670,RM-B222,11/15/2013,1110,0,0,0,0,0,1110
39681,RM-B222,11/29/2013,1110,0,0,0,0,0,1110
40358,RM-B224,11/15/2013,0,0,0,0,0,1110,1110
41046,RM-B225,11/15/2013,0,0,0,0,0,1110,1110
42416,RM-B230A,11/15/2013,0,0,0,0,0,1110,1110
45967,RM-B260,10/7/2014,555,0,555,0,0,0,1110
45974,RM-B260,10/14/2014,555,0,555,0,0,0,1110
2837,RM-1106,11/29/2013,0,0,0,0,0,1107,1107
2862,RM-1106,12/24/2013,0,0,0,0,0,1107,1107
4894,RM-1109,11/29/2013,0,0,0,0,0,1107,1107
4919,RM-1109,12/24/2013,0,0,0,0,0,1107,1107
4974,RM-1109,2/17/2014,0,0,0,0,0,1107,1107
6288,RM-1113,12/24/2013,0,0,1107,0,0,0,1107
6343,RM-1113,2/17/2014,0,0,1107,0,0,0,1107
7689,RM-1116,2/17/2014,1107,0,0,0,0,0,1107
8982,RM-1122,11/29/2013,0,0,0,0,0,1107,1107
9007,RM-1122,12/24/2013,0,0,0,0,0,1107,1107
9062,RM-1122,2/17/2014,0,0,0,0,0,1107,1107
9667,RM-1123,11/29/2013,0,0,1107,0,0,0,1107
9692,RM-1123,12/24/2013,0,0,1107,0,0,0,1107
10352,RM-1124,11/29/2013,0,0,0,0,0,1107,1107
10377,RM-1124,12/24/2013,0,0,0,0,0,1107,1107
12270,RM-1130,11/29/2013,0,0,0,0,0,1107,1107
12295,RM-1130,12/24/2013,0,0,0,0,0,1107,1107
12948,RM-1132,11/20/2013,0,0,1107,0,0,0,1107
12957,RM-1132,11/29/2013,0,0,1107,0,0,0,1107
12982,RM-1132,12/24/2013,0,0,1107,0,0,0,1107
13642,RM-1133,11/29/2013,0,0,1107,0,0,0,1107
13667,RM-1133,12/24/2013,0,0,1107,0,0,0,1107
15514,RM-1144,2/17/2014,0,0,1107,0,0,0,1107
16119,RM-1145,11/29/2013,0,0,0,0,0,1107,1107
16144,RM-1145,12/24/2013,0,0,0,0,0,1107,1107
16199,RM-1145,2/17/2014,0,0,0,0,0,1107,1107
22828,RM-1207,11/29/2013,0,0,0,0,0,1107,1107
24226,RM-1208B,12/24/2013,0,0,1107,0,0,0,1107
24886,RM-1212,11/29/2013,0,0,1107,0,0,0,1107
24911,RM-1212,12/24/2013,0,0,1107,0,0,0,1107
25556,RM-1213,11/29/2013,0,0,0,0,0,1107,1107
25636,RM-1213,2/17/2014,0,0,0,0,0,1107,1107
26321,RM-1213A,2/17/2014,0,0,1107,0,0,0,1107
26966,RM-1217,1/8/2014,963,0,0,144,0,0,1107
27006,RM-1217,2/17/2014,1107,0,0,0,0,0,1107
28302,RM-1221,11/29/2013,0,0,1107,0,0,0,1107
28382,RM-1221,2/17/2014,0,0,0,0,0,1107,1107
31697,RM-1231,11/29/2013,0,0,0,0,0,1107,1107
31777,RM-1231,2/17/2014,0,0,0,0,0,1107,1107
32387,RM-1236,11/29/2013,0,0,1107,0,0,0,1107
32412,RM-1236,12/24/2013,0,0,1107,0,0,0,1107
32467,RM-1236,2/17/2014,0,0,1107,0,0,0,1107
35644,RM-B109,2/17/2014,0,0,1107,0,0,0,1107
36251,RM-B200B,11/29/2013,0,0,0,0,0,1107,1107
36276,RM-B200B,12/24/2013,0,0,0,0,0,1107,1107
38388,RM-B215,2/17/2014,0,0,1107,0,0,0,1107
39073,RM-B220,2/17/2014,1107,0,0,0,0,0,1107
40369,RM-B224,11/29/2013,0,0,0,0,0,1107,1107
40394,RM-B224,12/24/2013,0,0,0,0,0,1107,1107
40449,RM-B224,2/17/2014,0,0,0,0,0,1107,1107
41057,RM-B225,11/29/2013,0,0,0,0,0,1107,1107
41082,RM-B225,12/24/2013,0,0,0,0,0,1107,1107
42427,RM-B230A,11/29/2013,0,0,0,0,0,1107,1107
42452,RM-B230A,12/24/2013,0,0,0,0,0,1107,1107
42507,RM-B230A,2/17/2014,0,0,0,0,0,1107,1107
43073,RM-B240,2/17/2014,0,0,1107,0,0,0,1107
44368,RM-B250,2/17/2014,0,0,1107,0,0,0,1107
45053,RM-B250A,2/17/2014,1107,0,0,0,0,0,1107
47695,RM-B275,11/29/2013,0,0,0,0,0,1107,1107
47720,RM-B275,12/24/2013,0,0,0,0,0,1107,1107
47775,RM-B275,2/17/2014,0,0,0,0,0,1107,1107
2360,RM-1104,5/12/2014,0,1104,0,0,0,0,1104
2828,RM-1106,11/20/2013,0,0,0,0,0,1104,1104
2870,RM-1106,1/1/2014,0,0,0,0,0,1104,1104
2998,RM-1106,5/9/2014,0,0,0,1104,0,0,1104
4885,RM-1109,11/20/2013,0,0,0,0,0,1104,1104
4927,RM-1109,1/1/2014,0,0,0,0,0,1104,1104
6296,RM-1113,1/1/2014,0,0,1104,0,0,0,1104
9015,RM-1122,1/1/2014,0,0,0,0,0,1104,1104
9658,RM-1123,11/20/2013,0,0,1104,0,0,0,1104
9659,RM-1123,11/21/2013,0,0,1104,0,0,0,1104
9684,RM-1123,12/16/2013,0,0,1104,0,0,0,1104
9700,RM-1123,1/1/2014,0,0,1104,0,0,0,1104
10343,RM-1124,11/20/2013,0,0,0,0,0,1104,1104
10385,RM-1124,1/1/2014,0,0,0,0,0,1104,1104
12261,RM-1130,11/20/2013,0,0,0,0,0,1104,1104
12974,RM-1132,12/16/2013,0,0,1104,0,0,0,1104
12990,RM-1132,1/1/2014,0,0,1104,0,0,0,1104
13633,RM-1133,11/20/2013,0,0,1104,0,0,0,1104
13634,RM-1133,11/21/2013,0,0,1104,0,0,0,1104
13659,RM-1133,12/16/2013,0,0,1104,0,0,0,1104
13675,RM-1133,1/1/2014,0,0,1104,0,0,0,1104
16110,RM-1145,11/20/2013,0,0,0,0,0,1104,1104
16152,RM-1145,1/1/2014,0,0,0,0,0,1104,1104
19543,RM-1156,1/1/2014,1104,0,0,0,0,0,1104
22819,RM-1207,11/20/2013,0,0,0,0,0,1104,1104
24218,RM-1208B,12/16/2013,0,0,1104,0,0,0,1104
24234,RM-1208B,1/1/2014,0,0,1104,0,0,0,1104
24877,RM-1212,11/20/2013,0,0,1104,0,0,0,1104
24878,RM-1212,11/21/2013,0,0,1104,0,0,0,1104
24903,RM-1212,12/16/2013,0,0,1104,0,0,0,1104
25547,RM-1213,11/20/2013,0,0,0,0,0,1104,1104
25581,RM-1213,12/24/2013,0,0,0,0,0,1104,1104
25589,RM-1213,1/1/2014,0,0,0,0,0,1104,1104
26917,RM-1217,11/20/2013,1104,0,0,0,0,0,1104
26943,RM-1217,12/16/2013,1104,0,0,0,0,0,1104
26951,RM-1217,12/24/2013,1104,0,0,0,0,0,1104
26959,RM-1217,1/1/2014,1104,0,0,0,0,0,1104
28293,RM-1221,11/20/2013,0,0,1104,0,0,0,1104
28294,RM-1221,11/21/2013,0,0,1104,0,0,0,1104
28319,RM-1221,12/16/2013,0,0,1104,0,0,0,1104
31688,RM-1231,11/20/2013,0,0,0,0,0,1104,1104
31722,RM-1231,12/24/2013,0,0,0,0,0,1104,1104
31730,RM-1231,1/1/2014,0,0,0,0,0,1104,1104
32378,RM-1236,11/20/2013,0,0,1104,0,0,0,1104
32379,RM-1236,11/21/2013,0,0,1104,0,0,0,1104
32404,RM-1236,12/16/2013,0,0,1104,0,0,0,1104
32420,RM-1236,1/1/2014,0,0,1104,0,0,0,1104
35006,RM-B103A,11/20/2013,0,0,0,0,0,1104,1104
35872,RM-B109,10/5/2014,552,0,552,0,0,0,1104
35873,RM-B109,10/6/2014,552,0,552,0,0,0,1104
35875,RM-B109,10/8/2014,552,0,552,0,0,0,1104
36242,RM-B200B,11/20/2013,0,0,0,0,0,1104,1104
36284,RM-B200B,1/1/2014,0,0,0,0,0,1104,1104
39010,RM-B220,12/16/2013,1104,0,0,0,0,0,1104
39018,RM-B220,12/24/2013,1104,0,0,0,0,0,1104
39026,RM-B220,1/1/2014,1104,0,0,0,0,0,1104
39672,RM-B222,11/20/2013,1104,0,0,0,0,0,1104
39698,RM-B222,12/16/2013,1104,0,0,0,0,0,1104
39706,RM-B222,12/24/2013,1104,0,0,0,0,0,1104
39714,RM-B222,1/1/2014,1104,0,0,0,0,0,1104
40360,RM-B224,11/20/2013,0,0,0,0,0,1104,1104
40402,RM-B224,1/1/2014,0,0,0,0,0,1104,1104
41048,RM-B225,11/20/2013,0,0,0,0,0,1104,1104
41090,RM-B225,1/1/2014,0,0,0,0,0,1104,1104
41775,RM-B230,1/1/2014,0,0,1104,0,0,0,1104
42418,RM-B230A,11/20/2013,0,0,0,0,0,1104,1104
42460,RM-B230A,1/1/2014,0,0,0,0,0,1104,1104
45965,RM-B260,10/5/2014,552,0,552,0,0,0,1104
45966,RM-B260,10/6/2014,552,0,552,0,0,0,1104
45968,RM-B260,10/8/2014,552,0,552,0,0,0,1104
47728,RM-B275,1/1/2014,0,0,0,0,0,1104,1104
2829,RM-1106,11/21/2013,0,0,0,0,0,1101,1101
2854,RM-1106,12/16/2013,0,0,0,0,0,1101,1101
4886,RM-1109,11/21/2013,0,0,0,0,0,1101,1101
4911,RM-1109,12/16/2013,0,0,0,0,0,1101,1101
8999,RM-1122,12/16/2013,0,0,0,0,0,1101,1101
9648,RM-1123,11/7/2013,0,0,1101,0,0,0,1101
10344,RM-1124,11/21/2013,0,0,0,0,0,1101,1101
10369,RM-1124,12/16/2013,0,0,0,0,0,1101,1101
12262,RM-1130,11/21/2013,0,0,0,0,0,1101,1101
12287,RM-1130,12/16/2013,0,0,0,0,0,1101,1101
12938,RM-1132,11/7/2013,0,0,1101,0,0,0,1101
12949,RM-1132,11/21/2013,0,0,1101,0,0,0,1101
13623,RM-1133,11/7/2013,0,0,1101,0,0,0,1101
16111,RM-1145,11/21/2013,0,0,0,0,0,1101,1101
16136,RM-1145,12/16/2013,0,0,0,0,0,1101,1101
20808,RM-1200B,11/7/2013,0,0,0,0,0,1101,1101
22820,RM-1207,11/21/2013,0,0,0,0,0,1101,1101
25548,RM-1213,11/21/2013,0,0,0,0,0,1101,1101
25573,RM-1213,12/16/2013,0,0,0,0,0,1101,1101
26918,RM-1217,11/21/2013,1101,0,0,0,0,0,1101
28283,RM-1221,11/7/2013,0,0,1101,0,0,0,1101
31689,RM-1231,11/21/2013,0,0,0,0,0,1101,1101
31714,RM-1231,12/16/2013,0,0,0,0,0,1101,1101
35007,RM-B103A,11/21/2013,0,0,0,0,0,1101,1101
36243,RM-B200B,11/21/2013,0,0,0,0,0,1101,1101
36268,RM-B200B,12/16/2013,0,0,0,0,0,1101,1101
39673,RM-B222,11/21/2013,1101,0,0,0,0,0,1101
40361,RM-B224,11/21/2013,0,0,0,0,0,1101,1101
40386,RM-B224,12/16/2013,0,0,0,0,0,1101,1101
41049,RM-B225,11/21/2013,0,0,0,0,0,1101,1101
41074,RM-B225,12/16/2013,0,0,0,0,0,1101,1101
42419,RM-B230A,11/21/2013,0,0,0,0,0,1101,1101
42444,RM-B230A,12/16/2013,0,0,0,0,0,1101,1101
47008,RM-B270,11/7/2013,0,0,1101,0,0,0,1101
47712,RM-B275,12/16/2013,0,0,0,0,0,1101,1101
2361,RM-1104,5/13/2014,0,1098,0,0,0,0,1098
2801,RM-1106,10/21/2013,0,0,0,0,0,1098,1098
2818,RM-1106,11/7/2013,0,0,0,0,0,1098,1098
4858,RM-1109,10/21/2013,0,0,0,0,0,1098,1098
4875,RM-1109,11/7/2013,0,0,0,0,0,1098,1098
10316,RM-1124,10/21/2013,0,0,0,0,0,1098,1098
10333,RM-1124,11/7/2013,0,0,0,0,0,1098,1098
12234,RM-1130,10/21/2013,0,0,0,0,0,1098,1098
12251,RM-1130,11/7/2013,0,0,0,0,0,1098,1098
15398,RM-1144,10/21/2013,0,0,0,0,0,1098,1098
15415,RM-1144,11/7/2013,0,0,0,0,0,1098,1098
16083,RM-1145,10/21/2013,0,0,0,0,0,1098,1098
16100,RM-1145,11/7/2013,0,0,0,0,0,1098,1098
22792,RM-1207,10/21/2013,0,0,0,0,0,1098,1098
22809,RM-1207,11/7/2013,0,0,0,0,0,1098,1098
25520,RM-1213,10/21/2013,0,0,0,0,0,1098,1098
25537,RM-1213,11/7/2013,0,0,0,0,0,1098,1098
26890,RM-1217,10/21/2013,1098,0,0,0,0,0,1098
26907,RM-1217,11/7/2013,1098,0,0,0,0,0,1098
31661,RM-1231,10/21/2013,0,0,0,0,0,1098,1098
31678,RM-1231,11/7/2013,0,0,0,0,0,1098,1098
34979,RM-B103A,10/21/2013,0,0,0,0,0,1098,1098
34996,RM-B103A,11/7/2013,0,0,0,0,0,1098,1098
35871,RM-B109,10/4/2014,549,0,549,0,0,0,1098
35876,RM-B109,10/9/2014,549,0,549,0,0,0,1098
36215,RM-B200B,10/21/2013,0,0,0,0,0,1098,1098
36232,RM-B200B,11/7/2013,0,0,0,0,0,1098,1098
38439,RM-B215,4/9/2014,87,0,1011,0,0,0,1098
39645,RM-B222,10/21/2013,1098,0,0,0,0,0,1098
39662,RM-B222,11/7/2013,1098,0,0,0,0,0,1098
40333,RM-B224,10/21/2013,0,0,0,0,0,1098,1098
40350,RM-B224,11/7/2013,0,0,0,0,0,1098,1098
41021,RM-B225,10/21/2013,0,0,0,0,0,1098,1098
41038,RM-B225,11/7/2013,0,0,0,0,0,1098,1098
42391,RM-B230A,10/21/2013,0,0,0,0,0,1098,1098
42408,RM-B230A,11/7/2013,0,0,0,0,0,1098,1098
45964,RM-B260,10/4/2014,549,0,549,0,0,0,1098
45969,RM-B260,10/9/2014,549,0,549,0,0,0,1098
294,RM-1100A,5/1/2014,1095,0,0,0,0,0,1095
1664,RM-1102,5/1/2014,1095,0,0,0,0,0,1095
2820,RM-1106,11/9/2013,0,0,0,0,0,1095,1095
2821,RM-1106,11/10/2013,0,0,0,0,0,1095,1095
4877,RM-1109,11/9/2013,0,0,0,0,0,1095,1095
4878,RM-1109,11/10/2013,0,0,0,0,0,1095,1095
5732,RM-1110,5/1/2014,0,0,1095,0,0,0,1095
6416,RM-1113,5/1/2014,0,0,1095,0,0,0,1095
7075,RM-1115,5/1/2014,1095,0,0,0,0,0,1095
7762,RM-1116,5/1/2014,1095,0,0,0,0,0,1095
9631,RM-1123,10/21/2013,0,0,1095,0,0,0,1095
9650,RM-1123,11/9/2013,0,0,1095,0,0,0,1095
10335,RM-1124,11/9/2013,0,0,0,0,0,1095,1095
10336,RM-1124,11/10/2013,0,0,0,0,0,1095,1095
12253,RM-1130,11/9/2013,0,0,0,0,0,1095,1095
12254,RM-1130,11/10/2013,0,0,0,0,0,1095,1095
12921,RM-1132,10/21/2013,0,0,1095,0,0,0,1095
12940,RM-1132,11/9/2013,0,0,1095,0,0,0,1095
12941,RM-1132,11/10/2013,0,0,1095,0,0,0,1095
13606,RM-1133,10/21/2013,0,0,1095,0,0,0,1095
13625,RM-1133,11/9/2013,0,0,1095,0,0,0,1095
14318,RM-1134,5/1/2014,1095,0,0,0,0,0,1095
15417,RM-1144,11/9/2013,0,0,0,0,0,1095,1095
15418,RM-1144,11/10/2013,0,0,0,0,0,1095,1095
15587,RM-1144,5/1/2014,0,0,1095,0,0,0,1095
16102,RM-1145,11/9/2013,0,0,0,0,0,1095,1095
16103,RM-1145,11/10/2013,0,0,0,0,0,1095,1095
16245,RM-1145,5/1/2014,0,0,1095,0,0,0,1095
18987,RM-1155,5/1/2014,1095,0,0,0,0,0,1095
20791,RM-1200B,10/21/2013,0,0,0,0,0,1095,1095
20810,RM-1200B,11/9/2013,0,0,0,0,0,1095,1095
22811,RM-1207,11/9/2013,0,0,0,0,0,1095,1095
22812,RM-1207,11/10/2013,0,0,0,0,0,1095,1095
22981,RM-1207,5/1/2014,1095,0,0,0,0,0,1095
25039,RM-1212,5/1/2014,1095,0,0,0,0,0,1095
25539,RM-1213,11/9/2013,0,0,0,0,0,1095,1095
25540,RM-1213,11/10/2013,0,0,0,0,0,1095,1095
26394,RM-1213A,5/1/2014,0,0,1095,0,0,0,1095
26909,RM-1217,11/9/2013,1095,0,0,0,0,0,1095
26910,RM-1217,11/10/2013,1095,0,0,0,0,0,1095
28266,RM-1221,10/21/2013,0,0,1095,0,0,0,1095
28285,RM-1221,11/9/2013,0,0,1095,0,0,0,1095
29140,RM-1223,5/1/2014,1095,0,0,0,0,0,1095
31680,RM-1231,11/9/2013,0,0,0,0,0,1095,1095
31681,RM-1231,11/10/2013,0,0,0,0,0,1095,1095
34998,RM-B103A,11/9/2013,0,0,0,0,0,1095,1095
34999,RM-B103A,11/10/2013,0,0,0,0,0,1095,1095
36234,RM-B200B,11/9/2013,0,0,0,0,0,1095,1095
36235,RM-B200B,11/10/2013,0,0,0,0,0,1095,1095
39146,RM-B220,5/1/2014,1095,0,0,0,0,0,1095
39664,RM-B222,11/9/2013,1095,0,0,0,0,0,1095
39665,RM-B222,11/10/2013,1095,0,0,0,0,0,1095
39834,RM-B222,5/1/2014,1095,0,0,0,0,0,1095
40352,RM-B224,11/9/2013,0,0,0,0,0,1095,1095
40353,RM-B224,11/10/2013,0,0,0,0,0,1095,1095
41040,RM-B225,11/9/2013,0,0,0,0,0,1095,1095
41041,RM-B225,11/10/2013,0,0,0,0,0,1095,1095
42410,RM-B230A,11/9/2013,0,0,0,0,0,1095,1095
42411,RM-B230A,11/10/2013,0,0,0,0,0,1095,1095
43146,RM-B240,5/1/2014,0,0,1095,0,0,0,1095
45126,RM-B250A,5/1/2014,1095,0,0,0,0,0,1095
46991,RM-B270,10/21/2013,0,0,1095,0,0,0,1095
47010,RM-B270,11/9/2013,0,0,1095,0,0,0,1095
5011,RM-1109,3/26/2014,0,0,0,0,0,1092,1092
6289,RM-1113,12/25/2013,0,0,1092,0,0,0,1092
6380,RM-1113,3/26/2014,0,0,1092,0,0,0,1092
7726,RM-1116,3/26/2014,1092,0,0,0,0,0,1092
9099,RM-1122,3/26/2014,0,0,0,0,0,1092,1092
9651,RM-1123,11/10/2013,0,0,1092,0,0,0,1092
9693,RM-1123,12/25/2013,0,0,1092,0,0,0,1092
12983,RM-1132,12/25/2013,0,0,1092,0,0,0,1092
13626,RM-1133,11/10/2013,0,0,1092,0,0,0,1092
13668,RM-1133,12/25/2013,0,0,1092,0,0,0,1092
14282,RM-1134,3/26/2014,1092,0,0,0,0,0,1092
15551,RM-1144,3/26/2014,0,0,1092,0,0,0,1092
24227,RM-1208B,12/25/2013,0,0,1092,0,0,0,1092
24870,RM-1212,11/10/2013,0,0,1092,0,0,0,1092
24912,RM-1212,12/25/2013,0,0,1092,0,0,0,1092
25582,RM-1213,12/25/2013,0,0,0,0,0,1092,1092
26358,RM-1213A,3/26/2014,0,0,1092,0,0,0,1092
26952,RM-1217,12/25/2013,1092,0,0,0,0,0,1092
27043,RM-1217,3/26/2014,1092,0,0,0,0,0,1092
28286,RM-1221,11/10/2013,0,0,1092,0,0,0,1092
31723,RM-1231,12/25/2013,0,0,0,0,0,1092,1092
32413,RM-1236,12/25/2013,0,0,1092,0,0,0,1092
32504,RM-1236,3/26/2014,0,0,1092,0,0,0,1092
35681,RM-B109,3/26/2014,0,0,1092,0,0,0,1092
35877,RM-B109,10/10/2014,546,0,546,0,0,0,1092
35878,RM-B109,10/11/2014,546,0,546,0,0,0,1092
38425,RM-B215,3/26/2014,0,0,1092,0,0,0,1092
39019,RM-B220,12/25/2013,1092,0,0,0,0,0,1092
39110,RM-B220,3/26/2014,1092,0,0,0,0,0,1092
39707,RM-B222,12/25/2013,1092,0,0,0,0,0,1092
40486,RM-B224,3/26/2014,0,0,0,0,0,1092,1092
41768,RM-B230,12/25/2013,0,0,1092,0,0,0,1092
42544,RM-B230A,3/26/2014,0,0,0,0,0,1092,1092
43110,RM-B240,3/26/2014,0,0,1092,0,0,0,1092
45090,RM-B250A,3/26/2014,1092,0,0,0,0,0,1092
45970,RM-B260,10/10/2014,546,0,546,0,0,0,1092
45971,RM-B260,10/11/2014,546,0,546,0,0,0,1092
47011,RM-B270,11/10/2013,0,0,1092,0,0,0,1092
47812,RM-B275,3/26/2014,0,0,0,0,0,1092,1092
2863,RM-1106,12/25/2013,0,0,0,0,0,1089,1089
4920,RM-1109,12/25/2013,0,0,0,0,0,1089,1089
6391,RM-1113,4/6/2014,0,0,1089,0,0,0,1089
9008,RM-1122,12/25/2013,0,0,0,0,0,1089,1089
10378,RM-1124,12/25/2013,0,0,0,0,0,1089,1089
12296,RM-1130,12/25/2013,0,0,0,0,0,1089,1089
15562,RM-1144,4/6/2014,0,0,1089,0,0,0,1089
16145,RM-1145,12/25/2013,0,0,0,0,0,1089,1089
16236,RM-1145,3/26/2014,0,0,0,0,0,1089,1089
25673,RM-1213,3/26/2014,0,0,0,0,0,1089,1089
26369,RM-1213A,4/6/2014,0,0,1089,0,0,0,1089
28419,RM-1221,3/26/2014,0,0,0,0,0,1089,1089
31814,RM-1231,3/26/2014,0,0,0,0,0,1089,1089
32515,RM-1236,4/6/2014,0,0,1089,0,0,0,1089
35692,RM-B109,4/6/2014,0,0,1089,0,0,0,1089
36277,RM-B200B,12/25/2013,0,0,0,0,0,1089,1089
38436,RM-B215,4/6/2014,0,0,1089,0,0,0,1089
40395,RM-B224,12/25/2013,0,0,0,0,0,1089,1089
41083,RM-B225,12/25/2013,0,0,0,0,0,1089,1089
42453,RM-B230A,12/25/2013,0,0,0,0,0,1089,1089
43121,RM-B240,4/6/2014,0,0,1089,0,0,0,1089
47721,RM-B275,12/25/2013,0,0,0,0,0,1089,1089
2357,RM-1104,5/9/2014,0,1086,0,0,0,0,1086
2871,RM-1106,1/2/2014,0,0,0,0,0,1086,1086
4368,RM-1108,5/10/2014,0,1086,0,0,0,0,1086
4928,RM-1109,1/2/2014,0,0,0,0,0,1086,1086
5707,RM-1110,4/6/2014,0,0,1086,0,0,0,1086
6297,RM-1113,1/2/2014,0,0,1086,0,0,0,1086
7050,RM-1115,4/6/2014,1086,0,0,0,0,0,1086
7737,RM-1116,4/6/2014,1086,0,0,0,0,0,1086
9016,RM-1122,1/2/2014,0,0,0,0,0,1086,1086
9668,RM-1123,11/30/2013,0,0,1086,0,0,0,1086
9701,RM-1123,1/2/2014,0,0,1086,0,0,0,1086
10386,RM-1124,1/2/2014,0,0,0,0,0,1086,1086
12958,RM-1132,11/30/2013,0,0,1086,0,0,0,1086
12991,RM-1132,1/2/2014,0,0,1086,0,0,0,1086
13643,RM-1133,11/30/2013,0,0,1086,0,0,0,1086
13676,RM-1133,1/2/2014,0,0,1086,0,0,0,1086
14293,RM-1134,4/6/2014,1086,0,0,0,0,0,1086
16153,RM-1145,1/2/2014,0,0,0,0,0,1086,1086
18962,RM-1155,4/6/2014,1086,0,0,0,0,0,1086
19544,RM-1156,1/2/2014,1086,0,0,0,0,0,1086
19638,RM-1156,4/6/2014,1086,0,0,0,0,0,1086
22956,RM-1207,4/6/2014,1086,0,0,0,0,0,1086
24235,RM-1208B,1/2/2014,0,0,1086,0,0,0,1086
24428,RM-1208B,7/14/2014,543,0,543,0,0,0,1086
24434,RM-1208B,7/20/2014,543,0,543,0,0,0,1086
24887,RM-1212,11/30/2013,0,0,1086,0,0,0,1086
25590,RM-1213,1/2/2014,0,0,0,0,0,1086,1086
26960,RM-1217,1/2/2014,1086,0,0,0,0,0,1086
27054,RM-1217,4/6/2014,1086,0,0,0,0,0,1086
28303,RM-1221,11/30/2013,0,0,1086,0,0,0,1086
31731,RM-1231,1/2/2014,0,0,0,0,0,1086,1086
32388,RM-1236,11/30/2013,0,0,1086,0,0,0,1086
32421,RM-1236,1/2/2014,0,0,1086,0,0,0,1086
35791,RM-B109,7/14/2014,543,0,543,0,0,0,1086
35796,RM-B109,7/19/2014,543,0,543,0,0,0,1086
36285,RM-B200B,1/2/2014,0,0,0,0,0,1086,1086
39027,RM-B220,1/2/2014,1086,0,0,0,0,0,1086
39121,RM-B220,4/6/2014,1086,0,0,0,0,0,1086
39715,RM-B222,1/2/2014,1086,0,0,0,0,0,1086
40403,RM-B224,1/2/2014,0,0,0,0,0,1086,1086
41091,RM-B225,1/2/2014,0,0,0,0,0,1086,1086
41776,RM-B230,1/2/2014,0,0,1086,0,0,0,1086
42461,RM-B230A,1/2/2014,0,0,0,0,0,1086,1086
47729,RM-B275,1/2/2014,0,0,0,0,0,1086,1086
2794,RM-1106,10/14/2013,0,0,0,0,0,1083,1083
2838,RM-1106,11/30/2013,0,0,0,0,0,1083,1083
4851,RM-1109,10/14/2013,0,0,0,0,0,1083,1083
4895,RM-1109,11/30/2013,0,0,0,0,0,1083,1083
5762,RM-1110,6/1/2014,0,0,1083,0,0,0,1083
6337,RM-1113,2/11/2014,0,0,1083,0,0,0,1083
6447,RM-1113,6/1/2014,0,0,1083,0,0,0,1083
6448,RM-1113,6/2/2014,0,0,1083,0,0,0,1083
7793,RM-1116,6/1/2014,1083,0,0,0,0,0,1083
8983,RM-1122,11/30/2013,0,0,0,0,0,1083,1083
9624,RM-1123,10/14/2013,0,0,1083,0,0,0,1083
10353,RM-1124,11/30/2013,0,0,0,0,0,1083,1083
12227,RM-1130,10/14/2013,0,0,0,0,0,1083,1083
12271,RM-1130,11/30/2013,0,0,0,0,0,1083,1083
12914,RM-1132,10/14/2013,0,0,1083,0,0,0,1083
13599,RM-1133,10/14/2013,0,0,1083,0,0,0,1083
14348,RM-1134,6/1/2014,1083,0,0,0,0,0,1083
15391,RM-1144,10/14/2013,0,0,0,0,0,1083,1083
15508,RM-1144,2/11/2014,0,0,1083,0,0,0,1083
15618,RM-1144,6/1/2014,0,0,1083,0,0,0,1083
15619,RM-1144,6/2/2014,0,0,1083,0,0,0,1083
16076,RM-1145,10/14/2013,0,0,0,0,0,1083,1083
16120,RM-1145,11/30/2013,0,0,0,0,0,1083,1083
16276,RM-1145,6/1/2014,0,0,1083,0,0,0,1083
16277,RM-1145,6/2/2014,0,0,1083,0,0,0,1083
19018,RM-1155,6/1/2014,1083,0,0,0,0,0,1083
20784,RM-1200B,10/14/2013,0,0,0,0,0,1083,1083
22785,RM-1207,10/14/2013,0,0,0,0,0,1083,1083
22829,RM-1207,11/30/2013,0,0,0,0,0,1083,1083
23012,RM-1207,6/1/2014,1083,0,0,0,0,0,1083
25070,RM-1212,6/1/2014,1083,0,0,0,0,0,1083
25513,RM-1213,10/14/2013,0,0,0,0,0,1083,1083
25557,RM-1213,11/30/2013,0,0,0,0,0,1083,1083
26315,RM-1213A,2/11/2014,0,0,1083,0,0,0,1083
26425,RM-1213A,6/1/2014,0,0,1083,0,0,0,1083
26426,RM-1213A,6/2/2014,0,0,1083,0,0,0,1083
26883,RM-1217,10/14/2013,1083,0,0,0,0,0,1083
26927,RM-1217,11/30/2013,1083,0,0,0,0,0,1083
28259,RM-1221,10/14/2013,0,0,1083,0,0,0,1083
28486,RM-1221,6/1/2014,0,0,1083,0,0,0,1083
28487,RM-1221,6/2/2014,0,0,1083,0,0,0,1083
29171,RM-1223,6/1/2014,1083,0,0,0,0,0,1083
31654,RM-1231,10/14/2013,0,0,0,0,0,1083,1083
31698,RM-1231,11/30/2013,0,0,0,0,0,1083,1083
32461,RM-1236,2/11/2014,0,0,1083,0,0,0,1083
34972,RM-B103A,10/14/2013,0,0,0,0,0,1083,1083
36208,RM-B200B,10/14/2013,0,0,0,0,0,1083,1083
36252,RM-B200B,11/30/2013,0,0,0,0,0,1083,1083
37116,RM-B200C,6/1/2014,1083,0,0,0,0,0,1083
38382,RM-B215,2/11/2014,0,0,1083,0,0,0,1083
38492,RM-B215,6/1/2014,0,0,1083,0,0,0,1083
38493,RM-B215,6/2/2014,0,0,1083,0,0,0,1083
39177,RM-B220,6/1/2014,1083,0,0,0,0,0,1083
39638,RM-B222,10/14/2013,1083,0,0,0,0,0,1083
39682,RM-B222,11/30/2013,1083,0,0,0,0,0,1083
40326,RM-B224,10/14/2013,0,0,0,0,0,1083,1083
40370,RM-B224,11/30/2013,0,0,0,0,0,1083,1083
41014,RM-B225,10/14/2013,0,0,0,0,0,1083,1083
41058,RM-B225,11/30/2013,0,0,0,0,0,1083,1083
41926,RM-B230,6/1/2014,1083,0,0,0,0,0,1083
42384,RM-B230A,10/14/2013,0,0,0,0,0,1083,1083
42428,RM-B230A,11/30/2013,0,0,0,0,0,1083,1083
43177,RM-B240,6/1/2014,0,0,1083,0,0,0,1083
43178,RM-B240,6/2/2014,0,0,1083,0,0,0,1083
44362,RM-B250,2/11/2014,0,0,1083,0,0,0,1083
45156,RM-B250A,6/1/2014,1083,0,0,0,0,0,1083
46984,RM-B270,10/14/2013,0,0,1083,0,0,0,1083
47696,RM-B275,11/30/2013,0,0,0,0,0,1083,1083
3001,RM-1106,5/12/2014,0,0,0,1080,0,0,1080
5763,RM-1110,6/2/2014,0,0,1080,0,0,0,1080
6381,RM-1113,3/27/2014,0,0,1080,0,0,0,1080
7727,RM-1116,3/27/2014,1080,0,0,0,0,0,1080
7794,RM-1116,6/2/2014,1080,0,0,0,0,0,1080
14283,RM-1134,3/27/2014,1080,0,0,0,0,0,1080
14349,RM-1134,6/2/2014,1080,0,0,0,0,0,1080
15552,RM-1144,3/27/2014,0,0,1080,0,0,0,1080
16237,RM-1145,3/27/2014,0,0,0,0,0,1080,1080
19019,RM-1155,6/2/2014,1080,0,0,0,0,0,1080
23013,RM-1207,6/2/2014,1080,0,0,0,0,0,1080
24426,RM-1208B,7/12/2014,540,0,540,0,0,0,1080
24432,RM-1208B,7/18/2014,540,0,540,0,0,0,1080
24433,RM-1208B,7/19/2014,540,0,540,0,0,0,1080
24438,RM-1208B,7/24/2014,540,0,540,0,0,0,1080
25071,RM-1212,6/2/2014,1080,0,0,0,0,0,1080
25674,RM-1213,3/27/2014,0,0,0,0,0,1080,1080
26359,RM-1213A,3/27/2014,0,0,1080,0,0,0,1080
27044,RM-1217,3/27/2014,1080,0,0,0,0,0,1080
28420,RM-1221,3/27/2014,0,0,0,0,0,1080,1080
29172,RM-1223,6/2/2014,1080,0,0,0,0,0,1080
31815,RM-1231,3/27/2014,0,0,0,0,0,1080,1080
32505,RM-1236,3/27/2014,0,0,1080,0,0,0,1080
35682,RM-B109,3/27/2014,0,0,1080,0,0,0,1080
35789,RM-B109,7/12/2014,540,0,540,0,0,0,1080
35795,RM-B109,7/18/2014,540,0,540,0,0,0,1080
35797,RM-B109,7/20/2014,540,0,540,0,0,0,1080
35798,RM-B109,7/21/2014,540,0,540,0,0,0,1080
35801,RM-B109,7/24/2014,540,0,540,0,0,0,1080
37117,RM-B200C,6/2/2014,1080,0,0,0,0,0,1080
38426,RM-B215,3/27/2014,0,0,1080,0,0,0,1080
39111,RM-B220,3/27/2014,1080,0,0,0,0,0,1080
39178,RM-B220,6/2/2014,1080,0,0,0,0,0,1080
41927,RM-B230,6/2/2014,1080,0,0,0,0,0,1080
43111,RM-B240,3/27/2014,0,0,1080,0,0,0,1080
45091,RM-B250A,3/27/2014,1080,0,0,0,0,0,1080
45157,RM-B250A,6/2/2014,1080,0,0,0,0,0,1080
5012,RM-1109,3/27/2014,0,0,0,0,0,1077,1077
6350,RM-1113,2/24/2014,0,0,1077,0,0,0,1077
9100,RM-1122,3/27/2014,0,0,0,0,0,1077,1077
15521,RM-1144,2/24/2014,0,0,1077,0,0,0,1077
18897,RM-1155,1/31/2014,150,0,153,624,0,150,1077
26328,RM-1213A,2/24/2014,0,0,1077,0,0,0,1077
32474,RM-1236,2/24/2014,0,0,1077,0,0,0,1077
35651,RM-B109,2/24/2014,0,0,1077,0,0,0,1077
38395,RM-B215,2/24/2014,0,0,1077,0,0,0,1077
40487,RM-B224,3/27/2014,0,0,0,0,0,1077,1077
42545,RM-B230A,3/27/2014,0,0,0,0,0,1077,1077
43080,RM-B240,2/24/2014,0,0,1077,0,0,0,1077
44375,RM-B250,2/24/2014,0,0,1077,0,0,0,1077
47813,RM-B275,3/27/2014,0,0,0,0,0,1077,1077
2789,RM-1106,10/9/2013,0,0,0,0,0,1074,1074
2819,RM-1106,11/8/2013,0,0,0,0,0,1074,1074
2864,RM-1106,12/26/2013,0,0,0,0,0,1074,1074
2868,RM-1106,12/30/2013,0,0,0,0,0,1074,1074
4846,RM-1109,10/9/2013,0,0,0,0,0,1074,1074
4876,RM-1109,11/8/2013,0,0,0,0,0,1074,1074
4921,RM-1109,12/26/2013,0,0,0,0,0,1074,1074
4925,RM-1109,12/30/2013,0,0,0,0,0,1074,1074
4981,RM-1109,2/24/2014,0,0,0,0,0,1074,1074
7696,RM-1116,2/24/2014,1074,0,0,0,0,0,1074
9009,RM-1122,12/26/2013,0,0,0,0,0,1074,1074
9013,RM-1122,12/30/2013,0,0,0,0,0,1074,1074
9069,RM-1122,2/24/2014,0,0,0,0,0,1074,1074
9619,RM-1123,10/9/2013,0,0,1074,0,0,0,1074
9649,RM-1123,11/8/2013,0,0,1074,0,0,0,1074
10334,RM-1124,11/8/2013,0,0,0,0,0,1074,1074
10379,RM-1124,12/26/2013,0,0,0,0,0,1074,1074
10383,RM-1124,12/30/2013,0,0,0,0,0,1074,1074
12222,RM-1130,10/9/2013,0,0,0,0,0,1074,1074
12252,RM-1130,11/8/2013,0,0,0,0,0,1074,1074
12909,RM-1132,10/9/2013,0,0,1074,0,0,0,1074
12939,RM-1132,11/8/2013,0,0,1074,0,0,0,1074
12984,RM-1132,12/26/2013,0,0,1074,0,0,0,1074
13594,RM-1133,10/9/2013,0,0,1074,0,0,0,1074
13624,RM-1133,11/8/2013,0,0,1074,0,0,0,1074
15386,RM-1144,10/9/2013,0,0,0,0,0,1074,1074
15416,RM-1144,11/8/2013,0,0,0,0,0,1074,1074
16101,RM-1145,11/8/2013,0,0,0,0,0,1074,1074
16146,RM-1145,12/26/2013,0,0,0,0,0,1074,1074
16150,RM-1145,12/30/2013,0,0,0,0,0,1074,1074
16206,RM-1145,2/24/2014,0,0,0,0,0,1074,1074
20779,RM-1200B,10/9/2013,0,0,0,0,0,1074,1074
20809,RM-1200B,11/8/2013,0,0,0,0,0,1074,1074
22780,RM-1207,10/9/2013,0,0,0,0,0,1074,1074
22810,RM-1207,11/8/2013,0,0,0,0,0,1074,1074
24430,RM-1208B,7/16/2014,537,0,537,0,0,0,1074
24431,RM-1208B,7/17/2014,537,0,537,0,0,0,1074
24435,RM-1208B,7/21/2014,537,0,537,0,0,0,1074
24436,RM-1208B,7/22/2014,537,0,537,0,0,0,1074
25508,RM-1213,10/9/2013,0,0,0,0,0,1074,1074
25538,RM-1213,11/8/2013,0,0,0,0,0,1074,1074
25583,RM-1213,12/26/2013,0,0,0,0,0,1074,1074
25587,RM-1213,12/30/2013,0,0,0,0,0,1074,1074
25643,RM-1213,2/24/2014,0,0,0,0,0,1074,1074
26878,RM-1217,10/9/2013,1074,0,0,0,0,0,1074
26908,RM-1217,11/8/2013,1074,0,0,0,0,0,1074
26953,RM-1217,12/26/2013,1074,0,0,0,0,0,1074
27013,RM-1217,2/24/2014,1074,0,0,0,0,0,1074
28284,RM-1221,11/8/2013,0,0,1074,0,0,0,1074
28389,RM-1221,2/24/2014,0,0,0,0,0,1074,1074
31649,RM-1231,10/9/2013,0,0,0,0,0,1074,1074
31679,RM-1231,11/8/2013,0,0,0,0,0,1074,1074
31724,RM-1231,12/26/2013,0,0,0,0,0,1074,1074
31728,RM-1231,12/30/2013,0,0,0,0,0,1074,1074
31784,RM-1231,2/24/2014,0,0,0,0,0,1074,1074
34967,RM-B103A,10/9/2013,0,0,0,0,0,1074,1074
34997,RM-B103A,11/8/2013,0,0,0,0,0,1074,1074
35793,RM-B109,7/16/2014,537,0,537,0,0,0,1074
35794,RM-B109,7/17/2014,537,0,537,0,0,0,1074
36203,RM-B200B,10/9/2013,0,0,0,0,0,1074,1074
36233,RM-B200B,11/8/2013,0,0,0,0,0,1074,1074
36278,RM-B200B,12/26/2013,0,0,0,0,0,1074,1074
36282,RM-B200B,12/30/2013,0,0,0,0,0,1074,1074
39020,RM-B220,12/26/2013,1074,0,0,0,0,0,1074
39080,RM-B220,2/24/2014,1074,0,0,0,0,0,1074
39633,RM-B222,10/9/2013,1074,0,0,0,0,0,1074
39663,RM-B222,11/8/2013,1074,0,0,0,0,0,1074
39708,RM-B222,12/26/2013,1074,0,0,0,0,0,1074
40321,RM-B224,10/9/2013,0,0,0,0,0,1074,1074
40351,RM-B224,11/8/2013,0,0,0,0,0,1074,1074
40396,RM-B224,12/26/2013,0,0,0,0,0,1074,1074
40400,RM-B224,12/30/2013,0,0,0,0,0,1074,1074
40456,RM-B224,2/24/2014,0,0,0,0,0,1074,1074
41009,RM-B225,10/9/2013,0,0,0,0,0,1074,1074
41039,RM-B225,11/8/2013,0,0,0,0,0,1074,1074
41084,RM-B225,12/26/2013,0,0,0,0,0,1074,1074
41088,RM-B225,12/30/2013,0,0,0,0,0,1074,1074
42379,RM-B230A,10/9/2013,0,0,0,0,0,1074,1074
42409,RM-B230A,11/8/2013,0,0,0,0,0,1074,1074
42454,RM-B230A,12/26/2013,0,0,0,0,0,1074,1074
42458,RM-B230A,12/30/2013,0,0,0,0,0,1074,1074
42514,RM-B230A,2/24/2014,0,0,0,0,0,1074,1074
45060,RM-B250A,2/24/2014,1074,0,0,0,0,0,1074
46979,RM-B270,10/9/2013,0,0,1074,0,0,0,1074
47009,RM-B270,11/8/2013,0,0,1074,0,0,0,1074
47722,RM-B275,12/26/2013,0,0,0,0,0,1074,1074
47726,RM-B275,12/30/2013,0,0,0,0,0,1074,1074
47782,RM-B275,2/24/2014,0,0,0,0,0,1074,1074
4987,RM-1109,3/2/2014,0,0,0,0,0,1071,1071
6290,RM-1113,12/26/2013,0,0,1071,0,0,0,1071
6294,RM-1113,12/30/2013,0,0,1071,0,0,0,1071
6356,RM-1113,3/2/2014,0,0,1071,0,0,0,1071
7702,RM-1116,3/2/2014,1071,0,0,0,0,0,1071
9075,RM-1122,3/2/2014,0,0,0,0,0,1071,1071
9694,RM-1123,12/26/2013,0,0,1071,0,0,0,1071
9698,RM-1123,12/30/2013,0,0,1071,0,0,0,1071
12988,RM-1132,12/30/2013,0,0,1071,0,0,0,1071
13669,RM-1133,12/26/2013,0,0,1071,0,0,0,1071
13673,RM-1133,12/30/2013,0,0,1071,0,0,0,1071
15527,RM-1144,3/2/2014,0,0,1071,0,0,0,1071
16212,RM-1145,3/2/2014,0,0,0,0,0,1071,1071
24228,RM-1208B,12/26/2013,0,0,1071,0,0,0,1071
24232,RM-1208B,12/30/2013,0,0,1071,0,0,0,1071
24913,RM-1212,12/26/2013,0,0,1071,0,0,0,1071
24917,RM-1212,12/30/2013,0,0,1071,0,0,0,1071
25649,RM-1213,3/2/2014,0,0,0,0,0,1071,1071
26334,RM-1213A,3/2/2014,0,0,1071,0,0,0,1071
26957,RM-1217,12/30/2013,1071,0,0,0,0,0,1071
27019,RM-1217,3/2/2014,1071,0,0,0,0,0,1071
28395,RM-1221,3/2/2014,0,0,0,0,0,1071,1071
31790,RM-1231,3/2/2014,0,0,0,0,0,1071,1071
32414,RM-1236,12/26/2013,0,0,1071,0,0,0,1071
32418,RM-1236,12/30/2013,0,0,1071,0,0,0,1071
32480,RM-1236,3/2/2014,0,0,1071,0,0,0,1071
35657,RM-B109,3/2/2014,0,0,1071,0,0,0,1071
38401,RM-B215,3/2/2014,0,0,1071,0,0,0,1071
39024,RM-B220,12/30/2013,1071,0,0,0,0,0,1071
39086,RM-B220,3/2/2014,1071,0,0,0,0,0,1071
39712,RM-B222,12/30/2013,1071,0,0,0,0,0,1071
40462,RM-B224,3/2/2014,0,0,0,0,0,1071,1071
41769,RM-B230,12/26/2013,0,0,1071,0,0,0,1071
41773,RM-B230,12/30/2013,0,0,1071,0,0,0,1071
42520,RM-B230A,3/2/2014,0,0,0,0,0,1071,1071
43086,RM-B240,3/2/2014,0,0,1071,0,0,0,1071
44381,RM-B250,3/2/2014,0,0,1071,0,0,0,1071
45066,RM-B250A,3/2/2014,1071,0,0,0,0,0,1071
47788,RM-B275,3/2/2014,0,0,0,0,0,1071,1071
4975,RM-1109,2/18/2014,0,0,0,0,0,1068,1068
6344,RM-1113,2/18/2014,0,0,1068,0,0,0,1068
7690,RM-1116,2/18/2014,1068,0,0,0,0,0,1068
9063,RM-1122,2/18/2014,0,0,0,0,0,1068,1068
15515,RM-1144,2/18/2014,0,0,1068,0,0,0,1068
16200,RM-1145,2/18/2014,0,0,0,0,0,1068,1068
25637,RM-1213,2/18/2014,0,0,0,0,0,1068,1068
26322,RM-1213A,2/18/2014,0,0,1068,0,0,0,1068
27007,RM-1217,2/18/2014,1068,0,0,0,0,0,1068
28383,RM-1221,2/18/2014,0,0,0,0,0,1068,1068
31778,RM-1231,2/18/2014,0,0,0,0,0,1068,1068
32468,RM-1236,2/18/2014,0,0,1068,0,0,0,1068
35645,RM-B109,2/18/2014,0,0,1068,0,0,0,1068
35799,RM-B109,7/22/2014,534,0,534,0,0,0,1068
38389,RM-B215,2/18/2014,0,0,1068,0,0,0,1068
39074,RM-B220,2/18/2014,1068,0,0,0,0,0,1068
40450,RM-B224,2/18/2014,0,0,0,0,0,1068,1068
42508,RM-B230A,2/18/2014,0,0,0,0,0,1068,1068
43074,RM-B240,2/18/2014,0,0,1068,0,0,0,1068
44369,RM-B250,2/18/2014,0,0,1068,0,0,0,1068
45054,RM-B250A,2/18/2014,1068,0,0,0,0,0,1068
47776,RM-B275,2/18/2014,0,0,0,0,0,1068,1068
4968,RM-1109,2/11/2014,0,0,0,0,0,1065,1065
9056,RM-1122,2/11/2014,0,0,0,0,0,1065,1065
16193,RM-1145,2/11/2014,0,0,0,0,0,1065,1065
25630,RM-1213,2/11/2014,0,0,0,0,0,1065,1065
28376,RM-1221,2/11/2014,0,0,0,0,0,1065,1065
31771,RM-1231,2/11/2014,0,0,0,0,0,1065,1065
36105,RM-B109,5/26/2015,216,0,849,0,0,0,1065
40443,RM-B224,2/11/2014,0,0,0,0,0,1065,1065
42501,RM-B230A,2/11/2014,0,0,0,0,0,1065,1065
47769,RM-B275,2/11/2014,0,0,0,0,0,1065,1065
2355,RM-1104,5/7/2014,0,1062,0,0,0,0,1062
4997,RM-1109,3/12/2014,0,0,0,0,0,1062,1062
5703,RM-1110,4/2/2014,0,0,1062,0,0,0,1062
6366,RM-1113,3/12/2014,0,0,1062,0,0,0,1062
6387,RM-1113,4/2/2014,0,0,1062,0,0,0,1062
7046,RM-1115,4/2/2014,1062,0,0,0,0,0,1062
7733,RM-1116,4/2/2014,1062,0,0,0,0,0,1062
9085,RM-1122,3/12/2014,0,0,0,0,0,1062,1062
9618,RM-1123,10/8/2013,0,0,1062,0,0,0,1062
12908,RM-1132,10/8/2013,0,0,1062,0,0,0,1062
13593,RM-1133,10/8/2013,0,0,1062,0,0,0,1062
14289,RM-1134,4/2/2014,1062,0,0,0,0,0,1062
15537,RM-1144,3/12/2014,0,0,1062,0,0,0,1062
15558,RM-1144,4/2/2014,0,0,1062,0,0,0,1062
16222,RM-1145,3/12/2014,0,0,0,0,0,1062,1062
18958,RM-1155,4/2/2014,1062,0,0,0,0,0,1062
19634,RM-1156,4/2/2014,1062,0,0,0,0,0,1062
20778,RM-1200B,10/8/2013,0,0,0,0,0,1062,1062
22952,RM-1207,4/2/2014,1062,0,0,0,0,0,1062
26344,RM-1213A,3/12/2014,0,0,1062,0,0,0,1062
26365,RM-1213A,4/2/2014,0,0,1062,0,0,0,1062
27050,RM-1217,4/2/2014,1062,0,0,0,0,0,1062
32490,RM-1236,3/12/2014,0,0,1062,0,0,0,1062
32511,RM-1236,4/2/2014,0,0,1062,0,0,0,1062
35667,RM-B109,3/12/2014,0,0,1062,0,0,0,1062
35688,RM-B109,4/2/2014,0,0,1062,0,0,0,1062
38411,RM-B215,3/12/2014,0,0,1062,0,0,0,1062
38432,RM-B215,4/2/2014,0,0,1062,0,0,0,1062
39117,RM-B220,4/2/2014,1062,0,0,0,0,0,1062
40472,RM-B224,3/12/2014,0,0,0,0,0,1062,1062
42530,RM-B230A,3/12/2014,0,0,0,0,0,1062,1062
43096,RM-B240,3/12/2014,0,0,1062,0,0,0,1062
43117,RM-B240,4/2/2014,0,0,1062,0,0,0,1062
44391,RM-B250,3/12/2014,0,0,1062,0,0,0,1062
46978,RM-B270,10/8/2013,0,0,1062,0,0,0,1062
47798,RM-B275,3/12/2014,0,0,0,0,0,1062,1062
295,RM-1100A,5/2/2014,1059,0,0,0,0,0,1059
1665,RM-1102,5/2/2014,1059,0,0,0,0,0,1059
2788,RM-1106,10/8/2013,0,0,0,0,0,1059,1059
4845,RM-1109,10/8/2013,0,0,0,0,0,1059,1059
5708,RM-1110,4/7/2014,0,0,1059,0,0,0,1059
5733,RM-1110,5/2/2014,0,0,1059,0,0,0,1059
6417,RM-1113,5/2/2014,0,0,1059,0,0,0,1059
7051,RM-1115,4/7/2014,1059,0,0,0,0,0,1059
7076,RM-1115,5/2/2014,1059,0,0,0,0,0,1059
7712,RM-1116,3/12/2014,1059,0,0,0,0,0,1059
7738,RM-1116,4/7/2014,1059,0,0,0,0,0,1059
7763,RM-1116,5/2/2014,1059,0,0,0,0,0,1059
12221,RM-1130,10/8/2013,0,0,0,0,0,1059,1059
14294,RM-1134,4/7/2014,1059,0,0,0,0,0,1059
14319,RM-1134,5/2/2014,1059,0,0,0,0,0,1059
15385,RM-1144,10/8/2013,0,0,0,0,0,1059,1059
15588,RM-1144,5/2/2014,0,0,1059,0,0,0,1059
16246,RM-1145,5/2/2014,0,0,1059,0,0,0,1059
18963,RM-1155,4/7/2014,1059,0,0,0,0,0,1059
18988,RM-1155,5/2/2014,1059,0,0,0,0,0,1059
19639,RM-1156,4/7/2014,1059,0,0,0,0,0,1059
22779,RM-1207,10/8/2013,0,0,0,0,0,1059,1059
22957,RM-1207,4/7/2014,1059,0,0,0,0,0,1059
22982,RM-1207,5/2/2014,1059,0,0,0,0,0,1059
25040,RM-1212,5/2/2014,1059,0,0,0,0,0,1059
25659,RM-1213,3/12/2014,0,0,0,0,0,1059,1059
26395,RM-1213A,5/2/2014,0,0,1059,0,0,0,1059
26877,RM-1217,10/8/2013,1059,0,0,0,0,0,1059
27029,RM-1217,3/12/2014,1059,0,0,0,0,0,1059
27055,RM-1217,4/7/2014,1059,0,0,0,0,0,1059
28405,RM-1221,3/12/2014,0,0,0,0,0,1059,1059
29141,RM-1223,5/2/2014,1059,0,0,0,0,0,1059
31648,RM-1231,10/8/2013,0,0,0,0,0,1059,1059
31800,RM-1231,3/12/2014,0,0,0,0,0,1059,1059
34966,RM-B103A,10/8/2013,0,0,0,0,0,1059,1059
36202,RM-B200B,10/8/2013,0,0,0,0,0,1059,1059
38462,RM-B215,5/2/2014,0,0,1059,0,0,0,1059
39096,RM-B220,3/12/2014,1059,0,0,0,0,0,1059
39122,RM-B220,4/7/2014,1059,0,0,0,0,0,1059
39147,RM-B220,5/2/2014,1059,0,0,0,0,0,1059
39632,RM-B222,10/8/2013,1059,0,0,0,0,0,1059
39835,RM-B222,5/2/2014,1059,0,0,0,0,0,1059
40320,RM-B224,10/8/2013,0,0,0,0,0,1059,1059
41008,RM-B225,10/8/2013,0,0,0,0,0,1059,1059
42378,RM-B230A,10/8/2013,0,0,0,0,0,1059,1059
43147,RM-B240,5/2/2014,0,0,1059,0,0,0,1059
45076,RM-B250A,3/12/2014,1059,0,0,0,0,0,1059
45127,RM-B250A,5/2/2014,1059,0,0,0,0,0,1059
2830,RM-1106,11/22/2013,0,0,0,0,0,1056,1056
2831,RM-1106,11/23/2013,0,0,0,0,0,1056,1056
2872,RM-1106,1/3/2014,0,0,0,0,0,1056,1056
4366,RM-1108,5/8/2014,0,1056,0,0,0,0,1056
4370,RM-1108,5/12/2014,0,1056,0,0,0,0,1056
4887,RM-1109,11/22/2013,0,0,0,0,0,1056,1056
4888,RM-1109,11/23/2013,0,0,0,0,0,1056,1056
4929,RM-1109,1/3/2014,0,0,0,0,0,1056,1056
6291,RM-1113,12/27/2013,0,0,1056,0,0,0,1056
6298,RM-1113,1/3/2014,0,0,1056,0,0,0,1056
6392,RM-1113,4/7/2014,0,0,1056,0,0,0,1056
9017,RM-1122,1/3/2014,0,0,0,0,0,1056,1056
9661,RM-1123,11/23/2013,0,0,1056,0,0,0,1056
9686,RM-1123,12/18/2013,0,0,1056,0,0,0,1056
9695,RM-1123,12/27/2013,0,0,1056,0,0,0,1056
9702,RM-1123,1/3/2014,0,0,1056,0,0,0,1056
10345,RM-1124,11/22/2013,0,0,0,0,0,1056,1056
10346,RM-1124,11/23/2013,0,0,0,0,0,1056,1056
10387,RM-1124,1/3/2014,0,0,0,0,0,1056,1056
12263,RM-1130,11/22/2013,0,0,0,0,0,1056,1056
12264,RM-1130,11/23/2013,0,0,0,0,0,1056,1056
12950,RM-1132,11/22/2013,0,0,1056,0,0,0,1056
12951,RM-1132,11/23/2013,0,0,1056,0,0,0,1056
12992,RM-1132,1/3/2014,0,0,1056,0,0,0,1056
13636,RM-1133,11/23/2013,0,0,1056,0,0,0,1056
13661,RM-1133,12/18/2013,0,0,1056,0,0,0,1056
13670,RM-1133,12/27/2013,0,0,1056,0,0,0,1056
13677,RM-1133,1/3/2014,0,0,1056,0,0,0,1056
15563,RM-1144,4/7/2014,0,0,1056,0,0,0,1056
16112,RM-1145,11/22/2013,0,0,0,0,0,1056,1056
16113,RM-1145,11/23/2013,0,0,0,0,0,1056,1056
16154,RM-1145,1/3/2014,0,0,0,0,0,1056,1056
19545,RM-1156,1/3/2014,1056,0,0,0,0,0,1056
22821,RM-1207,11/22/2013,0,0,0,0,0,1056,1056
22822,RM-1207,11/23/2013,0,0,0,0,0,1056,1056
24220,RM-1208B,12/18/2013,0,0,1056,0,0,0,1056
24229,RM-1208B,12/27/2013,0,0,1056,0,0,0,1056
24236,RM-1208B,1/3/2014,0,0,1056,0,0,0,1056
24880,RM-1212,11/23/2013,0,0,1056,0,0,0,1056
24905,RM-1212,12/18/2013,0,0,1056,0,0,0,1056
24914,RM-1212,12/27/2013,0,0,1056,0,0,0,1056
25549,RM-1213,11/22/2013,0,0,0,0,0,1056,1056
25550,RM-1213,11/23/2013,0,0,0,0,0,1056,1056
25591,RM-1213,1/3/2014,0,0,0,0,0,1056,1056
26370,RM-1213A,4/7/2014,0,0,1056,0,0,0,1056
26919,RM-1217,11/22/2013,1056,0,0,0,0,0,1056
26920,RM-1217,11/23/2013,1056,0,0,0,0,0,1056
26961,RM-1217,1/3/2014,1056,0,0,0,0,0,1056
28296,RM-1221,11/23/2013,0,0,1056,0,0,0,1056
28321,RM-1221,12/18/2013,0,0,1056,0,0,0,1056
31690,RM-1231,11/22/2013,0,0,0,0,0,1056,1056
31691,RM-1231,11/23/2013,0,0,0,0,0,1056,1056
31732,RM-1231,1/3/2014,0,0,0,0,0,1056,1056
32381,RM-1236,11/23/2013,0,0,1056,0,0,0,1056
32406,RM-1236,12/18/2013,0,0,1056,0,0,0,1056
32415,RM-1236,12/27/2013,0,0,1056,0,0,0,1056
32422,RM-1236,1/3/2014,0,0,1056,0,0,0,1056
32516,RM-1236,4/7/2014,0,0,1056,0,0,0,1056
35008,RM-B103A,11/22/2013,0,0,0,0,0,1056,1056
35009,RM-B103A,11/23/2013,0,0,0,0,0,1056,1056
35693,RM-B109,4/7/2014,0,0,1056,0,0,0,1056
35755,RM-B109,6/8/2014,525,0,531,0,0,0,1056
35887,RM-B109,10/20/2014,528,0,528,0,0,0,1056
36244,RM-B200B,11/22/2013,0,0,0,0,0,1056,1056
36245,RM-B200B,11/23/2013,0,0,0,0,0,1056,1056
36286,RM-B200B,1/3/2014,0,0,0,0,0,1056,1056
38437,RM-B215,4/7/2014,0,0,1056,0,0,0,1056
39028,RM-B220,1/3/2014,1056,0,0,0,0,0,1056
39674,RM-B222,11/22/2013,1056,0,0,0,0,0,1056
39675,RM-B222,11/23/2013,1056,0,0,0,0,0,1056
39716,RM-B222,1/3/2014,1056,0,0,0,0,0,1056
40362,RM-B224,11/22/2013,0,0,0,0,0,1056,1056
40363,RM-B224,11/23/2013,0,0,0,0,0,1056,1056
40404,RM-B224,1/3/2014,0,0,0,0,0,1056,1056
41050,RM-B225,11/22/2013,0,0,0,0,0,1056,1056
41051,RM-B225,11/23/2013,0,0,0,0,0,1056,1056
41092,RM-B225,1/3/2014,0,0,0,0,0,1056,1056
41770,RM-B230,12/27/2013,0,0,1056,0,0,0,1056
41777,RM-B230,1/3/2014,0,0,1056,0,0,0,1056
42420,RM-B230A,11/22/2013,0,0,0,0,0,1056,1056
42421,RM-B230A,11/23/2013,0,0,0,0,0,1056,1056
42462,RM-B230A,1/3/2014,0,0,0,0,0,1056,1056
43122,RM-B240,4/7/2014,0,0,1056,0,0,0,1056
45980,RM-B260,10/20/2014,528,0,528,0,0,0,1056
47730,RM-B275,1/3/2014,0,0,0,0,0,1056,1056
2856,RM-1106,12/18/2013,0,0,0,0,0,1053,1053
2865,RM-1106,12/27/2013,0,0,0,0,0,1053,1053
4913,RM-1109,12/18/2013,0,0,0,0,0,1053,1053
4922,RM-1109,12/27/2013,0,0,0,0,0,1053,1053
9001,RM-1122,12/18/2013,0,0,0,0,0,1053,1053
9010,RM-1122,12/27/2013,0,0,0,0,0,1053,1053
9660,RM-1123,11/22/2013,0,0,1053,0,0,0,1053
10371,RM-1124,12/18/2013,0,0,0,0,0,1053,1053
10380,RM-1124,12/27/2013,0,0,0,0,0,1053,1053
12289,RM-1130,12/18/2013,0,0,0,0,0,1053,1053
12976,RM-1132,12/18/2013,0,0,1053,0,0,0,1053
12985,RM-1132,12/27/2013,0,0,1053,0,0,0,1053
13635,RM-1133,11/22/2013,0,0,1053,0,0,0,1053
16138,RM-1145,12/18/2013,0,0,0,0,0,1053,1053
16147,RM-1145,12/27/2013,0,0,0,0,0,1053,1053
24879,RM-1212,11/22/2013,0,0,1053,0,0,0,1053
25575,RM-1213,12/18/2013,0,0,0,0,0,1053,1053
25584,RM-1213,12/27/2013,0,0,0,0,0,1053,1053
26945,RM-1217,12/18/2013,1053,0,0,0,0,0,1053
26954,RM-1217,12/27/2013,1053,0,0,0,0,0,1053
28295,RM-1221,11/22/2013,0,0,1053,0,0,0,1053
31716,RM-1231,12/18/2013,0,0,0,0,0,1053,1053
31725,RM-1231,12/27/2013,0,0,0,0,0,1053,1053
32380,RM-1236,11/22/2013,0,0,1053,0,0,0,1053
36270,RM-B200B,12/18/2013,0,0,0,0,0,1053,1053
36279,RM-B200B,12/27/2013,0,0,0,0,0,1053,1053
39012,RM-B220,12/18/2013,1053,0,0,0,0,0,1053
39021,RM-B220,12/27/2013,1053,0,0,0,0,0,1053
39700,RM-B222,12/18/2013,1053,0,0,0,0,0,1053
39709,RM-B222,12/27/2013,1053,0,0,0,0,0,1053
40388,RM-B224,12/18/2013,0,0,0,0,0,1053,1053
40397,RM-B224,12/27/2013,0,0,0,0,0,1053,1053
41076,RM-B225,12/18/2013,0,0,0,0,0,1053,1053
41085,RM-B225,12/27/2013,0,0,0,0,0,1053,1053
42446,RM-B230A,12/18/2013,0,0,0,0,0,1053,1053
42455,RM-B230A,12/27/2013,0,0,0,0,0,1053,1053
47714,RM-B275,12/18/2013,0,0,0,0,0,1053,1053
47723,RM-B275,12/27/2013,0,0,0,0,0,1053,1053
4986,RM-1109,3/1/2014,0,0,0,0,0,1050,1050
6355,RM-1113,3/1/2014,0,0,1050,0,0,0,1050
6393,RM-1113,4/8/2014,0,0,1050,0,0,0,1050
7701,RM-1116,3/1/2014,1050,0,0,0,0,0,1050
9074,RM-1122,3/1/2014,0,0,0,0,0,1050,1050
15526,RM-1144,3/1/2014,0,0,1050,0,0,0,1050
15564,RM-1144,4/8/2014,0,0,1050,0,0,0,1050
16211,RM-1145,3/1/2014,0,0,0,0,0,1050,1050
25648,RM-1213,3/1/2014,0,0,0,0,0,1050,1050
26333,RM-1213A,3/1/2014,0,0,1050,0,0,0,1050
26371,RM-1213A,4/8/2014,0,0,1050,0,0,0,1050
27018,RM-1217,3/1/2014,1050,0,0,0,0,0,1050
28394,RM-1221,3/1/2014,0,0,0,0,0,1050,1050
31789,RM-1231,3/1/2014,0,0,0,0,0,1050,1050
32479,RM-1236,3/1/2014,0,0,1050,0,0,0,1050
32517,RM-1236,4/8/2014,0,0,1050,0,0,0,1050
35656,RM-B109,3/1/2014,0,0,1050,0,0,0,1050
35694,RM-B109,4/8/2014,0,0,1050,0,0,0,1050
38400,RM-B215,3/1/2014,0,0,1050,0,0,0,1050
38438,RM-B215,4/8/2014,0,0,1050,0,0,0,1050
39085,RM-B220,3/1/2014,1050,0,0,0,0,0,1050
40461,RM-B224,3/1/2014,0,0,0,0,0,1050,1050
42519,RM-B230A,3/1/2014,0,0,0,0,0,1050,1050
43085,RM-B240,3/1/2014,0,0,1050,0,0,0,1050
43123,RM-B240,4/8/2014,0,0,1050,0,0,0,1050
44380,RM-B250,3/1/2014,0,0,1050,0,0,0,1050
45065,RM-B250A,3/1/2014,1050,0,0,0,0,0,1050
47787,RM-B275,3/1/2014,0,0,0,0,0,1050,1050
321,RM-1100A,5/28/2014,1047,0,0,0,0,0,1047
1647,RM-1102,4/14/2014,1047,0,0,0,0,0,1047
1648,RM-1102,4/15/2014,1047,0,0,0,0,0,1047
2839,RM-1106,12/1/2013,0,0,0,0,0,1047,1047
4896,RM-1109,12/1/2013,0,0,0,0,0,1047,1047
5709,RM-1110,4/8/2014,0,0,1047,0,0,0,1047
5716,RM-1110,4/15/2014,0,0,1047,0,0,0,1047
5758,RM-1110,5/28/2014,0,0,1047,0,0,0,1047
6399,RM-1113,4/14/2014,0,0,1047,0,0,0,1047
6443,RM-1113,5/28/2014,0,0,1047,0,0,0,1047
7052,RM-1115,4/8/2014,1047,0,0,0,0,0,1047
7058,RM-1115,4/14/2014,1047,0,0,0,0,0,1047
7059,RM-1115,4/15/2014,1047,0,0,0,0,0,1047
7683,RM-1116,2/11/2014,1047,0,0,0,0,0,1047
7739,RM-1116,4/8/2014,1047,0,0,0,0,0,1047
7745,RM-1116,4/14/2014,1047,0,0,0,0,0,1047
7746,RM-1116,4/15/2014,1047,0,0,0,0,0,1047
7789,RM-1116,5/28/2014,1047,0,0,0,0,0,1047
8984,RM-1122,12/1/2013,0,0,0,0,0,1047,1047
9664,RM-1123,11/26/2013,0,0,1047,0,0,0,1047
9669,RM-1123,12/1/2013,0,0,1047,0,0,0,1047
10354,RM-1124,12/1/2013,0,0,0,0,0,1047,1047
12272,RM-1130,12/1/2013,0,0,0,0,0,1047,1047
12959,RM-1132,12/1/2013,0,0,1047,0,0,0,1047
13639,RM-1133,11/26/2013,0,0,1047,0,0,0,1047
13644,RM-1133,12/1/2013,0,0,1047,0,0,0,1047
14295,RM-1134,4/8/2014,1047,0,0,0,0,0,1047
14301,RM-1134,4/14/2014,1047,0,0,0,0,0,1047
14302,RM-1134,4/15/2014,1047,0,0,0,0,0,1047
14344,RM-1134,5/28/2014,1047,0,0,0,0,0,1047
15570,RM-1144,4/14/2014,0,0,1047,0,0,0,1047
15614,RM-1144,5/28/2014,0,0,1047,0,0,0,1047
16121,RM-1145,12/1/2013,0,0,0,0,0,1047,1047
16272,RM-1145,5/28/2014,0,0,1047,0,0,0,1047
18964,RM-1155,4/8/2014,1047,0,0,0,0,0,1047
18970,RM-1155,4/14/2014,1047,0,0,0,0,0,1047
18971,RM-1155,4/15/2014,1047,0,0,0,0,0,1047
19014,RM-1155,5/28/2014,1047,0,0,0,0,0,1047
19640,RM-1156,4/8/2014,1047,0,0,0,0,0,1047
19646,RM-1156,4/14/2014,1047,0,0,0,0,0,1047
19647,RM-1156,4/15/2014,1047,0,0,0,0,0,1047
22830,RM-1207,12/1/2013,0,0,0,0,0,1047,1047
22958,RM-1207,4/8/2014,1047,0,0,0,0,0,1047
22964,RM-1207,4/14/2014,1047,0,0,0,0,0,1047
22965,RM-1207,4/15/2014,1047,0,0,0,0,0,1047
23008,RM-1207,5/28/2014,1047,0,0,0,0,0,1047
24883,RM-1212,11/26/2013,0,0,1047,0,0,0,1047
24888,RM-1212,12/1/2013,0,0,1047,0,0,0,1047
25066,RM-1212,5/28/2014,1047,0,0,0,0,0,1047
25558,RM-1213,12/1/2013,0,0,0,0,0,1047,1047
26377,RM-1213A,4/14/2014,0,0,1047,0,0,0,1047
26421,RM-1213A,5/28/2014,0,0,1047,0,0,0,1047
26928,RM-1217,12/1/2013,1047,0,0,0,0,0,1047
28299,RM-1221,11/26/2013,0,0,1047,0,0,0,1047
28304,RM-1221,12/1/2013,0,0,1047,0,0,0,1047
28482,RM-1221,5/28/2014,0,0,1047,0,0,0,1047
29167,RM-1223,5/28/2014,1047,0,0,0,0,0,1047
31699,RM-1231,12/1/2013,0,0,0,0,0,1047,1047
32384,RM-1236,11/26/2013,0,0,1047,0,0,0,1047
32389,RM-1236,12/1/2013,0,0,1047,0,0,0,1047
32523,RM-1236,4/14/2014,0,0,1047,0,0,0,1047
36253,RM-B200B,12/1/2013,0,0,0,0,0,1047,1047
37112,RM-B200C,5/28/2014,1047,0,0,0,0,0,1047
38444,RM-B215,4/14/2014,0,0,1047,0,0,0,1047
38488,RM-B215,5/28/2014,0,0,1047,0,0,0,1047
39067,RM-B220,2/11/2014,1047,0,0,0,0,0,1047
39123,RM-B220,4/8/2014,1047,0,0,0,0,0,1047
39129,RM-B220,4/14/2014,1047,0,0,0,0,0,1047
39130,RM-B220,4/15/2014,1047,0,0,0,0,0,1047
39173,RM-B220,5/28/2014,1047,0,0,0,0,0,1047
39683,RM-B222,12/1/2013,1047,0,0,0,0,0,1047
39818,RM-B222,4/15/2014,1047,0,0,0,0,0,1047
40371,RM-B224,12/1/2013,0,0,0,0,0,1047,1047
41059,RM-B225,12/1/2013,0,0,0,0,0,1047,1047
41922,RM-B230,5/28/2014,1047,0,0,0,0,0,1047
42429,RM-B230A,12/1/2013,0,0,0,0,0,1047,1047
43129,RM-B240,4/14/2014,0,0,1047,0,0,0,1047
43173,RM-B240,5/28/2014,0,0,1047,0,0,0,1047
45047,RM-B250A,2/11/2014,1047,0,0,0,0,0,1047
45152,RM-B250A,5/28/2014,1047,0,0,0,0,0,1047
47697,RM-B275,12/1/2013,0,0,0,0,0,1047,1047
2834,RM-1106,11/26/2013,0,0,0,0,0,1044,1044
4367,RM-1108,5/9/2014,0,1044,0,0,0,0,1044
4891,RM-1109,11/26/2013,0,0,0,0,0,1044,1044
5715,RM-1110,4/14/2014,0,0,1044,0,0,0,1044
5765,RM-1110,6/4/2014,0,0,1044,0,0,0,1044
6400,RM-1113,4/15/2014,0,0,1044,0,0,0,1044
7599,RM-1116,11/19/2013,348,0,348,0,0,348,1044
7796,RM-1116,6/4/2014,1044,0,0,0,0,0,1044
10349,RM-1124,11/26/2013,0,0,0,0,0,1044,1044
12267,RM-1130,11/26/2013,0,0,0,0,0,1044,1044
12954,RM-1132,11/26/2013,0,0,1044,0,0,0,1044
14351,RM-1134,6/4/2014,1044,0,0,0,0,0,1044
15571,RM-1144,4/15/2014,0,0,1044,0,0,0,1044
16116,RM-1145,11/26/2013,0,0,0,0,0,1044,1044
17619,RM-1151,5/6/2014,0,0,0,1044,0,0,1044
19021,RM-1155,6/4/2014,1044,0,0,0,0,0,1044
22758,RM-1207,9/17/2013,0,0,0,0,0,1044,1044
22825,RM-1207,11/26/2013,0,0,0,0,0,1044,1044
23015,RM-1207,6/4/2014,1044,0,0,0,0,0,1044
23671,RM-1208,5/6/2014,0,1044,0,0,0,0,1044
25073,RM-1212,6/4/2014,1044,0,0,0,0,0,1044
25553,RM-1213,11/26/2013,0,0,0,0,0,1044,1044
26378,RM-1213A,4/15/2014,0,0,1044,0,0,0,1044
26923,RM-1217,11/26/2013,1044,0,0,0,0,0,1044
29174,RM-1223,6/4/2014,1044,0,0,0,0,0,1044
31694,RM-1231,11/26/2013,0,0,0,0,0,1044,1044
32524,RM-1236,4/15/2014,0,0,1044,0,0,0,1044
35012,RM-B103A,11/26/2013,0,0,0,0,0,1044,1044
36248,RM-B200B,11/26/2013,0,0,0,0,0,1044,1044
36922,RM-B200C,11/19/2013,348,0,348,0,0,348,1044
37119,RM-B200C,6/4/2014,1044,0,0,0,0,0,1044
38298,RM-B215,11/19/2013,348,0,348,0,0,348,1044
38445,RM-B215,4/15/2014,0,0,1044,0,0,0,1044
38448,RM-B215,4/18/2014,84,0,960,0,0,0,1044
39180,RM-B220,6/4/2014,1044,0,0,0,0,0,1044
39678,RM-B222,11/26/2013,1044,0,0,0,0,0,1044
40366,RM-B224,11/26/2013,0,0,0,0,0,1044,1044
41054,RM-B225,11/26/2013,0,0,0,0,0,1044,1044
41929,RM-B230,6/4/2014,1044,0,0,0,0,0,1044
42424,RM-B230A,11/26/2013,0,0,0,0,0,1044,1044
43130,RM-B240,4/15/2014,0,0,1044,0,0,0,1044
45159,RM-B250A,6/4/2014,1044,0,0,0,0,0,1044
47692,RM-B275,11/26/2013,0,0,0,0,0,1044,1044
2855,RM-1106,12/17/2013,0,0,0,0,0,1041,1041
2866,RM-1106,12/28/2013,0,0,0,0,0,1041,1041
4912,RM-1109,12/17/2013,0,0,0,0,0,1041,1041
4923,RM-1109,12/28/2013,0,0,0,0,0,1041,1041
6292,RM-1113,12/28/2013,0,0,1041,0,0,0,1041
6450,RM-1113,6/4/2014,0,0,1041,0,0,0,1041
9000,RM-1122,12/17/2013,0,0,0,0,0,1041,1041
9011,RM-1122,12/28/2013,0,0,0,0,0,1041,1041
9662,RM-1123,11/24/2013,0,0,1041,0,0,0,1041
9696,RM-1123,12/28/2013,0,0,1041,0,0,0,1041
10370,RM-1124,12/17/2013,0,0,0,0,0,1041,1041
10381,RM-1124,12/28/2013,0,0,0,0,0,1041,1041
12288,RM-1130,12/17/2013,0,0,0,0,0,1041,1041
12986,RM-1132,12/28/2013,0,0,1041,0,0,0,1041
13637,RM-1133,11/24/2013,0,0,1041,0,0,0,1041
13671,RM-1133,12/28/2013,0,0,1041,0,0,0,1041
15621,RM-1144,6/4/2014,0,0,1041,0,0,0,1041
16137,RM-1145,12/17/2013,0,0,0,0,0,1041,1041
16148,RM-1145,12/28/2013,0,0,0,0,0,1041,1041
16279,RM-1145,6/4/2014,0,0,1041,0,0,0,1041
24230,RM-1208B,12/28/2013,0,0,1041,0,0,0,1041
24881,RM-1212,11/24/2013,0,0,1041,0,0,0,1041
24915,RM-1212,12/28/2013,0,0,1041,0,0,0,1041
25574,RM-1213,12/17/2013,0,0,0,0,0,1041,1041
25585,RM-1213,12/28/2013,0,0,0,0,0,1041,1041
26428,RM-1213A,6/4/2014,0,0,1041,0,0,0,1041
26955,RM-1217,12/28/2013,1041,0,0,0,0,0,1041
28297,RM-1221,11/24/2013,0,0,1041,0,0,0,1041
28489,RM-1221,6/4/2014,0,0,1041,0,0,0,1041
31715,RM-1231,12/17/2013,0,0,0,0,0,1041,1041
31726,RM-1231,12/28/2013,0,0,0,0,0,1041,1041
32382,RM-1236,11/24/2013,0,0,1041,0,0,0,1041
32416,RM-1236,12/28/2013,0,0,1041,0,0,0,1041
36269,RM-B200B,12/17/2013,0,0,0,0,0,1041,1041
36280,RM-B200B,12/28/2013,0,0,0,0,0,1041,1041
39022,RM-B220,12/28/2013,1041,0,0,0,0,0,1041
39710,RM-B222,12/28/2013,1041,0,0,0,0,0,1041
40387,RM-B224,12/17/2013,0,0,0,0,0,1041,1041
40398,RM-B224,12/28/2013,0,0,0,0,0,1041,1041
41075,RM-B225,12/17/2013,0,0,0,0,0,1041,1041
41086,RM-B225,12/28/2013,0,0,0,0,0,1041,1041
41771,RM-B230,12/28/2013,0,0,1041,0,0,0,1041
42445,RM-B230A,12/17/2013,0,0,0,0,0,1041,1041
42456,RM-B230A,12/28/2013,0,0,0,0,0,1041,1041
43180,RM-B240,6/4/2014,0,0,1041,0,0,0,1041
43617,RM-B240A,9/26/2013,0,0,0,0,0,1041,1041
47713,RM-B275,12/17/2013,0,0,0,0,0,1041,1041
47724,RM-B275,12/28/2013,0,0,0,0,0,1041,1041
2832,RM-1106,11/24/2013,0,0,0,0,0,1038,1038
2873,RM-1106,1/4/2014,0,0,0,0,0,1038,1038
4889,RM-1109,11/24/2013,0,0,0,0,0,1038,1038
4930,RM-1109,1/4/2014,0,0,0,0,0,1038,1038
9018,RM-1122,1/4/2014,0,0,0,0,0,1038,1038
9621,RM-1123,10/11/2013,0,0,1038,0,0,0,1038
9677,RM-1123,12/9/2013,0,0,1038,0,0,0,1038
9685,RM-1123,12/17/2013,0,0,1038,0,0,0,1038
10347,RM-1124,11/24/2013,0,0,0,0,0,1038,1038
10388,RM-1124,1/4/2014,0,0,0,0,0,1038,1038
12265,RM-1130,11/24/2013,0,0,0,0,0,1038,1038
12952,RM-1132,11/24/2013,0,0,1038,0,0,0,1038
12975,RM-1132,12/17/2013,0,0,1038,0,0,0,1038
13596,RM-1133,10/11/2013,0,0,1038,0,0,0,1038
13652,RM-1133,12/9/2013,0,0,1038,0,0,0,1038
13660,RM-1133,12/17/2013,0,0,1038,0,0,0,1038
13682,RM-1133,1/8/2014,0,72,966,0,0,0,1038
16114,RM-1145,11/24/2013,0,0,0,0,0,1038,1038
16155,RM-1145,1/4/2014,0,0,0,0,0,1038,1038
22823,RM-1207,11/24/2013,0,0,0,0,0,1038,1038
24211,RM-1208B,12/9/2013,0,0,1038,0,0,0,1038
24219,RM-1208B,12/17/2013,0,0,1038,0,0,0,1038
24427,RM-1208B,7/13/2014,519,0,519,0,0,0,1038
24439,RM-1208B,7/25/2014,519,0,519,0,0,0,1038
24896,RM-1212,12/9/2013,0,0,1038,0,0,0,1038
24904,RM-1212,12/17/2013,0,0,1038,0,0,0,1038
25551,RM-1213,11/24/2013,0,0,0,0,0,1038,1038
25592,RM-1213,1/4/2014,0,0,0,0,0,1038,1038
26921,RM-1217,11/24/2013,1038,0,0,0,0,0,1038
26944,RM-1217,12/17/2013,1038,0,0,0,0,0,1038
28312,RM-1221,12/9/2013,0,0,1038,0,0,0,1038
28320,RM-1221,12/17/2013,0,0,1038,0,0,0,1038
31692,RM-1231,11/24/2013,0,0,0,0,0,1038,1038
31733,RM-1231,1/4/2014,0,0,0,0,0,1038,1038
32397,RM-1236,12/9/2013,0,0,1038,0,0,0,1038
32405,RM-1236,12/17/2013,0,0,1038,0,0,0,1038
35010,RM-B103A,11/24/2013,0,0,0,0,0,1038,1038
35790,RM-B109,7/13/2014,519,0,519,0,0,0,1038
35802,RM-B109,7/25/2014,519,0,519,0,0,0,1038
35892,RM-B109,10/25/2014,519,0,519,0,0,0,1038
36246,RM-B200B,11/24/2013,0,0,0,0,0,1038,1038
36287,RM-B200B,1/4/2014,0,0,0,0,0,1038,1038
39011,RM-B220,12/17/2013,1038,0,0,0,0,0,1038
39676,RM-B222,11/24/2013,1038,0,0,0,0,0,1038
39699,RM-B222,12/17/2013,1038,0,0,0,0,0,1038
40364,RM-B224,11/24/2013,0,0,0,0,0,1038,1038
40405,RM-B224,1/4/2014,0,0,0,0,0,1038,1038
41052,RM-B225,11/24/2013,0,0,0,0,0,1038,1038
41093,RM-B225,1/4/2014,0,0,0,0,0,1038,1038
41782,RM-B230,1/8/2014,0,72,966,0,0,0,1038
42422,RM-B230A,11/24/2013,0,0,0,0,0,1038,1038
42463,RM-B230A,1/4/2014,0,0,0,0,0,1038,1038
45985,RM-B260,10/25/2014,519,0,519,0,0,0,1038
46981,RM-B270,10/11/2013,0,0,1038,0,0,0,1038
47731,RM-B275,1/4/2014,0,0,0,0,0,1038,1038
2791,RM-1106,10/11/2013,0,0,0,0,0,1035,1035
2796,RM-1106,10/16/2013,0,0,0,0,0,1035,1035
2847,RM-1106,12/9/2013,0,0,0,0,0,1035,1035
4848,RM-1109,10/11/2013,0,0,0,0,0,1035,1035
4853,RM-1109,10/16/2013,0,0,0,0,0,1035,1035
4904,RM-1109,12/9/2013,0,0,0,0,0,1035,1035
4982,RM-1109,2/25/2014,0,0,0,0,0,1035,1035
4988,RM-1109,3/3/2014,0,0,0,0,0,1035,1035
6299,RM-1113,1/4/2014,0,0,1035,0,0,0,1035
6351,RM-1113,2/25/2014,0,0,1035,0,0,0,1035
6357,RM-1113,3/3/2014,0,0,1035,0,0,0,1035
7697,RM-1116,2/25/2014,1035,0,0,0,0,0,1035
7703,RM-1116,3/3/2014,1035,0,0,0,0,0,1035
8992,RM-1122,12/9/2013,0,0,0,0,0,1035,1035
9070,RM-1122,2/25/2014,0,0,0,0,0,1035,1035
9076,RM-1122,3/3/2014,0,0,0,0,0,1035,1035
9626,RM-1123,10/16/2013,0,0,1035,0,0,0,1035
9703,RM-1123,1/4/2014,0,0,1035,0,0,0,1035
10362,RM-1124,12/9/2013,0,0,0,0,0,1035,1035
12224,RM-1130,10/11/2013,0,0,0,0,0,1035,1035
12229,RM-1130,10/16/2013,0,0,0,0,0,1035,1035
12280,RM-1130,12/9/2013,0,0,0,0,0,1035,1035
12911,RM-1132,10/11/2013,0,0,1035,0,0,0,1035
12916,RM-1132,10/16/2013,0,0,1035,0,0,0,1035
12993,RM-1132,1/4/2014,0,0,1035,0,0,0,1035
13601,RM-1133,10/16/2013,0,0,1035,0,0,0,1035
13678,RM-1133,1/4/2014,0,0,1035,0,0,0,1035
15388,RM-1144,10/11/2013,0,0,0,0,0,1035,1035
15393,RM-1144,10/16/2013,0,0,0,0,0,1035,1035
15522,RM-1144,2/25/2014,0,0,1035,0,0,0,1035
15528,RM-1144,3/3/2014,0,0,1035,0,0,0,1035
16078,RM-1145,10/16/2013,0,0,0,0,0,1035,1035
16129,RM-1145,12/9/2013,0,0,0,0,0,1035,1035
16207,RM-1145,2/25/2014,0,0,0,0,0,1035,1035
16213,RM-1145,3/3/2014,0,0,0,0,0,1035,1035
19546,RM-1156,1/4/2014,1035,0,0,0,0,0,1035
20781,RM-1200B,10/11/2013,0,0,0,0,0,1035,1035
20786,RM-1200B,10/16/2013,0,0,0,0,0,1035,1035
22782,RM-1207,10/11/2013,0,0,0,0,0,1035,1035
22787,RM-1207,10/16/2013,0,0,0,0,0,1035,1035
22838,RM-1207,12/9/2013,0,0,0,0,0,1035,1035
24237,RM-1208B,1/4/2014,0,0,1035,0,0,0,1035
25510,RM-1213,10/11/2013,0,0,0,0,0,1035,1035
25515,RM-1213,10/16/2013,0,0,0,0,0,1035,1035
25566,RM-1213,12/9/2013,0,0,0,0,0,1035,1035
25644,RM-1213,2/25/2014,0,0,0,0,0,1035,1035
25650,RM-1213,3/3/2014,0,0,0,0,0,1035,1035
26329,RM-1213A,2/25/2014,0,0,1035,0,0,0,1035
26335,RM-1213A,3/3/2014,0,0,1035,0,0,0,1035
26880,RM-1217,10/11/2013,1035,0,0,0,0,0,1035
26885,RM-1217,10/16/2013,1035,0,0,0,0,0,1035
26962,RM-1217,1/4/2014,1035,0,0,0,0,0,1035
27014,RM-1217,2/25/2014,1035,0,0,0,0,0,1035
27020,RM-1217,3/3/2014,1035,0,0,0,0,0,1035
28261,RM-1221,10/16/2013,0,0,1035,0,0,0,1035
28390,RM-1221,2/25/2014,0,0,0,0,0,1035,1035
28396,RM-1221,3/3/2014,0,0,0,0,0,1035,1035
31651,RM-1231,10/11/2013,0,0,0,0,0,1035,1035
31656,RM-1231,10/16/2013,0,0,0,0,0,1035,1035
31707,RM-1231,12/9/2013,0,0,0,0,0,1035,1035
31785,RM-1231,2/25/2014,0,0,0,0,0,1035,1035
31791,RM-1231,3/3/2014,0,0,0,0,0,1035,1035
32423,RM-1236,1/4/2014,0,0,1035,0,0,0,1035
32475,RM-1236,2/25/2014,0,0,1035,0,0,0,1035
32481,RM-1236,3/3/2014,0,0,1035,0,0,0,1035
34969,RM-B103A,10/11/2013,0,0,0,0,0,1035,1035
34974,RM-B103A,10/16/2013,0,0,0,0,0,1035,1035
35652,RM-B109,2/25/2014,0,0,1035,0,0,0,1035
35658,RM-B109,3/3/2014,0,0,1035,0,0,0,1035
36205,RM-B200B,10/11/2013,0,0,0,0,0,1035,1035
36210,RM-B200B,10/16/2013,0,0,0,0,0,1035,1035
36261,RM-B200B,12/9/2013,0,0,0,0,0,1035,1035
36291,RM-B200B,1/8/2014,0,72,0,0,0,963,1035
38396,RM-B215,2/25/2014,0,0,1035,0,0,0,1035
38402,RM-B215,3/3/2014,0,0,1035,0,0,0,1035
39029,RM-B220,1/4/2014,1035,0,0,0,0,0,1035
39081,RM-B220,2/25/2014,1035,0,0,0,0,0,1035
39087,RM-B220,3/3/2014,1035,0,0,0,0,0,1035
39635,RM-B222,10/11/2013,1035,0,0,0,0,0,1035
39640,RM-B222,10/16/2013,1035,0,0,0,0,0,1035
39717,RM-B222,1/4/2014,1035,0,0,0,0,0,1035
40323,RM-B224,10/11/2013,0,0,0,0,0,1035,1035
40328,RM-B224,10/16/2013,0,0,0,0,0,1035,1035
40379,RM-B224,12/9/2013,0,0,0,0,0,1035,1035
40457,RM-B224,2/25/2014,0,0,0,0,0,1035,1035
40463,RM-B224,3/3/2014,0,0,0,0,0,1035,1035
41011,RM-B225,10/11/2013,0,0,0,0,0,1035,1035
41016,RM-B225,10/16/2013,0,0,0,0,0,1035,1035
41067,RM-B225,12/9/2013,0,0,0,0,0,1035,1035
41778,RM-B230,1/4/2014,0,0,1035,0,0,0,1035
42381,RM-B230A,10/11/2013,0,0,0,0,0,1035,1035
42386,RM-B230A,10/16/2013,0,0,0,0,0,1035,1035
42437,RM-B230A,12/9/2013,0,0,0,0,0,1035,1035
42515,RM-B230A,2/25/2014,0,0,0,0,0,1035,1035
42521,RM-B230A,3/3/2014,0,0,0,0,0,1035,1035
43081,RM-B240,2/25/2014,0,0,1035,0,0,0,1035
43087,RM-B240,3/3/2014,0,0,1035,0,0,0,1035
44376,RM-B250,2/25/2014,0,0,1035,0,0,0,1035
44382,RM-B250,3/3/2014,0,0,1035,0,0,0,1035
45061,RM-B250A,2/25/2014,1035,0,0,0,0,0,1035
45067,RM-B250A,3/3/2014,1035,0,0,0,0,0,1035
46986,RM-B270,10/16/2013,0,0,1035,0,0,0,1035
47705,RM-B275,12/9/2013,0,0,0,0,0,1035,1035
47735,RM-B275,1/8/2014,0,72,0,0,0,963,1035
47783,RM-B275,2/25/2014,0,0,0,0,0,1035,1035
47789,RM-B275,3/3/2014,0,0,0,0,0,1035,1035
5010,RM-1109,3/25/2014,0,0,0,0,0,1032,1032
6379,RM-1113,3/25/2014,0,0,1032,0,0,0,1032
9098,RM-1122,3/25/2014,0,0,0,0,0,1032,1032
15550,RM-1144,3/25/2014,0,0,1032,0,0,0,1032
16235,RM-1145,3/25/2014,0,0,0,0,0,1032,1032
25672,RM-1213,3/25/2014,0,0,0,0,0,1032,1032
26357,RM-1213A,3/25/2014,0,0,1032,0,0,0,1032
28418,RM-1221,3/25/2014,0,0,0,0,0,1032,1032
31813,RM-1231,3/25/2014,0,0,0,0,0,1032,1032
32503,RM-1236,3/25/2014,0,0,1032,0,0,0,1032
35680,RM-B109,3/25/2014,0,0,1032,0,0,0,1032
38424,RM-B215,3/25/2014,0,0,1032,0,0,0,1032
40485,RM-B224,3/25/2014,0,0,0,0,0,1032,1032
42543,RM-B230A,3/25/2014,0,0,0,0,0,1032,1032
43109,RM-B240,3/25/2014,0,0,1032,0,0,0,1032
47811,RM-B275,3/25/2014,0,0,0,0,0,1032,1032
2867,RM-1106,12/29/2013,0,0,0,0,0,1029,1029
4924,RM-1109,12/29/2013,0,0,0,0,0,1029,1029
4983,RM-1109,2/26/2014,0,0,0,0,0,1029,1029
4990,RM-1109,3/5/2014,0,0,0,0,0,1029,1029
6293,RM-1113,12/29/2013,0,0,1029,0,0,0,1029
6352,RM-1113,2/26/2014,0,0,1029,0,0,0,1029
6359,RM-1113,3/5/2014,0,0,1029,0,0,0,1029
6375,RM-1113,3/21/2014,0,0,1029,0,0,0,1029
7698,RM-1116,2/26/2014,1029,0,0,0,0,0,1029
7705,RM-1116,3/5/2014,1029,0,0,0,0,0,1029
7725,RM-1116,3/25/2014,1029,0,0,0,0,0,1029
9012,RM-1122,12/29/2013,0,0,0,0,0,1029,1029
9071,RM-1122,2/26/2014,0,0,0,0,0,1029,1029
9078,RM-1122,3/5/2014,0,0,0,0,0,1029,1029
9697,RM-1123,12/29/2013,0,0,1029,0,0,0,1029
10382,RM-1124,12/29/2013,0,0,0,0,0,1029,1029
12987,RM-1132,12/29/2013,0,0,1029,0,0,0,1029
13672,RM-1133,12/29/2013,0,0,1029,0,0,0,1029
14281,RM-1134,3/25/2014,1029,0,0,0,0,0,1029
15523,RM-1144,2/26/2014,0,0,1029,0,0,0,1029
15530,RM-1144,3/5/2014,0,0,1029,0,0,0,1029
15546,RM-1144,3/21/2014,0,0,1029,0,0,0,1029
16149,RM-1145,12/29/2013,0,0,0,0,0,1029,1029
16208,RM-1145,2/26/2014,0,0,0,0,0,1029,1029
16215,RM-1145,3/5/2014,0,0,0,0,0,1029,1029
24231,RM-1208B,12/29/2013,0,0,1029,0,0,0,1029
24916,RM-1212,12/29/2013,0,0,1029,0,0,0,1029
25586,RM-1213,12/29/2013,0,0,0,0,0,1029,1029
25645,RM-1213,2/26/2014,0,0,0,0,0,1029,1029
25652,RM-1213,3/5/2014,0,0,0,0,0,1029,1029
26330,RM-1213A,2/26/2014,0,0,1029,0,0,0,1029
26337,RM-1213A,3/5/2014,0,0,1029,0,0,0,1029
26353,RM-1213A,3/21/2014,0,0,1029,0,0,0,1029
26956,RM-1217,12/29/2013,1029,0,0,0,0,0,1029
27015,RM-1217,2/26/2014,1029,0,0,0,0,0,1029
27022,RM-1217,3/5/2014,1029,0,0,0,0,0,1029
27042,RM-1217,3/25/2014,1029,0,0,0,0,0,1029
28391,RM-1221,2/26/2014,0,0,0,0,0,1029,1029
28398,RM-1221,3/5/2014,0,0,0,0,0,1029,1029
31727,RM-1231,12/29/2013,0,0,0,0,0,1029,1029
31786,RM-1231,2/26/2014,0,0,0,0,0,1029,1029
31793,RM-1231,3/5/2014,0,0,0,0,0,1029,1029
32417,RM-1236,12/29/2013,0,0,1029,0,0,0,1029
32476,RM-1236,2/26/2014,0,0,1029,0,0,0,1029
32483,RM-1236,3/5/2014,0,0,1029,0,0,0,1029
32499,RM-1236,3/21/2014,0,0,1029,0,0,0,1029
35653,RM-B109,2/26/2014,0,0,1029,0,0,0,1029
35660,RM-B109,3/5/2014,0,0,1029,0,0,0,1029
35676,RM-B109,3/21/2014,0,0,1029,0,0,0,1029
36281,RM-B200B,12/29/2013,0,0,0,0,0,1029,1029
38397,RM-B215,2/26/2014,0,0,1029,0,0,0,1029
38404,RM-B215,3/5/2014,0,0,1029,0,0,0,1029
38420,RM-B215,3/21/2014,0,0,1029,0,0,0,1029
39023,RM-B220,12/29/2013,1029,0,0,0,0,0,1029
39082,RM-B220,2/26/2014,1029,0,0,0,0,0,1029
39089,RM-B220,3/5/2014,1029,0,0,0,0,0,1029
39109,RM-B220,3/25/2014,1029,0,0,0,0,0,1029
39711,RM-B222,12/29/2013,1029,0,0,0,0,0,1029
40399,RM-B224,12/29/2013,0,0,0,0,0,1029,1029
40458,RM-B224,2/26/2014,0,0,0,0,0,1029,1029
40465,RM-B224,3/5/2014,0,0,0,0,0,1029,1029
41087,RM-B225,12/29/2013,0,0,0,0,0,1029,1029
41772,RM-B230,12/29/2013,0,0,1029,0,0,0,1029
42457,RM-B230A,12/29/2013,0,0,0,0,0,1029,1029
42516,RM-B230A,2/26/2014,0,0,0,0,0,1029,1029
42523,RM-B230A,3/5/2014,0,0,0,0,0,1029,1029
43082,RM-B240,2/26/2014,0,0,1029,0,0,0,1029
43089,RM-B240,3/5/2014,0,0,1029,0,0,0,1029
43105,RM-B240,3/21/2014,0,0,1029,0,0,0,1029
44377,RM-B250,2/26/2014,0,0,1029,0,0,0,1029
44384,RM-B250,3/5/2014,0,0,1029,0,0,0,1029
45062,RM-B250A,2/26/2014,1029,0,0,0,0,0,1029
45069,RM-B250A,3/5/2014,1029,0,0,0,0,0,1029
45089,RM-B250A,3/25/2014,1029,0,0,0,0,0,1029
47725,RM-B275,12/29/2013,0,0,0,0,0,1029,1029
47784,RM-B275,2/26/2014,0,0,0,0,0,1029,1029
47791,RM-B275,3/5/2014,0,0,0,0,0,1029,1029
296,RM-1100A,5/3/2014,1026,0,0,0,0,0,1026
1666,RM-1102,5/3/2014,1026,0,0,0,0,0,1026
4371,RM-1108,5/13/2014,0,1026,0,0,0,0,1026
5006,RM-1109,3/21/2014,0,0,0,0,0,1026,1026
5734,RM-1110,5/3/2014,0,0,1026,0,0,0,1026
6300,RM-1113,1/5/2014,0,0,1026,0,0,0,1026
6418,RM-1113,5/3/2014,0,0,1026,0,0,0,1026
7077,RM-1115,5/3/2014,1026,0,0,0,0,0,1026
7721,RM-1116,3/21/2014,1026,0,0,0,0,0,1026
7764,RM-1116,5/3/2014,1026,0,0,0,0,0,1026
9094,RM-1122,3/21/2014,0,0,0,0,0,1026,1026
9704,RM-1123,1/5/2014,0,0,1026,0,0,0,1026
12994,RM-1132,1/5/2014,0,0,1026,0,0,0,1026
13679,RM-1133,1/5/2014,0,0,1026,0,0,0,1026
14277,RM-1134,3/21/2014,1026,0,0,0,0,0,1026
14320,RM-1134,5/3/2014,1026,0,0,0,0,0,1026
15589,RM-1144,5/3/2014,0,0,1026,0,0,0,1026
16231,RM-1145,3/21/2014,0,0,0,0,0,1026,1026
16247,RM-1145,5/3/2014,0,0,1026,0,0,0,1026
18989,RM-1155,5/3/2014,1026,0,0,0,0,0,1026
19547,RM-1156,1/5/2014,1026,0,0,0,0,0,1026
22983,RM-1207,5/3/2014,1026,0,0,0,0,0,1026
24238,RM-1208B,1/5/2014,0,0,1026,0,0,0,1026
25041,RM-1212,5/3/2014,1026,0,0,0,0,0,1026
25668,RM-1213,3/21/2014,0,0,0,0,0,1026,1026
26396,RM-1213A,5/3/2014,0,0,1026,0,0,0,1026
26963,RM-1217,1/5/2014,1026,0,0,0,0,0,1026
27038,RM-1217,3/21/2014,1026,0,0,0,0,0,1026
28414,RM-1221,3/21/2014,0,0,0,0,0,1026,1026
29142,RM-1223,5/3/2014,1026,0,0,0,0,0,1026
31809,RM-1231,3/21/2014,0,0,0,0,0,1026,1026
32424,RM-1236,1/5/2014,0,0,1026,0,0,0,1026
35891,RM-B109,10/24/2014,513,0,513,0,0,0,1026
35893,RM-B109,10/26/2014,513,0,513,0,0,0,1026
35894,RM-B109,10/27/2014,513,0,513,0,0,0,1026
35899,RM-B109,11/1/2014,513,0,513,0,0,0,1026
38463,RM-B215,5/3/2014,0,0,1026,0,0,0,1026
39030,RM-B220,1/5/2014,1026,0,0,0,0,0,1026
39105,RM-B220,3/21/2014,1026,0,0,0,0,0,1026
39148,RM-B220,5/3/2014,1026,0,0,0,0,0,1026
39718,RM-B222,1/5/2014,1026,0,0,0,0,0,1026
39836,RM-B222,5/3/2014,1026,0,0,0,0,0,1026
40481,RM-B224,3/21/2014,0,0,0,0,0,1026,1026
41779,RM-B230,1/5/2014,0,0,1026,0,0,0,1026
42539,RM-B230A,3/21/2014,0,0,0,0,0,1026,1026
43148,RM-B240,5/3/2014,0,0,1026,0,0,0,1026
45085,RM-B250A,3/21/2014,1026,0,0,0,0,0,1026
45128,RM-B250A,5/3/2014,1026,0,0,0,0,0,1026
45984,RM-B260,10/24/2014,513,0,513,0,0,0,1026
45986,RM-B260,10/26/2014,513,0,513,0,0,0,1026
45987,RM-B260,10/27/2014,513,0,513,0,0,0,1026
45992,RM-B260,11/1/2014,513,0,513,0,0,0,1026
47807,RM-B275,3/21/2014,0,0,0,0,0,1026,1026
2874,RM-1106,1/5/2014,0,0,0,0,0,1023,1023
4931,RM-1109,1/5/2014,0,0,0,0,0,1023,1023
6345,RM-1113,2/19/2014,0,0,1023,0,0,0,1023
9019,RM-1122,1/5/2014,0,0,0,0,0,1023,1023
10389,RM-1124,1/5/2014,0,0,0,0,0,1023,1023
15516,RM-1144,2/19/2014,0,0,1023,0,0,0,1023
16156,RM-1145,1/5/2014,0,0,0,0,0,1023,1023
25593,RM-1213,1/5/2014,0,0,0,0,0,1023,1023
26323,RM-1213A,2/19/2014,0,0,1023,0,0,0,1023
31734,RM-1231,1/5/2014,0,0,0,0,0,1023,1023
32469,RM-1236,2/19/2014,0,0,1023,0,0,0,1023
35646,RM-B109,2/19/2014,0,0,1023,0,0,0,1023
36288,RM-B200B,1/5/2014,0,0,0,0,0,1023,1023
38390,RM-B215,2/19/2014,0,0,1023,0,0,0,1023
38418,RM-B215,3/19/2014,93,0,930,0,0,0,1023
40406,RM-B224,1/5/2014,0,0,0,0,0,1023,1023
41094,RM-B225,1/5/2014,0,0,0,0,0,1023,1023
42464,RM-B230A,1/5/2014,0,0,0,0,0,1023,1023
43075,RM-B240,2/19/2014,0,0,1023,0,0,0,1023
44370,RM-B250,2/19/2014,0,0,1023,0,0,0,1023
47732,RM-B275,1/5/2014,0,0,0,0,0,1023,1023
1649,RM-1102,4/16/2014,1020,0,0,0,0,0,1020
4976,RM-1109,2/19/2014,0,0,0,0,0,1020,1020
6401,RM-1113,4/16/2014,0,0,1020,0,0,0,1020
7060,RM-1115,4/16/2014,1020,0,0,0,0,0,1020
7691,RM-1116,2/19/2014,1020,0,0,0,0,0,1020
7747,RM-1116,4/16/2014,1020,0,0,0,0,0,1020
9064,RM-1122,2/19/2014,0,0,0,0,0,1020,1020
14303,RM-1134,4/16/2014,1020,0,0,0,0,0,1020
15572,RM-1144,4/16/2014,0,0,1020,0,0,0,1020
16201,RM-1145,2/19/2014,0,0,0,0,0,1020,1020
18972,RM-1155,4/16/2014,1020,0,0,0,0,0,1020
19648,RM-1156,4/16/2014,1020,0,0,0,0,0,1020
22966,RM-1207,4/16/2014,1020,0,0,0,0,0,1020
25638,RM-1213,2/19/2014,0,0,0,0,0,1020,1020
26379,RM-1213A,4/16/2014,0,0,1020,0,0,0,1020
27008,RM-1217,2/19/2014,1020,0,0,0,0,0,1020
28384,RM-1221,2/19/2014,0,0,0,0,0,1020,1020
31779,RM-1231,2/19/2014,0,0,0,0,0,1020,1020
32525,RM-1236,4/16/2014,0,0,1020,0,0,0,1020
35898,RM-B109,10/31/2014,510,0,510,0,0,0,1020
35900,RM-B109,11/2/2014,510,0,510,0,0,0,1020
38446,RM-B215,4/16/2014,0,0,1020,0,0,0,1020
39075,RM-B220,2/19/2014,1020,0,0,0,0,0,1020
39131,RM-B220,4/16/2014,1020,0,0,0,0,0,1020
39819,RM-B222,4/16/2014,1020,0,0,0,0,0,1020
40451,RM-B224,2/19/2014,0,0,0,0,0,1020,1020
42509,RM-B230A,2/19/2014,0,0,0,0,0,1020,1020
43131,RM-B240,4/16/2014,0,0,1020,0,0,0,1020
45055,RM-B250A,2/19/2014,1020,0,0,0,0,0,1020
45991,RM-B260,10/31/2014,510,0,510,0,0,0,1020
45993,RM-B260,11/2/2014,510,0,510,0,0,0,1020
47777,RM-B275,2/19/2014,0,0,0,0,0,1020,1020
5717,RM-1110,4/16/2014,0,0,1017,0,0,0,1017
2996,RM-1106,5/7/2014,0,0,0,1014,0,0,1014
3047,RM-1106,6/27/2014,0,0,0,1014,0,0,1014
8457,RM-1117,5/8/2014,0,1014,0,0,0,0,1014
19942,RM-1156,2/6/2015,210,0,804,0,0,0,1014
35888,RM-B109,10/21/2014,507,0,507,0,0,0,1014
35889,RM-B109,10/22/2014,507,0,507,0,0,0,1014
35897,RM-B109,10/30/2014,507,0,507,0,0,0,1014
45981,RM-B260,10/21/2014,507,0,507,0,0,0,1014
45982,RM-B260,10/22/2014,507,0,507,0,0,0,1014
45990,RM-B260,10/30/2014,507,0,507,0,0,0,1014
2833,RM-1106,11/25/2013,0,0,0,0,0,1011,1011
4890,RM-1109,11/25/2013,0,0,0,0,0,1011,1011
5710,RM-1110,4/9/2014,0,0,1011,0,0,0,1011
6394,RM-1113,4/9/2014,0,0,1011,0,0,0,1011
7053,RM-1115,4/9/2014,1011,0,0,0,0,0,1011
7740,RM-1116,4/9/2014,1011,0,0,0,0,0,1011
10348,RM-1124,11/25/2013,0,0,0,0,0,1011,1011
12266,RM-1130,11/25/2013,0,0,0,0,0,1011,1011
12953,RM-1132,11/25/2013,0,0,1011,0,0,0,1011
14296,RM-1134,4/9/2014,1011,0,0,0,0,0,1011
15565,RM-1144,4/9/2014,0,0,1011,0,0,0,1011
16115,RM-1145,11/25/2013,0,0,0,0,0,1011,1011
18965,RM-1155,4/9/2014,1011,0,0,0,0,0,1011
19641,RM-1156,4/9/2014,1011,0,0,0,0,0,1011
22824,RM-1207,11/25/2013,0,0,0,0,0,1011,1011
22959,RM-1207,4/9/2014,1011,0,0,0,0,0,1011
25552,RM-1213,11/25/2013,0,0,0,0,0,1011,1011
26372,RM-1213A,4/9/2014,0,0,1011,0,0,0,1011
26922,RM-1217,11/25/2013,1011,0,0,0,0,0,1011
26936,RM-1217,12/9/2013,1011,0,0,0,0,0,1011
31693,RM-1231,11/25/2013,0,0,0,0,0,1011,1011
32518,RM-1236,4/9/2014,0,0,1011,0,0,0,1011
35011,RM-B103A,11/25/2013,0,0,0,0,0,1011,1011
35695,RM-B109,4/9/2014,0,0,1011,0,0,0,1011
36247,RM-B200B,11/25/2013,0,0,0,0,0,1011,1011
39003,RM-B220,12/9/2013,1011,0,0,0,0,0,1011
39124,RM-B220,4/9/2014,1011,0,0,0,0,0,1011
39677,RM-B222,11/25/2013,1011,0,0,0,0,0,1011
39691,RM-B222,12/9/2013,1011,0,0,0,0,0,1011
40365,RM-B224,11/25/2013,0,0,0,0,0,1011,1011
41053,RM-B225,11/25/2013,0,0,0,0,0,1011,1011
42423,RM-B230A,11/25/2013,0,0,0,0,0,1011,1011
43124,RM-B240,4/9/2014,0,0,1011,0,0,0,1011
2799,RM-1106,10/19/2013,0,0,0,0,0,1008,1008
3003,RM-1106,5/14/2014,0,0,0,1008,0,0,1008
4856,RM-1109,10/19/2013,0,0,0,0,0,1008,1008
9629,RM-1123,10/19/2013,0,0,1008,0,0,0,1008
9663,RM-1123,11/25/2013,0,0,1008,0,0,0,1008
10314,RM-1124,10/19/2013,0,0,0,0,0,1008,1008
12232,RM-1130,10/19/2013,0,0,0,0,0,1008,1008
12919,RM-1132,10/19/2013,0,0,1008,0,0,0,1008
12967,RM-1132,12/9/2013,0,0,1008,0,0,0,1008
13604,RM-1133,10/19/2013,0,0,1008,0,0,0,1008
13638,RM-1133,11/25/2013,0,0,1008,0,0,0,1008
15396,RM-1144,10/19/2013,0,0,0,0,0,1008,1008
16081,RM-1145,10/19/2013,0,0,0,0,0,1008,1008
20789,RM-1200B,10/19/2013,0,0,0,0,0,1008,1008
22790,RM-1207,10/19/2013,0,0,0,0,0,1008,1008
24882,RM-1212,11/25/2013,0,0,1008,0,0,0,1008
25518,RM-1213,10/19/2013,0,0,0,0,0,1008,1008
26888,RM-1217,10/19/2013,1008,0,0,0,0,0,1008
28264,RM-1221,10/19/2013,0,0,1008,0,0,0,1008
28298,RM-1221,11/25/2013,0,0,1008,0,0,0,1008
31659,RM-1231,10/19/2013,0,0,0,0,0,1008,1008
32383,RM-1236,11/25/2013,0,0,1008,0,0,0,1008
34977,RM-B103A,10/19/2013,0,0,0,0,0,1008,1008
35895,RM-B109,10/28/2014,504,0,504,0,0,0,1008
36213,RM-B200B,10/19/2013,0,0,0,0,0,1008,1008
39643,RM-B222,10/19/2013,1008,0,0,0,0,0,1008
40331,RM-B224,10/19/2013,0,0,0,0,0,1008,1008
41019,RM-B225,10/19/2013,0,0,0,0,0,1008,1008
42389,RM-B230A,10/19/2013,0,0,0,0,0,1008,1008
45988,RM-B260,10/28/2014,504,0,504,0,0,0,1008
46989,RM-B270,10/19/2013,0,0,1008,0,0,0,1008
35758,RM-B109,6/11/2014,501,0,504,0,0,0,1005
32531,RM-1236,4/22/2014,0,138,864,0,0,0,1002
35896,RM-B109,10/29/2014,501,0,501,0,0,0,1002
45989,RM-B260,10/29/2014,501,0,501,0,0,0,1002
2800,RM-1106,10/20/2013,0,0,0,0,0,999,999
2840,RM-1106,12/2/2013,0,0,0,0,0,999,999
4857,RM-1109,10/20/2013,0,0,0,0,0,999,999
4897,RM-1109,12/2/2013,0,0,0,0,0,999,999
8985,RM-1122,12/2/2013,0,0,0,0,0,999,999
9630,RM-1123,10/20/2013,0,0,999,0,0,0,999
9670,RM-1123,12/2/2013,0,0,999,0,0,0,999
10315,RM-1124,10/20/2013,0,0,0,0,0,999,999
10355,RM-1124,12/2/2013,0,0,0,0,0,999,999
12233,RM-1130,10/20/2013,0,0,0,0,0,999,999
12273,RM-1130,12/2/2013,0,0,0,0,0,999,999
12920,RM-1132,10/20/2013,0,0,999,0,0,0,999
12960,RM-1132,12/2/2013,0,0,999,0,0,0,999
13605,RM-1133,10/20/2013,0,0,999,0,0,0,999
13645,RM-1133,12/2/2013,0,0,999,0,0,0,999
15397,RM-1144,10/20/2013,0,0,0,0,0,999,999
16082,RM-1145,10/20/2013,0,0,0,0,0,999,999
16122,RM-1145,12/2/2013,0,0,0,0,0,999,999
20790,RM-1200B,10/20/2013,0,0,0,0,0,999,999
22791,RM-1207,10/20/2013,0,0,0,0,0,999,999
22831,RM-1207,12/2/2013,0,0,0,0,0,999,999
24889,RM-1212,12/2/2013,0,0,999,0,0,0,999
25519,RM-1213,10/20/2013,0,0,0,0,0,999,999
25559,RM-1213,12/2/2013,0,0,0,0,0,999,999
26889,RM-1217,10/20/2013,999,0,0,0,0,0,999
26929,RM-1217,12/2/2013,999,0,0,0,0,0,999
28265,RM-1221,10/20/2013,0,0,999,0,0,0,999
28305,RM-1221,12/2/2013,0,0,999,0,0,0,999
31660,RM-1231,10/20/2013,0,0,0,0,0,999,999
31700,RM-1231,12/2/2013,0,0,0,0,0,999,999
32390,RM-1236,12/2/2013,0,0,999,0,0,0,999
34978,RM-B103A,10/20/2013,0,0,0,0,0,999,999
36214,RM-B200B,10/20/2013,0,0,0,0,0,999,999
36254,RM-B200B,12/2/2013,0,0,0,0,0,999,999
39644,RM-B222,10/20/2013,999,0,0,0,0,0,999
39684,RM-B222,12/2/2013,999,0,0,0,0,0,999
40332,RM-B224,10/20/2013,0,0,0,0,0,999,999
40372,RM-B224,12/2/2013,0,0,0,0,0,999,999
41020,RM-B225,10/20/2013,0,0,0,0,0,999,999
41060,RM-B225,12/2/2013,0,0,0,0,0,999,999
42390,RM-B230A,10/20/2013,0,0,0,0,0,999,999
42430,RM-B230A,12/2/2013,0,0,0,0,0,999,999
46990,RM-B270,10/20/2013,0,0,999,0,0,0,999
47698,RM-B275,12/2/2013,0,0,0,0,0,999,999
297,RM-1100A,5/4/2014,996,0,0,0,0,0,996
1667,RM-1102,5/4/2014,996,0,0,0,0,0,996
2875,RM-1106,1/6/2014,0,0,0,0,0,996,996
4932,RM-1109,1/6/2014,0,0,0,0,0,996,996
5718,RM-1110,4/17/2014,0,0,996,0,0,0,996
5735,RM-1110,5/4/2014,0,0,996,0,0,0,996
6402,RM-1113,4/17/2014,0,0,996,0,0,0,996
6419,RM-1113,5/4/2014,0,0,996,0,0,0,996
7078,RM-1115,5/4/2014,996,0,0,0,0,0,996
7765,RM-1116,5/4/2014,996,0,0,0,0,0,996
8459,RM-1117,5/10/2014,0,996,0,0,0,0,996
9020,RM-1122,1/6/2014,0,0,0,0,0,996,996
10390,RM-1124,1/6/2014,0,0,0,0,0,996,996
12995,RM-1132,1/6/2014,0,0,996,0,0,0,996
14321,RM-1134,5/4/2014,996,0,0,0,0,0,996
15573,RM-1144,4/17/2014,0,0,996,0,0,0,996
15590,RM-1144,5/4/2014,0,0,996,0,0,0,996
16157,RM-1145,1/6/2014,0,0,0,0,0,996,996
16248,RM-1145,5/4/2014,0,0,996,0,0,0,996
18990,RM-1155,5/4/2014,996,0,0,0,0,0,996
19548,RM-1156,1/6/2014,996,0,0,0,0,0,996
22984,RM-1207,5/4/2014,996,0,0,0,0,0,996
25042,RM-1212,5/4/2014,996,0,0,0,0,0,996
25594,RM-1213,1/6/2014,0,0,0,0,0,996,996
26380,RM-1213A,4/17/2014,0,0,996,0,0,0,996
26397,RM-1213A,5/4/2014,0,0,996,0,0,0,996
26964,RM-1217,1/6/2014,996,0,0,0,0,0,996
29143,RM-1223,5/4/2014,996,0,0,0,0,0,996
31735,RM-1231,1/6/2014,0,0,0,0,0,996,996
32526,RM-1236,4/17/2014,0,0,996,0,0,0,996
36289,RM-B200B,1/6/2014,0,0,0,0,0,996,996
38447,RM-B215,4/17/2014,0,0,996,0,0,0,996
38464,RM-B215,5/4/2014,0,0,996,0,0,0,996
39031,RM-B220,1/6/2014,996,0,0,0,0,0,996
39149,RM-B220,5/4/2014,996,0,0,0,0,0,996
39719,RM-B222,1/6/2014,996,0,0,0,0,0,996
39837,RM-B222,5/4/2014,996,0,0,0,0,0,996
40407,RM-B224,1/6/2014,0,0,0,0,0,996,996
41095,RM-B225,1/6/2014,0,0,0,0,0,996,996
42465,RM-B230A,1/6/2014,0,0,0,0,0,996,996
43132,RM-B240,4/17/2014,0,0,996,0,0,0,996
43149,RM-B240,5/4/2014,0,0,996,0,0,0,996
45129,RM-B250A,5/4/2014,996,0,0,0,0,0,996
47733,RM-B275,1/6/2014,0,0,0,0,0,996,996
1650,RM-1102,4/17/2014,993,0,0,0,0,0,993
6301,RM-1113,1/6/2014,0,0,993,0,0,0,993
6353,RM-1113,2/27/2014,0,0,993,0,0,0,993
7061,RM-1115,4/17/2014,993,0,0,0,0,0,993
7748,RM-1116,4/17/2014,993,0,0,0,0,0,993
9627,RM-1123,10/17/2013,0,0,993,0,0,0,993
9705,RM-1123,1/6/2014,0,0,993,0,0,0,993
13602,RM-1133,10/17/2013,0,0,993,0,0,0,993
13680,RM-1133,1/6/2014,0,0,993,0,0,0,993
14304,RM-1134,4/17/2014,993,0,0,0,0,0,993
15472,RM-1144,1/6/2014,0,0,993,0,0,0,993
15524,RM-1144,2/27/2014,0,0,993,0,0,0,993
18973,RM-1155,4/17/2014,993,0,0,0,0,0,993
19649,RM-1156,4/17/2014,993,0,0,0,0,0,993
22967,RM-1207,4/17/2014,993,0,0,0,0,0,993
24239,RM-1208B,1/6/2014,0,0,993,0,0,0,993
26331,RM-1213A,2/27/2014,0,0,993,0,0,0,993
28262,RM-1221,10/17/2013,0,0,993,0,0,0,993
32425,RM-1236,1/6/2014,0,0,993,0,0,0,993
32477,RM-1236,2/27/2014,0,0,993,0,0,0,993
35654,RM-B109,2/27/2014,0,0,993,0,0,0,993
38398,RM-B215,2/27/2014,0,0,993,0,0,0,993
39132,RM-B220,4/17/2014,993,0,0,0,0,0,993
39820,RM-B222,4/17/2014,993,0,0,0,0,0,993
41780,RM-B230,1/6/2014,0,0,993,0,0,0,993
43083,RM-B240,2/27/2014,0,0,993,0,0,0,993
44378,RM-B250,2/27/2014,0,0,993,0,0,0,993
46987,RM-B270,10/17/2013,0,0,993,0,0,0,993
288,RM-1100A,4/25/2014,990,0,0,0,0,0,990
1658,RM-1102,4/25/2014,990,0,0,0,0,0,990
2797,RM-1106,10/17/2013,0,0,0,0,0,990,990
2841,RM-1106,12/3/2013,0,0,0,0,0,990,990
4365,RM-1108,5/7/2014,0,990,0,0,0,0,990
4854,RM-1109,10/17/2013,0,0,0,0,0,990,990
4898,RM-1109,12/3/2013,0,0,0,0,0,990,990
5726,RM-1110,4/25/2014,0,0,990,0,0,0,990
5730,RM-1110,4/29/2014,0,0,990,0,0,0,990
6410,RM-1113,4/25/2014,0,0,990,0,0,0,990
6414,RM-1113,4/29/2014,0,0,990,0,0,0,990
7069,RM-1115,4/25/2014,990,0,0,0,0,0,990
7756,RM-1116,4/25/2014,990,0,0,0,0,0,990
8465,RM-1117,5/16/2014,0,990,0,0,0,0,990
8986,RM-1122,12/3/2013,0,0,0,0,0,990,990
10312,RM-1124,10/17/2013,0,0,0,0,0,990,990
10356,RM-1124,12/3/2013,0,0,0,0,0,990,990
12230,RM-1130,10/17/2013,0,0,0,0,0,990,990
12274,RM-1130,12/3/2013,0,0,0,0,0,990,990
12917,RM-1132,10/17/2013,0,0,990,0,0,0,990
14312,RM-1134,4/25/2014,990,0,0,0,0,0,990
15394,RM-1144,10/17/2013,0,0,0,0,0,990,990
15581,RM-1144,4/25/2014,0,0,990,0,0,0,990
15585,RM-1144,4/29/2014,0,0,990,0,0,0,990
16079,RM-1145,10/17/2013,0,0,0,0,0,990,990
16123,RM-1145,12/3/2013,0,0,0,0,0,990,990
16243,RM-1145,4/29/2014,0,0,990,0,0,0,990
18981,RM-1155,4/25/2014,990,0,0,0,0,0,990
20787,RM-1200B,10/17/2013,0,0,0,0,0,990,990
22788,RM-1207,10/17/2013,0,0,0,0,0,990,990
22832,RM-1207,12/3/2013,0,0,0,0,0,990,990
22975,RM-1207,4/25/2014,990,0,0,0,0,0,990
25033,RM-1212,4/25/2014,990,0,0,0,0,0,990
25516,RM-1213,10/17/2013,0,0,0,0,0,990,990
25560,RM-1213,12/3/2013,0,0,0,0,0,990,990
26388,RM-1213A,4/25/2014,0,0,990,0,0,0,990
26392,RM-1213A,4/29/2014,0,0,990,0,0,0,990
26886,RM-1217,10/17/2013,990,0,0,0,0,0,990
31657,RM-1231,10/17/2013,0,0,0,0,0,990,990
31701,RM-1231,12/3/2013,0,0,0,0,0,990,990
34975,RM-B103A,10/17/2013,0,0,0,0,0,990,990
36211,RM-B200B,10/17/2013,0,0,0,0,0,990,990
36255,RM-B200B,12/3/2013,0,0,0,0,0,990,990
38455,RM-B215,4/25/2014,0,0,990,0,0,0,990
38459,RM-B215,4/29/2014,0,0,990,0,0,0,990
39140,RM-B220,4/25/2014,990,0,0,0,0,0,990
39641,RM-B222,10/17/2013,990,0,0,0,0,0,990
39828,RM-B222,4/25/2014,990,0,0,0,0,0,990
40329,RM-B224,10/17/2013,0,0,0,0,0,990,990
40373,RM-B224,12/3/2013,0,0,0,0,0,990,990
41017,RM-B225,10/17/2013,0,0,0,0,0,990,990
41061,RM-B225,12/3/2013,0,0,0,0,0,990,990
42387,RM-B230A,10/17/2013,0,0,0,0,0,990,990
42431,RM-B230A,12/3/2013,0,0,0,0,0,990,990
43140,RM-B240,4/25/2014,0,0,990,0,0,0,990
43144,RM-B240,4/29/2014,0,0,990,0,0,0,990
45120,RM-B250A,4/25/2014,990,0,0,0,0,0,990
47699,RM-B275,12/3/2013,0,0,0,0,0,990,990
292,RM-1100A,4/29/2014,987,0,0,0,0,0,987
1662,RM-1102,4/29/2014,987,0,0,0,0,0,987
7073,RM-1115,4/29/2014,987,0,0,0,0,0,987
7760,RM-1116,4/29/2014,987,0,0,0,0,0,987
9671,RM-1123,12/3/2013,0,0,987,0,0,0,987
12961,RM-1132,12/3/2013,0,0,987,0,0,0,987
13646,RM-1133,12/3/2013,0,0,987,0,0,0,987
14316,RM-1134,4/29/2014,987,0,0,0,0,0,987
18985,RM-1155,4/29/2014,987,0,0,0,0,0,987
22979,RM-1207,4/29/2014,987,0,0,0,0,0,987
24890,RM-1212,12/3/2013,0,0,987,0,0,0,987
25037,RM-1212,4/29/2014,987,0,0,0,0,0,987
26930,RM-1217,12/3/2013,987,0,0,0,0,0,987
28306,RM-1221,12/3/2013,0,0,987,0,0,0,987
29138,RM-1223,4/29/2014,987,0,0,0,0,0,987
32391,RM-1236,12/3/2013,0,0,987,0,0,0,987
39144,RM-B220,4/29/2014,987,0,0,0,0,0,987
39685,RM-B222,12/3/2013,987,0,0,0,0,0,987
39832,RM-B222,4/29/2014,987,0,0,0,0,0,987
45124,RM-B250A,4/29/2014,987,0,0,0,0,0,987
4989,RM-1109,3/4/2014,0,0,0,0,0,984,984
6358,RM-1113,3/4/2014,0,0,984,0,0,0,984
7704,RM-1116,3/4/2014,984,0,0,0,0,0,984
8461,RM-1117,5/12/2014,0,984,0,0,0,0,984
9077,RM-1122,3/4/2014,0,0,0,0,0,984,984
15529,RM-1144,3/4/2014,0,0,984,0,0,0,984
16214,RM-1145,3/4/2014,0,0,0,0,0,984,984
24429,RM-1208B,7/15/2014,492,0,492,0,0,0,984
25651,RM-1213,3/4/2014,0,0,0,0,0,984,984
26336,RM-1213A,3/4/2014,0,0,984,0,0,0,984
27021,RM-1217,3/4/2014,984,0,0,0,0,0,984
28397,RM-1221,3/4/2014,0,0,0,0,0,984,984
31792,RM-1231,3/4/2014,0,0,0,0,0,984,984
32482,RM-1236,3/4/2014,0,0,984,0,0,0,984
35659,RM-B109,3/4/2014,0,0,984,0,0,0,984
35792,RM-B109,7/15/2014,492,0,492,0,0,0,984
38403,RM-B215,3/4/2014,0,0,984,0,0,0,984
39088,RM-B220,3/4/2014,984,0,0,0,0,0,984
40464,RM-B224,3/4/2014,0,0,0,0,0,984,984
42522,RM-B230A,3/4/2014,0,0,0,0,0,984,984
43088,RM-B240,3/4/2014,0,0,984,0,0,0,984
44383,RM-B250,3/4/2014,0,0,984,0,0,0,984
45068,RM-B250A,3/4/2014,984,0,0,0,0,0,984
47790,RM-B275,3/4/2014,0,0,0,0,0,984,984
301,RM-1100A,5/8/2014,981,0,0,0,0,0,981
1671,RM-1102,5/8/2014,981,0,0,0,0,0,981
5738,RM-1110,5/8/2014,0,0,981,0,0,0,981
6424,RM-1113,5/9/2014,0,0,981,0,0,0,981
7082,RM-1115,5/8/2014,981,0,0,0,0,0,981
7769,RM-1116,5/8/2014,981,0,0,0,0,0,981
14324,RM-1134,5/8/2014,981,0,0,0,0,0,981
15595,RM-1144,5/9/2014,0,0,981,0,0,0,981
16252,RM-1145,5/8/2014,0,0,981,0,0,0,981
18994,RM-1155,5/8/2014,981,0,0,0,0,0,981
22988,RM-1207,5/8/2014,981,0,0,0,0,0,981
25046,RM-1212,5/8/2014,981,0,0,0,0,0,981
26402,RM-1213A,5/9/2014,0,0,981,0,0,0,981
29147,RM-1223,5/8/2014,981,0,0,0,0,0,981
38468,RM-B215,5/8/2014,0,0,981,0,0,0,981
39153,RM-B220,5/8/2014,981,0,0,0,0,0,981
39841,RM-B222,5/8/2014,981,0,0,0,0,0,981
43153,RM-B240,5/8/2014,0,0,981,0,0,0,981
45132,RM-B250A,5/8/2014,981,0,0,0,0,0,981
302,RM-1100A,5/9/2014,978,0,0,0,0,0,978
1672,RM-1102,5/9/2014,978,0,0,0,0,0,978
4984,RM-1109,2/27/2014,0,0,0,0,0,978,978
5739,RM-1110,5/9/2014,0,0,978,0,0,0,978
6423,RM-1113,5/8/2014,0,0,978,0,0,0,978
7083,RM-1115,5/9/2014,978,0,0,0,0,0,978
7699,RM-1116,2/27/2014,978,0,0,0,0,0,978
7770,RM-1116,5/9/2014,978,0,0,0,0,0,978
8460,RM-1117,5/11/2014,0,978,0,0,0,0,978
9072,RM-1122,2/27/2014,0,0,0,0,0,978,978
14325,RM-1134,5/9/2014,978,0,0,0,0,0,978
15594,RM-1144,5/8/2014,0,0,978,0,0,0,978
16209,RM-1145,2/27/2014,0,0,0,0,0,978,978
16253,RM-1145,5/9/2014,0,0,978,0,0,0,978
18995,RM-1155,5/9/2014,978,0,0,0,0,0,978
22989,RM-1207,5/9/2014,978,0,0,0,0,0,978
25047,RM-1212,5/9/2014,978,0,0,0,0,0,978
25646,RM-1213,2/27/2014,0,0,0,0,0,978,978
26401,RM-1213A,5/8/2014,0,0,978,0,0,0,978
27016,RM-1217,2/27/2014,978,0,0,0,0,0,978
28392,RM-1221,2/27/2014,0,0,0,0,0,978,978
29148,RM-1223,5/9/2014,978,0,0,0,0,0,978
31787,RM-1231,2/27/2014,0,0,0,0,0,978,978
38469,RM-B215,5/9/2014,0,0,978,0,0,0,978
39083,RM-B220,2/27/2014,978,0,0,0,0,0,978
39154,RM-B220,5/9/2014,978,0,0,0,0,0,978
39842,RM-B222,5/9/2014,978,0,0,0,0,0,978
40459,RM-B224,2/27/2014,0,0,0,0,0,978,978
42517,RM-B230A,2/27/2014,0,0,0,0,0,978,978
43154,RM-B240,5/9/2014,0,0,978,0,0,0,978
45063,RM-B250A,2/27/2014,978,0,0,0,0,0,978
45133,RM-B250A,5/9/2014,978,0,0,0,0,0,978
47785,RM-B275,2/27/2014,0,0,0,0,0,978,978
2845,RM-1106,12/7/2013,0,0,0,0,0,972,972
4902,RM-1109,12/7/2013,0,0,0,0,0,972,972
8990,RM-1122,12/7/2013,0,0,0,0,0,972,972
9675,RM-1123,12/7/2013,0,0,972,0,0,0,972
10360,RM-1124,12/7/2013,0,0,0,0,0,972,972
12278,RM-1130,12/7/2013,0,0,0,0,0,972,972
12965,RM-1132,12/7/2013,0,0,972,0,0,0,972
13650,RM-1133,12/7/2013,0,0,972,0,0,0,972
16127,RM-1145,12/7/2013,0,0,0,0,0,972,972
22836,RM-1207,12/7/2013,0,0,0,0,0,972,972
24209,RM-1208B,12/7/2013,0,0,972,0,0,0,972
24894,RM-1212,12/7/2013,0,0,972,0,0,0,972
25564,RM-1213,12/7/2013,0,0,0,0,0,972,972
26934,RM-1217,12/7/2013,972,0,0,0,0,0,972
28310,RM-1221,12/7/2013,0,0,972,0,0,0,972
31705,RM-1231,12/7/2013,0,0,0,0,0,972,972
32395,RM-1236,12/7/2013,0,0,972,0,0,0,972
36259,RM-B200B,12/7/2013,0,0,0,0,0,972,972
39001,RM-B220,12/7/2013,972,0,0,0,0,0,972
39689,RM-B222,12/7/2013,972,0,0,0,0,0,972
40377,RM-B224,12/7/2013,0,0,0,0,0,972,972
41065,RM-B225,12/7/2013,0,0,0,0,0,972,972
42435,RM-B230A,12/7/2013,0,0,0,0,0,972,972
47703,RM-B275,12/7/2013,0,0,0,0,0,972,972
2362,RM-1104,5/14/2014,0,966,0,0,0,0,966
2844,RM-1106,12/6/2013,0,0,0,0,0,966,966
4901,RM-1109,12/6/2013,0,0,0,0,0,966,966
6303,RM-1113,1/8/2014,0,0,966,0,0,0,966
8989,RM-1122,12/6/2013,0,0,0,0,0,966,966
9674,RM-1123,12/6/2013,0,0,966,0,0,0,966
9707,RM-1123,1/8/2014,0,0,966,0,0,0,966
10359,RM-1124,12/6/2013,0,0,0,0,0,966,966
12277,RM-1130,12/6/2013,0,0,0,0,0,966,966
12964,RM-1132,12/6/2013,0,0,966,0,0,0,966
13649,RM-1133,12/6/2013,0,0,966,0,0,0,966
15474,RM-1144,1/8/2014,0,0,966,0,0,0,966
16126,RM-1145,12/6/2013,0,0,0,0,0,966,966
22835,RM-1207,12/6/2013,0,0,0,0,0,966,966
24208,RM-1208B,12/6/2013,0,0,966,0,0,0,966
24241,RM-1208B,1/8/2014,0,0,966,0,0,0,966
24893,RM-1212,12/6/2013,0,0,966,0,0,0,966
25563,RM-1213,12/6/2013,0,0,0,0,0,966,966
26933,RM-1217,12/6/2013,966,0,0,0,0,0,966
28309,RM-1221,12/6/2013,0,0,966,0,0,0,966
31704,RM-1231,12/6/2013,0,0,0,0,0,966,966
32394,RM-1236,12/6/2013,0,0,966,0,0,0,966
32427,RM-1236,1/8/2014,0,0,966,0,0,0,966
36258,RM-B200B,12/6/2013,0,0,0,0,0,966,966
39688,RM-B222,12/6/2013,966,0,0,0,0,0,966
40376,RM-B224,12/6/2013,0,0,0,0,0,966,966
41064,RM-B225,12/6/2013,0,0,0,0,0,966,966
42434,RM-B230A,12/6/2013,0,0,0,0,0,966,966
47702,RM-B275,12/6/2013,0,0,0,0,0,966,966
1651,RM-1102,4/18/2014,963,0,0,0,0,0,963
2745,RM-1106,8/17/2013,480,0,0,0,0,483,963
2846,RM-1106,12/8/2013,0,0,0,0,0,963,963
2877,RM-1106,1/8/2014,0,0,0,0,0,963,963
4903,RM-1109,12/8/2013,0,0,0,0,0,963,963
4934,RM-1109,1/8/2014,0,0,0,0,0,963,963
5719,RM-1110,4/18/2014,0,0,963,0,0,0,963
6962,RM-1115,1/8/2014,0,0,0,0,0,963,963
7062,RM-1115,4/18/2014,963,0,0,0,0,0,963
7517,RM-1116,8/17/2013,0,0,480,0,0,483,963
7649,RM-1116,1/8/2014,963,0,0,0,0,0,963
7749,RM-1116,4/18/2014,963,0,0,0,0,0,963
8205,RM-1117,8/17/2013,480,0,0,0,0,483,963
8991,RM-1122,12/8/2013,0,0,0,0,0,963,963
9022,RM-1122,1/8/2014,0,0,0,0,0,963,963
9676,RM-1123,12/8/2013,0,0,963,0,0,0,963
10361,RM-1124,12/8/2013,0,0,0,0,0,963,963
10392,RM-1124,1/8/2014,0,0,0,0,0,963,963
12279,RM-1130,12/8/2013,0,0,0,0,0,963,963
12966,RM-1132,12/8/2013,0,0,963,0,0,0,963
12997,RM-1132,1/8/2014,0,0,963,0,0,0,963
13651,RM-1133,12/8/2013,0,0,963,0,0,0,963
14305,RM-1134,4/18/2014,963,0,0,0,0,0,963
15324,RM-1144,7/30/2013,0,0,0,0,0,963,963
16128,RM-1145,12/8/2013,0,0,0,0,0,963,963
16159,RM-1145,1/8/2014,0,0,0,0,0,963,963
18974,RM-1155,4/18/2014,963,0,0,0,0,0,963
19550,RM-1156,1/8/2014,963,0,0,0,0,0,963
19650,RM-1156,4/18/2014,963,0,0,0,0,0,963
22837,RM-1207,12/8/2013,0,0,0,0,0,963,963
22968,RM-1207,4/18/2014,963,0,0,0,0,0,963
24210,RM-1208B,12/8/2013,0,0,963,0,0,0,963
24895,RM-1212,12/8/2013,0,0,963,0,0,0,963
25565,RM-1213,12/8/2013,0,0,0,0,0,963,963
25596,RM-1213,1/8/2014,0,0,0,0,0,963,963
26935,RM-1217,12/8/2013,963,0,0,0,0,0,963
28311,RM-1221,12/8/2013,0,0,963,0,0,0,963
31706,RM-1231,12/8/2013,0,0,0,0,0,963,963
31737,RM-1231,1/8/2014,0,0,0,0,0,963,963
32396,RM-1236,12/8/2013,0,0,963,0,0,0,963
36260,RM-B200B,12/8/2013,0,0,0,0,0,963,963
36840,RM-B200C,8/17/2013,0,0,480,0,0,483,963
38216,RM-B215,8/17/2013,480,0,0,0,0,483,963
39002,RM-B220,12/8/2013,963,0,0,0,0,0,963
39033,RM-B220,1/8/2014,963,0,0,0,0,0,963
39133,RM-B220,4/18/2014,963,0,0,0,0,0,963
39155,RM-B220,5/10/2014,963,0,0,0,0,0,963
39690,RM-B222,12/8/2013,963,0,0,0,0,0,963
39721,RM-B222,1/8/2014,963,0,0,0,0,0,963
39821,RM-B222,4/18/2014,963,0,0,0,0,0,963
39843,RM-B222,5/10/2014,963,0,0,0,0,0,963
40277,RM-B224,8/17/2013,0,0,480,0,0,483,963
40378,RM-B224,12/8/2013,0,0,0,0,0,963,963
40409,RM-B224,1/8/2014,0,0,0,0,0,963,963
41066,RM-B225,12/8/2013,0,0,0,0,0,963,963
41097,RM-B225,1/8/2014,0,0,0,0,0,963,963
42436,RM-B230A,12/8/2013,0,0,0,0,0,963,963
42467,RM-B230A,1/8/2014,0,0,0,0,0,963,963
45134,RM-B250A,5/10/2014,963,0,0,0,0,0,963
47603,RM-B275,8/17/2013,0,0,480,0,0,483,963
47704,RM-B275,12/8/2013,0,0,0,0,0,963,963
303,RM-1100A,5/10/2014,960,0,0,0,0,0,960
1673,RM-1102,5/10/2014,960,0,0,0,0,0,960
5740,RM-1110,5/10/2014,0,0,960,0,0,0,960
6403,RM-1113,4/18/2014,0,0,960,0,0,0,960
6425,RM-1113,5/10/2014,0,0,960,0,0,0,960
7084,RM-1115,5/10/2014,960,0,0,0,0,0,960
7771,RM-1116,5/10/2014,960,0,0,0,0,0,960
14326,RM-1134,5/10/2014,960,0,0,0,0,0,960
15574,RM-1144,4/18/2014,0,0,960,0,0,0,960
15596,RM-1144,5/10/2014,0,0,960,0,0,0,960
16254,RM-1145,5/10/2014,0,0,960,0,0,0,960
18742,RM-1155,8/17/2013,480,0,480,0,0,0,960
18996,RM-1155,5/10/2014,960,0,0,0,0,0,960
22990,RM-1207,5/10/2014,960,0,0,0,0,0,960
23421,RM-1208,8/17/2013,477,0,0,0,0,483,960
25048,RM-1212,5/10/2014,960,0,0,0,0,0,960
26381,RM-1213A,4/18/2014,0,0,960,0,0,0,960
26403,RM-1213A,5/10/2014,0,0,960,0,0,0,960
29149,RM-1223,5/10/2014,960,0,0,0,0,0,960
30268,RM-1229,8/17/2013,480,0,480,0,0,0,960
32295,RM-1236,8/17/2013,480,0,480,0,0,0,960
32527,RM-1236,4/18/2014,0,0,960,0,0,0,960
35864,RM-B109,9/25/2014,480,0,480,0,0,0,960
38470,RM-B215,5/10/2014,0,0,960,0,0,0,960
39589,RM-B222,8/17/2013,480,0,480,0,0,0,960
43133,RM-B240,4/18/2014,0,0,960,0,0,0,960
43155,RM-B240,5/10/2014,0,0,960,0,0,0,960
45942,RM-B260,9/10/2014,762,0,198,0,0,0,960
45957,RM-B260,9/25/2014,480,0,480,0,0,0,960
5711,RM-1110,4/10/2014,0,0,957,0,0,0,957
7054,RM-1115,4/10/2014,957,0,0,0,0,0,957
7741,RM-1116,4/10/2014,957,0,0,0,0,0,957
14297,RM-1134,4/10/2014,957,0,0,0,0,0,957
18966,RM-1155,4/10/2014,957,0,0,0,0,0,957
19642,RM-1156,4/10/2014,957,0,0,0,0,0,957
22960,RM-1207,4/10/2014,957,0,0,0,0,0,957
39125,RM-B220,4/10/2014,957,0,0,0,0,0,957
4993,RM-1109,3/8/2014,0,0,0,0,0,954,954
6362,RM-1113,3/8/2014,0,0,954,0,0,0,954
6395,RM-1113,4/10/2014,0,0,954,0,0,0,954
7708,RM-1116,3/8/2014,954,0,0,0,0,0,954
9081,RM-1122,3/8/2014,0,0,0,0,0,954,954
15533,RM-1144,3/8/2014,0,0,954,0,0,0,954
15566,RM-1144,4/10/2014,0,0,954,0,0,0,954
16218,RM-1145,3/8/2014,0,0,0,0,0,954,954
25655,RM-1213,3/8/2014,0,0,0,0,0,954,954
26340,RM-1213A,3/8/2014,0,0,954,0,0,0,954
26373,RM-1213A,4/10/2014,0,0,954,0,0,0,954
27025,RM-1217,3/8/2014,954,0,0,0,0,0,954
28401,RM-1221,3/8/2014,0,0,0,0,0,954,954
31796,RM-1231,3/8/2014,0,0,0,0,0,954,954
32486,RM-1236,3/8/2014,0,0,954,0,0,0,954
32519,RM-1236,4/10/2014,0,0,954,0,0,0,954
35663,RM-B109,3/8/2014,0,0,954,0,0,0,954
35696,RM-B109,4/10/2014,0,0,954,0,0,0,954
38407,RM-B215,3/8/2014,0,0,954,0,0,0,954
38440,RM-B215,4/10/2014,0,0,954,0,0,0,954
39092,RM-B220,3/8/2014,954,0,0,0,0,0,954
40468,RM-B224,3/8/2014,0,0,0,0,0,954,954
42526,RM-B230A,3/8/2014,0,0,0,0,0,954,954
43092,RM-B240,3/8/2014,0,0,954,0,0,0,954
43125,RM-B240,4/10/2014,0,0,954,0,0,0,954
44387,RM-B250,3/8/2014,0,0,954,0,0,0,954
45072,RM-B250A,3/8/2014,954,0,0,0,0,0,954
47794,RM-B275,3/8/2014,0,0,0,0,0,954,954
3426,RM-1107,8/13/2013,0,0,951,0,0,0,951
4992,RM-1109,3/7/2014,0,0,0,0,0,951,951
6167,RM-1113,8/13/2013,0,0,951,0,0,0,951
6361,RM-1113,3/7/2014,0,0,951,0,0,0,951
7707,RM-1116,3/7/2014,951,0,0,0,0,0,951
8886,RM-1122,8/13/2013,0,0,951,0,0,0,951
9080,RM-1122,3/7/2014,0,0,0,0,0,951,951
9571,RM-1123,8/13/2013,0,0,951,0,0,0,951
13546,RM-1133,8/13/2013,0,0,951,0,0,0,951
15532,RM-1144,3/7/2014,0,0,951,0,0,0,951
16217,RM-1145,3/7/2014,0,0,0,0,0,951,951
25460,RM-1213,8/13/2013,0,0,951,0,0,0,951
25654,RM-1213,3/7/2014,0,0,0,0,0,951,951
26339,RM-1213A,3/7/2014,0,0,951,0,0,0,951
27024,RM-1217,3/7/2014,951,0,0,0,0,0,951
28400,RM-1221,3/7/2014,0,0,0,0,0,951,951
31795,RM-1231,3/7/2014,0,0,0,0,0,951,951
32485,RM-1236,3/7/2014,0,0,951,0,0,0,951
33703,RM-B102C,8/13/2013,0,0,951,0,0,0,951
35662,RM-B109,3/7/2014,0,0,951,0,0,0,951
38406,RM-B215,3/7/2014,0,0,951,0,0,0,951
39091,RM-B220,3/7/2014,951,0,0,0,0,0,951
40467,RM-B224,3/7/2014,0,0,0,0,0,951,951
42525,RM-B230A,3/7/2014,0,0,0,0,0,951,951
43091,RM-B240,3/7/2014,0,0,951,0,0,0,951
44386,RM-B250,3/7/2014,0,0,951,0,0,0,951
45071,RM-B250A,3/7/2014,951,0,0,0,0,0,951
46931,RM-B270,8/13/2013,0,0,951,0,0,0,951
47793,RM-B275,3/7/2014,0,0,0,0,0,951,951
8458,RM-1117,5/9/2014,0,948,0,0,0,0,948
12174,RM-1130,8/13/2013,0,0,0,0,0,948,948
15338,RM-1144,8/13/2013,0,0,0,0,0,948,948
26145,RM-1213A,8/13/2013,0,0,0,0,0,948,948
31601,RM-1231,8/13/2013,0,0,0,0,0,948,948
34919,RM-B103A,8/13/2013,0,0,0,0,0,948,948
40961,RM-B225,8/13/2013,0,0,0,0,0,948,948
42331,RM-B230A,8/13/2013,0,0,0,0,0,948,948
43582,RM-B240A,8/13/2013,0,0,0,0,0,948,948
304,RM-1100A,5/11/2014,945,0,0,0,0,0,945
1674,RM-1102,5/11/2014,945,0,0,0,0,0,945
2882,RM-1106,1/13/2014,0,0,0,0,0,945,945
4939,RM-1109,1/13/2014,0,0,0,0,0,945,945
5741,RM-1110,5/11/2014,0,0,945,0,0,0,945
6967,RM-1115,1/13/2014,0,0,0,0,0,945,945
7085,RM-1115,5/11/2014,945,0,0,0,0,0,945
7654,RM-1116,1/13/2014,945,0,0,0,0,0,945
7772,RM-1116,5/11/2014,945,0,0,0,0,0,945
9027,RM-1122,1/13/2014,0,0,0,0,0,945,945
10397,RM-1124,1/13/2014,0,0,0,0,0,945,945
13002,RM-1132,1/13/2014,0,0,945,0,0,0,945
14327,RM-1134,5/11/2014,945,0,0,0,0,0,945
15471,RM-1144,1/5/2014,0,0,945,0,0,0,945
16164,RM-1145,1/13/2014,0,0,0,0,0,945,945
18050,RM-1154,8/13/2013,945,0,0,0,0,0,945
18997,RM-1155,5/11/2014,945,0,0,0,0,0,945
19555,RM-1156,1/13/2014,945,0,0,0,0,0,945
20731,RM-1200B,8/13/2013,0,0,0,0,0,945,945
22991,RM-1207,5/11/2014,945,0,0,0,0,0,945
25049,RM-1212,5/11/2014,945,0,0,0,0,0,945
25601,RM-1213,1/13/2014,0,0,0,0,0,945,945
26830,RM-1217,8/13/2013,945,0,0,0,0,0,945
26971,RM-1217,1/13/2014,945,0,0,0,0,0,945
29150,RM-1223,5/11/2014,945,0,0,0,0,0,945
31742,RM-1231,1/13/2014,0,0,0,0,0,945,945
36296,RM-B200B,1/13/2014,0,0,0,0,0,945,945
39038,RM-B220,1/13/2014,945,0,0,0,0,0,945
39726,RM-B222,1/13/2014,945,0,0,0,0,0,945
40414,RM-B224,1/13/2014,0,0,0,0,0,945,945
41102,RM-B225,1/13/2014,0,0,0,0,0,945,945
42472,RM-B230A,1/13/2014,0,0,0,0,0,945,945
44192,RM-B250,8/13/2013,945,0,0,0,0,0,945
47740,RM-B275,1/13/2014,0,0,0,0,0,945,945
6308,RM-1113,1/13/2014,0,0,942,0,0,0,942
6396,RM-1113,4/11/2014,0,0,942,0,0,0,942
6426,RM-1113,5/11/2014,0,0,942,0,0,0,942
7055,RM-1115,4/11/2014,942,0,0,0,0,0,942
7742,RM-1116,4/11/2014,942,0,0,0,0,0,942
8342,RM-1117,1/13/2014,0,0,942,0,0,0,942
9712,RM-1123,1/13/2014,0,0,942,0,0,0,942
13687,RM-1133,1/13/2014,0,0,942,0,0,0,942
14298,RM-1134,4/11/2014,942,0,0,0,0,0,942
15479,RM-1144,1/13/2014,0,0,942,0,0,0,942
15567,RM-1144,4/11/2014,0,0,942,0,0,0,942
15597,RM-1144,5/11/2014,0,0,942,0,0,0,942
16255,RM-1145,5/11/2014,0,0,942,0,0,0,942
18967,RM-1155,4/11/2014,942,0,0,0,0,0,942
19643,RM-1156,4/11/2014,942,0,0,0,0,0,942
22961,RM-1207,4/11/2014,942,0,0,0,0,0,942
24246,RM-1208B,1/13/2014,0,0,942,0,0,0,942
26374,RM-1213A,4/11/2014,0,0,942,0,0,0,942
26404,RM-1213A,5/11/2014,0,0,942,0,0,0,942
32432,RM-1236,1/13/2014,0,0,942,0,0,0,942
32520,RM-1236,4/11/2014,0,0,942,0,0,0,942
35697,RM-B109,4/11/2014,0,0,942,0,0,0,942
38441,RM-B215,4/11/2014,0,0,942,0,0,0,942
38471,RM-B215,5/11/2014,0,0,942,0,0,0,942
39126,RM-B220,4/11/2014,942,0,0,0,0,0,942
39156,RM-B220,5/11/2014,942,0,0,0,0,0,942
39844,RM-B222,5/11/2014,942,0,0,0,0,0,942
41787,RM-B230,1/13/2014,0,0,942,0,0,0,942
43126,RM-B240,4/11/2014,0,0,942,0,0,0,942
43156,RM-B240,5/11/2014,0,0,942,0,0,0,942
44333,RM-B250,1/13/2014,0,0,942,0,0,0,942
45135,RM-B250A,5/11/2014,942,0,0,0,0,0,942
2878,RM-1106,1/9/2014,0,0,0,0,0,939,939
4935,RM-1109,1/9/2014,0,0,0,0,0,939,939
5712,RM-1110,4/11/2014,0,0,939,0,0,0,939
6304,RM-1113,1/9/2014,0,0,939,0,0,0,939
6963,RM-1115,1/9/2014,0,0,0,0,0,939,939
7650,RM-1116,1/9/2014,939,0,0,0,0,0,939
9023,RM-1122,1/9/2014,0,0,0,0,0,939,939
9708,RM-1123,1/9/2014,0,0,939,0,0,0,939
10393,RM-1124,1/9/2014,0,0,0,0,0,939,939
12998,RM-1132,1/9/2014,0,0,939,0,0,0,939
13683,RM-1133,1/9/2014,0,0,939,0,0,0,939
15475,RM-1144,1/9/2014,0,0,939,0,0,0,939
16160,RM-1145,1/9/2014,0,0,0,0,0,939,939
19551,RM-1156,1/9/2014,939,0,0,0,0,0,939
24242,RM-1208B,1/9/2014,0,0,939,0,0,0,939
25507,RM-1213,10/8/2013,0,0,0,0,0,939,939
25597,RM-1213,1/9/2014,0,0,0,0,0,939,939
26967,RM-1217,1/9/2014,939,0,0,0,0,0,939
31738,RM-1231,1/9/2014,0,0,0,0,0,939,939
32428,RM-1236,1/9/2014,0,0,939,0,0,0,939
36292,RM-B200B,1/9/2014,0,0,0,0,0,939,939
39034,RM-B220,1/9/2014,939,0,0,0,0,0,939
39722,RM-B222,1/9/2014,939,0,0,0,0,0,939
40410,RM-B224,1/9/2014,0,0,0,0,0,939,939
41098,RM-B225,1/9/2014,0,0,0,0,0,939,939
41783,RM-B230,1/9/2014,0,0,939,0,0,0,939
42468,RM-B230A,1/9/2014,0,0,0,0,0,939,939
47736,RM-B275,1/9/2014,0,0,0,0,0,939,939
8464,RM-1117,5/15/2014,0,936,0,0,0,0,936
16936,RM-1150,5/8/2014,0,0,0,936,0,0,936
16939,RM-1150,5/11/2014,0,0,0,936,0,0,936
2798,RM-1106,10/18/2013,0,0,0,0,0,933,933
4855,RM-1109,10/18/2013,0,0,0,0,0,933,933
4994,RM-1109,3/9/2014,0,0,0,0,0,933,933
6363,RM-1113,3/9/2014,0,0,933,0,0,0,933
6398,RM-1113,4/13/2014,0,0,933,0,0,0,933
7709,RM-1116,3/9/2014,933,0,0,0,0,0,933
9082,RM-1122,3/9/2014,0,0,0,0,0,933,933
9628,RM-1123,10/18/2013,0,0,933,0,0,0,933
10313,RM-1124,10/18/2013,0,0,0,0,0,933,933
12231,RM-1130,10/18/2013,0,0,0,0,0,933,933
12918,RM-1132,10/18/2013,0,0,933,0,0,0,933
13603,RM-1133,10/18/2013,0,0,933,0,0,0,933
15395,RM-1144,10/18/2013,0,0,0,0,0,933,933
15534,RM-1144,3/9/2014,0,0,933,0,0,0,933
15569,RM-1144,4/13/2014,0,0,933,0,0,0,933
16080,RM-1145,10/18/2013,0,0,0,0,0,933,933
16219,RM-1145,3/9/2014,0,0,0,0,0,933,933
20788,RM-1200B,10/18/2013,0,0,0,0,0,933,933
22789,RM-1207,10/18/2013,0,0,0,0,0,933,933
25517,RM-1213,10/18/2013,0,0,0,0,0,933,933
25656,RM-1213,3/9/2014,0,0,0,0,0,933,933
26341,RM-1213A,3/9/2014,0,0,933,0,0,0,933
26376,RM-1213A,4/13/2014,0,0,933,0,0,0,933
26887,RM-1217,10/18/2013,933,0,0,0,0,0,933
27026,RM-1217,3/9/2014,933,0,0,0,0,0,933
28263,RM-1221,10/18/2013,0,0,933,0,0,0,933
28402,RM-1221,3/9/2014,0,0,0,0,0,933,933
31658,RM-1231,10/18/2013,0,0,0,0,0,933,933
31797,RM-1231,3/9/2014,0,0,0,0,0,933,933
32487,RM-1236,3/9/2014,0,0,933,0,0,0,933
32522,RM-1236,4/13/2014,0,0,933,0,0,0,933
34976,RM-B103A,10/18/2013,0,0,0,0,0,933,933
35664,RM-B109,3/9/2014,0,0,933,0,0,0,933
35699,RM-B109,4/13/2014,0,0,933,0,0,0,933
36212,RM-B200B,10/18/2013,0,0,0,0,0,933,933
38408,RM-B215,3/9/2014,0,0,933,0,0,0,933
38443,RM-B215,4/13/2014,0,0,933,0,0,0,933
39093,RM-B220,3/9/2014,933,0,0,0,0,0,933
39642,RM-B222,10/18/2013,933,0,0,0,0,0,933
40330,RM-B224,10/18/2013,0,0,0,0,0,933,933
40469,RM-B224,3/9/2014,0,0,0,0,0,933,933
41018,RM-B225,10/18/2013,0,0,0,0,0,933,933
42388,RM-B230A,10/18/2013,0,0,0,0,0,933,933
42527,RM-B230A,3/9/2014,0,0,0,0,0,933,933
43093,RM-B240,3/9/2014,0,0,933,0,0,0,933
43128,RM-B240,4/13/2014,0,0,933,0,0,0,933
44388,RM-B250,3/9/2014,0,0,933,0,0,0,933
45073,RM-B250A,3/9/2014,933,0,0,0,0,0,933
46988,RM-B270,10/18/2013,0,0,933,0,0,0,933
47795,RM-B275,3/9/2014,0,0,0,0,0,933,933
5714,RM-1110,4/13/2014,0,0,930,0,0,0,930
6373,RM-1113,3/19/2014,0,0,930,0,0,0,930
7057,RM-1115,4/13/2014,930,0,0,0,0,0,930
7744,RM-1116,4/13/2014,930,0,0,0,0,0,930
14300,RM-1134,4/13/2014,930,0,0,0,0,0,930
15544,RM-1144,3/19/2014,0,0,930,0,0,0,930
18969,RM-1155,4/13/2014,930,0,0,0,0,0,930
19645,RM-1156,4/13/2014,930,0,0,0,0,0,930
22963,RM-1207,4/13/2014,930,0,0,0,0,0,930
26351,RM-1213A,3/19/2014,0,0,930,0,0,0,930
32497,RM-1236,3/19/2014,0,0,930,0,0,0,930
35674,RM-B109,3/19/2014,0,0,930,0,0,0,930
39128,RM-B220,4/13/2014,930,0,0,0,0,0,930
43103,RM-B240,3/19/2014,0,0,930,0,0,0,930
398,RM-1100A,8/13/2014,927,0,0,0,0,0,927
1768,RM-1102,8/13/2014,927,0,0,0,0,0,927
5004,RM-1109,3/19/2014,0,0,0,0,0,927,927
5835,RM-1110,8/13/2014,0,0,927,0,0,0,927
6520,RM-1113,8/13/2014,0,0,927,0,0,0,927
7719,RM-1116,3/19/2014,927,0,0,0,0,0,927
9092,RM-1122,3/19/2014,0,0,0,0,0,927,927
9924,RM-1123,8/13/2014,927,0,0,0,0,0,927
13214,RM-1132,8/13/2014,0,0,927,0,0,0,927
14275,RM-1134,3/19/2014,927,0,0,0,0,0,927
14421,RM-1134,8/13/2014,927,0,0,0,0,0,927
15691,RM-1144,8/13/2014,0,0,927,0,0,0,927
16229,RM-1145,3/19/2014,0,0,0,0,0,927,927
16349,RM-1145,8/13/2014,0,0,927,0,0,0,927
17718,RM-1151,8/13/2014,927,0,0,0,0,0,927
19091,RM-1155,8/13/2014,927,0,0,0,0,0,927
23770,RM-1208,8/13/2014,927,0,0,0,0,0,927
25143,RM-1212,8/13/2014,927,0,0,0,0,0,927
25666,RM-1213,3/19/2014,0,0,0,0,0,927,927
26498,RM-1213A,8/13/2014,0,0,927,0,0,0,927
27036,RM-1217,3/19/2014,927,0,0,0,0,0,927
27183,RM-1217,8/13/2014,927,0,0,0,0,0,927
28412,RM-1221,3/19/2014,0,0,0,0,0,927,927
28559,RM-1221,8/13/2014,0,0,927,0,0,0,927
29244,RM-1223,8/13/2014,927,0,0,0,0,0,927
30617,RM-1229,8/13/2014,0,0,927,0,0,0,927
31807,RM-1231,3/19/2014,0,0,0,0,0,927,927
36508,RM-B200B,8/13/2014,0,0,927,0,0,0,927
37189,RM-B200C,8/13/2014,927,0,0,0,0,0,927
39103,RM-B220,3/19/2014,927,0,0,0,0,0,927
39250,RM-B220,8/13/2014,927,0,0,0,0,0,927
39938,RM-B222,8/13/2014,927,0,0,0,0,0,927
40479,RM-B224,3/19/2014,0,0,0,0,0,927,927
41999,RM-B230,8/13/2014,927,0,0,0,0,0,927
42537,RM-B230A,3/19/2014,0,0,0,0,0,927,927
43250,RM-B240,8/13/2014,0,0,927,0,0,0,927
44545,RM-B250,8/13/2014,0,0,927,0,0,0,927
45083,RM-B250A,3/19/2014,927,0,0,0,0,0,927
45229,RM-B250A,8/13/2014,927,0,0,0,0,0,927
45914,RM-B260,8/13/2014,927,0,0,0,0,0,927
47805,RM-B275,3/19/2014,0,0,0,0,0,927,927
20995,RM-1200B,5/16/2014,0,924,0,0,0,0,924
35078,RM-B103A,1/31/2014,150,0,0,624,0,150,924
41767,RM-B230,12/24/2013,0,0,921,0,0,0,921
282,RM-1100A,4/19/2014,918,0,0,0,0,0,918
1652,RM-1102,4/19/2014,918,0,0,0,0,0,918
2879,RM-1106,1/10/2014,0,0,0,0,0,918,918
4936,RM-1109,1/10/2014,0,0,0,0,0,918,918
5720,RM-1110,4/19/2014,0,0,918,0,0,0,918
6404,RM-1113,4/19/2014,0,0,918,0,0,0,918
6427,RM-1113,5/12/2014,0,0,918,0,0,0,918
6964,RM-1115,1/10/2014,0,0,0,0,0,918,918
7063,RM-1115,4/19/2014,918,0,0,0,0,0,918
7651,RM-1116,1/10/2014,918,0,0,0,0,0,918
7750,RM-1116,4/19/2014,918,0,0,0,0,0,918
9024,RM-1122,1/10/2014,0,0,0,0,0,918,918
10394,RM-1124,1/10/2014,0,0,0,0,0,918,918
12999,RM-1132,1/10/2014,0,0,918,0,0,0,918
14306,RM-1134,4/19/2014,918,0,0,0,0,0,918
15575,RM-1144,4/19/2014,0,0,918,0,0,0,918
15598,RM-1144,5/12/2014,0,0,918,0,0,0,918
16161,RM-1145,1/10/2014,0,0,0,0,0,918,918
16256,RM-1145,5/12/2014,0,0,918,0,0,0,918
18975,RM-1155,4/19/2014,918,0,0,0,0,0,918
19552,RM-1156,1/10/2014,918,0,0,0,0,0,918
19651,RM-1156,4/19/2014,918,0,0,0,0,0,918
22969,RM-1207,4/19/2014,918,0,0,0,0,0,918
25598,RM-1213,1/10/2014,0,0,0,0,0,918,918
26382,RM-1213A,4/19/2014,0,0,918,0,0,0,918
26405,RM-1213A,5/12/2014,0,0,918,0,0,0,918
31739,RM-1231,1/10/2014,0,0,0,0,0,918,918
32528,RM-1236,4/19/2014,0,0,918,0,0,0,918
38449,RM-B215,4/19/2014,0,0,918,0,0,0,918
38472,RM-B215,5/12/2014,0,0,918,0,0,0,918
39035,RM-B220,1/10/2014,918,0,0,0,0,0,918
39134,RM-B220,4/19/2014,918,0,0,0,0,0,918
39723,RM-B222,1/10/2014,918,0,0,0,0,0,918
39822,RM-B222,4/19/2014,918,0,0,0,0,0,918
40411,RM-B224,1/10/2014,0,0,0,0,0,918,918
41099,RM-B225,1/10/2014,0,0,0,0,0,918,918
42469,RM-B230A,1/10/2014,0,0,0,0,0,918,918
43134,RM-B240,4/19/2014,0,0,918,0,0,0,918
43157,RM-B240,5/12/2014,0,0,918,0,0,0,918
305,RM-1100A,5/12/2014,915,0,0,0,0,0,915
1675,RM-1102,5/12/2014,915,0,0,0,0,0,915
5742,RM-1110,5/12/2014,0,0,915,0,0,0,915
6305,RM-1113,1/10/2014,0,0,915,0,0,0,915
7086,RM-1115,5/12/2014,915,0,0,0,0,0,915
7773,RM-1116,5/12/2014,915,0,0,0,0,0,915
8165,RM-1117,7/7/2013,459,0,0,0,0,456,915
9709,RM-1123,1/10/2014,0,0,915,0,0,0,915
14328,RM-1134,5/12/2014,915,0,0,0,0,0,915
15476,RM-1144,1/10/2014,0,0,915,0,0,0,915
18702,RM-1155,7/7/2013,459,0,456,0,0,0,915
18998,RM-1155,5/12/2014,915,0,0,0,0,0,915
22992,RM-1207,5/12/2014,915,0,0,0,0,0,915
24243,RM-1208B,1/10/2014,0,0,915,0,0,0,915
25050,RM-1212,5/12/2014,915,0,0,0,0,0,915
29151,RM-1223,5/12/2014,915,0,0,0,0,0,915
32255,RM-1236,7/7/2013,459,0,456,0,0,0,915
32429,RM-1236,1/10/2014,0,0,915,0,0,0,915
35759,RM-B109,6/12/2014,456,0,459,0,0,0,915
39157,RM-B220,5/12/2014,915,0,0,0,0,0,915
39845,RM-B222,5/12/2014,915,0,0,0,0,0,915
44330,RM-B250,1/10/2014,0,0,915,0,0,0,915
45136,RM-B250A,5/12/2014,915,0,0,0,0,0,915
7477,RM-1116,7/7/2013,0,0,456,0,0,456,912
36800,RM-B200C,7/7/2013,0,0,456,0,0,456,912
40237,RM-B224,7/7/2013,0,0,456,0,0,456,912
1762,RM-1102,8/7/2014,906,0,0,0,0,0,906
5829,RM-1110,8/7/2014,0,0,906,0,0,0,906
8462,RM-1117,5/13/2014,0,906,0,0,0,0,906
15685,RM-1144,8/7/2014,0,0,906,0,0,0,906
16343,RM-1145,8/7/2014,0,0,906,0,0,0,906
23764,RM-1208,8/7/2014,906,0,0,0,0,0,906
25137,RM-1212,8/7/2014,906,0,0,0,0,0,906
28553,RM-1221,8/7/2014,0,0,906,0,0,0,906
29238,RM-1223,8/7/2014,906,0,0,0,0,0,906
36502,RM-B200B,8/7/2014,0,0,906,0,0,0,906
37183,RM-B200C,8/7/2014,906,0,0,0,0,0,906
38431,RM-B215,4/1/2014,84,0,822,0,0,0,906
39244,RM-B220,8/7/2014,906,0,0,0,0,0,906
41993,RM-B230,8/7/2014,906,0,0,0,0,0,906
43244,RM-B240,8/7/2014,0,0,906,0,0,0,906
44539,RM-B250,8/7/2014,0,0,906,0,0,0,906
45223,RM-B250A,8/7/2014,906,0,0,0,0,0,906
45908,RM-B260,8/7/2014,906,0,0,0,0,0,906
392,RM-1100A,8/7/2014,903,0,0,0,0,0,903
528,RM-1100A,12/23/2014,903,0,0,0,0,0,903
1898,RM-1102,12/23/2014,903,0,0,0,0,0,903
4593,RM-1108,12/23/2014,0,0,903,0,0,0,903
5713,RM-1110,4/12/2014,0,0,903,0,0,0,903
6514,RM-1113,8/7/2014,0,0,903,0,0,0,903
7478,RM-1116,7/8/2013,0,0,453,0,0,450,903
9918,RM-1123,8/7/2014,903,0,0,0,0,0,903
10054,RM-1123,12/23/2014,903,0,0,0,0,0,903
12656,RM-1130,12/23/2014,0,0,903,0,0,0,903
13208,RM-1132,8/7/2014,0,0,903,0,0,0,903
13344,RM-1132,12/23/2014,0,0,903,0,0,0,903
14415,RM-1134,8/7/2014,903,0,0,0,0,0,903
14551,RM-1134,12/23/2014,903,0,0,0,0,0,903
15821,RM-1144,12/23/2014,0,0,903,0,0,0,903
16479,RM-1145,12/23/2014,0,0,903,0,0,0,903
17712,RM-1151,8/7/2014,903,0,0,0,0,0,903
18703,RM-1155,7/8/2013,450,0,453,0,0,0,903
19085,RM-1155,8/7/2014,903,0,0,0,0,0,903
19221,RM-1155,12/23/2014,903,0,0,0,0,0,903
19897,RM-1156,12/23/2014,0,0,903,0,0,0,903
24588,RM-1208B,12/23/2014,903,0,0,0,0,0,903
26492,RM-1213A,8/7/2014,0,0,903,0,0,0,903
27177,RM-1217,8/7/2014,903,0,0,0,0,0,903
28001,RM-1218,12/23/2014,903,0,0,0,0,0,903
29374,RM-1223,12/23/2014,903,0,0,0,0,0,903
30611,RM-1229,8/7/2014,0,0,903,0,0,0,903
30747,RM-1229,12/23/2014,0,0,903,0,0,0,903
32256,RM-1236,7/8/2013,450,0,453,0,0,0,903
32774,RM-1236,12/23/2014,903,0,0,0,0,0,903
33612,RM-4xxx,12/23/2014,0,0,0,0,903,0,903
34035,RM-B102C,12/23/2014,903,0,0,0,0,0,903
36801,RM-B200C,7/8/2013,0,0,453,0,0,450,903
37319,RM-B200C,12/23/2014,903,0,0,0,0,0,903
39932,RM-B222,8/7/2014,903,0,0,0,0,0,903
40068,RM-B222,12/23/2014,903,0,0,0,0,0,903
40238,RM-B224,7/8/2013,0,0,453,0,0,450,903
43380,RM-B240,12/23/2014,0,0,903,0,0,0,903
43990,RM-B240A,12/23/2014,0,0,903,0,0,0,903
45359,RM-B250A,12/23/2014,903,0,0,0,0,0,903
46044,RM-B260,12/23/2014,0,0,903,0,0,0,903
48082,RM-B275,12/23/2014,903,0,0,0,0,0,903
4372,RM-1108,5/14/2014,0,900,0,0,0,0,900
6397,RM-1113,4/12/2014,0,0,900,0,0,0,900
7056,RM-1115,4/12/2014,900,0,0,0,0,0,900
7743,RM-1116,4/12/2014,900,0,0,0,0,0,900
8166,RM-1117,7/8/2013,450,0,0,0,0,450,900
14299,RM-1134,4/12/2014,900,0,0,0,0,0,900
15568,RM-1144,4/12/2014,0,0,900,0,0,0,900
18968,RM-1155,4/12/2014,900,0,0,0,0,0,900
19644,RM-1156,4/12/2014,900,0,0,0,0,0,900
22962,RM-1207,4/12/2014,900,0,0,0,0,0,900
26375,RM-1213A,4/12/2014,0,0,900,0,0,0,900
32521,RM-1236,4/12/2014,0,0,900,0,0,0,900
35698,RM-B109,4/12/2014,0,0,900,0,0,0,900
38442,RM-B215,4/12/2014,0,0,900,0,0,0,900
39127,RM-B220,4/12/2014,900,0,0,0,0,0,900
43127,RM-B240,4/12/2014,0,0,900,0,0,0,900
6422,RM-1113,5/7/2014,0,0,897,0,0,0,897
15593,RM-1144,5/7/2014,0,0,897,0,0,0,897
16251,RM-1145,5/7/2014,0,0,897,0,0,0,897
26400,RM-1213A,5/7/2014,0,0,897,0,0,0,897
33593,RM-4xxx,12/4/2014,0,0,0,0,897,0,897
37300,RM-B200C,12/4/2014,897,0,0,0,0,0,897
38467,RM-B215,5/7/2014,0,0,897,0,0,0,897
43152,RM-B240,5/7/2014,0,0,897,0,0,0,897
43361,RM-B240,12/4/2014,0,0,897,0,0,0,897
394,RM-1100A,8/9/2014,894,0,0,0,0,0,894
395,RM-1100A,8/10/2014,894,0,0,0,0,0,894
396,RM-1100A,8/11/2014,894,0,0,0,0,0,894
509,RM-1100A,12/4/2014,894,0,0,0,0,0,894
510,RM-1100A,12/5/2014,894,0,0,0,0,0,894
511,RM-1100A,12/6/2014,894,0,0,0,0,0,894
512,RM-1100A,12/7/2014,894,0,0,0,0,0,894
530,RM-1100A,12/25/2014,894,0,0,0,0,0,894
561,RM-1100A,1/25/2015,894,0,0,0,0,0,894
1764,RM-1102,8/9/2014,894,0,0,0,0,0,894
1765,RM-1102,8/10/2014,894,0,0,0,0,0,894
1766,RM-1102,8/11/2014,894,0,0,0,0,0,894
1879,RM-1102,12/4/2014,894,0,0,0,0,0,894
1880,RM-1102,12/5/2014,894,0,0,0,0,0,894
1881,RM-1102,12/6/2014,894,0,0,0,0,0,894
1882,RM-1102,12/7/2014,894,0,0,0,0,0,894
1900,RM-1102,12/25/2014,894,0,0,0,0,0,894
1931,RM-1102,1/25/2015,894,0,0,0,0,0,894
4279,RM-1108,2/10/2014,0,894,0,0,0,0,894
4595,RM-1108,12/25/2014,0,0,894,0,0,0,894
4626,RM-1108,1/25/2015,0,0,894,0,0,0,894
5831,RM-1110,8/9/2014,0,0,894,0,0,0,894
5832,RM-1110,8/10/2014,0,0,894,0,0,0,894
5833,RM-1110,8/11/2014,0,0,894,0,0,0,894
6405,RM-1113,4/20/2014,0,0,894,0,0,0,894
6516,RM-1113,8/9/2014,0,0,894,0,0,0,894
6517,RM-1113,8/10/2014,0,0,894,0,0,0,894
6518,RM-1113,8/11/2014,0,0,894,0,0,0,894
9920,RM-1123,8/9/2014,894,0,0,0,0,0,894
9921,RM-1123,8/10/2014,894,0,0,0,0,0,894
9922,RM-1123,8/11/2014,894,0,0,0,0,0,894
10035,RM-1123,12/4/2014,894,0,0,0,0,0,894
10036,RM-1123,12/5/2014,894,0,0,0,0,0,894
10037,RM-1123,12/6/2014,894,0,0,0,0,0,894
10038,RM-1123,12/7/2014,894,0,0,0,0,0,894
10056,RM-1123,12/25/2014,894,0,0,0,0,0,894
10087,RM-1123,1/25/2015,894,0,0,0,0,0,894
12637,RM-1130,12/4/2014,0,0,894,0,0,0,894
12638,RM-1130,12/5/2014,0,0,894,0,0,0,894
12639,RM-1130,12/6/2014,0,0,894,0,0,0,894
12640,RM-1130,12/7/2014,0,0,894,0,0,0,894
12658,RM-1130,12/25/2014,0,0,894,0,0,0,894
12689,RM-1130,1/25/2015,0,0,894,0,0,0,894
13210,RM-1132,8/9/2014,0,0,894,0,0,0,894
13211,RM-1132,8/10/2014,0,0,894,0,0,0,894
13212,RM-1132,8/11/2014,0,0,894,0,0,0,894
13325,RM-1132,12/4/2014,0,0,894,0,0,0,894
13326,RM-1132,12/5/2014,0,0,894,0,0,0,894
13327,RM-1132,12/6/2014,0,0,894,0,0,0,894
13328,RM-1132,12/7/2014,0,0,894,0,0,0,894
13346,RM-1132,12/25/2014,0,0,894,0,0,0,894
13377,RM-1132,1/25/2015,0,0,894,0,0,0,894
14417,RM-1134,8/9/2014,894,0,0,0,0,0,894
14418,RM-1134,8/10/2014,894,0,0,0,0,0,894
14419,RM-1134,8/11/2014,894,0,0,0,0,0,894
14532,RM-1134,12/4/2014,894,0,0,0,0,0,894
14533,RM-1134,12/5/2014,894,0,0,0,0,0,894
14534,RM-1134,12/6/2014,894,0,0,0,0,0,894
14535,RM-1134,12/7/2014,894,0,0,0,0,0,894
14553,RM-1134,12/25/2014,894,0,0,0,0,0,894
15576,RM-1144,4/20/2014,0,0,894,0,0,0,894
15687,RM-1144,8/9/2014,0,0,894,0,0,0,894
15688,RM-1144,8/10/2014,0,0,894,0,0,0,894
15689,RM-1144,8/11/2014,0,0,894,0,0,0,894
15802,RM-1144,12/4/2014,0,0,894,0,0,0,894
15803,RM-1144,12/5/2014,0,0,894,0,0,0,894
15804,RM-1144,12/6/2014,0,0,894,0,0,0,894
15805,RM-1144,12/7/2014,0,0,894,0,0,0,894
15823,RM-1144,12/25/2014,0,0,894,0,0,0,894
16345,RM-1145,8/9/2014,0,0,894,0,0,0,894
16346,RM-1145,8/10/2014,0,0,894,0,0,0,894
16347,RM-1145,8/11/2014,0,0,894,0,0,0,894
16460,RM-1145,12/4/2014,0,0,894,0,0,0,894
16461,RM-1145,12/5/2014,0,0,894,0,0,0,894
16462,RM-1145,12/6/2014,0,0,894,0,0,0,894
16463,RM-1145,12/7/2014,0,0,894,0,0,0,894
16481,RM-1145,12/25/2014,0,0,894,0,0,0,894
16512,RM-1145,1/25/2015,0,0,894,0,0,0,894
17714,RM-1151,8/9/2014,894,0,0,0,0,0,894
17715,RM-1151,8/10/2014,894,0,0,0,0,0,894
17716,RM-1151,8/11/2014,894,0,0,0,0,0,894
19087,RM-1155,8/9/2014,894,0,0,0,0,0,894
19088,RM-1155,8/10/2014,894,0,0,0,0,0,894
19089,RM-1155,8/11/2014,894,0,0,0,0,0,894
19202,RM-1155,12/4/2014,894,0,0,0,0,0,894
19203,RM-1155,12/5/2014,894,0,0,0,0,0,894
19204,RM-1155,12/6/2014,894,0,0,0,0,0,894
19205,RM-1155,12/7/2014,894,0,0,0,0,0,894
19223,RM-1155,12/25/2014,894,0,0,0,0,0,894
19254,RM-1155,1/25/2015,894,0,0,0,0,0,894
19878,RM-1156,12/4/2014,0,0,894,0,0,0,894
19879,RM-1156,12/5/2014,0,0,894,0,0,0,894
19880,RM-1156,12/6/2014,0,0,894,0,0,0,894
19881,RM-1156,12/7/2014,0,0,894,0,0,0,894
19899,RM-1156,12/25/2014,0,0,894,0,0,0,894
19930,RM-1156,1/25/2015,0,0,894,0,0,0,894
23766,RM-1208,8/9/2014,894,0,0,0,0,0,894
23767,RM-1208,8/10/2014,894,0,0,0,0,0,894
23768,RM-1208,8/11/2014,894,0,0,0,0,0,894
24569,RM-1208B,12/4/2014,894,0,0,0,0,0,894
24570,RM-1208B,12/5/2014,894,0,0,0,0,0,894
24571,RM-1208B,12/6/2014,894,0,0,0,0,0,894
24572,RM-1208B,12/7/2014,894,0,0,0,0,0,894
24590,RM-1208B,12/25/2014,894,0,0,0,0,0,894
24621,RM-1208B,1/25/2015,894,0,0,0,0,0,894
25139,RM-1212,8/9/2014,894,0,0,0,0,0,894
25140,RM-1212,8/10/2014,894,0,0,0,0,0,894
25141,RM-1212,8/11/2014,894,0,0,0,0,0,894
25254,RM-1212,12/4/2014,894,0,0,0,0,0,894
25255,RM-1212,12/5/2014,894,0,0,0,0,0,894
25256,RM-1212,12/6/2014,894,0,0,0,0,0,894
25257,RM-1212,12/7/2014,894,0,0,0,0,0,894
26383,RM-1213A,4/20/2014,0,0,894,0,0,0,894
26494,RM-1213A,8/9/2014,0,0,894,0,0,0,894
26495,RM-1213A,8/10/2014,0,0,894,0,0,0,894
26496,RM-1213A,8/11/2014,0,0,894,0,0,0,894
27179,RM-1217,8/9/2014,894,0,0,0,0,0,894
27180,RM-1217,8/10/2014,894,0,0,0,0,0,894
27181,RM-1217,8/11/2014,894,0,0,0,0,0,894
27982,RM-1218,12/4/2014,894,0,0,0,0,0,894
27983,RM-1218,12/5/2014,894,0,0,0,0,0,894
27984,RM-1218,12/6/2014,894,0,0,0,0,0,894
27985,RM-1218,12/7/2014,894,0,0,0,0,0,894
28003,RM-1218,12/25/2014,894,0,0,0,0,0,894
28034,RM-1218,1/25/2015,894,0,0,0,0,0,894
28555,RM-1221,8/9/2014,0,0,894,0,0,0,894
28556,RM-1221,8/10/2014,0,0,894,0,0,0,894
28557,RM-1221,8/11/2014,0,0,894,0,0,0,894
29240,RM-1223,8/9/2014,894,0,0,0,0,0,894
29241,RM-1223,8/10/2014,894,0,0,0,0,0,894
29242,RM-1223,8/11/2014,894,0,0,0,0,0,894
29355,RM-1223,12/4/2014,894,0,0,0,0,0,894
29356,RM-1223,12/5/2014,894,0,0,0,0,0,894
29357,RM-1223,12/6/2014,894,0,0,0,0,0,894
29358,RM-1223,12/7/2014,894,0,0,0,0,0,894
29376,RM-1223,12/25/2014,894,0,0,0,0,0,894
30092,RM-1224,1/25/2015,894,0,0,0,0,0,894
30613,RM-1229,8/9/2014,0,0,894,0,0,0,894
30614,RM-1229,8/10/2014,0,0,894,0,0,0,894
30615,RM-1229,8/11/2014,0,0,894,0,0,0,894
30728,RM-1229,12/4/2014,0,0,894,0,0,0,894
30729,RM-1229,12/5/2014,0,0,894,0,0,0,894
30730,RM-1229,12/6/2014,0,0,894,0,0,0,894
30731,RM-1229,12/7/2014,0,0,894,0,0,0,894
30749,RM-1229,12/25/2014,0,0,894,0,0,0,894
30780,RM-1229,1/25/2015,0,0,894,0,0,0,894
32529,RM-1236,4/20/2014,0,0,894,0,0,0,894
32755,RM-1236,12/4/2014,894,0,0,0,0,0,894
32756,RM-1236,12/5/2014,894,0,0,0,0,0,894
32757,RM-1236,12/6/2014,894,0,0,0,0,0,894
32758,RM-1236,12/7/2014,894,0,0,0,0,0,894
32776,RM-1236,12/25/2014,894,0,0,0,0,0,894
32807,RM-1236,1/25/2015,894,0,0,0,0,0,894
33595,RM-4xxx,12/6/2014,0,0,0,0,894,0,894
33596,RM-4xxx,12/7/2014,0,0,0,0,894,0,894
33614,RM-4xxx,12/25/2014,0,0,0,0,894,0,894
33645,RM-4xxx,1/25/2015,0,0,0,0,894,0,894
34018,RM-B102C,12/6/2014,894,0,0,0,0,0,894
34019,RM-B102C,12/7/2014,894,0,0,0,0,0,894
34037,RM-B102C,12/25/2014,894,0,0,0,0,0,894
34068,RM-B102C,1/25/2015,894,0,0,0,0,0,894
36504,RM-B200B,8/9/2014,0,0,894,0,0,0,894
36505,RM-B200B,8/10/2014,0,0,894,0,0,0,894
36506,RM-B200B,8/11/2014,0,0,894,0,0,0,894
36667,RM-B200B,1/25/2015,0,0,894,0,0,0,894
37185,RM-B200C,8/9/2014,894,0,0,0,0,0,894
37186,RM-B200C,8/10/2014,894,0,0,0,0,0,894
37187,RM-B200C,8/11/2014,894,0,0,0,0,0,894
37302,RM-B200C,12/6/2014,894,0,0,0,0,0,894
37303,RM-B200C,12/7/2014,894,0,0,0,0,0,894
37321,RM-B200C,12/25/2014,894,0,0,0,0,0,894
37352,RM-B200C,1/25/2015,894,0,0,0,0,0,894
38450,RM-B215,4/20/2014,0,0,894,0,0,0,894
38728,RM-B215,1/25/2015,894,0,0,0,0,0,894
39246,RM-B220,8/9/2014,894,0,0,0,0,0,894
39247,RM-B220,8/10/2014,894,0,0,0,0,0,894
39248,RM-B220,8/11/2014,894,0,0,0,0,0,894
39934,RM-B222,8/9/2014,894,0,0,0,0,0,894
39935,RM-B222,8/10/2014,894,0,0,0,0,0,894
39936,RM-B222,8/11/2014,894,0,0,0,0,0,894
40049,RM-B222,12/4/2014,894,0,0,0,0,0,894
40050,RM-B222,12/5/2014,894,0,0,0,0,0,894
40051,RM-B222,12/6/2014,894,0,0,0,0,0,894
40052,RM-B222,12/7/2014,894,0,0,0,0,0,894
40070,RM-B222,12/25/2014,894,0,0,0,0,0,894
41995,RM-B230,8/9/2014,894,0,0,0,0,0,894
41996,RM-B230,8/10/2014,894,0,0,0,0,0,894
41997,RM-B230,8/11/2014,894,0,0,0,0,0,894
43135,RM-B240,4/20/2014,0,0,894,0,0,0,894
43246,RM-B240,8/9/2014,0,0,894,0,0,0,894
43247,RM-B240,8/10/2014,0,0,894,0,0,0,894
43248,RM-B240,8/11/2014,0,0,894,0,0,0,894
43363,RM-B240,12/6/2014,0,0,894,0,0,0,894
43364,RM-B240,12/7/2014,0,0,894,0,0,0,894
43382,RM-B240,12/25/2014,0,0,894,0,0,0,894
43413,RM-B240,1/25/2015,0,0,894,0,0,0,894
43971,RM-B240A,12/4/2014,0,0,894,0,0,0,894
43972,RM-B240A,12/5/2014,0,0,894,0,0,0,894
43973,RM-B240A,12/6/2014,0,0,894,0,0,0,894
43974,RM-B240A,12/7/2014,0,0,894,0,0,0,894
43992,RM-B240A,12/25/2014,0,0,894,0,0,0,894
44023,RM-B240A,1/25/2015,0,0,894,0,0,0,894
44541,RM-B250,8/9/2014,0,0,894,0,0,0,894
44542,RM-B250,8/10/2014,0,0,894,0,0,0,894
44543,RM-B250,8/11/2014,0,0,894,0,0,0,894
45225,RM-B250A,8/9/2014,894,0,0,0,0,0,894
45226,RM-B250A,8/10/2014,894,0,0,0,0,0,894
45227,RM-B250A,8/11/2014,894,0,0,0,0,0,894
45340,RM-B250A,12/4/2014,894,0,0,0,0,0,894
45341,RM-B250A,12/5/2014,894,0,0,0,0,0,894
45342,RM-B250A,12/6/2014,894,0,0,0,0,0,894
45343,RM-B250A,12/7/2014,894,0,0,0,0,0,894
45361,RM-B250A,12/25/2014,894,0,0,0,0,0,894
45392,RM-B250A,1/25/2015,894,0,0,0,0,0,894
45910,RM-B260,8/9/2014,894,0,0,0,0,0,894
45911,RM-B260,8/10/2014,894,0,0,0,0,0,894
45912,RM-B260,8/11/2014,894,0,0,0,0,0,894
46046,RM-B260,12/25/2014,0,0,894,0,0,0,894
46077,RM-B260,1/25/2015,0,0,894,0,0,0,894
48063,RM-B275,12/4/2014,894,0,0,0,0,0,894
48064,RM-B275,12/5/2014,894,0,0,0,0,0,894
48065,RM-B275,12/6/2014,894,0,0,0,0,0,894
48066,RM-B275,12/7/2014,894,0,0,0,0,0,894
48084,RM-B275,12/25/2014,894,0,0,0,0,0,894
48115,RM-B275,1/25/2015,894,0,0,0,0,0,894
283,RM-1100A,4/20/2014,891,0,0,0,0,0,891
383,RM-1100A,7/29/2014,891,0,0,0,0,0,891
390,RM-1100A,8/5/2014,891,0,0,0,0,0,891
397,RM-1100A,8/12/2014,891,0,0,0,0,0,891
506,RM-1100A,12/1/2014,891,0,0,0,0,0,891
513,RM-1100A,12/8/2014,891,0,0,0,0,0,891
531,RM-1100A,12/26/2014,891,0,0,0,0,0,891
547,RM-1100A,1/11/2015,891,0,0,0,0,0,891
1653,RM-1102,4/20/2014,891,0,0,0,0,0,891
1753,RM-1102,7/29/2014,891,0,0,0,0,0,891
1760,RM-1102,8/5/2014,891,0,0,0,0,0,891
1767,RM-1102,8/12/2014,891,0,0,0,0,0,891
1876,RM-1102,12/1/2014,891,0,0,0,0,0,891
1883,RM-1102,12/8/2014,891,0,0,0,0,0,891
1901,RM-1102,12/26/2014,891,0,0,0,0,0,891
1917,RM-1102,1/11/2015,891,0,0,0,0,0,891
4596,RM-1108,12/26/2014,0,0,891,0,0,0,891
4612,RM-1108,1/11/2015,0,0,891,0,0,0,891
5721,RM-1110,4/20/2014,0,0,891,0,0,0,891
5820,RM-1110,7/29/2014,0,0,891,0,0,0,891
5827,RM-1110,8/5/2014,0,0,891,0,0,0,891
5834,RM-1110,8/12/2014,0,0,891,0,0,0,891
6505,RM-1113,7/29/2014,0,0,891,0,0,0,891
6512,RM-1113,8/5/2014,0,0,891,0,0,0,891
6519,RM-1113,8/12/2014,0,0,891,0,0,0,891
7064,RM-1115,4/20/2014,891,0,0,0,0,0,891
7751,RM-1116,4/20/2014,891,0,0,0,0,0,891
9909,RM-1123,7/29/2014,891,0,0,0,0,0,891
9916,RM-1123,8/5/2014,891,0,0,0,0,0,891
9923,RM-1123,8/12/2014,891,0,0,0,0,0,891
10032,RM-1123,12/1/2014,891,0,0,0,0,0,891
10039,RM-1123,12/8/2014,891,0,0,0,0,0,891
10057,RM-1123,12/26/2014,891,0,0,0,0,0,891
10073,RM-1123,1/11/2015,891,0,0,0,0,0,891
12634,RM-1130,12/1/2014,0,0,891,0,0,0,891
12641,RM-1130,12/8/2014,0,0,891,0,0,0,891
12659,RM-1130,12/26/2014,0,0,891,0,0,0,891
12675,RM-1130,1/11/2015,0,0,891,0,0,0,891
13199,RM-1132,7/29/2014,0,0,891,0,0,0,891
13206,RM-1132,8/5/2014,0,0,891,0,0,0,891
13213,RM-1132,8/12/2014,0,0,891,0,0,0,891
13322,RM-1132,12/1/2014,0,0,891,0,0,0,891
13329,RM-1132,12/8/2014,0,0,891,0,0,0,891
13347,RM-1132,12/26/2014,0,0,891,0,0,0,891
13363,RM-1132,1/11/2015,0,0,891,0,0,0,891
14307,RM-1134,4/20/2014,891,0,0,0,0,0,891
14406,RM-1134,7/29/2014,891,0,0,0,0,0,891
14413,RM-1134,8/5/2014,891,0,0,0,0,0,891
14420,RM-1134,8/12/2014,891,0,0,0,0,0,891
14529,RM-1134,12/1/2014,891,0,0,0,0,0,891
14536,RM-1134,12/8/2014,891,0,0,0,0,0,891
14554,RM-1134,12/26/2014,891,0,0,0,0,0,891
15676,RM-1144,7/29/2014,0,0,891,0,0,0,891
15683,RM-1144,8/5/2014,0,0,891,0,0,0,891
15690,RM-1144,8/12/2014,0,0,891,0,0,0,891
15799,RM-1144,12/1/2014,0,0,891,0,0,0,891
15806,RM-1144,12/8/2014,0,0,891,0,0,0,891
15824,RM-1144,12/26/2014,0,0,891,0,0,0,891
16334,RM-1145,7/29/2014,0,0,891,0,0,0,891
16341,RM-1145,8/5/2014,0,0,891,0,0,0,891
16348,RM-1145,8/12/2014,0,0,891,0,0,0,891
16457,RM-1145,12/1/2014,0,0,891,0,0,0,891
16464,RM-1145,12/8/2014,0,0,891,0,0,0,891
16482,RM-1145,12/26/2014,0,0,891,0,0,0,891
16498,RM-1145,1/11/2015,0,0,891,0,0,0,891
17703,RM-1151,7/29/2014,891,0,0,0,0,0,891
17710,RM-1151,8/5/2014,891,0,0,0,0,0,891
17717,RM-1151,8/12/2014,891,0,0,0,0,0,891
18976,RM-1155,4/20/2014,891,0,0,0,0,0,891
19076,RM-1155,7/29/2014,891,0,0,0,0,0,891
19083,RM-1155,8/5/2014,891,0,0,0,0,0,891
19090,RM-1155,8/12/2014,891,0,0,0,0,0,891
19199,RM-1155,12/1/2014,891,0,0,0,0,0,891
19206,RM-1155,12/8/2014,891,0,0,0,0,0,891
19224,RM-1155,12/26/2014,891,0,0,0,0,0,891
19240,RM-1155,1/11/2015,891,0,0,0,0,0,891
19652,RM-1156,4/20/2014,891,0,0,0,0,0,891
19875,RM-1156,12/1/2014,0,0,891,0,0,0,891
19882,RM-1156,12/8/2014,0,0,891,0,0,0,891
19900,RM-1156,12/26/2014,0,0,891,0,0,0,891
19916,RM-1156,1/11/2015,0,0,891,0,0,0,891
22970,RM-1207,4/20/2014,891,0,0,0,0,0,891
23070,RM-1207,7/29/2014,891,0,0,0,0,0,891
23755,RM-1208,7/29/2014,891,0,0,0,0,0,891
23762,RM-1208,8/5/2014,891,0,0,0,0,0,891
23769,RM-1208,8/12/2014,891,0,0,0,0,0,891
24566,RM-1208B,12/1/2014,891,0,0,0,0,0,891
24573,RM-1208B,12/8/2014,891,0,0,0,0,0,891
24591,RM-1208B,12/26/2014,891,0,0,0,0,0,891
24607,RM-1208B,1/11/2015,891,0,0,0,0,0,891
25028,RM-1212,4/20/2014,891,0,0,0,0,0,891
25128,RM-1212,7/29/2014,891,0,0,0,0,0,891
25135,RM-1212,8/5/2014,891,0,0,0,0,0,891
25142,RM-1212,8/12/2014,891,0,0,0,0,0,891
25251,RM-1212,12/1/2014,891,0,0,0,0,0,891
25258,RM-1212,12/8/2014,891,0,0,0,0,0,891
26483,RM-1213A,7/29/2014,0,0,891,0,0,0,891
26490,RM-1213A,8/5/2014,0,0,891,0,0,0,891
26497,RM-1213A,8/12/2014,0,0,891,0,0,0,891
27168,RM-1217,7/29/2014,891,0,0,0,0,0,891
27175,RM-1217,8/5/2014,891,0,0,0,0,0,891
27182,RM-1217,8/12/2014,891,0,0,0,0,0,891
27979,RM-1218,12/1/2014,891,0,0,0,0,0,891
27986,RM-1218,12/8/2014,891,0,0,0,0,0,891
28004,RM-1218,12/26/2014,891,0,0,0,0,0,891
28020,RM-1218,1/11/2015,891,0,0,0,0,0,891
28544,RM-1221,7/29/2014,0,0,891,0,0,0,891
28551,RM-1221,8/5/2014,0,0,891,0,0,0,891
28558,RM-1221,8/12/2014,0,0,891,0,0,0,891
29229,RM-1223,7/29/2014,891,0,0,0,0,0,891
29236,RM-1223,8/5/2014,891,0,0,0,0,0,891
29243,RM-1223,8/12/2014,891,0,0,0,0,0,891
29352,RM-1223,12/1/2014,891,0,0,0,0,0,891
29359,RM-1223,12/8/2014,891,0,0,0,0,0,891
30062,RM-1224,12/26/2014,891,0,0,0,0,0,891
30078,RM-1224,1/11/2015,891,0,0,0,0,0,891
30602,RM-1229,7/29/2014,0,0,891,0,0,0,891
30609,RM-1229,8/5/2014,0,0,891,0,0,0,891
30616,RM-1229,8/12/2014,0,0,891,0,0,0,891
30725,RM-1229,12/1/2014,0,0,891,0,0,0,891
30732,RM-1229,12/8/2014,0,0,891,0,0,0,891
30750,RM-1229,12/26/2014,0,0,891,0,0,0,891
30766,RM-1229,1/11/2015,0,0,891,0,0,0,891
32629,RM-1236,7/29/2014,0,0,891,0,0,0,891
32752,RM-1236,12/1/2014,891,0,0,0,0,0,891
32759,RM-1236,12/8/2014,891,0,0,0,0,0,891
32777,RM-1236,12/26/2014,891,0,0,0,0,0,891
32793,RM-1236,1/11/2015,891,0,0,0,0,0,891
33590,RM-4xxx,12/1/2014,0,0,0,0,891,0,891
33594,RM-4xxx,12/5/2014,0,0,0,0,891,0,891
33597,RM-4xxx,12/8/2014,0,0,0,0,891,0,891
33615,RM-4xxx,12/26/2014,0,0,0,0,891,0,891
34020,RM-B102C,12/8/2014,891,0,0,0,0,0,891
34038,RM-B102C,12/26/2014,891,0,0,0,0,0,891
34054,RM-B102C,1/11/2015,891,0,0,0,0,0,891
36493,RM-B200B,7/29/2014,0,0,891,0,0,0,891
36500,RM-B200B,8/5/2014,0,0,891,0,0,0,891
36507,RM-B200B,8/12/2014,0,0,891,0,0,0,891
37174,RM-B200C,7/29/2014,891,0,0,0,0,0,891
37181,RM-B200C,8/5/2014,891,0,0,0,0,0,891
37188,RM-B200C,8/12/2014,891,0,0,0,0,0,891
37297,RM-B200C,12/1/2014,891,0,0,0,0,0,891
37301,RM-B200C,12/5/2014,891,0,0,0,0,0,891
37304,RM-B200C,12/8/2014,891,0,0,0,0,0,891
37322,RM-B200C,12/26/2014,891,0,0,0,0,0,891
37338,RM-B200C,1/11/2015,891,0,0,0,0,0,891
38714,RM-B215,1/11/2015,891,0,0,0,0,0,891
39135,RM-B220,4/20/2014,891,0,0,0,0,0,891
39235,RM-B220,7/29/2014,891,0,0,0,0,0,891
39242,RM-B220,8/5/2014,891,0,0,0,0,0,891
39249,RM-B220,8/12/2014,891,0,0,0,0,0,891
39823,RM-B222,4/20/2014,891,0,0,0,0,0,891
39923,RM-B222,7/29/2014,891,0,0,0,0,0,891
39930,RM-B222,8/5/2014,891,0,0,0,0,0,891
39937,RM-B222,8/12/2014,891,0,0,0,0,0,891
40046,RM-B222,12/1/2014,891,0,0,0,0,0,891
40053,RM-B222,12/8/2014,891,0,0,0,0,0,891
40071,RM-B222,12/26/2014,891,0,0,0,0,0,891
41984,RM-B230,7/29/2014,891,0,0,0,0,0,891
41991,RM-B230,8/5/2014,891,0,0,0,0,0,891
41998,RM-B230,8/12/2014,891,0,0,0,0,0,891
43235,RM-B240,7/29/2014,0,0,891,0,0,0,891
43242,RM-B240,8/5/2014,0,0,891,0,0,0,891
43249,RM-B240,8/12/2014,0,0,891,0,0,0,891
43358,RM-B240,12/1/2014,0,0,891,0,0,0,891
43362,RM-B240,12/5/2014,0,0,891,0,0,0,891
43365,RM-B240,12/8/2014,0,0,891,0,0,0,891
43383,RM-B240,12/26/2014,0,0,891,0,0,0,891
43399,RM-B240,1/11/2015,0,0,891,0,0,0,891
43968,RM-B240A,12/1/2014,0,0,891,0,0,0,891
43975,RM-B240A,12/8/2014,0,0,891,0,0,0,891
43993,RM-B240A,12/26/2014,0,0,891,0,0,0,891
44009,RM-B240A,1/11/2015,0,0,891,0,0,0,891
44530,RM-B250,7/29/2014,0,0,891,0,0,0,891
44537,RM-B250,8/5/2014,0,0,891,0,0,0,891
44544,RM-B250,8/12/2014,0,0,891,0,0,0,891
45214,RM-B250A,7/29/2014,891,0,0,0,0,0,891
45221,RM-B250A,8/5/2014,891,0,0,0,0,0,891
45228,RM-B250A,8/12/2014,891,0,0,0,0,0,891
45337,RM-B250A,12/1/2014,891,0,0,0,0,0,891
45344,RM-B250A,12/8/2014,891,0,0,0,0,0,891
45362,RM-B250A,12/26/2014,891,0,0,0,0,0,891
45378,RM-B250A,1/11/2015,891,0,0,0,0,0,891
45899,RM-B260,7/29/2014,891,0,0,0,0,0,891
45906,RM-B260,8/5/2014,891,0,0,0,0,0,891
45913,RM-B260,8/12/2014,891,0,0,0,0,0,891
46047,RM-B260,12/26/2014,0,0,891,0,0,0,891
46063,RM-B260,1/11/2015,0,0,891,0,0,0,891
48060,RM-B275,12/1/2014,891,0,0,0,0,0,891
48067,RM-B275,12/8/2014,891,0,0,0,0,0,891
48085,RM-B275,12/26/2014,891,0,0,0,0,0,891
48101,RM-B275,1/11/2015,891,0,0,0,0,0,891
300,RM-1100A,5/7/2014,888,0,0,0,0,0,888
393,RM-1100A,8/8/2014,888,0,0,0,0,0,888
501,RM-1100A,11/26/2014,888,0,0,0,0,0,888
524,RM-1100A,12/19/2014,888,0,0,0,0,0,888
533,RM-1100A,12/28/2014,888,0,0,0,0,0,888
1670,RM-1102,5/7/2014,888,0,0,0,0,0,888
1763,RM-1102,8/8/2014,888,0,0,0,0,0,888
1871,RM-1102,11/26/2014,888,0,0,0,0,0,888
1894,RM-1102,12/19/2014,888,0,0,0,0,0,888
1903,RM-1102,12/28/2014,888,0,0,0,0,0,888
1936,RM-1102,1/30/2015,888,0,0,0,0,0,888
4598,RM-1108,12/28/2014,0,0,888,0,0,0,888
4631,RM-1108,1/30/2015,0,0,888,0,0,0,888
5737,RM-1110,5/7/2014,0,0,888,0,0,0,888
5830,RM-1110,8/8/2014,0,0,888,0,0,0,888
6515,RM-1113,8/8/2014,0,0,888,0,0,0,888
7081,RM-1115,5/7/2014,888,0,0,0,0,0,888
7474,RM-1116,7/4/2013,0,0,444,0,0,444,888
7768,RM-1116,5/7/2014,888,0,0,0,0,0,888
8162,RM-1117,7/4/2013,444,0,0,0,0,444,888
9919,RM-1123,8/8/2014,888,0,0,0,0,0,888
10027,RM-1123,11/26/2014,888,0,0,0,0,0,888
10050,RM-1123,12/19/2014,888,0,0,0,0,0,888
10059,RM-1123,12/28/2014,888,0,0,0,0,0,888
10092,RM-1123,1/30/2015,888,0,0,0,0,0,888
12629,RM-1130,11/26/2014,0,0,888,0,0,0,888
12661,RM-1130,12/28/2014,0,0,888,0,0,0,888
12694,RM-1130,1/30/2015,0,0,888,0,0,0,888
13209,RM-1132,8/8/2014,0,0,888,0,0,0,888
13317,RM-1132,11/26/2014,0,0,888,0,0,0,888
13340,RM-1132,12/19/2014,0,0,888,0,0,0,888
13349,RM-1132,12/28/2014,0,0,888,0,0,0,888
13382,RM-1132,1/30/2015,0,0,888,0,0,0,888
14323,RM-1134,5/7/2014,888,0,0,0,0,0,888
14416,RM-1134,8/8/2014,888,0,0,0,0,0,888
14524,RM-1134,11/26/2014,888,0,0,0,0,0,888
14547,RM-1134,12/19/2014,888,0,0,0,0,0,888
14556,RM-1134,12/28/2014,888,0,0,0,0,0,888
15686,RM-1144,8/8/2014,0,0,888,0,0,0,888
15794,RM-1144,11/26/2014,0,0,888,0,0,0,888
15817,RM-1144,12/19/2014,0,0,888,0,0,0,888
15826,RM-1144,12/28/2014,0,0,888,0,0,0,888
16344,RM-1145,8/8/2014,0,0,888,0,0,0,888
16452,RM-1145,11/26/2014,0,0,888,0,0,0,888
16484,RM-1145,12/28/2014,0,0,888,0,0,0,888
16517,RM-1145,1/30/2015,0,0,888,0,0,0,888
17713,RM-1151,8/8/2014,888,0,0,0,0,0,888
18699,RM-1155,7/4/2013,444,0,444,0,0,0,888
18993,RM-1155,5/7/2014,888,0,0,0,0,0,888
19086,RM-1155,8/8/2014,888,0,0,0,0,0,888
19194,RM-1155,11/26/2014,888,0,0,0,0,0,888
19226,RM-1155,12/28/2014,888,0,0,0,0,0,888
19259,RM-1155,1/30/2015,888,0,0,0,0,0,888
19870,RM-1156,11/26/2014,0,0,888,0,0,0,888
19893,RM-1156,12/19/2014,0,0,888,0,0,0,888
19902,RM-1156,12/28/2014,0,0,888,0,0,0,888
19935,RM-1156,1/30/2015,0,0,888,0,0,0,888
20992,RM-1200B,5/13/2014,0,888,0,0,0,0,888
22987,RM-1207,5/7/2014,888,0,0,0,0,0,888
23765,RM-1208,8/8/2014,888,0,0,0,0,0,888
24561,RM-1208B,11/26/2014,888,0,0,0,0,0,888
24584,RM-1208B,12/19/2014,888,0,0,0,0,0,888
24593,RM-1208B,12/28/2014,888,0,0,0,0,0,888
24626,RM-1208B,1/30/2015,888,0,0,0,0,0,888
25045,RM-1212,5/7/2014,888,0,0,0,0,0,888
25138,RM-1212,8/8/2014,888,0,0,0,0,0,888
25246,RM-1212,11/26/2014,888,0,0,0,0,0,888
25269,RM-1212,12/19/2014,888,0,0,0,0,0,888
26493,RM-1213A,8/8/2014,0,0,888,0,0,0,888
27178,RM-1217,8/8/2014,888,0,0,0,0,0,888
27974,RM-1218,11/26/2014,888,0,0,0,0,0,888
27997,RM-1218,12/19/2014,888,0,0,0,0,0,888
28006,RM-1218,12/28/2014,888,0,0,0,0,0,888
28039,RM-1218,1/30/2015,888,0,0,0,0,0,888
28554,RM-1221,8/8/2014,0,0,888,0,0,0,888
29146,RM-1223,5/7/2014,888,0,0,0,0,0,888
29239,RM-1223,8/8/2014,888,0,0,0,0,0,888
29347,RM-1223,11/26/2014,888,0,0,0,0,0,888
29370,RM-1223,12/19/2014,888,0,0,0,0,0,888
30064,RM-1224,12/28/2014,888,0,0,0,0,0,888
30097,RM-1224,1/30/2015,888,0,0,0,0,0,888
30612,RM-1229,8/8/2014,0,0,888,0,0,0,888
30720,RM-1229,11/26/2014,0,0,888,0,0,0,888
30743,RM-1229,12/19/2014,0,0,888,0,0,0,888
30752,RM-1229,12/28/2014,0,0,888,0,0,0,888
30785,RM-1229,1/30/2015,0,0,888,0,0,0,888
32252,RM-1236,7/4/2013,444,0,444,0,0,0,888
32747,RM-1236,11/26/2014,888,0,0,0,0,0,888
32770,RM-1236,12/19/2014,888,0,0,0,0,0,888
32779,RM-1236,12/28/2014,888,0,0,0,0,0,888
32812,RM-1236,1/30/2015,888,0,0,0,0,0,888
33585,RM-4xxx,11/26/2014,0,0,0,0,888,0,888
33617,RM-4xxx,12/28/2014,0,0,0,0,888,0,888
33619,RM-4xxx,12/30/2014,0,0,0,0,888,0,888
33631,RM-4xxx,1/11/2015,0,0,0,0,888,0,888
33650,RM-4xxx,1/30/2015,0,0,0,0,888,0,888
34031,RM-B102C,12/19/2014,888,0,0,0,0,0,888
34040,RM-B102C,12/28/2014,888,0,0,0,0,0,888
34073,RM-B102C,1/30/2015,888,0,0,0,0,0,888
36503,RM-B200B,8/8/2014,0,0,888,0,0,0,888
36672,RM-B200B,1/30/2015,0,0,888,0,0,0,888
36797,RM-B200C,7/4/2013,0,0,444,0,0,444,888
37184,RM-B200C,8/8/2014,888,0,0,0,0,0,888
37292,RM-B200C,11/26/2014,888,0,0,0,0,0,888
37324,RM-B200C,12/28/2014,888,0,0,0,0,0,888
37357,RM-B200C,1/30/2015,888,0,0,0,0,0,888
38733,RM-B215,1/30/2015,888,0,0,0,0,0,888
39152,RM-B220,5/7/2014,888,0,0,0,0,0,888
39245,RM-B220,8/8/2014,888,0,0,0,0,0,888
39840,RM-B222,5/7/2014,888,0,0,0,0,0,888
39933,RM-B222,8/8/2014,888,0,0,0,0,0,888
40041,RM-B222,11/26/2014,888,0,0,0,0,0,888
40073,RM-B222,12/28/2014,888,0,0,0,0,0,888
40234,RM-B224,7/4/2013,0,0,444,0,0,444,888
41994,RM-B230,8/8/2014,888,0,0,0,0,0,888
43245,RM-B240,8/8/2014,0,0,888,0,0,0,888
43353,RM-B240,11/26/2014,0,0,888,0,0,0,888
43385,RM-B240,12/28/2014,0,0,888,0,0,0,888
43418,RM-B240,1/30/2015,0,0,888,0,0,0,888
43963,RM-B240A,11/26/2014,0,0,888,0,0,0,888
43995,RM-B240A,12/28/2014,0,0,888,0,0,0,888
44028,RM-B240A,1/30/2015,0,0,888,0,0,0,888
44540,RM-B250,8/8/2014,0,0,888,0,0,0,888
45131,RM-B250A,5/7/2014,888,0,0,0,0,0,888
45224,RM-B250A,8/8/2014,888,0,0,0,0,0,888
45332,RM-B250A,11/26/2014,888,0,0,0,0,0,888
45364,RM-B250A,12/28/2014,888,0,0,0,0,0,888
45397,RM-B250A,1/30/2015,888,0,0,0,0,0,888
45909,RM-B260,8/8/2014,888,0,0,0,0,0,888
46049,RM-B260,12/28/2014,0,0,888,0,0,0,888
46082,RM-B260,1/30/2015,0,0,888,0,0,0,888
48055,RM-B275,11/26/2014,888,0,0,0,0,0,888
48087,RM-B275,12/28/2014,888,0,0,0,0,0,888
48120,RM-B275,1/30/2015,888,0,0,0,0,0,888
298,RM-1100A,5/5/2014,885,0,0,0,0,0,885
399,RM-1100A,8/14/2014,885,0,0,0,0,0,885
502,RM-1100A,11/27/2014,885,0,0,0,0,0,885
507,RM-1100A,12/2/2014,885,0,0,0,0,0,885
525,RM-1100A,12/20/2014,885,0,0,0,0,0,885
529,RM-1100A,12/24/2014,885,0,0,0,0,0,885
535,RM-1100A,12/30/2014,885,0,0,0,0,0,885
1668,RM-1102,5/5/2014,885,0,0,0,0,0,885
1769,RM-1102,8/14/2014,885,0,0,0,0,0,885
1872,RM-1102,11/27/2014,885,0,0,0,0,0,885
1877,RM-1102,12/2/2014,885,0,0,0,0,0,885
1895,RM-1102,12/20/2014,885,0,0,0,0,0,885
1899,RM-1102,12/24/2014,885,0,0,0,0,0,885
1905,RM-1102,12/30/2014,885,0,0,0,0,0,885
4588,RM-1108,12/18/2014,0,0,885,0,0,0,885
4589,RM-1108,12/19/2014,0,0,885,0,0,0,885
4590,RM-1108,12/20/2014,0,0,885,0,0,0,885
4594,RM-1108,12/24/2014,0,0,885,0,0,0,885
4600,RM-1108,12/30/2014,0,0,885,0,0,0,885
5736,RM-1110,5/5/2014,0,0,885,0,0,0,885
5836,RM-1110,8/14/2014,0,0,885,0,0,0,885
6420,RM-1113,5/5/2014,0,0,885,0,0,0,885
6521,RM-1113,8/14/2014,0,0,885,0,0,0,885
7079,RM-1115,5/5/2014,885,0,0,0,0,0,885
7766,RM-1116,5/5/2014,885,0,0,0,0,0,885
9925,RM-1123,8/14/2014,885,0,0,0,0,0,885
10028,RM-1123,11/27/2014,885,0,0,0,0,0,885
10033,RM-1123,12/2/2014,885,0,0,0,0,0,885
10051,RM-1123,12/20/2014,885,0,0,0,0,0,885
10055,RM-1123,12/24/2014,885,0,0,0,0,0,885
10061,RM-1123,12/30/2014,885,0,0,0,0,0,885
12630,RM-1130,11/27/2014,0,0,885,0,0,0,885
12635,RM-1130,12/2/2014,0,0,885,0,0,0,885
12651,RM-1130,12/18/2014,0,0,885,0,0,0,885
12652,RM-1130,12/19/2014,0,0,885,0,0,0,885
12653,RM-1130,12/20/2014,0,0,885,0,0,0,885
12657,RM-1130,12/24/2014,0,0,885,0,0,0,885
12663,RM-1130,12/30/2014,0,0,885,0,0,0,885
13215,RM-1132,8/14/2014,0,0,885,0,0,0,885
13318,RM-1132,11/27/2014,0,0,885,0,0,0,885
13323,RM-1132,12/2/2014,0,0,885,0,0,0,885
13341,RM-1132,12/20/2014,0,0,885,0,0,0,885
13345,RM-1132,12/24/2014,0,0,885,0,0,0,885
13351,RM-1132,12/30/2014,0,0,885,0,0,0,885
14322,RM-1134,5/5/2014,885,0,0,0,0,0,885
14422,RM-1134,8/14/2014,885,0,0,0,0,0,885
14525,RM-1134,11/27/2014,885,0,0,0,0,0,885
14530,RM-1134,12/2/2014,885,0,0,0,0,0,885
14548,RM-1134,12/20/2014,885,0,0,0,0,0,885
14552,RM-1134,12/24/2014,885,0,0,0,0,0,885
14558,RM-1134,12/30/2014,885,0,0,0,0,0,885
15591,RM-1144,5/5/2014,0,0,885,0,0,0,885
15692,RM-1144,8/14/2014,0,0,885,0,0,0,885
15795,RM-1144,11/27/2014,0,0,885,0,0,0,885
15800,RM-1144,12/2/2014,0,0,885,0,0,0,885
15818,RM-1144,12/20/2014,0,0,885,0,0,0,885
15822,RM-1144,12/24/2014,0,0,885,0,0,0,885
15828,RM-1144,12/30/2014,0,0,885,0,0,0,885
16249,RM-1145,5/5/2014,0,0,885,0,0,0,885
16350,RM-1145,8/14/2014,0,0,885,0,0,0,885
16453,RM-1145,11/27/2014,0,0,885,0,0,0,885
16458,RM-1145,12/2/2014,0,0,885,0,0,0,885
16474,RM-1145,12/18/2014,0,0,885,0,0,0,885
16475,RM-1145,12/19/2014,0,0,885,0,0,0,885
16476,RM-1145,12/20/2014,0,0,885,0,0,0,885
16480,RM-1145,12/24/2014,0,0,885,0,0,0,885
16486,RM-1145,12/30/2014,0,0,885,0,0,0,885
17719,RM-1151,8/14/2014,885,0,0,0,0,0,885
18991,RM-1155,5/5/2014,885,0,0,0,0,0,885
19092,RM-1155,8/14/2014,885,0,0,0,0,0,885
19195,RM-1155,11/27/2014,885,0,0,0,0,0,885
19200,RM-1155,12/2/2014,885,0,0,0,0,0,885
19216,RM-1155,12/18/2014,885,0,0,0,0,0,885
19217,RM-1155,12/19/2014,885,0,0,0,0,0,885
19218,RM-1155,12/20/2014,885,0,0,0,0,0,885
19222,RM-1155,12/24/2014,885,0,0,0,0,0,885
19228,RM-1155,12/30/2014,885,0,0,0,0,0,885
19871,RM-1156,11/27/2014,0,0,885,0,0,0,885
19876,RM-1156,12/2/2014,0,0,885,0,0,0,885
19894,RM-1156,12/20/2014,0,0,885,0,0,0,885
19898,RM-1156,12/24/2014,0,0,885,0,0,0,885
19904,RM-1156,12/30/2014,0,0,885,0,0,0,885
22985,RM-1207,5/5/2014,885,0,0,0,0,0,885
23771,RM-1208,8/14/2014,885,0,0,0,0,0,885
24562,RM-1208B,11/27/2014,885,0,0,0,0,0,885
24567,RM-1208B,12/2/2014,885,0,0,0,0,0,885
24585,RM-1208B,12/20/2014,885,0,0,0,0,0,885
24589,RM-1208B,12/24/2014,885,0,0,0,0,0,885
24595,RM-1208B,12/30/2014,885,0,0,0,0,0,885
25043,RM-1212,5/5/2014,885,0,0,0,0,0,885
25144,RM-1212,8/14/2014,885,0,0,0,0,0,885
25247,RM-1212,11/27/2014,885,0,0,0,0,0,885
25252,RM-1212,12/2/2014,885,0,0,0,0,0,885
25270,RM-1212,12/20/2014,885,0,0,0,0,0,885
26398,RM-1213A,5/5/2014,0,0,885,0,0,0,885
26499,RM-1213A,8/14/2014,0,0,885,0,0,0,885
27184,RM-1217,8/14/2014,885,0,0,0,0,0,885
27975,RM-1218,11/27/2014,885,0,0,0,0,0,885
27980,RM-1218,12/2/2014,885,0,0,0,0,0,885
27998,RM-1218,12/20/2014,885,0,0,0,0,0,885
28002,RM-1218,12/24/2014,885,0,0,0,0,0,885
28008,RM-1218,12/30/2014,885,0,0,0,0,0,885
28560,RM-1221,8/14/2014,0,0,885,0,0,0,885
29144,RM-1223,5/5/2014,885,0,0,0,0,0,885
29245,RM-1223,8/14/2014,885,0,0,0,0,0,885
29348,RM-1223,11/27/2014,885,0,0,0,0,0,885
29353,RM-1223,12/2/2014,885,0,0,0,0,0,885
29371,RM-1223,12/20/2014,885,0,0,0,0,0,885
29375,RM-1223,12/24/2014,885,0,0,0,0,0,885
30066,RM-1224,12/30/2014,885,0,0,0,0,0,885
30618,RM-1229,8/14/2014,0,0,885,0,0,0,885
30721,RM-1229,11/27/2014,0,0,885,0,0,0,885
30726,RM-1229,12/2/2014,0,0,885,0,0,0,885
30744,RM-1229,12/20/2014,0,0,885,0,0,0,885
30748,RM-1229,12/24/2014,0,0,885,0,0,0,885
30754,RM-1229,12/30/2014,0,0,885,0,0,0,885
32748,RM-1236,11/27/2014,885,0,0,0,0,0,885
32753,RM-1236,12/2/2014,885,0,0,0,0,0,885
32771,RM-1236,12/20/2014,885,0,0,0,0,0,885
32775,RM-1236,12/24/2014,885,0,0,0,0,0,885
32781,RM-1236,12/30/2014,885,0,0,0,0,0,885
33586,RM-4xxx,11/27/2014,0,0,0,0,885,0,885
33591,RM-4xxx,12/2/2014,0,0,0,0,885,0,885
33607,RM-4xxx,12/18/2014,0,0,0,0,885,0,885
33608,RM-4xxx,12/19/2014,0,0,0,0,885,0,885
33609,RM-4xxx,12/20/2014,0,0,0,0,885,0,885
33613,RM-4xxx,12/24/2014,0,0,0,0,885,0,885
34032,RM-B102C,12/20/2014,885,0,0,0,0,0,885
34036,RM-B102C,12/24/2014,885,0,0,0,0,0,885
34042,RM-B102C,12/30/2014,885,0,0,0,0,0,885
36509,RM-B200B,8/14/2014,0,0,885,0,0,0,885
37190,RM-B200C,8/14/2014,885,0,0,0,0,0,885
37293,RM-B200C,11/27/2014,885,0,0,0,0,0,885
37298,RM-B200C,12/2/2014,885,0,0,0,0,0,885
37314,RM-B200C,12/18/2014,885,0,0,0,0,0,885
37315,RM-B200C,12/19/2014,885,0,0,0,0,0,885
37316,RM-B200C,12/20/2014,885,0,0,0,0,0,885
37320,RM-B200C,12/24/2014,885,0,0,0,0,0,885
37326,RM-B200C,12/30/2014,885,0,0,0,0,0,885
37356,RM-B200C,1/29/2015,885,0,0,0,0,0,885
38465,RM-B215,5/5/2014,0,0,885,0,0,0,885
38732,RM-B215,1/29/2015,885,0,0,0,0,0,885
39150,RM-B220,5/5/2014,885,0,0,0,0,0,885
39251,RM-B220,8/14/2014,885,0,0,0,0,0,885
39838,RM-B222,5/5/2014,885,0,0,0,0,0,885
39939,RM-B222,8/14/2014,885,0,0,0,0,0,885
40042,RM-B222,11/27/2014,885,0,0,0,0,0,885
40047,RM-B222,12/2/2014,885,0,0,0,0,0,885
40063,RM-B222,12/18/2014,885,0,0,0,0,0,885
40064,RM-B222,12/19/2014,885,0,0,0,0,0,885
40065,RM-B222,12/20/2014,885,0,0,0,0,0,885
40069,RM-B222,12/24/2014,885,0,0,0,0,0,885
40075,RM-B222,12/30/2014,885,0,0,0,0,0,885
42000,RM-B230,8/14/2014,885,0,0,0,0,0,885
43150,RM-B240,5/5/2014,0,0,885,0,0,0,885
43251,RM-B240,8/14/2014,0,0,885,0,0,0,885
43354,RM-B240,11/27/2014,0,0,885,0,0,0,885
43359,RM-B240,12/2/2014,0,0,885,0,0,0,885
43375,RM-B240,12/18/2014,0,0,885,0,0,0,885
43376,RM-B240,12/19/2014,0,0,885,0,0,0,885
43377,RM-B240,12/20/2014,0,0,885,0,0,0,885
43381,RM-B240,12/24/2014,0,0,885,0,0,0,885
43387,RM-B240,12/30/2014,0,0,885,0,0,0,885
43417,RM-B240,1/29/2015,0,0,885,0,0,0,885
43964,RM-B240A,11/27/2014,0,0,885,0,0,0,885
43969,RM-B240A,12/2/2014,0,0,885,0,0,0,885
43985,RM-B240A,12/18/2014,0,0,885,0,0,0,885
43986,RM-B240A,12/19/2014,0,0,885,0,0,0,885
43987,RM-B240A,12/20/2014,0,0,885,0,0,0,885
43991,RM-B240A,12/24/2014,0,0,885,0,0,0,885
43997,RM-B240A,12/30/2014,0,0,885,0,0,0,885
44027,RM-B240A,1/29/2015,0,0,885,0,0,0,885
44546,RM-B250,8/14/2014,0,0,885,0,0,0,885
45130,RM-B250A,5/5/2014,885,0,0,0,0,0,885
45230,RM-B250A,8/14/2014,885,0,0,0,0,0,885
45333,RM-B250A,11/27/2014,885,0,0,0,0,0,885
45338,RM-B250A,12/2/2014,885,0,0,0,0,0,885
45354,RM-B250A,12/18/2014,885,0,0,0,0,0,885
45355,RM-B250A,12/19/2014,885,0,0,0,0,0,885
45356,RM-B250A,12/20/2014,885,0,0,0,0,0,885
45360,RM-B250A,12/24/2014,885,0,0,0,0,0,885
45366,RM-B250A,12/30/2014,885,0,0,0,0,0,885
45396,RM-B250A,1/29/2015,885,0,0,0,0,0,885
45915,RM-B260,8/14/2014,885,0,0,0,0,0,885
46039,RM-B260,12/18/2014,0,0,885,0,0,0,885
46040,RM-B260,12/19/2014,0,0,885,0,0,0,885
46041,RM-B260,12/20/2014,0,0,885,0,0,0,885
46045,RM-B260,12/24/2014,0,0,885,0,0,0,885
46051,RM-B260,12/30/2014,0,0,885,0,0,0,885
46081,RM-B260,1/29/2015,0,0,885,0,0,0,885
48056,RM-B275,11/27/2014,885,0,0,0,0,0,885
48061,RM-B275,12/2/2014,885,0,0,0,0,0,885
48077,RM-B275,12/18/2014,885,0,0,0,0,0,885
48078,RM-B275,12/19/2014,885,0,0,0,0,0,885
48079,RM-B275,12/20/2014,885,0,0,0,0,0,885
48083,RM-B275,12/24/2014,885,0,0,0,0,0,885
48089,RM-B275,12/30/2014,885,0,0,0,0,0,885
505,RM-1100A,11/30/2014,882,0,0,0,0,0,882
522,RM-1100A,12/17/2014,882,0,0,0,0,0,882
523,RM-1100A,12/18/2014,882,0,0,0,0,0,882
532,RM-1100A,12/27/2014,882,0,0,0,0,0,882
536,RM-1100A,12/31/2014,882,0,0,0,0,0,882
1875,RM-1102,11/30/2014,882,0,0,0,0,0,882
1892,RM-1102,12/17/2014,882,0,0,0,0,0,882
1893,RM-1102,12/18/2014,882,0,0,0,0,0,882
1902,RM-1102,12/27/2014,882,0,0,0,0,0,882
1906,RM-1102,12/31/2014,882,0,0,0,0,0,882
1932,RM-1102,1/26/2015,882,0,0,0,0,0,882
1935,RM-1102,1/29/2015,882,0,0,0,0,0,882
4587,RM-1108,12/17/2014,0,0,882,0,0,0,882
4597,RM-1108,12/27/2014,0,0,882,0,0,0,882
4601,RM-1108,12/31/2014,0,0,882,0,0,0,882
4627,RM-1108,1/26/2015,0,0,882,0,0,0,882
4630,RM-1108,1/29/2015,0,0,882,0,0,0,882
8163,RM-1117,7/5/2013,441,0,0,0,0,441,882
10031,RM-1123,11/30/2014,882,0,0,0,0,0,882
10048,RM-1123,12/17/2014,882,0,0,0,0,0,882
10049,RM-1123,12/18/2014,882,0,0,0,0,0,882
10058,RM-1123,12/27/2014,882,0,0,0,0,0,882
10062,RM-1123,12/31/2014,882,0,0,0,0,0,882
10088,RM-1123,1/26/2015,882,0,0,0,0,0,882
10091,RM-1123,1/29/2015,882,0,0,0,0,0,882
12633,RM-1130,11/30/2014,0,0,882,0,0,0,882
12650,RM-1130,12/17/2014,0,0,882,0,0,0,882
12660,RM-1130,12/27/2014,0,0,882,0,0,0,882
12664,RM-1130,12/31/2014,0,0,882,0,0,0,882
12690,RM-1130,1/26/2015,0,0,882,0,0,0,882
12693,RM-1130,1/29/2015,0,0,882,0,0,0,882
13321,RM-1132,11/30/2014,0,0,882,0,0,0,882
13338,RM-1132,12/17/2014,0,0,882,0,0,0,882
13339,RM-1132,12/18/2014,0,0,882,0,0,0,882
13348,RM-1132,12/27/2014,0,0,882,0,0,0,882
13352,RM-1132,12/31/2014,0,0,882,0,0,0,882
13378,RM-1132,1/26/2015,0,0,882,0,0,0,882
13381,RM-1132,1/29/2015,0,0,882,0,0,0,882
14528,RM-1134,11/30/2014,882,0,0,0,0,0,882
14545,RM-1134,12/17/2014,882,0,0,0,0,0,882
14546,RM-1134,12/18/2014,882,0,0,0,0,0,882
14555,RM-1134,12/27/2014,882,0,0,0,0,0,882
14559,RM-1134,12/31/2014,882,0,0,0,0,0,882
15798,RM-1144,11/30/2014,0,0,882,0,0,0,882
15815,RM-1144,12/17/2014,0,0,882,0,0,0,882
15816,RM-1144,12/18/2014,0,0,882,0,0,0,882
15825,RM-1144,12/27/2014,0,0,882,0,0,0,882
16456,RM-1145,11/30/2014,0,0,882,0,0,0,882
16473,RM-1145,12/17/2014,0,0,882,0,0,0,882
16483,RM-1145,12/27/2014,0,0,882,0,0,0,882
16487,RM-1145,12/31/2014,0,0,882,0,0,0,882
16513,RM-1145,1/26/2015,0,0,882,0,0,0,882
16516,RM-1145,1/29/2015,0,0,882,0,0,0,882
16937,RM-1150,5/9/2014,0,0,0,882,0,0,882
16938,RM-1150,5/10/2014,0,0,0,882,0,0,882
19198,RM-1155,11/30/2014,882,0,0,0,0,0,882
19215,RM-1155,12/17/2014,882,0,0,0,0,0,882
19225,RM-1155,12/27/2014,882,0,0,0,0,0,882
19229,RM-1155,12/31/2014,882,0,0,0,0,0,882
19255,RM-1155,1/26/2015,882,0,0,0,0,0,882
19258,RM-1155,1/29/2015,882,0,0,0,0,0,882
19874,RM-1156,11/30/2014,0,0,882,0,0,0,882
19891,RM-1156,12/17/2014,0,0,882,0,0,0,882
19892,RM-1156,12/18/2014,0,0,882,0,0,0,882
19901,RM-1156,12/27/2014,0,0,882,0,0,0,882
19905,RM-1156,12/31/2014,0,0,882,0,0,0,882
19931,RM-1156,1/26/2015,0,0,882,0,0,0,882
19934,RM-1156,1/29/2015,0,0,882,0,0,0,882
20991,RM-1200B,5/12/2014,0,882,0,0,0,0,882
24565,RM-1208B,11/30/2014,882,0,0,0,0,0,882
24582,RM-1208B,12/17/2014,882,0,0,0,0,0,882
24583,RM-1208B,12/18/2014,882,0,0,0,0,0,882
24592,RM-1208B,12/27/2014,882,0,0,0,0,0,882
24596,RM-1208B,12/31/2014,882,0,0,0,0,0,882
24622,RM-1208B,1/26/2015,882,0,0,0,0,0,882
24625,RM-1208B,1/29/2015,882,0,0,0,0,0,882
25250,RM-1212,11/30/2014,882,0,0,0,0,0,882
25267,RM-1212,12/17/2014,882,0,0,0,0,0,882
25268,RM-1212,12/18/2014,882,0,0,0,0,0,882
27774,RM-1218,5/8/2014,0,0,0,882,0,0,882
27978,RM-1218,11/30/2014,882,0,0,0,0,0,882
27995,RM-1218,12/17/2014,882,0,0,0,0,0,882
27996,RM-1218,12/18/2014,882,0,0,0,0,0,882
28005,RM-1218,12/27/2014,882,0,0,0,0,0,882
28009,RM-1218,12/31/2014,882,0,0,0,0,0,882
28035,RM-1218,1/26/2015,882,0,0,0,0,0,882
28038,RM-1218,1/29/2015,882,0,0,0,0,0,882
29351,RM-1223,11/30/2014,882,0,0,0,0,0,882
29368,RM-1223,12/17/2014,882,0,0,0,0,0,882
29369,RM-1223,12/18/2014,882,0,0,0,0,0,882
30063,RM-1224,12/27/2014,882,0,0,0,0,0,882
30067,RM-1224,12/31/2014,882,0,0,0,0,0,882
30093,RM-1224,1/26/2015,882,0,0,0,0,0,882
30096,RM-1224,1/29/2015,882,0,0,0,0,0,882
30724,RM-1229,11/30/2014,0,0,882,0,0,0,882
30741,RM-1229,12/17/2014,0,0,882,0,0,0,882
30742,RM-1229,12/18/2014,0,0,882,0,0,0,882
30751,RM-1229,12/27/2014,0,0,882,0,0,0,882
30755,RM-1229,12/31/2014,0,0,882,0,0,0,882
30781,RM-1229,1/26/2015,0,0,882,0,0,0,882
30784,RM-1229,1/29/2015,0,0,882,0,0,0,882
31172,RM-1230,5/8/2014,0,882,0,0,0,0,882
32751,RM-1236,11/30/2014,882,0,0,0,0,0,882
32768,RM-1236,12/17/2014,882,0,0,0,0,0,882
32769,RM-1236,12/18/2014,882,0,0,0,0,0,882
32778,RM-1236,12/27/2014,882,0,0,0,0,0,882
32782,RM-1236,12/31/2014,882,0,0,0,0,0,882
32808,RM-1236,1/26/2015,882,0,0,0,0,0,882
32811,RM-1236,1/29/2015,882,0,0,0,0,0,882
33589,RM-4xxx,11/30/2014,0,0,0,0,882,0,882
33606,RM-4xxx,12/17/2014,0,0,0,0,882,0,882
33616,RM-4xxx,12/27/2014,0,0,0,0,882,0,882
33646,RM-4xxx,1/26/2015,0,0,0,0,882,0,882
33649,RM-4xxx,1/29/2015,0,0,0,0,882,0,882
34029,RM-B102C,12/17/2014,882,0,0,0,0,0,882
34030,RM-B102C,12/18/2014,882,0,0,0,0,0,882
34039,RM-B102C,12/27/2014,882,0,0,0,0,0,882
34043,RM-B102C,12/31/2014,882,0,0,0,0,0,882
34069,RM-B102C,1/26/2015,882,0,0,0,0,0,882
34072,RM-B102C,1/29/2015,882,0,0,0,0,0,882
36419,RM-B200B,5/16/2014,0,882,0,0,0,0,882
36668,RM-B200B,1/26/2015,0,0,882,0,0,0,882
36671,RM-B200B,1/29/2015,0,0,882,0,0,0,882
37296,RM-B200C,11/30/2014,882,0,0,0,0,0,882
37313,RM-B200C,12/17/2014,882,0,0,0,0,0,882
37323,RM-B200C,12/27/2014,882,0,0,0,0,0,882
37327,RM-B200C,12/31/2014,882,0,0,0,0,0,882
37353,RM-B200C,1/26/2015,882,0,0,0,0,0,882
38729,RM-B215,1/26/2015,882,0,0,0,0,0,882
40045,RM-B222,11/30/2014,882,0,0,0,0,0,882
40062,RM-B222,12/17/2014,882,0,0,0,0,0,882
40072,RM-B222,12/27/2014,882,0,0,0,0,0,882
40076,RM-B222,12/31/2014,882,0,0,0,0,0,882
43357,RM-B240,11/30/2014,0,0,882,0,0,0,882
43374,RM-B240,12/17/2014,0,0,882,0,0,0,882
43384,RM-B240,12/27/2014,0,0,882,0,0,0,882
43388,RM-B240,12/31/2014,0,0,882,0,0,0,882
43414,RM-B240,1/26/2015,0,0,882,0,0,0,882
43967,RM-B240A,11/30/2014,0,0,882,0,0,0,882
43984,RM-B240A,12/17/2014,0,0,882,0,0,0,882
43994,RM-B240A,12/27/2014,0,0,882,0,0,0,882
43998,RM-B240A,12/31/2014,0,0,882,0,0,0,882
44024,RM-B240A,1/26/2015,0,0,882,0,0,0,882
45336,RM-B250A,11/30/2014,882,0,0,0,0,0,882
45353,RM-B250A,12/17/2014,882,0,0,0,0,0,882
45363,RM-B250A,12/27/2014,882,0,0,0,0,0,882
45367,RM-B250A,12/31/2014,882,0,0,0,0,0,882
45393,RM-B250A,1/26/2015,882,0,0,0,0,0,882
46038,RM-B260,12/17/2014,0,0,882,0,0,0,882
46048,RM-B260,12/27/2014,0,0,882,0,0,0,882
46052,RM-B260,12/31/2014,0,0,882,0,0,0,882
46078,RM-B260,1/26/2015,0,0,882,0,0,0,882
48059,RM-B275,11/30/2014,882,0,0,0,0,0,882
48076,RM-B275,12/17/2014,882,0,0,0,0,0,882
48086,RM-B275,12/27/2014,882,0,0,0,0,0,882
48090,RM-B275,12/31/2014,882,0,0,0,0,0,882
48116,RM-B275,1/26/2015,882,0,0,0,0,0,882
48119,RM-B275,1/29/2015,882,0,0,0,0,0,882
515,RM-1100A,12/10/2014,879,0,0,0,0,0,879
540,RM-1100A,1/4/2015,879,0,0,0,0,0,879
548,RM-1100A,1/12/2015,879,0,0,0,0,0,879
549,RM-1100A,1/13/2015,879,0,0,0,0,0,879
550,RM-1100A,1/14/2015,879,0,0,0,0,0,879
1910,RM-1102,1/4/2015,879,0,0,0,0,0,879
1918,RM-1102,1/12/2015,879,0,0,0,0,0,879
1919,RM-1102,1/13/2015,879,0,0,0,0,0,879
1920,RM-1102,1/14/2015,879,0,0,0,0,0,879
1942,RM-1102,2/5/2015,879,0,0,0,0,0,879
4605,RM-1108,1/4/2015,0,0,879,0,0,0,879
4613,RM-1108,1/12/2015,0,0,879,0,0,0,879
4614,RM-1108,1/13/2015,0,0,879,0,0,0,879
4615,RM-1108,1/14/2015,0,0,879,0,0,0,879
4637,RM-1108,2/5/2015,0,0,879,0,0,0,879
7475,RM-1116,7/5/2013,0,0,438,0,0,441,879
10041,RM-1123,12/10/2014,879,0,0,0,0,0,879
10066,RM-1123,1/4/2015,879,0,0,0,0,0,879
10074,RM-1123,1/12/2015,879,0,0,0,0,0,879
10075,RM-1123,1/13/2015,879,0,0,0,0,0,879
10076,RM-1123,1/14/2015,879,0,0,0,0,0,879
10098,RM-1123,2/5/2015,879,0,0,0,0,0,879
12643,RM-1130,12/10/2014,0,0,879,0,0,0,879
12668,RM-1130,1/4/2015,0,0,879,0,0,0,879
12676,RM-1130,1/12/2015,0,0,879,0,0,0,879
12677,RM-1130,1/13/2015,0,0,879,0,0,0,879
12678,RM-1130,1/14/2015,0,0,879,0,0,0,879
12700,RM-1130,2/5/2015,0,0,879,0,0,0,879
13331,RM-1132,12/10/2014,0,0,879,0,0,0,879
13356,RM-1132,1/4/2015,0,0,879,0,0,0,879
13364,RM-1132,1/12/2015,0,0,879,0,0,0,879
13365,RM-1132,1/13/2015,0,0,879,0,0,0,879
13366,RM-1132,1/14/2015,0,0,879,0,0,0,879
13388,RM-1132,2/5/2015,0,0,879,0,0,0,879
14538,RM-1134,12/10/2014,879,0,0,0,0,0,879
14563,RM-1134,1/4/2015,879,0,0,0,0,0,879
15808,RM-1144,12/10/2014,0,0,879,0,0,0,879
16466,RM-1145,12/10/2014,0,0,879,0,0,0,879
16491,RM-1145,1/4/2015,0,0,879,0,0,0,879
16499,RM-1145,1/12/2015,0,0,879,0,0,0,879
16500,RM-1145,1/13/2015,0,0,879,0,0,0,879
16501,RM-1145,1/14/2015,0,0,879,0,0,0,879
16523,RM-1145,2/5/2015,0,0,879,0,0,0,879
18700,RM-1155,7/5/2013,441,0,438,0,0,0,879
19208,RM-1155,12/10/2014,879,0,0,0,0,0,879
19233,RM-1155,1/4/2015,879,0,0,0,0,0,879
19241,RM-1155,1/12/2015,879,0,0,0,0,0,879
19242,RM-1155,1/13/2015,879,0,0,0,0,0,879
19243,RM-1155,1/14/2015,879,0,0,0,0,0,879
19265,RM-1155,2/5/2015,879,0,0,0,0,0,879
19884,RM-1156,12/10/2014,0,0,879,0,0,0,879
19909,RM-1156,1/4/2015,0,0,879,0,0,0,879
19917,RM-1156,1/12/2015,0,0,879,0,0,0,879
19918,RM-1156,1/13/2015,0,0,879,0,0,0,879
19919,RM-1156,1/14/2015,0,0,879,0,0,0,879
19941,RM-1156,2/5/2015,0,0,879,0,0,0,879
24600,RM-1208B,1/4/2015,879,0,0,0,0,0,879
24608,RM-1208B,1/12/2015,879,0,0,0,0,0,879
24609,RM-1208B,1/13/2015,879,0,0,0,0,0,879
24610,RM-1208B,1/14/2015,879,0,0,0,0,0,879
24632,RM-1208B,2/5/2015,879,0,0,0,0,0,879
28013,RM-1218,1/4/2015,879,0,0,0,0,0,879
28021,RM-1218,1/12/2015,879,0,0,0,0,0,879
28022,RM-1218,1/13/2015,879,0,0,0,0,0,879
28023,RM-1218,1/14/2015,879,0,0,0,0,0,879
28045,RM-1218,2/5/2015,879,0,0,0,0,0,879
30071,RM-1224,1/4/2015,879,0,0,0,0,0,879
30079,RM-1224,1/12/2015,879,0,0,0,0,0,879
30080,RM-1224,1/13/2015,879,0,0,0,0,0,879
30081,RM-1224,1/14/2015,879,0,0,0,0,0,879
30103,RM-1224,2/5/2015,879,0,0,0,0,0,879
30734,RM-1229,12/10/2014,0,0,879,0,0,0,879
30759,RM-1229,1/4/2015,0,0,879,0,0,0,879
30767,RM-1229,1/12/2015,0,0,879,0,0,0,879
30768,RM-1229,1/13/2015,0,0,879,0,0,0,879
30769,RM-1229,1/14/2015,0,0,879,0,0,0,879
30791,RM-1229,2/5/2015,0,0,879,0,0,0,879
32253,RM-1236,7/5/2013,441,0,438,0,0,0,879
32761,RM-1236,12/10/2014,879,0,0,0,0,0,879
32786,RM-1236,1/4/2015,879,0,0,0,0,0,879
32794,RM-1236,1/12/2015,879,0,0,0,0,0,879
32795,RM-1236,1/13/2015,879,0,0,0,0,0,879
32796,RM-1236,1/14/2015,879,0,0,0,0,0,879
32818,RM-1236,2/5/2015,879,0,0,0,0,0,879
33599,RM-4xxx,12/10/2014,0,0,0,0,879,0,879
33610,RM-4xxx,12/21/2014,0,0,0,0,879,0,879
33620,RM-4xxx,12/31/2014,0,0,0,0,879,0,879
33624,RM-4xxx,1/4/2015,0,0,0,0,879,0,879
33632,RM-4xxx,1/12/2015,0,0,0,0,879,0,879
33633,RM-4xxx,1/13/2015,0,0,0,0,879,0,879
33634,RM-4xxx,1/14/2015,0,0,0,0,879,0,879
33656,RM-4xxx,2/5/2015,0,0,0,0,879,0,879
34045,RM-B102C,1/2/2015,879,0,0,0,0,0,879
34047,RM-B102C,1/4/2015,879,0,0,0,0,0,879
34055,RM-B102C,1/12/2015,879,0,0,0,0,0,879
34056,RM-B102C,1/13/2015,879,0,0,0,0,0,879
34057,RM-B102C,1/14/2015,879,0,0,0,0,0,879
34079,RM-B102C,2/5/2015,879,0,0,0,0,0,879
36678,RM-B200B,2/5/2015,0,0,879,0,0,0,879
36798,RM-B200C,7/5/2013,0,0,438,0,0,441,879
37306,RM-B200C,12/10/2014,879,0,0,0,0,0,879
37331,RM-B200C,1/4/2015,879,0,0,0,0,0,879
37339,RM-B200C,1/12/2015,879,0,0,0,0,0,879
37340,RM-B200C,1/13/2015,879,0,0,0,0,0,879
37341,RM-B200C,1/14/2015,879,0,0,0,0,0,879
37363,RM-B200C,2/5/2015,879,0,0,0,0,0,879
38707,RM-B215,1/4/2015,879,0,0,0,0,0,879
38715,RM-B215,1/12/2015,879,0,0,0,0,0,879
38716,RM-B215,1/13/2015,879,0,0,0,0,0,879
38717,RM-B215,1/14/2015,879,0,0,0,0,0,879
38739,RM-B215,2/5/2015,879,0,0,0,0,0,879
40055,RM-B222,12/10/2014,879,0,0,0,0,0,879
40080,RM-B222,1/4/2015,879,0,0,0,0,0,879
40235,RM-B224,7/5/2013,0,0,438,0,0,441,879
43367,RM-B240,12/10/2014,0,0,879,0,0,0,879
43392,RM-B240,1/4/2015,0,0,879,0,0,0,879
43400,RM-B240,1/12/2015,0,0,879,0,0,0,879
43401,RM-B240,1/13/2015,0,0,879,0,0,0,879
43402,RM-B240,1/14/2015,0,0,879,0,0,0,879
43424,RM-B240,2/5/2015,0,0,879,0,0,0,879
43977,RM-B240A,12/10/2014,0,0,879,0,0,0,879
44002,RM-B240A,1/4/2015,0,0,879,0,0,0,879
44010,RM-B240A,1/12/2015,0,0,879,0,0,0,879
44011,RM-B240A,1/13/2015,0,0,879,0,0,0,879
44012,RM-B240A,1/14/2015,0,0,879,0,0,0,879
44034,RM-B240A,2/5/2015,0,0,879,0,0,0,879
45346,RM-B250A,12/10/2014,879,0,0,0,0,0,879
45371,RM-B250A,1/4/2015,879,0,0,0,0,0,879
45379,RM-B250A,1/12/2015,879,0,0,0,0,0,879
45380,RM-B250A,1/13/2015,879,0,0,0,0,0,879
45381,RM-B250A,1/14/2015,879,0,0,0,0,0,879
45403,RM-B250A,2/5/2015,879,0,0,0,0,0,879
46056,RM-B260,1/4/2015,0,0,879,0,0,0,879
46064,RM-B260,1/12/2015,0,0,879,0,0,0,879
46065,RM-B260,1/13/2015,0,0,879,0,0,0,879
46066,RM-B260,1/14/2015,0,0,879,0,0,0,879
46088,RM-B260,2/5/2015,0,0,879,0,0,0,879
48069,RM-B275,12/10/2014,879,0,0,0,0,0,879
48094,RM-B275,1/4/2015,879,0,0,0,0,0,879
48102,RM-B275,1/12/2015,879,0,0,0,0,0,879
48103,RM-B275,1/13/2015,879,0,0,0,0,0,879
48104,RM-B275,1/14/2015,879,0,0,0,0,0,879
48126,RM-B275,2/5/2015,879,0,0,0,0,0,879
519,RM-1100A,12/14/2014,876,0,0,0,0,0,876
520,RM-1100A,12/15/2014,876,0,0,0,0,0,876
526,RM-1100A,12/21/2014,876,0,0,0,0,0,876
534,RM-1100A,12/29/2014,876,0,0,0,0,0,876
538,RM-1100A,1/2/2015,876,0,0,0,0,0,876
539,RM-1100A,1/3/2015,876,0,0,0,0,0,876
559,RM-1100A,1/23/2015,876,0,0,0,0,0,876
560,RM-1100A,1/24/2015,876,0,0,0,0,0,876
1885,RM-1102,12/10/2014,876,0,0,0,0,0,876
1889,RM-1102,12/14/2014,876,0,0,0,0,0,876
1890,RM-1102,12/15/2014,876,0,0,0,0,0,876
1896,RM-1102,12/21/2014,876,0,0,0,0,0,876
1904,RM-1102,12/29/2014,876,0,0,0,0,0,876
1908,RM-1102,1/2/2015,876,0,0,0,0,0,876
1909,RM-1102,1/3/2015,876,0,0,0,0,0,876
1929,RM-1102,1/23/2015,876,0,0,0,0,0,876
1930,RM-1102,1/24/2015,876,0,0,0,0,0,876
4585,RM-1108,12/15/2014,0,0,876,0,0,0,876
4591,RM-1108,12/21/2014,0,0,876,0,0,0,876
4599,RM-1108,12/29/2014,0,0,876,0,0,0,876
4603,RM-1108,1/2/2015,0,0,876,0,0,0,876
4604,RM-1108,1/3/2015,0,0,876,0,0,0,876
4624,RM-1108,1/23/2015,0,0,876,0,0,0,876
4625,RM-1108,1/24/2015,0,0,876,0,0,0,876
6307,RM-1113,1/12/2014,0,0,876,0,0,0,876
8456,RM-1117,5/7/2014,0,876,0,0,0,0,876
9711,RM-1123,1/12/2014,0,0,876,0,0,0,876
10045,RM-1123,12/14/2014,876,0,0,0,0,0,876
10046,RM-1123,12/15/2014,876,0,0,0,0,0,876
10052,RM-1123,12/21/2014,876,0,0,0,0,0,876
10060,RM-1123,12/29/2014,876,0,0,0,0,0,876
10064,RM-1123,1/2/2015,876,0,0,0,0,0,876
10065,RM-1123,1/3/2015,876,0,0,0,0,0,876
10085,RM-1123,1/23/2015,876,0,0,0,0,0,876
10086,RM-1123,1/24/2015,876,0,0,0,0,0,876
12647,RM-1130,12/14/2014,0,0,876,0,0,0,876
12648,RM-1130,12/15/2014,0,0,876,0,0,0,876
12654,RM-1130,12/21/2014,0,0,876,0,0,0,876
12662,RM-1130,12/29/2014,0,0,876,0,0,0,876
12666,RM-1130,1/2/2015,0,0,876,0,0,0,876
12667,RM-1130,1/3/2015,0,0,876,0,0,0,876
12687,RM-1130,1/23/2015,0,0,876,0,0,0,876
12688,RM-1130,1/24/2015,0,0,876,0,0,0,876
13335,RM-1132,12/14/2014,0,0,876,0,0,0,876
13336,RM-1132,12/15/2014,0,0,876,0,0,0,876
13342,RM-1132,12/21/2014,0,0,876,0,0,0,876
13350,RM-1132,12/29/2014,0,0,876,0,0,0,876
13354,RM-1132,1/2/2015,0,0,876,0,0,0,876
13355,RM-1132,1/3/2015,0,0,876,0,0,0,876
13375,RM-1132,1/23/2015,0,0,876,0,0,0,876
13376,RM-1132,1/24/2015,0,0,876,0,0,0,876
14542,RM-1134,12/14/2014,876,0,0,0,0,0,876
14543,RM-1134,12/15/2014,876,0,0,0,0,0,876
14549,RM-1134,12/21/2014,876,0,0,0,0,0,876
14557,RM-1134,12/29/2014,876,0,0,0,0,0,876
14561,RM-1134,1/2/2015,876,0,0,0,0,0,876
14562,RM-1134,1/3/2015,876,0,0,0,0,0,876
15478,RM-1144,1/12/2014,0,0,876,0,0,0,876
15812,RM-1144,12/14/2014,0,0,876,0,0,0,876
15813,RM-1144,12/15/2014,0,0,876,0,0,0,876
15819,RM-1144,12/21/2014,0,0,876,0,0,0,876
15827,RM-1144,12/29/2014,0,0,876,0,0,0,876
16470,RM-1145,12/14/2014,0,0,876,0,0,0,876
16471,RM-1145,12/15/2014,0,0,876,0,0,0,876
16477,RM-1145,12/21/2014,0,0,876,0,0,0,876
16485,RM-1145,12/29/2014,0,0,876,0,0,0,876
16489,RM-1145,1/2/2015,0,0,876,0,0,0,876
16490,RM-1145,1/3/2015,0,0,876,0,0,0,876
16510,RM-1145,1/23/2015,0,0,876,0,0,0,876
16511,RM-1145,1/24/2015,0,0,876,0,0,0,876
16940,RM-1150,5/12/2014,0,0,0,876,0,0,876
19212,RM-1155,12/14/2014,876,0,0,0,0,0,876
19213,RM-1155,12/15/2014,876,0,0,0,0,0,876
19219,RM-1155,12/21/2014,876,0,0,0,0,0,876
19227,RM-1155,12/29/2014,876,0,0,0,0,0,876
19231,RM-1155,1/2/2015,876,0,0,0,0,0,876
19232,RM-1155,1/3/2015,876,0,0,0,0,0,876
19252,RM-1155,1/23/2015,876,0,0,0,0,0,876
19253,RM-1155,1/24/2015,876,0,0,0,0,0,876
19888,RM-1156,12/14/2014,0,0,876,0,0,0,876
19889,RM-1156,12/15/2014,0,0,876,0,0,0,876
19895,RM-1156,12/21/2014,0,0,876,0,0,0,876
19903,RM-1156,12/29/2014,0,0,876,0,0,0,876
19907,RM-1156,1/2/2015,0,0,876,0,0,0,876
19908,RM-1156,1/3/2015,0,0,876,0,0,0,876
19928,RM-1156,1/23/2015,0,0,876,0,0,0,876
19929,RM-1156,1/24/2015,0,0,876,0,0,0,876
20990,RM-1200B,5/11/2014,0,876,0,0,0,0,876
20994,RM-1200B,5/15/2014,0,876,0,0,0,0,876
24245,RM-1208B,1/12/2014,0,0,876,0,0,0,876
24575,RM-1208B,12/10/2014,876,0,0,0,0,0,876
24579,RM-1208B,12/14/2014,876,0,0,0,0,0,876
24580,RM-1208B,12/15/2014,876,0,0,0,0,0,876
24586,RM-1208B,12/21/2014,876,0,0,0,0,0,876
24594,RM-1208B,12/29/2014,876,0,0,0,0,0,876
24598,RM-1208B,1/2/2015,876,0,0,0,0,0,876
24599,RM-1208B,1/3/2015,876,0,0,0,0,0,876
24619,RM-1208B,1/23/2015,876,0,0,0,0,0,876
24620,RM-1208B,1/24/2015,876,0,0,0,0,0,876
25260,RM-1212,12/10/2014,876,0,0,0,0,0,876
25264,RM-1212,12/14/2014,876,0,0,0,0,0,876
25265,RM-1212,12/15/2014,876,0,0,0,0,0,876
25271,RM-1212,12/21/2014,876,0,0,0,0,0,876
27988,RM-1218,12/10/2014,876,0,0,0,0,0,876
27992,RM-1218,12/14/2014,876,0,0,0,0,0,876
27993,RM-1218,12/15/2014,876,0,0,0,0,0,876
27999,RM-1218,12/21/2014,876,0,0,0,0,0,876
28007,RM-1218,12/29/2014,876,0,0,0,0,0,876
28011,RM-1218,1/2/2015,876,0,0,0,0,0,876
28012,RM-1218,1/3/2015,876,0,0,0,0,0,876
28032,RM-1218,1/23/2015,876,0,0,0,0,0,876
28033,RM-1218,1/24/2015,876,0,0,0,0,0,876
29361,RM-1223,12/10/2014,876,0,0,0,0,0,876
29365,RM-1223,12/14/2014,876,0,0,0,0,0,876
29366,RM-1223,12/15/2014,876,0,0,0,0,0,876
29372,RM-1223,12/21/2014,876,0,0,0,0,0,876
30065,RM-1224,12/29/2014,876,0,0,0,0,0,876
30069,RM-1224,1/2/2015,876,0,0,0,0,0,876
30070,RM-1224,1/3/2015,876,0,0,0,0,0,876
30090,RM-1224,1/23/2015,876,0,0,0,0,0,876
30091,RM-1224,1/24/2015,876,0,0,0,0,0,876
30738,RM-1229,12/14/2014,0,0,876,0,0,0,876
30739,RM-1229,12/15/2014,0,0,876,0,0,0,876
30745,RM-1229,12/21/2014,0,0,876,0,0,0,876
30753,RM-1229,12/29/2014,0,0,876,0,0,0,876
30757,RM-1229,1/2/2015,0,0,876,0,0,0,876
30758,RM-1229,1/3/2015,0,0,876,0,0,0,876
30778,RM-1229,1/23/2015,0,0,876,0,0,0,876
30779,RM-1229,1/24/2015,0,0,876,0,0,0,876
32431,RM-1236,1/12/2014,0,0,876,0,0,0,876
32765,RM-1236,12/14/2014,876,0,0,0,0,0,876
32766,RM-1236,12/15/2014,876,0,0,0,0,0,876
32772,RM-1236,12/21/2014,876,0,0,0,0,0,876
32780,RM-1236,12/29/2014,876,0,0,0,0,0,876
32784,RM-1236,1/2/2015,876,0,0,0,0,0,876
32785,RM-1236,1/3/2015,876,0,0,0,0,0,876
32805,RM-1236,1/23/2015,876,0,0,0,0,0,876
32806,RM-1236,1/24/2015,876,0,0,0,0,0,876
33602,RM-4xxx,12/13/2014,0,0,0,0,876,0,876
33604,RM-4xxx,12/15/2014,0,0,0,0,876,0,876
33618,RM-4xxx,12/29/2014,0,0,0,0,876,0,876
33622,RM-4xxx,1/2/2015,0,0,0,0,876,0,876
33623,RM-4xxx,1/3/2015,0,0,0,0,876,0,876
33643,RM-4xxx,1/23/2015,0,0,0,0,876,0,876
33644,RM-4xxx,1/24/2015,0,0,0,0,876,0,876
34022,RM-B102C,12/10/2014,876,0,0,0,0,0,876
34026,RM-B102C,12/14/2014,876,0,0,0,0,0,876
34027,RM-B102C,12/15/2014,876,0,0,0,0,0,876
34033,RM-B102C,12/21/2014,876,0,0,0,0,0,876
34041,RM-B102C,12/29/2014,876,0,0,0,0,0,876
34046,RM-B102C,1/3/2015,876,0,0,0,0,0,876
34066,RM-B102C,1/23/2015,876,0,0,0,0,0,876
34067,RM-B102C,1/24/2015,876,0,0,0,0,0,876
36666,RM-B200B,1/24/2015,0,0,876,0,0,0,876
37310,RM-B200C,12/14/2014,876,0,0,0,0,0,876
37311,RM-B200C,12/15/2014,876,0,0,0,0,0,876
37317,RM-B200C,12/21/2014,876,0,0,0,0,0,876
37325,RM-B200C,12/29/2014,876,0,0,0,0,0,876
37329,RM-B200C,1/2/2015,876,0,0,0,0,0,876
37330,RM-B200C,1/3/2015,876,0,0,0,0,0,876
37350,RM-B200C,1/23/2015,876,0,0,0,0,0,876
37351,RM-B200C,1/24/2015,876,0,0,0,0,0,876
38705,RM-B215,1/2/2015,876,0,0,0,0,0,876
38706,RM-B215,1/3/2015,876,0,0,0,0,0,876
38726,RM-B215,1/23/2015,876,0,0,0,0,0,876
38727,RM-B215,1/24/2015,876,0,0,0,0,0,876
40059,RM-B222,12/14/2014,876,0,0,0,0,0,876
40060,RM-B222,12/15/2014,876,0,0,0,0,0,876
40066,RM-B222,12/21/2014,876,0,0,0,0,0,876
40074,RM-B222,12/29/2014,876,0,0,0,0,0,876
40078,RM-B222,1/2/2015,876,0,0,0,0,0,876
40079,RM-B222,1/3/2015,876,0,0,0,0,0,876
43371,RM-B240,12/14/2014,0,0,876,0,0,0,876
43372,RM-B240,12/15/2014,0,0,876,0,0,0,876
43378,RM-B240,12/21/2014,0,0,876,0,0,0,876
43386,RM-B240,12/29/2014,0,0,876,0,0,0,876
43390,RM-B240,1/2/2015,0,0,876,0,0,0,876
43391,RM-B240,1/3/2015,0,0,876,0,0,0,876
43411,RM-B240,1/23/2015,0,0,876,0,0,0,876
43412,RM-B240,1/24/2015,0,0,876,0,0,0,876
43981,RM-B240A,12/14/2014,0,0,876,0,0,0,876
43982,RM-B240A,12/15/2014,0,0,876,0,0,0,876
43988,RM-B240A,12/21/2014,0,0,876,0,0,0,876
43996,RM-B240A,12/29/2014,0,0,876,0,0,0,876
44000,RM-B240A,1/2/2015,0,0,876,0,0,0,876
44001,RM-B240A,1/3/2015,0,0,876,0,0,0,876
44021,RM-B240A,1/23/2015,0,0,876,0,0,0,876
44022,RM-B240A,1/24/2015,0,0,876,0,0,0,876
44332,RM-B250,1/12/2014,0,0,876,0,0,0,876
45350,RM-B250A,12/14/2014,876,0,0,0,0,0,876
45351,RM-B250A,12/15/2014,876,0,0,0,0,0,876
45357,RM-B250A,12/21/2014,876,0,0,0,0,0,876
45365,RM-B250A,12/29/2014,876,0,0,0,0,0,876
45369,RM-B250A,1/2/2015,876,0,0,0,0,0,876
45370,RM-B250A,1/3/2015,876,0,0,0,0,0,876
45390,RM-B250A,1/23/2015,876,0,0,0,0,0,876
45391,RM-B250A,1/24/2015,876,0,0,0,0,0,876
46042,RM-B260,12/21/2014,0,0,876,0,0,0,876
46050,RM-B260,12/29/2014,0,0,876,0,0,0,876
46054,RM-B260,1/2/2015,0,0,876,0,0,0,876
46055,RM-B260,1/3/2015,0,0,876,0,0,0,876
46075,RM-B260,1/23/2015,0,0,876,0,0,0,876
46076,RM-B260,1/24/2015,0,0,876,0,0,0,876
48073,RM-B275,12/14/2014,876,0,0,0,0,0,876
48074,RM-B275,12/15/2014,876,0,0,0,0,0,876
48080,RM-B275,12/21/2014,876,0,0,0,0,0,876
48088,RM-B275,12/29/2014,876,0,0,0,0,0,876
48092,RM-B275,1/2/2015,876,0,0,0,0,0,876
48093,RM-B275,1/3/2015,876,0,0,0,0,0,876
48113,RM-B275,1/23/2015,876,0,0,0,0,0,876
48114,RM-B275,1/24/2015,876,0,0,0,0,0,876
308,RM-1100A,5/15/2014,873,0,0,0,0,0,873
518,RM-1100A,12/13/2014,873,0,0,0,0,0,873
551,RM-1100A,1/15/2015,873,0,0,0,0,0,873
554,RM-1100A,1/18/2015,873,0,0,0,0,0,873
557,RM-1100A,1/21/2015,873,0,0,0,0,0,873
1678,RM-1102,5/15/2014,873,0,0,0,0,0,873
1886,RM-1102,12/11/2014,873,0,0,0,0,0,873
1888,RM-1102,12/13/2014,873,0,0,0,0,0,873
1921,RM-1102,1/15/2015,873,0,0,0,0,0,873
1924,RM-1102,1/18/2015,873,0,0,0,0,0,873
1927,RM-1102,1/21/2015,873,0,0,0,0,0,873
2881,RM-1106,1/12/2014,0,0,0,0,0,873,873
4616,RM-1108,1/15/2015,0,0,873,0,0,0,873
4619,RM-1108,1/18/2015,0,0,873,0,0,0,873
4622,RM-1108,1/21/2015,0,0,873,0,0,0,873
4938,RM-1109,1/12/2014,0,0,0,0,0,873,873
5745,RM-1110,5/15/2014,0,0,873,0,0,0,873
6966,RM-1115,1/12/2014,0,0,0,0,0,873,873
7089,RM-1115,5/15/2014,873,0,0,0,0,0,873
7653,RM-1116,1/12/2014,873,0,0,0,0,0,873
7776,RM-1116,5/15/2014,873,0,0,0,0,0,873
9026,RM-1122,1/12/2014,0,0,0,0,0,873,873
10044,RM-1123,12/13/2014,873,0,0,0,0,0,873
10077,RM-1123,1/15/2015,873,0,0,0,0,0,873
10080,RM-1123,1/18/2015,873,0,0,0,0,0,873
10083,RM-1123,1/21/2015,873,0,0,0,0,0,873
10396,RM-1124,1/12/2014,0,0,0,0,0,873,873
12646,RM-1130,12/13/2014,0,0,873,0,0,0,873
12679,RM-1130,1/15/2015,0,0,873,0,0,0,873
12682,RM-1130,1/18/2015,0,0,873,0,0,0,873
12685,RM-1130,1/21/2015,0,0,873,0,0,0,873
13001,RM-1132,1/12/2014,0,0,873,0,0,0,873
13334,RM-1132,12/13/2014,0,0,873,0,0,0,873
13367,RM-1132,1/15/2015,0,0,873,0,0,0,873
13370,RM-1132,1/18/2015,0,0,873,0,0,0,873
13373,RM-1132,1/21/2015,0,0,873,0,0,0,873
14331,RM-1134,5/15/2014,873,0,0,0,0,0,873
14541,RM-1134,12/13/2014,873,0,0,0,0,0,873
15811,RM-1144,12/13/2014,0,0,873,0,0,0,873
16163,RM-1145,1/12/2014,0,0,0,0,0,873,873
16469,RM-1145,12/13/2014,0,0,873,0,0,0,873
16502,RM-1145,1/15/2015,0,0,873,0,0,0,873
16505,RM-1145,1/18/2015,0,0,873,0,0,0,873
16508,RM-1145,1/21/2015,0,0,873,0,0,0,873
19001,RM-1155,5/15/2014,873,0,0,0,0,0,873
19211,RM-1155,12/13/2014,873,0,0,0,0,0,873
19244,RM-1155,1/15/2015,873,0,0,0,0,0,873
19247,RM-1155,1/18/2015,873,0,0,0,0,0,873
19250,RM-1155,1/21/2015,873,0,0,0,0,0,873
19554,RM-1156,1/12/2014,873,0,0,0,0,0,873
19887,RM-1156,12/13/2014,0,0,873,0,0,0,873
19920,RM-1156,1/15/2015,0,0,873,0,0,0,873
19923,RM-1156,1/18/2015,0,0,873,0,0,0,873
19926,RM-1156,1/21/2015,0,0,873,0,0,0,873
22995,RM-1207,5/15/2014,873,0,0,0,0,0,873
24576,RM-1208B,12/11/2014,873,0,0,0,0,0,873
24578,RM-1208B,12/13/2014,873,0,0,0,0,0,873
24611,RM-1208B,1/15/2015,873,0,0,0,0,0,873
24614,RM-1208B,1/18/2015,873,0,0,0,0,0,873
24617,RM-1208B,1/21/2015,873,0,0,0,0,0,873
25053,RM-1212,5/15/2014,873,0,0,0,0,0,873
25261,RM-1212,12/11/2014,873,0,0,0,0,0,873
25263,RM-1212,12/13/2014,873,0,0,0,0,0,873
25600,RM-1213,1/12/2014,0,0,0,0,0,873,873
27989,RM-1218,12/11/2014,873,0,0,0,0,0,873
27991,RM-1218,12/13/2014,873,0,0,0,0,0,873
28024,RM-1218,1/15/2015,873,0,0,0,0,0,873
28027,RM-1218,1/18/2015,873,0,0,0,0,0,873
28030,RM-1218,1/21/2015,873,0,0,0,0,0,873
29154,RM-1223,5/15/2014,873,0,0,0,0,0,873
29362,RM-1223,12/11/2014,873,0,0,0,0,0,873
29364,RM-1223,12/13/2014,873,0,0,0,0,0,873
30082,RM-1224,1/15/2015,873,0,0,0,0,0,873
30085,RM-1224,1/18/2015,873,0,0,0,0,0,873
30088,RM-1224,1/21/2015,873,0,0,0,0,0,873
30737,RM-1229,12/13/2014,0,0,873,0,0,0,873
30770,RM-1229,1/15/2015,0,0,873,0,0,0,873
30773,RM-1229,1/18/2015,0,0,873,0,0,0,873
30776,RM-1229,1/21/2015,0,0,873,0,0,0,873
31741,RM-1231,1/12/2014,0,0,0,0,0,873,873
32764,RM-1236,12/13/2014,873,0,0,0,0,0,873
32797,RM-1236,1/15/2015,873,0,0,0,0,0,873
32800,RM-1236,1/18/2015,873,0,0,0,0,0,873
32803,RM-1236,1/21/2015,873,0,0,0,0,0,873
33603,RM-4xxx,12/14/2014,0,0,0,0,873,0,873
33635,RM-4xxx,1/15/2015,0,0,0,0,873,0,873
33638,RM-4xxx,1/18/2015,0,0,0,0,873,0,873
33641,RM-4xxx,1/21/2015,0,0,0,0,873,0,873
34023,RM-B102C,12/11/2014,873,0,0,0,0,0,873
34025,RM-B102C,12/13/2014,873,0,0,0,0,0,873
34058,RM-B102C,1/15/2015,873,0,0,0,0,0,873
34061,RM-B102C,1/18/2015,873,0,0,0,0,0,873
34064,RM-B102C,1/21/2015,873,0,0,0,0,0,873
37309,RM-B200C,12/13/2014,873,0,0,0,0,0,873
37342,RM-B200C,1/15/2015,873,0,0,0,0,0,873
37345,RM-B200C,1/18/2015,873,0,0,0,0,0,873
37348,RM-B200C,1/21/2015,873,0,0,0,0,0,873
38718,RM-B215,1/15/2015,873,0,0,0,0,0,873
38721,RM-B215,1/18/2015,873,0,0,0,0,0,873
38724,RM-B215,1/21/2015,873,0,0,0,0,0,873
39037,RM-B220,1/12/2014,873,0,0,0,0,0,873
39160,RM-B220,5/15/2014,873,0,0,0,0,0,873
39725,RM-B222,1/12/2014,873,0,0,0,0,0,873
39848,RM-B222,5/15/2014,873,0,0,0,0,0,873
40058,RM-B222,12/13/2014,873,0,0,0,0,0,873
40413,RM-B224,1/12/2014,0,0,0,0,0,873,873
41101,RM-B225,1/12/2014,0,0,0,0,0,873,873
42471,RM-B230A,1/12/2014,0,0,0,0,0,873,873
43370,RM-B240,12/13/2014,0,0,873,0,0,0,873
43403,RM-B240,1/15/2015,0,0,873,0,0,0,873
43406,RM-B240,1/18/2015,0,0,873,0,0,0,873
43409,RM-B240,1/21/2015,0,0,873,0,0,0,873
43980,RM-B240A,12/13/2014,0,0,873,0,0,0,873
44013,RM-B240A,1/15/2015,0,0,873,0,0,0,873
44016,RM-B240A,1/18/2015,0,0,873,0,0,0,873
44019,RM-B240A,1/21/2015,0,0,873,0,0,0,873
45139,RM-B250A,5/15/2014,873,0,0,0,0,0,873
45349,RM-B250A,12/13/2014,873,0,0,0,0,0,873
45382,RM-B250A,1/15/2015,873,0,0,0,0,0,873
45385,RM-B250A,1/18/2015,873,0,0,0,0,0,873
45388,RM-B250A,1/21/2015,873,0,0,0,0,0,873
46067,RM-B260,1/15/2015,0,0,873,0,0,0,873
46070,RM-B260,1/18/2015,0,0,873,0,0,0,873
46073,RM-B260,1/21/2015,0,0,873,0,0,0,873
48072,RM-B275,12/13/2014,873,0,0,0,0,0,873
48105,RM-B275,1/15/2015,873,0,0,0,0,0,873
48108,RM-B275,1/18/2015,873,0,0,0,0,0,873
48111,RM-B275,1/21/2015,873,0,0,0,0,0,873
387,RM-1100A,8/2/2014,870,0,0,0,0,0,870
391,RM-1100A,8/6/2014,870,0,0,0,0,0,870
508,RM-1100A,12/3/2014,870,0,0,0,0,0,870
516,RM-1100A,12/11/2014,870,0,0,0,0,0,870
517,RM-1100A,12/12/2014,870,0,0,0,0,0,870
545,RM-1100A,1/9/2015,870,0,0,0,0,0,870
553,RM-1100A,1/17/2015,870,0,0,0,0,0,870
558,RM-1100A,1/22/2015,870,0,0,0,0,0,870
1757,RM-1102,8/2/2014,870,0,0,0,0,0,870
1761,RM-1102,8/6/2014,870,0,0,0,0,0,870
1878,RM-1102,12/3/2014,870,0,0,0,0,0,870
1887,RM-1102,12/12/2014,870,0,0,0,0,0,870
1923,RM-1102,1/17/2015,870,0,0,0,0,0,870
1928,RM-1102,1/22/2015,870,0,0,0,0,0,870
4610,RM-1108,1/9/2015,0,0,870,0,0,0,870
4618,RM-1108,1/17/2015,0,0,870,0,0,0,870
4623,RM-1108,1/22/2015,0,0,870,0,0,0,870
5824,RM-1110,8/2/2014,0,0,870,0,0,0,870
5828,RM-1110,8/6/2014,0,0,870,0,0,0,870
6430,RM-1113,5/15/2014,0,0,870,0,0,0,870
6509,RM-1113,8/2/2014,0,0,870,0,0,0,870
6513,RM-1113,8/6/2014,0,0,870,0,0,0,870
9913,RM-1123,8/2/2014,870,0,0,0,0,0,870
9917,RM-1123,8/6/2014,870,0,0,0,0,0,870
10034,RM-1123,12/3/2014,870,0,0,0,0,0,870
10042,RM-1123,12/11/2014,870,0,0,0,0,0,870
10043,RM-1123,12/12/2014,870,0,0,0,0,0,870
10071,RM-1123,1/9/2015,870,0,0,0,0,0,870
10079,RM-1123,1/17/2015,870,0,0,0,0,0,870
10084,RM-1123,1/22/2015,870,0,0,0,0,0,870
12636,RM-1130,12/3/2014,0,0,870,0,0,0,870
12644,RM-1130,12/11/2014,0,0,870,0,0,0,870
12645,RM-1130,12/12/2014,0,0,870,0,0,0,870
12673,RM-1130,1/9/2015,0,0,870,0,0,0,870
12681,RM-1130,1/17/2015,0,0,870,0,0,0,870
12686,RM-1130,1/22/2015,0,0,870,0,0,0,870
13203,RM-1132,8/2/2014,0,0,870,0,0,0,870
13207,RM-1132,8/6/2014,0,0,870,0,0,0,870
13324,RM-1132,12/3/2014,0,0,870,0,0,0,870
13332,RM-1132,12/11/2014,0,0,870,0,0,0,870
13333,RM-1132,12/12/2014,0,0,870,0,0,0,870
13361,RM-1132,1/9/2015,0,0,870,0,0,0,870
13369,RM-1132,1/17/2015,0,0,870,0,0,0,870
13374,RM-1132,1/22/2015,0,0,870,0,0,0,870
14410,RM-1134,8/2/2014,870,0,0,0,0,0,870
14414,RM-1134,8/6/2014,870,0,0,0,0,0,870
14531,RM-1134,12/3/2014,870,0,0,0,0,0,870
14539,RM-1134,12/11/2014,870,0,0,0,0,0,870
14540,RM-1134,12/12/2014,870,0,0,0,0,0,870
15601,RM-1144,5/15/2014,0,0,870,0,0,0,870
15680,RM-1144,8/2/2014,0,0,870,0,0,0,870
15684,RM-1144,8/6/2014,0,0,870,0,0,0,870
15801,RM-1144,12/3/2014,0,0,870,0,0,0,870
15809,RM-1144,12/11/2014,0,0,870,0,0,0,870
15810,RM-1144,12/12/2014,0,0,870,0,0,0,870
16259,RM-1145,5/15/2014,0,0,870,0,0,0,870
16338,RM-1145,8/2/2014,0,0,870,0,0,0,870
16342,RM-1145,8/6/2014,0,0,870,0,0,0,870
16459,RM-1145,12/3/2014,0,0,870,0,0,0,870
16467,RM-1145,12/11/2014,0,0,870,0,0,0,870
16468,RM-1145,12/12/2014,0,0,870,0,0,0,870
16496,RM-1145,1/9/2015,0,0,870,0,0,0,870
16504,RM-1145,1/17/2015,0,0,870,0,0,0,870
16509,RM-1145,1/22/2015,0,0,870,0,0,0,870
17707,RM-1151,8/2/2014,870,0,0,0,0,0,870
17711,RM-1151,8/6/2014,870,0,0,0,0,0,870
19080,RM-1155,8/2/2014,870,0,0,0,0,0,870
19084,RM-1155,8/6/2014,870,0,0,0,0,0,870
19201,RM-1155,12/3/2014,870,0,0,0,0,0,870
19209,RM-1155,12/11/2014,870,0,0,0,0,0,870
19210,RM-1155,12/12/2014,870,0,0,0,0,0,870
19238,RM-1155,1/9/2015,870,0,0,0,0,0,870
19246,RM-1155,1/17/2015,870,0,0,0,0,0,870
19251,RM-1155,1/22/2015,870,0,0,0,0,0,870
19877,RM-1156,12/3/2014,0,0,870,0,0,0,870
19885,RM-1156,12/11/2014,0,0,870,0,0,0,870
19886,RM-1156,12/12/2014,0,0,870,0,0,0,870
19914,RM-1156,1/9/2015,0,0,870,0,0,0,870
19922,RM-1156,1/17/2015,0,0,870,0,0,0,870
19927,RM-1156,1/22/2015,0,0,870,0,0,0,870
23074,RM-1207,8/2/2014,870,0,0,0,0,0,870
23759,RM-1208,8/2/2014,870,0,0,0,0,0,870
23763,RM-1208,8/6/2014,870,0,0,0,0,0,870
24568,RM-1208B,12/3/2014,870,0,0,0,0,0,870
24577,RM-1208B,12/12/2014,870,0,0,0,0,0,870
24613,RM-1208B,1/17/2015,870,0,0,0,0,0,870
24618,RM-1208B,1/22/2015,870,0,0,0,0,0,870
25132,RM-1212,8/2/2014,870,0,0,0,0,0,870
25136,RM-1212,8/6/2014,870,0,0,0,0,0,870
25253,RM-1212,12/3/2014,870,0,0,0,0,0,870
25262,RM-1212,12/12/2014,870,0,0,0,0,0,870
26408,RM-1213A,5/15/2014,0,0,870,0,0,0,870
26487,RM-1213A,8/2/2014,0,0,870,0,0,0,870
26491,RM-1213A,8/6/2014,0,0,870,0,0,0,870
27172,RM-1217,8/2/2014,870,0,0,0,0,0,870
27176,RM-1217,8/6/2014,870,0,0,0,0,0,870
27981,RM-1218,12/3/2014,870,0,0,0,0,0,870
27990,RM-1218,12/12/2014,870,0,0,0,0,0,870
28026,RM-1218,1/17/2015,870,0,0,0,0,0,870
28031,RM-1218,1/22/2015,870,0,0,0,0,0,870
28548,RM-1221,8/2/2014,0,0,870,0,0,0,870
28552,RM-1221,8/6/2014,0,0,870,0,0,0,870
29233,RM-1223,8/2/2014,870,0,0,0,0,0,870
29237,RM-1223,8/6/2014,870,0,0,0,0,0,870
29354,RM-1223,12/3/2014,870,0,0,0,0,0,870
29363,RM-1223,12/12/2014,870,0,0,0,0,0,870
30084,RM-1224,1/17/2015,870,0,0,0,0,0,870
30089,RM-1224,1/22/2015,870,0,0,0,0,0,870
30606,RM-1229,8/2/2014,0,0,870,0,0,0,870
30610,RM-1229,8/6/2014,0,0,870,0,0,0,870
30727,RM-1229,12/3/2014,0,0,870,0,0,0,870
30735,RM-1229,12/11/2014,0,0,870,0,0,0,870
30736,RM-1229,12/12/2014,0,0,870,0,0,0,870
30772,RM-1229,1/17/2015,0,0,870,0,0,0,870
30777,RM-1229,1/22/2015,0,0,870,0,0,0,870
32754,RM-1236,12/3/2014,870,0,0,0,0,0,870
32762,RM-1236,12/11/2014,870,0,0,0,0,0,870
32763,RM-1236,12/12/2014,870,0,0,0,0,0,870
32799,RM-1236,1/17/2015,870,0,0,0,0,0,870
32804,RM-1236,1/22/2015,870,0,0,0,0,0,870
33592,RM-4xxx,12/3/2014,0,0,0,0,870,0,870
33600,RM-4xxx,12/11/2014,0,0,0,0,870,0,870
33601,RM-4xxx,12/12/2014,0,0,0,0,870,0,870
33629,RM-4xxx,1/9/2015,0,0,0,0,870,0,870
33637,RM-4xxx,1/17/2015,0,0,0,0,870,0,870
34024,RM-B102C,12/12/2014,870,0,0,0,0,0,870
34060,RM-B102C,1/17/2015,870,0,0,0,0,0,870
34065,RM-B102C,1/22/2015,870,0,0,0,0,0,870
36497,RM-B200B,8/2/2014,0,0,870,0,0,0,870
36501,RM-B200B,8/6/2014,0,0,870,0,0,0,870
37178,RM-B200C,8/2/2014,870,0,0,0,0,0,870
37182,RM-B200C,8/6/2014,870,0,0,0,0,0,870
37299,RM-B200C,12/3/2014,870,0,0,0,0,0,870
37307,RM-B200C,12/11/2014,870,0,0,0,0,0,870
37308,RM-B200C,12/12/2014,870,0,0,0,0,0,870
37336,RM-B200C,1/9/2015,870,0,0,0,0,0,870
37344,RM-B200C,1/17/2015,870,0,0,0,0,0,870
37349,RM-B200C,1/22/2015,870,0,0,0,0,0,870
38475,RM-B215,5/15/2014,0,0,870,0,0,0,870
38712,RM-B215,1/9/2015,870,0,0,0,0,0,870
38720,RM-B215,1/17/2015,870,0,0,0,0,0,870
38725,RM-B215,1/22/2015,870,0,0,0,0,0,870
39239,RM-B220,8/2/2014,870,0,0,0,0,0,870
39243,RM-B220,8/6/2014,870,0,0,0,0,0,870
39927,RM-B222,8/2/2014,870,0,0,0,0,0,870
39931,RM-B222,8/6/2014,870,0,0,0,0,0,870
40048,RM-B222,12/3/2014,870,0,0,0,0,0,870
40056,RM-B222,12/11/2014,870,0,0,0,0,0,870
40057,RM-B222,12/12/2014,870,0,0,0,0,0,870
40085,RM-B222,1/9/2015,870,0,0,0,0,0,870
41988,RM-B230,8/2/2014,870,0,0,0,0,0,870
41992,RM-B230,8/6/2014,870,0,0,0,0,0,870
43160,RM-B240,5/15/2014,0,0,870,0,0,0,870
43239,RM-B240,8/2/2014,0,0,870,0,0,0,870
43243,RM-B240,8/6/2014,0,0,870,0,0,0,870
43360,RM-B240,12/3/2014,0,0,870,0,0,0,870
43368,RM-B240,12/11/2014,0,0,870,0,0,0,870
43369,RM-B240,12/12/2014,0,0,870,0,0,0,870
43397,RM-B240,1/9/2015,0,0,870,0,0,0,870
43405,RM-B240,1/17/2015,0,0,870,0,0,0,870
43410,RM-B240,1/22/2015,0,0,870,0,0,0,870
43970,RM-B240A,12/3/2014,0,0,870,0,0,0,870
43978,RM-B240A,12/11/2014,0,0,870,0,0,0,870
43979,RM-B240A,12/12/2014,0,0,870,0,0,0,870
44007,RM-B240A,1/9/2015,0,0,870,0,0,0,870
44015,RM-B240A,1/17/2015,0,0,870,0,0,0,870
44020,RM-B240A,1/22/2015,0,0,870,0,0,0,870
44534,RM-B250,8/2/2014,0,0,870,0,0,0,870
44538,RM-B250,8/6/2014,0,0,870,0,0,0,870
45218,RM-B250A,8/2/2014,870,0,0,0,0,0,870
45222,RM-B250A,8/6/2014,870,0,0,0,0,0,870
45339,RM-B250A,12/3/2014,870,0,0,0,0,0,870
45347,RM-B250A,12/11/2014,870,0,0,0,0,0,870
45348,RM-B250A,12/12/2014,870,0,0,0,0,0,870
45376,RM-B250A,1/9/2015,870,0,0,0,0,0,870
45384,RM-B250A,1/17/2015,870,0,0,0,0,0,870
45389,RM-B250A,1/22/2015,870,0,0,0,0,0,870
45903,RM-B260,8/2/2014,870,0,0,0,0,0,870
45907,RM-B260,8/6/2014,870,0,0,0,0,0,870
46061,RM-B260,1/9/2015,0,0,870,0,0,0,870
46069,RM-B260,1/17/2015,0,0,870,0,0,0,870
46074,RM-B260,1/22/2015,0,0,870,0,0,0,870
48062,RM-B275,12/3/2014,870,0,0,0,0,0,870
48070,RM-B275,12/11/2014,870,0,0,0,0,0,870
48071,RM-B275,12/12/2014,870,0,0,0,0,0,870
48099,RM-B275,1/9/2015,870,0,0,0,0,0,870
48107,RM-B275,1/17/2015,870,0,0,0,0,0,870
48112,RM-B275,1/22/2015,870,0,0,0,0,0,870
284,RM-1100A,4/21/2014,867,0,0,0,0,0,867
386,RM-1100A,8/1/2014,867,0,0,0,0,0,867
388,RM-1100A,8/3/2014,867,0,0,0,0,0,867
537,RM-1100A,1/1/2015,867,0,0,0,0,0,867
541,RM-1100A,1/5/2015,867,0,0,0,0,0,867
542,RM-1100A,1/6/2015,867,0,0,0,0,0,867
543,RM-1100A,1/7/2015,867,0,0,0,0,0,867
544,RM-1100A,1/8/2015,867,0,0,0,0,0,867
1654,RM-1102,4/21/2014,867,0,0,0,0,0,867
1756,RM-1102,8/1/2014,867,0,0,0,0,0,867
1758,RM-1102,8/3/2014,867,0,0,0,0,0,867
1907,RM-1102,1/1/2015,867,0,0,0,0,0,867
1911,RM-1102,1/5/2015,867,0,0,0,0,0,867
1912,RM-1102,1/6/2015,867,0,0,0,0,0,867
1913,RM-1102,1/7/2015,867,0,0,0,0,0,867
1914,RM-1102,1/8/2015,867,0,0,0,0,0,867
1915,RM-1102,1/9/2015,867,0,0,0,0,0,867
1916,RM-1102,1/10/2015,867,0,0,0,0,0,867
2029,RM-1102,5/3/2015,867,0,0,0,0,0,867
4602,RM-1108,1/1/2015,0,0,867,0,0,0,867
4606,RM-1108,1/5/2015,0,0,867,0,0,0,867
4607,RM-1108,1/6/2015,0,0,867,0,0,0,867
4608,RM-1108,1/7/2015,0,0,867,0,0,0,867
4609,RM-1108,1/8/2015,0,0,867,0,0,0,867
4724,RM-1108,5/3/2015,0,0,867,0,0,0,867
5722,RM-1110,4/21/2014,0,0,867,0,0,0,867
5823,RM-1110,8/1/2014,0,0,867,0,0,0,867
5825,RM-1110,8/3/2014,0,0,867,0,0,0,867
6406,RM-1113,4/21/2014,0,0,867,0,0,0,867
6508,RM-1113,8/1/2014,0,0,867,0,0,0,867
6510,RM-1113,8/3/2014,0,0,867,0,0,0,867
7065,RM-1115,4/21/2014,867,0,0,0,0,0,867
7752,RM-1116,4/21/2014,867,0,0,0,0,0,867
8127,RM-1116,5/3/2015,0,0,867,0,0,0,867
9500,RM-1122,5/3/2015,0,0,867,0,0,0,867
9912,RM-1123,8/1/2014,867,0,0,0,0,0,867
9914,RM-1123,8/3/2014,867,0,0,0,0,0,867
10063,RM-1123,1/1/2015,867,0,0,0,0,0,867
10067,RM-1123,1/5/2015,867,0,0,0,0,0,867
10068,RM-1123,1/6/2015,867,0,0,0,0,0,867
10069,RM-1123,1/7/2015,867,0,0,0,0,0,867
10070,RM-1123,1/8/2015,867,0,0,0,0,0,867
12665,RM-1130,1/1/2015,0,0,867,0,0,0,867
12669,RM-1130,1/5/2015,0,0,867,0,0,0,867
12670,RM-1130,1/6/2015,0,0,867,0,0,0,867
12671,RM-1130,1/7/2015,0,0,867,0,0,0,867
12672,RM-1130,1/8/2015,0,0,867,0,0,0,867
13202,RM-1132,8/1/2014,0,0,867,0,0,0,867
13204,RM-1132,8/3/2014,0,0,867,0,0,0,867
13353,RM-1132,1/1/2015,0,0,867,0,0,0,867
13357,RM-1132,1/5/2015,0,0,867,0,0,0,867
13358,RM-1132,1/6/2015,0,0,867,0,0,0,867
13359,RM-1132,1/7/2015,0,0,867,0,0,0,867
13360,RM-1132,1/8/2015,0,0,867,0,0,0,867
13475,RM-1132,5/3/2015,0,0,867,0,0,0,867
14308,RM-1134,4/21/2014,867,0,0,0,0,0,867
14409,RM-1134,8/1/2014,867,0,0,0,0,0,867
14411,RM-1134,8/3/2014,867,0,0,0,0,0,867
14560,RM-1134,1/1/2015,867,0,0,0,0,0,867
14564,RM-1134,1/5/2015,867,0,0,0,0,0,867
14565,RM-1134,1/6/2015,867,0,0,0,0,0,867
14566,RM-1134,1/7/2015,867,0,0,0,0,0,867
15577,RM-1144,4/21/2014,0,0,867,0,0,0,867
15679,RM-1144,8/1/2014,0,0,867,0,0,0,867
15681,RM-1144,8/3/2014,0,0,867,0,0,0,867
16337,RM-1145,8/1/2014,0,0,867,0,0,0,867
16339,RM-1145,8/3/2014,0,0,867,0,0,0,867
16488,RM-1145,1/1/2015,0,0,867,0,0,0,867
16492,RM-1145,1/5/2015,0,0,867,0,0,0,867
16493,RM-1145,1/6/2015,0,0,867,0,0,0,867
16494,RM-1145,1/7/2015,0,0,867,0,0,0,867
16495,RM-1145,1/8/2015,0,0,867,0,0,0,867
17706,RM-1151,8/1/2014,867,0,0,0,0,0,867
17708,RM-1151,8/3/2014,867,0,0,0,0,0,867
18977,RM-1155,4/21/2014,867,0,0,0,0,0,867
19079,RM-1155,8/1/2014,867,0,0,0,0,0,867
19081,RM-1155,8/3/2014,867,0,0,0,0,0,867
19230,RM-1155,1/1/2015,867,0,0,0,0,0,867
19234,RM-1155,1/5/2015,867,0,0,0,0,0,867
19235,RM-1155,1/6/2015,867,0,0,0,0,0,867
19236,RM-1155,1/7/2015,867,0,0,0,0,0,867
19237,RM-1155,1/8/2015,867,0,0,0,0,0,867
19906,RM-1156,1/1/2015,0,0,867,0,0,0,867
19910,RM-1156,1/5/2015,0,0,867,0,0,0,867
19911,RM-1156,1/6/2015,0,0,867,0,0,0,867
19912,RM-1156,1/7/2015,0,0,867,0,0,0,867
19913,RM-1156,1/8/2015,0,0,867,0,0,0,867
20682,RM-1200A,5/3/2015,867,0,0,0,0,0,867
22030,RM-1200C,5/3/2015,867,0,0,0,0,0,867
22971,RM-1207,4/21/2014,867,0,0,0,0,0,867
23073,RM-1207,8/1/2014,867,0,0,0,0,0,867
23758,RM-1208,8/1/2014,867,0,0,0,0,0,867
23760,RM-1208,8/3/2014,867,0,0,0,0,0,867
24597,RM-1208B,1/1/2015,867,0,0,0,0,0,867
24601,RM-1208B,1/5/2015,867,0,0,0,0,0,867
24602,RM-1208B,1/6/2015,867,0,0,0,0,0,867
24603,RM-1208B,1/7/2015,867,0,0,0,0,0,867
24604,RM-1208B,1/8/2015,867,0,0,0,0,0,867
24605,RM-1208B,1/9/2015,867,0,0,0,0,0,867
24606,RM-1208B,1/10/2015,867,0,0,0,0,0,867
24719,RM-1208B,5/3/2015,867,0,0,0,0,0,867
25029,RM-1212,4/21/2014,867,0,0,0,0,0,867
25131,RM-1212,8/1/2014,867,0,0,0,0,0,867
25133,RM-1212,8/3/2014,867,0,0,0,0,0,867
26384,RM-1213A,4/21/2014,0,0,867,0,0,0,867
26486,RM-1213A,8/1/2014,0,0,867,0,0,0,867
26488,RM-1213A,8/3/2014,0,0,867,0,0,0,867
27171,RM-1217,8/1/2014,867,0,0,0,0,0,867
27173,RM-1217,8/3/2014,867,0,0,0,0,0,867
28010,RM-1218,1/1/2015,867,0,0,0,0,0,867
28014,RM-1218,1/5/2015,867,0,0,0,0,0,867
28015,RM-1218,1/6/2015,867,0,0,0,0,0,867
28016,RM-1218,1/7/2015,867,0,0,0,0,0,867
28017,RM-1218,1/8/2015,867,0,0,0,0,0,867
28018,RM-1218,1/9/2015,867,0,0,0,0,0,867
28019,RM-1218,1/10/2015,867,0,0,0,0,0,867
28132,RM-1218,5/3/2015,867,0,0,0,0,0,867
28547,RM-1221,8/1/2014,0,0,867,0,0,0,867
28549,RM-1221,8/3/2014,0,0,867,0,0,0,867
29232,RM-1223,8/1/2014,867,0,0,0,0,0,867
29234,RM-1223,8/3/2014,867,0,0,0,0,0,867
29505,RM-1223,5/3/2015,0,0,867,0,0,0,867
30068,RM-1224,1/1/2015,867,0,0,0,0,0,867
30072,RM-1224,1/5/2015,867,0,0,0,0,0,867
30073,RM-1224,1/6/2015,867,0,0,0,0,0,867
30074,RM-1224,1/7/2015,867,0,0,0,0,0,867
30075,RM-1224,1/8/2015,867,0,0,0,0,0,867
30076,RM-1224,1/9/2015,867,0,0,0,0,0,867
30077,RM-1224,1/10/2015,867,0,0,0,0,0,867
30190,RM-1224,5/3/2015,867,0,0,0,0,0,867
30605,RM-1229,8/1/2014,0,0,867,0,0,0,867
30607,RM-1229,8/3/2014,0,0,867,0,0,0,867
30756,RM-1229,1/1/2015,0,0,867,0,0,0,867
30760,RM-1229,1/5/2015,0,0,867,0,0,0,867
30761,RM-1229,1/6/2015,0,0,867,0,0,0,867
30762,RM-1229,1/7/2015,0,0,867,0,0,0,867
30763,RM-1229,1/8/2015,0,0,867,0,0,0,867
30764,RM-1229,1/9/2015,0,0,867,0,0,0,867
30765,RM-1229,1/10/2015,0,0,867,0,0,0,867
30878,RM-1229,5/3/2015,0,0,867,0,0,0,867
32217,RM-1231,5/3/2015,0,0,867,0,0,0,867
32530,RM-1236,4/21/2014,0,0,867,0,0,0,867
32783,RM-1236,1/1/2015,867,0,0,0,0,0,867
32787,RM-1236,1/5/2015,867,0,0,0,0,0,867
32788,RM-1236,1/6/2015,867,0,0,0,0,0,867
32789,RM-1236,1/7/2015,867,0,0,0,0,0,867
32790,RM-1236,1/8/2015,867,0,0,0,0,0,867
32791,RM-1236,1/9/2015,867,0,0,0,0,0,867
32792,RM-1236,1/10/2015,867,0,0,0,0,0,867
32905,RM-1236,5/3/2015,867,0,0,0,0,0,867
33621,RM-4xxx,1/1/2015,0,0,0,0,867,0,867
33625,RM-4xxx,1/5/2015,0,0,0,0,867,0,867
33626,RM-4xxx,1/6/2015,0,0,0,0,867,0,867
33627,RM-4xxx,1/7/2015,0,0,0,0,867,0,867
33628,RM-4xxx,1/8/2015,0,0,0,0,867,0,867
33630,RM-4xxx,1/10/2015,0,0,0,0,867,0,867
33642,RM-4xxx,1/22/2015,0,0,0,0,867,0,867
34048,RM-B102C,1/5/2015,867,0,0,0,0,0,867
34049,RM-B102C,1/6/2015,867,0,0,0,0,0,867
34050,RM-B102C,1/7/2015,867,0,0,0,0,0,867
34051,RM-B102C,1/8/2015,867,0,0,0,0,0,867
34052,RM-B102C,1/9/2015,867,0,0,0,0,0,867
34053,RM-B102C,1/10/2015,867,0,0,0,0,0,867
34166,RM-B102C,5/3/2015,867,0,0,0,0,0,867
34848,RM-B103,5/3/2015,0,0,867,0,0,0,867
36496,RM-B200B,8/1/2014,0,0,867,0,0,0,867
36498,RM-B200B,8/3/2014,0,0,867,0,0,0,867
37177,RM-B200C,8/1/2014,867,0,0,0,0,0,867
37179,RM-B200C,8/3/2014,867,0,0,0,0,0,867
37328,RM-B200C,1/1/2015,867,0,0,0,0,0,867
37332,RM-B200C,1/5/2015,867,0,0,0,0,0,867
37333,RM-B200C,1/6/2015,867,0,0,0,0,0,867
37334,RM-B200C,1/7/2015,867,0,0,0,0,0,867
37335,RM-B200C,1/8/2015,867,0,0,0,0,0,867
37378,RM-B200C,2/20/2015,867,0,0,0,0,0,867
37450,RM-B200C,5/3/2015,867,0,0,0,0,0,867
38451,RM-B215,4/21/2014,0,0,867,0,0,0,867
38704,RM-B215,1/1/2015,867,0,0,0,0,0,867
38708,RM-B215,1/5/2015,867,0,0,0,0,0,867
38709,RM-B215,1/6/2015,867,0,0,0,0,0,867
38710,RM-B215,1/7/2015,867,0,0,0,0,0,867
38711,RM-B215,1/8/2015,867,0,0,0,0,0,867
39136,RM-B220,4/21/2014,867,0,0,0,0,0,867
39238,RM-B220,8/1/2014,867,0,0,0,0,0,867
39240,RM-B220,8/3/2014,867,0,0,0,0,0,867
39824,RM-B222,4/21/2014,867,0,0,0,0,0,867
39926,RM-B222,8/1/2014,867,0,0,0,0,0,867
39928,RM-B222,8/3/2014,867,0,0,0,0,0,867
40077,RM-B222,1/1/2015,867,0,0,0,0,0,867
40081,RM-B222,1/5/2015,867,0,0,0,0,0,867
40082,RM-B222,1/6/2015,867,0,0,0,0,0,867
40083,RM-B222,1/7/2015,867,0,0,0,0,0,867
40084,RM-B222,1/8/2015,867,0,0,0,0,0,867
41987,RM-B230,8/1/2014,867,0,0,0,0,0,867
41989,RM-B230,8/3/2014,867,0,0,0,0,0,867
43136,RM-B240,4/21/2014,0,0,867,0,0,0,867
43238,RM-B240,8/1/2014,0,0,867,0,0,0,867
43240,RM-B240,8/3/2014,0,0,867,0,0,0,867
43389,RM-B240,1/1/2015,0,0,867,0,0,0,867
43393,RM-B240,1/5/2015,0,0,867,0,0,0,867
43394,RM-B240,1/6/2015,0,0,867,0,0,0,867
43395,RM-B240,1/7/2015,0,0,867,0,0,0,867
43396,RM-B240,1/8/2015,0,0,867,0,0,0,867
43439,RM-B240,2/20/2015,0,0,867,0,0,0,867
43511,RM-B240,5/3/2015,0,0,867,0,0,0,867
43999,RM-B240A,1/1/2015,0,0,867,0,0,0,867
44003,RM-B240A,1/5/2015,0,0,867,0,0,0,867
44004,RM-B240A,1/6/2015,0,0,867,0,0,0,867
44005,RM-B240A,1/7/2015,0,0,867,0,0,0,867
44006,RM-B240A,1/8/2015,0,0,867,0,0,0,867
44121,RM-B240A,5/3/2015,0,0,867,0,0,0,867
44533,RM-B250,8/1/2014,0,0,867,0,0,0,867
44535,RM-B250,8/3/2014,0,0,867,0,0,0,867
45116,RM-B250A,4/21/2014,867,0,0,0,0,0,867
45217,RM-B250A,8/1/2014,867,0,0,0,0,0,867
45219,RM-B250A,8/3/2014,867,0,0,0,0,0,867
45368,RM-B250A,1/1/2015,867,0,0,0,0,0,867
45372,RM-B250A,1/5/2015,867,0,0,0,0,0,867
45373,RM-B250A,1/6/2015,867,0,0,0,0,0,867
45374,RM-B250A,1/7/2015,867,0,0,0,0,0,867
45375,RM-B250A,1/8/2015,867,0,0,0,0,0,867
45490,RM-B250A,5/3/2015,867,0,0,0,0,0,867
45902,RM-B260,8/1/2014,867,0,0,0,0,0,867
45904,RM-B260,8/3/2014,867,0,0,0,0,0,867
46053,RM-B260,1/1/2015,0,0,867,0,0,0,867
46057,RM-B260,1/5/2015,0,0,867,0,0,0,867
46058,RM-B260,1/6/2015,0,0,867,0,0,0,867
46059,RM-B260,1/7/2015,0,0,867,0,0,0,867
46060,RM-B260,1/8/2015,0,0,867,0,0,0,867
46103,RM-B260,2/20/2015,0,0,867,0,0,0,867
46175,RM-B260,5/3/2015,0,0,867,0,0,0,867
48091,RM-B275,1/1/2015,867,0,0,0,0,0,867
48095,RM-B275,1/5/2015,867,0,0,0,0,0,867
48096,RM-B275,1/6/2015,867,0,0,0,0,0,867
48097,RM-B275,1/7/2015,867,0,0,0,0,0,867
48098,RM-B275,1/8/2015,867,0,0,0,0,0,867
48213,RM-B275,5/3/2015,867,0,0,0,0,0,867
285,RM-1100A,4/22/2014,864,0,0,0,0,0,864
385,RM-1100A,7/31/2014,864,0,0,0,0,0,864
400,RM-1100A,8/15/2014,864,0,0,0,0,0,864
503,RM-1100A,11/28/2014,864,0,0,0,0,0,864
504,RM-1100A,11/29/2014,864,0,0,0,0,0,864
546,RM-1100A,1/10/2015,864,0,0,0,0,0,864
1655,RM-1102,4/22/2014,864,0,0,0,0,0,864
1755,RM-1102,7/31/2014,864,0,0,0,0,0,864
1770,RM-1102,8/15/2014,864,0,0,0,0,0,864
1873,RM-1102,11/28/2014,864,0,0,0,0,0,864
1874,RM-1102,11/29/2014,864,0,0,0,0,0,864
1950,RM-1102,2/13/2015,864,0,0,0,0,0,864
1956,RM-1102,2/19/2015,864,0,0,0,0,0,864
1957,RM-1102,2/20/2015,864,0,0,0,0,0,864
1962,RM-1102,2/25/2015,864,0,0,0,0,0,864
1965,RM-1102,2/28/2015,864,0,0,0,0,0,864
4611,RM-1108,1/10/2015,0,0,864,0,0,0,864
4645,RM-1108,2/13/2015,0,0,864,0,0,0,864
4651,RM-1108,2/19/2015,0,0,864,0,0,0,864
4652,RM-1108,2/20/2015,0,0,864,0,0,0,864
4657,RM-1108,2/25/2015,0,0,864,0,0,0,864
4660,RM-1108,2/28/2015,0,0,864,0,0,0,864
5723,RM-1110,4/22/2014,0,0,864,0,0,0,864
5822,RM-1110,7/31/2014,0,0,864,0,0,0,864
5837,RM-1110,8/15/2014,0,0,864,0,0,0,864
6407,RM-1113,4/22/2014,0,0,864,0,0,0,864
6507,RM-1113,7/31/2014,0,0,864,0,0,0,864
6522,RM-1113,8/15/2014,0,0,864,0,0,0,864
6702,RM-1113,2/13/2015,864,0,0,0,0,0,864
6708,RM-1113,2/19/2015,864,0,0,0,0,0,864
6709,RM-1113,2/20/2015,864,0,0,0,0,0,864
6714,RM-1113,2/25/2015,864,0,0,0,0,0,864
6717,RM-1113,2/28/2015,864,0,0,0,0,0,864
7066,RM-1115,4/22/2014,864,0,0,0,0,0,864
7753,RM-1116,4/22/2014,864,0,0,0,0,0,864
9911,RM-1123,7/31/2014,864,0,0,0,0,0,864
9926,RM-1123,8/15/2014,864,0,0,0,0,0,864
10029,RM-1123,11/28/2014,864,0,0,0,0,0,864
10030,RM-1123,11/29/2014,864,0,0,0,0,0,864
10072,RM-1123,1/10/2015,864,0,0,0,0,0,864
10106,RM-1123,2/13/2015,864,0,0,0,0,0,864
10112,RM-1123,2/19/2015,864,0,0,0,0,0,864
10113,RM-1123,2/20/2015,864,0,0,0,0,0,864
10118,RM-1123,2/25/2015,864,0,0,0,0,0,864
10121,RM-1123,2/28/2015,864,0,0,0,0,0,864
12631,RM-1130,11/28/2014,0,0,864,0,0,0,864
12632,RM-1130,11/29/2014,0,0,864,0,0,0,864
12674,RM-1130,1/10/2015,0,0,864,0,0,0,864
12708,RM-1130,2/13/2015,0,0,864,0,0,0,864
12714,RM-1130,2/19/2015,0,0,864,0,0,0,864
12715,RM-1130,2/20/2015,0,0,864,0,0,0,864
12720,RM-1130,2/25/2015,0,0,864,0,0,0,864
12723,RM-1130,2/28/2015,0,0,864,0,0,0,864
13201,RM-1132,7/31/2014,0,0,864,0,0,0,864
13216,RM-1132,8/15/2014,0,0,864,0,0,0,864
13319,RM-1132,11/28/2014,0,0,864,0,0,0,864
13320,RM-1132,11/29/2014,0,0,864,0,0,0,864
13362,RM-1132,1/10/2015,0,0,864,0,0,0,864
13396,RM-1132,2/13/2015,0,0,864,0,0,0,864
13402,RM-1132,2/19/2015,0,0,864,0,0,0,864
13403,RM-1132,2/20/2015,0,0,864,0,0,0,864
13408,RM-1132,2/25/2015,0,0,864,0,0,0,864
13411,RM-1132,2/28/2015,0,0,864,0,0,0,864
14309,RM-1134,4/22/2014,864,0,0,0,0,0,864
14408,RM-1134,7/31/2014,864,0,0,0,0,0,864
14423,RM-1134,8/15/2014,864,0,0,0,0,0,864
14526,RM-1134,11/28/2014,864,0,0,0,0,0,864
14527,RM-1134,11/29/2014,864,0,0,0,0,0,864
15578,RM-1144,4/22/2014,0,0,864,0,0,0,864
15678,RM-1144,7/31/2014,0,0,864,0,0,0,864
15693,RM-1144,8/15/2014,0,0,864,0,0,0,864
15796,RM-1144,11/28/2014,0,0,864,0,0,0,864
15797,RM-1144,11/29/2014,0,0,864,0,0,0,864
16336,RM-1145,7/31/2014,0,0,864,0,0,0,864
16351,RM-1145,8/15/2014,0,0,864,0,0,0,864
16454,RM-1145,11/28/2014,0,0,864,0,0,0,864
16455,RM-1145,11/29/2014,0,0,864,0,0,0,864
16497,RM-1145,1/10/2015,0,0,864,0,0,0,864
16531,RM-1145,2/13/2015,0,0,864,0,0,0,864
16537,RM-1145,2/19/2015,0,0,864,0,0,0,864
16538,RM-1145,2/20/2015,0,0,864,0,0,0,864
16543,RM-1145,2/25/2015,0,0,864,0,0,0,864
16546,RM-1145,2/28/2015,0,0,864,0,0,0,864
17705,RM-1151,7/31/2014,864,0,0,0,0,0,864
17720,RM-1151,8/15/2014,864,0,0,0,0,0,864
18978,RM-1155,4/22/2014,864,0,0,0,0,0,864
19078,RM-1155,7/31/2014,864,0,0,0,0,0,864
19093,RM-1155,8/15/2014,864,0,0,0,0,0,864
19196,RM-1155,11/28/2014,864,0,0,0,0,0,864
19197,RM-1155,11/29/2014,864,0,0,0,0,0,864
19239,RM-1155,1/10/2015,864,0,0,0,0,0,864
19872,RM-1156,11/28/2014,0,0,864,0,0,0,864
19873,RM-1156,11/29/2014,0,0,864,0,0,0,864
19915,RM-1156,1/10/2015,0,0,864,0,0,0,864
20988,RM-1200B,5/9/2014,0,864,0,0,0,0,864
21951,RM-1200C,2/13/2015,864,0,0,0,0,0,864
21957,RM-1200C,2/19/2015,864,0,0,0,0,0,864
21958,RM-1200C,2/20/2015,864,0,0,0,0,0,864
21963,RM-1200C,2/25/2015,864,0,0,0,0,0,864
21966,RM-1200C,2/28/2015,864,0,0,0,0,0,864
22972,RM-1207,4/22/2014,864,0,0,0,0,0,864
23072,RM-1207,7/31/2014,864,0,0,0,0,0,864
23757,RM-1208,7/31/2014,864,0,0,0,0,0,864
23772,RM-1208,8/15/2014,864,0,0,0,0,0,864
24563,RM-1208B,11/28/2014,864,0,0,0,0,0,864
24564,RM-1208B,11/29/2014,864,0,0,0,0,0,864
24640,RM-1208B,2/13/2015,864,0,0,0,0,0,864
24646,RM-1208B,2/19/2015,864,0,0,0,0,0,864
24647,RM-1208B,2/20/2015,864,0,0,0,0,0,864
24652,RM-1208B,2/25/2015,864,0,0,0,0,0,864
24655,RM-1208B,2/28/2015,864,0,0,0,0,0,864
25030,RM-1212,4/22/2014,864,0,0,0,0,0,864
25130,RM-1212,7/31/2014,864,0,0,0,0,0,864
25145,RM-1212,8/15/2014,864,0,0,0,0,0,864
25248,RM-1212,11/28/2014,864,0,0,0,0,0,864
25249,RM-1212,11/29/2014,864,0,0,0,0,0,864
26385,RM-1213A,4/22/2014,0,0,864,0,0,0,864
26485,RM-1213A,7/31/2014,0,0,864,0,0,0,864
26500,RM-1213A,8/15/2014,0,0,864,0,0,0,864
27170,RM-1217,7/31/2014,864,0,0,0,0,0,864
27185,RM-1217,8/15/2014,864,0,0,0,0,0,864
27976,RM-1218,11/28/2014,864,0,0,0,0,0,864
27977,RM-1218,11/29/2014,864,0,0,0,0,0,864
28053,RM-1218,2/13/2015,864,0,0,0,0,0,864
28059,RM-1218,2/19/2015,864,0,0,0,0,0,864
28060,RM-1218,2/20/2015,864,0,0,0,0,0,864
28065,RM-1218,2/25/2015,864,0,0,0,0,0,864
28068,RM-1218,2/28/2015,864,0,0,0,0,0,864
28546,RM-1221,7/31/2014,0,0,864,0,0,0,864
28561,RM-1221,8/15/2014,0,0,864,0,0,0,864
29231,RM-1223,7/31/2014,864,0,0,0,0,0,864
29246,RM-1223,8/15/2014,864,0,0,0,0,0,864
29349,RM-1223,11/28/2014,864,0,0,0,0,0,864
29350,RM-1223,11/29/2014,864,0,0,0,0,0,864
29832,RM-1224,5/8/2014,0,0,0,864,0,0,864
30111,RM-1224,2/13/2015,864,0,0,0,0,0,864
30117,RM-1224,2/19/2015,864,0,0,0,0,0,864
30118,RM-1224,2/20/2015,864,0,0,0,0,0,864
30123,RM-1224,2/25/2015,864,0,0,0,0,0,864
30126,RM-1224,2/28/2015,864,0,0,0,0,0,864
30604,RM-1229,7/31/2014,0,0,864,0,0,0,864
30619,RM-1229,8/15/2014,0,0,864,0,0,0,864
30722,RM-1229,11/28/2014,0,0,864,0,0,0,864
30723,RM-1229,11/29/2014,0,0,864,0,0,0,864
30799,RM-1229,2/13/2015,0,0,864,0,0,0,864
30805,RM-1229,2/19/2015,0,0,864,0,0,0,864
30806,RM-1229,2/20/2015,0,0,864,0,0,0,864
30811,RM-1229,2/25/2015,0,0,864,0,0,0,864
30814,RM-1229,2/28/2015,0,0,864,0,0,0,864
32631,RM-1236,7/31/2014,0,0,864,0,0,0,864
32749,RM-1236,11/28/2014,864,0,0,0,0,0,864
32750,RM-1236,11/29/2014,864,0,0,0,0,0,864
32826,RM-1236,2/13/2015,864,0,0,0,0,0,864
32832,RM-1236,2/19/2015,864,0,0,0,0,0,864
32833,RM-1236,2/20/2015,864,0,0,0,0,0,864
32838,RM-1236,2/25/2015,864,0,0,0,0,0,864
32841,RM-1236,2/28/2015,864,0,0,0,0,0,864
33587,RM-4xxx,11/28/2014,0,0,0,0,864,0,864
33588,RM-4xxx,11/29/2014,0,0,0,0,864,0,864
34044,RM-B102C,1/1/2015,864,0,0,0,0,0,864
34087,RM-B102C,2/13/2015,864,0,0,0,0,0,864
34093,RM-B102C,2/19/2015,864,0,0,0,0,0,864
34094,RM-B102C,2/20/2015,864,0,0,0,0,0,864
34099,RM-B102C,2/25/2015,864,0,0,0,0,0,864
36495,RM-B200B,7/31/2014,0,0,864,0,0,0,864
36510,RM-B200B,8/15/2014,0,0,864,0,0,0,864
36686,RM-B200B,2/13/2015,0,0,864,0,0,0,864
36692,RM-B200B,2/19/2015,0,0,864,0,0,0,864
36693,RM-B200B,2/20/2015,0,0,864,0,0,0,864
36698,RM-B200B,2/25/2015,0,0,864,0,0,0,864
36701,RM-B200B,2/28/2015,0,0,864,0,0,0,864
37176,RM-B200C,7/31/2014,864,0,0,0,0,0,864
37191,RM-B200C,8/15/2014,864,0,0,0,0,0,864
37294,RM-B200C,11/28/2014,864,0,0,0,0,0,864
37295,RM-B200C,11/29/2014,864,0,0,0,0,0,864
37337,RM-B200C,1/10/2015,864,0,0,0,0,0,864
37377,RM-B200C,2/19/2015,864,0,0,0,0,0,864
37383,RM-B200C,2/25/2015,864,0,0,0,0,0,864
37386,RM-B200C,2/28/2015,864,0,0,0,0,0,864
38452,RM-B215,4/22/2014,0,0,864,0,0,0,864
38713,RM-B215,1/10/2015,864,0,0,0,0,0,864
38747,RM-B215,2/13/2015,864,0,0,0,0,0,864
38753,RM-B215,2/19/2015,864,0,0,0,0,0,864
38754,RM-B215,2/20/2015,864,0,0,0,0,0,864
38759,RM-B215,2/25/2015,864,0,0,0,0,0,864
38762,RM-B215,2/28/2015,864,0,0,0,0,0,864
39137,RM-B220,4/22/2014,864,0,0,0,0,0,864
39237,RM-B220,7/31/2014,864,0,0,0,0,0,864
39252,RM-B220,8/15/2014,864,0,0,0,0,0,864
39825,RM-B222,4/22/2014,864,0,0,0,0,0,864
39925,RM-B222,7/31/2014,864,0,0,0,0,0,864
39940,RM-B222,8/15/2014,864,0,0,0,0,0,864
40043,RM-B222,11/28/2014,864,0,0,0,0,0,864
40044,RM-B222,11/29/2014,864,0,0,0,0,0,864
41986,RM-B230,7/31/2014,864,0,0,0,0,0,864
42001,RM-B230,8/15/2014,864,0,0,0,0,0,864
43137,RM-B240,4/22/2014,0,0,864,0,0,0,864
43237,RM-B240,7/31/2014,0,0,864,0,0,0,864
43252,RM-B240,8/15/2014,0,0,864,0,0,0,864
43355,RM-B240,11/28/2014,0,0,864,0,0,0,864
43356,RM-B240,11/29/2014,0,0,864,0,0,0,864
43398,RM-B240,1/10/2015,0,0,864,0,0,0,864
43438,RM-B240,2/19/2015,0,0,864,0,0,0,864
43444,RM-B240,2/25/2015,0,0,864,0,0,0,864
43447,RM-B240,2/28/2015,0,0,864,0,0,0,864
43965,RM-B240A,11/28/2014,0,0,864,0,0,0,864
43966,RM-B240A,11/29/2014,0,0,864,0,0,0,864
44008,RM-B240A,1/10/2015,0,0,864,0,0,0,864
44042,RM-B240A,2/13/2015,0,0,864,0,0,0,864
44048,RM-B240A,2/19/2015,0,0,864,0,0,0,864
44049,RM-B240A,2/20/2015,0,0,864,0,0,0,864
44054,RM-B240A,2/25/2015,0,0,864,0,0,0,864
44057,RM-B240A,2/28/2015,0,0,864,0,0,0,864
44532,RM-B250,7/31/2014,0,0,864,0,0,0,864
44547,RM-B250,8/15/2014,0,0,864,0,0,0,864
45117,RM-B250A,4/22/2014,864,0,0,0,0,0,864
45216,RM-B250A,7/31/2014,864,0,0,0,0,0,864
45231,RM-B250A,8/15/2014,864,0,0,0,0,0,864
45334,RM-B250A,11/28/2014,864,0,0,0,0,0,864
45335,RM-B250A,11/29/2014,864,0,0,0,0,0,864
45377,RM-B250A,1/10/2015,864,0,0,0,0,0,864
45411,RM-B250A,2/13/2015,864,0,0,0,0,0,864
45417,RM-B250A,2/19/2015,864,0,0,0,0,0,864
45418,RM-B250A,2/20/2015,864,0,0,0,0,0,864
45423,RM-B250A,2/25/2015,864,0,0,0,0,0,864
45426,RM-B250A,2/28/2015,864,0,0,0,0,0,864
45901,RM-B260,7/31/2014,864,0,0,0,0,0,864
45916,RM-B260,8/15/2014,864,0,0,0,0,0,864
46062,RM-B260,1/10/2015,0,0,864,0,0,0,864
46102,RM-B260,2/19/2015,0,0,864,0,0,0,864
46108,RM-B260,2/25/2015,0,0,864,0,0,0,864
46111,RM-B260,2/28/2015,0,0,864,0,0,0,864
48057,RM-B275,11/28/2014,864,0,0,0,0,0,864
48058,RM-B275,11/29/2014,864,0,0,0,0,0,864
48100,RM-B275,1/10/2015,864,0,0,0,0,0,864
48134,RM-B275,2/13/2015,864,0,0,0,0,0,864
48140,RM-B275,2/19/2015,864,0,0,0,0,0,864
48141,RM-B275,2/20/2015,864,0,0,0,0,0,864
48146,RM-B275,2/25/2015,864,0,0,0,0,0,864
48149,RM-B275,2/28/2015,864,0,0,0,0,0,864
527,RM-1100A,12/22/2014,861,0,0,0,0,0,861
1897,RM-1102,12/22/2014,861,0,0,0,0,0,861
1959,RM-1102,2/22/2015,861,0,0,0,0,0,861
1963,RM-1102,2/26/2015,861,0,0,0,0,0,861
1964,RM-1102,2/27/2015,861,0,0,0,0,0,861
2030,RM-1102,5/4/2015,861,0,0,0,0,0,861
2031,RM-1102,5/5/2015,861,0,0,0,0,0,861
4592,RM-1108,12/22/2014,0,0,861,0,0,0,861
4654,RM-1108,2/22/2015,0,0,861,0,0,0,861
4658,RM-1108,2/26/2015,0,0,861,0,0,0,861
4659,RM-1108,2/27/2015,0,0,861,0,0,0,861
4725,RM-1108,5/4/2015,0,0,861,0,0,0,861
4726,RM-1108,5/5/2015,0,0,861,0,0,0,861
4996,RM-1109,3/11/2014,0,0,0,0,0,861,861
6323,RM-1113,1/28/2014,0,0,861,0,0,0,861
6365,RM-1113,3/11/2014,0,0,861,0,0,0,861
6476,RM-1113,6/30/2014,0,0,861,0,0,0,861
6711,RM-1113,2/22/2015,861,0,0,0,0,0,861
6715,RM-1113,2/26/2015,861,0,0,0,0,0,861
6716,RM-1113,2/27/2015,861,0,0,0,0,0,861
7711,RM-1116,3/11/2014,861,0,0,0,0,0,861
8128,RM-1116,5/4/2015,0,0,861,0,0,0,861
8129,RM-1116,5/5/2015,0,0,861,0,0,0,861
9084,RM-1122,3/11/2014,0,0,0,0,0,861,861
9501,RM-1122,5/4/2015,0,0,861,0,0,0,861
9502,RM-1122,5/5/2015,0,0,861,0,0,0,861
10053,RM-1123,12/22/2014,861,0,0,0,0,0,861
10115,RM-1123,2/22/2015,861,0,0,0,0,0,861
10119,RM-1123,2/26/2015,861,0,0,0,0,0,861
10120,RM-1123,2/27/2015,861,0,0,0,0,0,861
12655,RM-1130,12/22/2014,0,0,861,0,0,0,861
12717,RM-1130,2/22/2015,0,0,861,0,0,0,861
12721,RM-1130,2/26/2015,0,0,861,0,0,0,861
12722,RM-1130,2/27/2015,0,0,861,0,0,0,861
13343,RM-1132,12/22/2014,0,0,861,0,0,0,861
13405,RM-1132,2/22/2015,0,0,861,0,0,0,861
13409,RM-1132,2/26/2015,0,0,861,0,0,0,861
13410,RM-1132,2/27/2015,0,0,861,0,0,0,861
13476,RM-1132,5/4/2015,0,0,861,0,0,0,861
13477,RM-1132,5/5/2015,0,0,861,0,0,0,861
14550,RM-1134,12/22/2014,861,0,0,0,0,0,861
15494,RM-1144,1/28/2014,0,0,861,0,0,0,861
15536,RM-1144,3/11/2014,0,0,861,0,0,0,861
15647,RM-1144,6/30/2014,0,0,861,0,0,0,861
15820,RM-1144,12/22/2014,0,0,861,0,0,0,861
16221,RM-1145,3/11/2014,0,0,0,0,0,861,861
16305,RM-1145,6/30/2014,0,0,861,0,0,0,861
16478,RM-1145,12/22/2014,0,0,861,0,0,0,861
16540,RM-1145,2/22/2015,0,0,861,0,0,0,861
16544,RM-1145,2/26/2015,0,0,861,0,0,0,861
16545,RM-1145,2/27/2015,0,0,861,0,0,0,861
19220,RM-1155,12/22/2014,861,0,0,0,0,0,861
19896,RM-1156,12/22/2014,0,0,861,0,0,0,861
20683,RM-1200A,5/4/2015,861,0,0,0,0,0,861
20684,RM-1200A,5/5/2015,861,0,0,0,0,0,861
21960,RM-1200C,2/22/2015,861,0,0,0,0,0,861
21964,RM-1200C,2/26/2015,861,0,0,0,0,0,861
21965,RM-1200C,2/27/2015,861,0,0,0,0,0,861
22031,RM-1200C,5/4/2015,861,0,0,0,0,0,861
22032,RM-1200C,5/5/2015,861,0,0,0,0,0,861
24587,RM-1208B,12/22/2014,861,0,0,0,0,0,861
24649,RM-1208B,2/22/2015,861,0,0,0,0,0,861
24653,RM-1208B,2/26/2015,861,0,0,0,0,0,861
24654,RM-1208B,2/27/2015,861,0,0,0,0,0,861
24720,RM-1208B,5/4/2015,861,0,0,0,0,0,861
24721,RM-1208B,5/5/2015,861,0,0,0,0,0,861
25272,RM-1212,12/22/2014,861,0,0,0,0,0,861
25658,RM-1213,3/11/2014,0,0,0,0,0,861,861
26301,RM-1213A,1/28/2014,0,0,861,0,0,0,861
26343,RM-1213A,3/11/2014,0,0,861,0,0,0,861
26454,RM-1213A,6/30/2014,0,0,861,0,0,0,861
27028,RM-1217,3/11/2014,861,0,0,0,0,0,861
28000,RM-1218,12/22/2014,861,0,0,0,0,0,861
28062,RM-1218,2/22/2015,861,0,0,0,0,0,861
28066,RM-1218,2/26/2015,861,0,0,0,0,0,861
28067,RM-1218,2/27/2015,861,0,0,0,0,0,861
28133,RM-1218,5/4/2015,861,0,0,0,0,0,861
28134,RM-1218,5/5/2015,861,0,0,0,0,0,861
28404,RM-1221,3/11/2014,0,0,0,0,0,861,861
28515,RM-1221,6/30/2014,0,0,861,0,0,0,861
29373,RM-1223,12/22/2014,861,0,0,0,0,0,861
29506,RM-1223,5/4/2015,0,0,861,0,0,0,861
29507,RM-1223,5/5/2015,0,0,861,0,0,0,861
30120,RM-1224,2/22/2015,861,0,0,0,0,0,861
30124,RM-1224,2/26/2015,861,0,0,0,0,0,861
30125,RM-1224,2/27/2015,861,0,0,0,0,0,861
30191,RM-1224,5/4/2015,861,0,0,0,0,0,861
30192,RM-1224,5/5/2015,861,0,0,0,0,0,861
30746,RM-1229,12/22/2014,0,0,861,0,0,0,861
30808,RM-1229,2/22/2015,0,0,861,0,0,0,861
30812,RM-1229,2/26/2015,0,0,861,0,0,0,861
30813,RM-1229,2/27/2015,0,0,861,0,0,0,861
30879,RM-1229,5/4/2015,0,0,861,0,0,0,861
30880,RM-1229,5/5/2015,0,0,861,0,0,0,861
31799,RM-1231,3/11/2014,0,0,0,0,0,861,861
32218,RM-1231,5/4/2015,0,0,861,0,0,0,861
32219,RM-1231,5/5/2015,0,0,861,0,0,0,861
32447,RM-1236,1/28/2014,0,0,861,0,0,0,861
32489,RM-1236,3/11/2014,0,0,861,0,0,0,861
32773,RM-1236,12/22/2014,861,0,0,0,0,0,861
32835,RM-1236,2/22/2015,861,0,0,0,0,0,861
32839,RM-1236,2/26/2015,861,0,0,0,0,0,861
32840,RM-1236,2/27/2015,861,0,0,0,0,0,861
32906,RM-1236,5/4/2015,861,0,0,0,0,0,861
32907,RM-1236,5/5/2015,861,0,0,0,0,0,861
34034,RM-B102C,12/22/2014,861,0,0,0,0,0,861
34096,RM-B102C,2/22/2015,861,0,0,0,0,0,861
34100,RM-B102C,2/26/2015,861,0,0,0,0,0,861
34101,RM-B102C,2/27/2015,861,0,0,0,0,0,861
34102,RM-B102C,2/28/2015,861,0,0,0,0,0,861
34167,RM-B102C,5/4/2015,861,0,0,0,0,0,861
34168,RM-B102C,5/5/2015,861,0,0,0,0,0,861
34849,RM-B103,5/4/2015,0,0,861,0,0,0,861
34850,RM-B103,5/5/2015,0,0,861,0,0,0,861
35666,RM-B109,3/11/2014,0,0,861,0,0,0,861
36695,RM-B200B,2/22/2015,0,0,861,0,0,0,861
36699,RM-B200B,2/26/2015,0,0,861,0,0,0,861
36700,RM-B200B,2/27/2015,0,0,861,0,0,0,861
37318,RM-B200C,12/22/2014,861,0,0,0,0,0,861
37371,RM-B200C,2/13/2015,861,0,0,0,0,0,861
37380,RM-B200C,2/22/2015,861,0,0,0,0,0,861
37384,RM-B200C,2/26/2015,861,0,0,0,0,0,861
37385,RM-B200C,2/27/2015,861,0,0,0,0,0,861
37451,RM-B200C,5/4/2015,861,0,0,0,0,0,861
37452,RM-B200C,5/5/2015,861,0,0,0,0,0,861
38368,RM-B215,1/28/2014,0,0,861,0,0,0,861
38410,RM-B215,3/11/2014,0,0,861,0,0,0,861
38756,RM-B215,2/22/2015,861,0,0,0,0,0,861
38760,RM-B215,2/26/2015,861,0,0,0,0,0,861
38761,RM-B215,2/27/2015,861,0,0,0,0,0,861
39095,RM-B220,3/11/2014,861,0,0,0,0,0,861
40067,RM-B222,12/22/2014,861,0,0,0,0,0,861
40471,RM-B224,3/11/2014,0,0,0,0,0,861,861
42529,RM-B230A,3/11/2014,0,0,0,0,0,861,861
43095,RM-B240,3/11/2014,0,0,861,0,0,0,861
43379,RM-B240,12/22/2014,0,0,861,0,0,0,861
43432,RM-B240,2/13/2015,0,0,861,0,0,0,861
43441,RM-B240,2/22/2015,0,0,861,0,0,0,861
43445,RM-B240,2/26/2015,0,0,861,0,0,0,861
43446,RM-B240,2/27/2015,0,0,861,0,0,0,861
43512,RM-B240,5/4/2015,0,0,861,0,0,0,861
43513,RM-B240,5/5/2015,0,0,861,0,0,0,861
43989,RM-B240A,12/22/2014,0,0,861,0,0,0,861
44051,RM-B240A,2/22/2015,0,0,861,0,0,0,861
44055,RM-B240A,2/26/2015,0,0,861,0,0,0,861
44056,RM-B240A,2/27/2015,0,0,861,0,0,0,861
44122,RM-B240A,5/4/2015,0,0,861,0,0,0,861
44123,RM-B240A,5/5/2015,0,0,861,0,0,0,861
44348,RM-B250,1/28/2014,0,0,861,0,0,0,861
44390,RM-B250,3/11/2014,0,0,861,0,0,0,861
45075,RM-B250A,3/11/2014,861,0,0,0,0,0,861
45358,RM-B250A,12/22/2014,861,0,0,0,0,0,861
45420,RM-B250A,2/22/2015,861,0,0,0,0,0,861
45424,RM-B250A,2/26/2015,861,0,0,0,0,0,861
45425,RM-B250A,2/27/2015,861,0,0,0,0,0,861
45491,RM-B250A,5/4/2015,861,0,0,0,0,0,861
45492,RM-B250A,5/5/2015,861,0,0,0,0,0,861
46043,RM-B260,12/22/2014,0,0,861,0,0,0,861
46096,RM-B260,2/13/2015,0,0,861,0,0,0,861
46105,RM-B260,2/22/2015,0,0,861,0,0,0,861
46109,RM-B260,2/26/2015,0,0,861,0,0,0,861
46110,RM-B260,2/27/2015,0,0,861,0,0,0,861
46176,RM-B260,5/4/2015,0,0,861,0,0,0,861
46177,RM-B260,5/5/2015,0,0,861,0,0,0,861
47797,RM-B275,3/11/2014,0,0,0,0,0,861,861
48081,RM-B275,12/22/2014,861,0,0,0,0,0,861
48143,RM-B275,2/22/2015,861,0,0,0,0,0,861
48147,RM-B275,2/26/2015,861,0,0,0,0,0,861
48148,RM-B275,2/27/2015,861,0,0,0,0,0,861
48214,RM-B275,5/4/2015,861,0,0,0,0,0,861
48215,RM-B275,5/5/2015,861,0,0,0,0,0,861
1941,RM-1102,2/4/2015,858,0,0,0,0,0,858
1951,RM-1102,2/14/2015,858,0,0,0,0,0,858
1958,RM-1102,2/21/2015,858,0,0,0,0,0,858
1960,RM-1102,2/23/2015,858,0,0,0,0,0,858
1961,RM-1102,2/24/2015,858,0,0,0,0,0,858
2027,RM-1102,5/1/2015,858,0,0,0,0,0,858
2035,RM-1102,5/9/2015,858,0,0,0,0,0,858
2037,RM-1102,5/11/2015,858,0,0,0,0,0,858
2039,RM-1102,5/13/2015,858,0,0,0,0,0,858
2042,RM-1102,5/16/2015,858,0,0,0,0,0,858
2051,RM-1102,5/25/2015,858,0,0,0,0,0,858
4636,RM-1108,2/4/2015,0,0,858,0,0,0,858
4646,RM-1108,2/14/2015,0,0,858,0,0,0,858
4653,RM-1108,2/21/2015,0,0,858,0,0,0,858
4655,RM-1108,2/23/2015,0,0,858,0,0,0,858
4656,RM-1108,2/24/2015,0,0,858,0,0,0,858
4722,RM-1108,5/1/2015,0,0,858,0,0,0,858
4730,RM-1108,5/9/2015,0,0,858,0,0,0,858
4732,RM-1108,5/11/2015,0,0,858,0,0,0,858
4734,RM-1108,5/13/2015,0,0,858,0,0,0,858
4737,RM-1108,5/16/2015,0,0,858,0,0,0,858
4746,RM-1108,5/25/2015,0,0,858,0,0,0,858
4954,RM-1109,1/28/2014,0,0,0,0,0,858,858
6703,RM-1113,2/14/2015,858,0,0,0,0,0,858
6710,RM-1113,2/21/2015,858,0,0,0,0,0,858
6712,RM-1113,2/23/2015,858,0,0,0,0,0,858
6713,RM-1113,2/24/2015,858,0,0,0,0,0,858
6982,RM-1115,1/28/2014,0,0,0,0,0,858,858
7669,RM-1116,1/28/2014,858,0,0,0,0,0,858
8125,RM-1116,5/1/2015,0,0,858,0,0,0,858
8133,RM-1116,5/9/2015,0,0,858,0,0,0,858
8135,RM-1116,5/11/2015,0,0,858,0,0,0,858
8137,RM-1116,5/13/2015,0,0,858,0,0,0,858
8140,RM-1116,5/16/2015,0,0,858,0,0,0,858
8149,RM-1116,5/25/2015,0,0,858,0,0,0,858
9042,RM-1122,1/28/2014,0,0,0,0,0,858,858
9498,RM-1122,5/1/2015,0,0,858,0,0,0,858
9506,RM-1122,5/9/2015,0,0,858,0,0,0,858
9508,RM-1122,5/11/2015,0,0,858,0,0,0,858
9510,RM-1122,5/13/2015,0,0,858,0,0,0,858
9513,RM-1122,5/16/2015,0,0,858,0,0,0,858
9522,RM-1122,5/25/2015,0,0,858,0,0,0,858
10097,RM-1123,2/4/2015,858,0,0,0,0,0,858
10107,RM-1123,2/14/2015,858,0,0,0,0,0,858
10114,RM-1123,2/21/2015,858,0,0,0,0,0,858
10116,RM-1123,2/23/2015,858,0,0,0,0,0,858
10117,RM-1123,2/24/2015,858,0,0,0,0,0,858
10412,RM-1124,1/28/2014,0,0,0,0,0,858,858
12699,RM-1130,2/4/2015,0,0,858,0,0,0,858
12709,RM-1130,2/14/2015,0,0,858,0,0,0,858
12716,RM-1130,2/21/2015,0,0,858,0,0,0,858
12718,RM-1130,2/23/2015,0,0,858,0,0,0,858
12719,RM-1130,2/24/2015,0,0,858,0,0,0,858
13387,RM-1132,2/4/2015,0,0,858,0,0,0,858
13397,RM-1132,2/14/2015,0,0,858,0,0,0,858
13404,RM-1132,2/21/2015,0,0,858,0,0,0,858
13406,RM-1132,2/23/2015,0,0,858,0,0,0,858
13407,RM-1132,2/24/2015,0,0,858,0,0,0,858
13473,RM-1132,5/1/2015,0,0,858,0,0,0,858
13481,RM-1132,5/9/2015,0,0,858,0,0,0,858
13483,RM-1132,5/11/2015,0,0,858,0,0,0,858
13485,RM-1132,5/13/2015,0,0,858,0,0,0,858
13488,RM-1132,5/16/2015,0,0,858,0,0,0,858
13497,RM-1132,5/25/2015,0,0,858,0,0,0,858
16179,RM-1145,1/28/2014,0,0,0,0,0,858,858
16522,RM-1145,2/4/2015,0,0,858,0,0,0,858
16532,RM-1145,2/14/2015,0,0,858,0,0,0,858
16539,RM-1145,2/21/2015,0,0,858,0,0,0,858
16541,RM-1145,2/23/2015,0,0,858,0,0,0,858
16542,RM-1145,2/24/2015,0,0,858,0,0,0,858
19264,RM-1155,2/4/2015,858,0,0,0,0,0,858
19570,RM-1156,1/28/2014,858,0,0,0,0,0,858
19940,RM-1156,2/4/2015,0,0,858,0,0,0,858
20332,RM-1200A,5/16/2014,0,0,0,858,0,0,858
20688,RM-1200A,5/9/2015,858,0,0,0,0,0,858
20690,RM-1200A,5/11/2015,858,0,0,0,0,0,858
20692,RM-1200A,5/13/2015,858,0,0,0,0,0,858
20695,RM-1200A,5/16/2015,858,0,0,0,0,0,858
20704,RM-1200A,5/25/2015,858,0,0,0,0,0,858
21952,RM-1200C,2/14/2015,858,0,0,0,0,0,858
21959,RM-1200C,2/21/2015,858,0,0,0,0,0,858
21961,RM-1200C,2/23/2015,858,0,0,0,0,0,858
21962,RM-1200C,2/24/2015,858,0,0,0,0,0,858
22028,RM-1200C,5/1/2015,858,0,0,0,0,0,858
22036,RM-1200C,5/9/2015,858,0,0,0,0,0,858
22038,RM-1200C,5/11/2015,858,0,0,0,0,0,858
22040,RM-1200C,5/13/2015,858,0,0,0,0,0,858
22043,RM-1200C,5/16/2015,858,0,0,0,0,0,858
22052,RM-1200C,5/25/2015,858,0,0,0,0,0,858
24631,RM-1208B,2/4/2015,858,0,0,0,0,0,858
24641,RM-1208B,2/14/2015,858,0,0,0,0,0,858
24648,RM-1208B,2/21/2015,858,0,0,0,0,0,858
24650,RM-1208B,2/23/2015,858,0,0,0,0,0,858
24651,RM-1208B,2/24/2015,858,0,0,0,0,0,858
24717,RM-1208B,5/1/2015,858,0,0,0,0,0,858
24725,RM-1208B,5/9/2015,858,0,0,0,0,0,858
24727,RM-1208B,5/11/2015,858,0,0,0,0,0,858
24729,RM-1208B,5/13/2015,858,0,0,0,0,0,858
24732,RM-1208B,5/16/2015,858,0,0,0,0,0,858
24741,RM-1208B,5/25/2015,858,0,0,0,0,0,858
25616,RM-1213,1/28/2014,0,0,0,0,0,858,858
28044,RM-1218,2/4/2015,858,0,0,0,0,0,858
28054,RM-1218,2/14/2015,858,0,0,0,0,0,858
28061,RM-1218,2/21/2015,858,0,0,0,0,0,858
28063,RM-1218,2/23/2015,858,0,0,0,0,0,858
28064,RM-1218,2/24/2015,858,0,0,0,0,0,858
28130,RM-1218,5/1/2015,858,0,0,0,0,0,858
28138,RM-1218,5/9/2015,858,0,0,0,0,0,858
28140,RM-1218,5/11/2015,858,0,0,0,0,0,858
28142,RM-1218,5/13/2015,858,0,0,0,0,0,858
28145,RM-1218,5/16/2015,858,0,0,0,0,0,858
28154,RM-1218,5/25/2015,858,0,0,0,0,0,858
29503,RM-1223,5/1/2015,0,0,858,0,0,0,858
29511,RM-1223,5/9/2015,0,0,858,0,0,0,858
29513,RM-1223,5/11/2015,0,0,858,0,0,0,858
29515,RM-1223,5/13/2015,0,0,858,0,0,0,858
29518,RM-1223,5/16/2015,0,0,858,0,0,0,858
29527,RM-1223,5/25/2015,0,0,858,0,0,0,858
30102,RM-1224,2/4/2015,858,0,0,0,0,0,858
30112,RM-1224,2/14/2015,858,0,0,0,0,0,858
30119,RM-1224,2/21/2015,858,0,0,0,0,0,858
30121,RM-1224,2/23/2015,858,0,0,0,0,0,858
30122,RM-1224,2/24/2015,858,0,0,0,0,0,858
30188,RM-1224,5/1/2015,858,0,0,0,0,0,858
30196,RM-1224,5/9/2015,858,0,0,0,0,0,858
30198,RM-1224,5/11/2015,858,0,0,0,0,0,858
30200,RM-1224,5/13/2015,858,0,0,0,0,0,858
30203,RM-1224,5/16/2015,858,0,0,0,0,0,858
30212,RM-1224,5/25/2015,858,0,0,0,0,0,858
30790,RM-1229,2/4/2015,0,0,858,0,0,0,858
30800,RM-1229,2/14/2015,0,0,858,0,0,0,858
30807,RM-1229,2/21/2015,0,0,858,0,0,0,858
30809,RM-1229,2/23/2015,0,0,858,0,0,0,858
30810,RM-1229,2/24/2015,0,0,858,0,0,0,858
30876,RM-1229,5/1/2015,0,0,858,0,0,0,858
30884,RM-1229,5/9/2015,0,0,858,0,0,0,858
30886,RM-1229,5/11/2015,0,0,858,0,0,0,858
31757,RM-1231,1/28/2014,0,0,0,0,0,858,858
32215,RM-1231,5/1/2015,0,0,858,0,0,0,858
32223,RM-1231,5/9/2015,0,0,858,0,0,0,858
32225,RM-1231,5/11/2015,0,0,858,0,0,0,858
32227,RM-1231,5/13/2015,0,0,858,0,0,0,858
32230,RM-1231,5/16/2015,0,0,858,0,0,0,858
32239,RM-1231,5/25/2015,0,0,858,0,0,0,858
32817,RM-1236,2/4/2015,858,0,0,0,0,0,858
32827,RM-1236,2/14/2015,858,0,0,0,0,0,858
32834,RM-1236,2/21/2015,858,0,0,0,0,0,858
32836,RM-1236,2/23/2015,858,0,0,0,0,0,858
32837,RM-1236,2/24/2015,858,0,0,0,0,0,858
32903,RM-1236,5/1/2015,858,0,0,0,0,0,858
32911,RM-1236,5/9/2015,858,0,0,0,0,0,858
33611,RM-4xxx,12/22/2014,0,0,0,0,858,0,858
33655,RM-4xxx,2/4/2015,0,0,0,0,858,0,858
34078,RM-B102C,2/4/2015,858,0,0,0,0,0,858
34088,RM-B102C,2/14/2015,858,0,0,0,0,0,858
34095,RM-B102C,2/21/2015,858,0,0,0,0,0,858
34097,RM-B102C,2/23/2015,858,0,0,0,0,0,858
34098,RM-B102C,2/24/2015,858,0,0,0,0,0,858
34103,RM-B102C,3/1/2015,858,0,0,0,0,0,858
34164,RM-B102C,5/1/2015,858,0,0,0,0,0,858
34172,RM-B102C,5/9/2015,858,0,0,0,0,0,858
34174,RM-B102C,5/11/2015,858,0,0,0,0,0,858
34179,RM-B102C,5/16/2015,858,0,0,0,0,0,858
34188,RM-B102C,5/25/2015,858,0,0,0,0,0,858
34846,RM-B103,5/1/2015,0,0,858,0,0,0,858
34854,RM-B103,5/9/2015,0,0,858,0,0,0,858
34856,RM-B103,5/11/2015,0,0,858,0,0,0,858
34858,RM-B103,5/13/2015,0,0,858,0,0,0,858
34861,RM-B103,5/16/2015,0,0,858,0,0,0,858
34870,RM-B103,5/25/2015,0,0,858,0,0,0,858
36414,RM-B200B,5/11/2014,0,858,0,0,0,0,858
36677,RM-B200B,2/4/2015,0,0,858,0,0,0,858
36687,RM-B200B,2/14/2015,0,0,858,0,0,0,858
36694,RM-B200B,2/21/2015,0,0,858,0,0,0,858
36696,RM-B200B,2/23/2015,0,0,858,0,0,0,858
36697,RM-B200B,2/24/2015,0,0,858,0,0,0,858
37362,RM-B200C,2/4/2015,858,0,0,0,0,0,858
37372,RM-B200C,2/14/2015,858,0,0,0,0,0,858
37381,RM-B200C,2/23/2015,858,0,0,0,0,0,858
37382,RM-B200C,2/24/2015,858,0,0,0,0,0,858
37448,RM-B200C,5/1/2015,858,0,0,0,0,0,858
37456,RM-B200C,5/9/2015,858,0,0,0,0,0,858
37458,RM-B200C,5/11/2015,858,0,0,0,0,0,858
37460,RM-B200C,5/13/2015,858,0,0,0,0,0,858
37463,RM-B200C,5/16/2015,858,0,0,0,0,0,858
37472,RM-B200C,5/25/2015,858,0,0,0,0,0,858
38738,RM-B215,2/4/2015,858,0,0,0,0,0,858
38748,RM-B215,2/14/2015,858,0,0,0,0,0,858
38755,RM-B215,2/21/2015,858,0,0,0,0,0,858
38757,RM-B215,2/23/2015,858,0,0,0,0,0,858
38758,RM-B215,2/24/2015,858,0,0,0,0,0,858
39053,RM-B220,1/28/2014,858,0,0,0,0,0,858
40429,RM-B224,1/28/2014,0,0,0,0,0,858,858
41117,RM-B225,1/28/2014,0,0,0,0,0,858,858
42487,RM-B230A,1/28/2014,0,0,0,0,0,858,858
43206,RM-B240,6/30/2014,0,0,858,0,0,0,858
43423,RM-B240,2/4/2015,0,0,858,0,0,0,858
43433,RM-B240,2/14/2015,0,0,858,0,0,0,858
43442,RM-B240,2/23/2015,0,0,858,0,0,0,858
43443,RM-B240,2/24/2015,0,0,858,0,0,0,858
43509,RM-B240,5/1/2015,0,0,858,0,0,0,858
43517,RM-B240,5/9/2015,0,0,858,0,0,0,858
43519,RM-B240,5/11/2015,0,0,858,0,0,0,858
43521,RM-B240,5/13/2015,0,0,858,0,0,0,858
43524,RM-B240,5/16/2015,0,0,858,0,0,0,858
43533,RM-B240,5/25/2015,0,0,858,0,0,0,858
43846,RM-B240A,5/16/2014,0,858,0,0,0,0,858
44033,RM-B240A,2/4/2015,0,0,858,0,0,0,858
44043,RM-B240A,2/14/2015,0,0,858,0,0,0,858
44050,RM-B240A,2/21/2015,0,0,858,0,0,0,858
44052,RM-B240A,2/23/2015,0,0,858,0,0,0,858
44053,RM-B240A,2/24/2015,0,0,858,0,0,0,858
44119,RM-B240A,5/1/2015,0,0,858,0,0,0,858
44127,RM-B240A,5/9/2015,0,0,858,0,0,0,858
44129,RM-B240A,5/11/2015,0,0,858,0,0,0,858
44131,RM-B240A,5/13/2015,0,0,858,0,0,0,858
44134,RM-B240A,5/16/2015,0,0,858,0,0,0,858
44143,RM-B240A,5/25/2015,0,0,858,0,0,0,858
45402,RM-B250A,2/4/2015,858,0,0,0,0,0,858
45412,RM-B250A,2/14/2015,858,0,0,0,0,0,858
45419,RM-B250A,2/21/2015,858,0,0,0,0,0,858
45421,RM-B250A,2/23/2015,858,0,0,0,0,0,858
45422,RM-B250A,2/24/2015,858,0,0,0,0,0,858
45488,RM-B250A,5/1/2015,858,0,0,0,0,0,858
45496,RM-B250A,5/9/2015,858,0,0,0,0,0,858
45498,RM-B250A,5/11/2015,858,0,0,0,0,0,858
45500,RM-B250A,5/13/2015,858,0,0,0,0,0,858
45503,RM-B250A,5/16/2015,858,0,0,0,0,0,858
45512,RM-B250A,5/25/2015,858,0,0,0,0,0,858
46087,RM-B260,2/4/2015,0,0,858,0,0,0,858
46097,RM-B260,2/14/2015,0,0,858,0,0,0,858
46106,RM-B260,2/23/2015,0,0,858,0,0,0,858
46107,RM-B260,2/24/2015,0,0,858,0,0,0,858
46173,RM-B260,5/1/2015,0,0,858,0,0,0,858
46181,RM-B260,5/9/2015,0,0,858,0,0,0,858
46183,RM-B260,5/11/2015,0,0,858,0,0,0,858
46185,RM-B260,5/13/2015,0,0,858,0,0,0,858
46188,RM-B260,5/16/2015,0,0,858,0,0,0,858
46197,RM-B260,5/25/2015,0,0,858,0,0,0,858
48125,RM-B275,2/4/2015,858,0,0,0,0,0,858
48135,RM-B275,2/14/2015,858,0,0,0,0,0,858
48142,RM-B275,2/21/2015,858,0,0,0,0,0,858
48144,RM-B275,2/23/2015,858,0,0,0,0,0,858
48145,RM-B275,2/24/2015,858,0,0,0,0,0,858
48211,RM-B275,5/1/2015,858,0,0,0,0,0,858
48219,RM-B275,5/9/2015,858,0,0,0,0,0,858
48221,RM-B275,5/11/2015,858,0,0,0,0,0,858
48223,RM-B275,5/13/2015,858,0,0,0,0,0,858
48226,RM-B275,5/16/2015,858,0,0,0,0,0,858
48235,RM-B275,5/25/2015,858,0,0,0,0,0,858
555,RM-1100A,1/19/2015,855,0,0,0,0,0,855
1925,RM-1102,1/19/2015,855,0,0,0,0,0,855
1952,RM-1102,2/15/2015,855,0,0,0,0,0,855
1954,RM-1102,2/17/2015,855,0,0,0,0,0,855
1966,RM-1102,3/1/2015,855,0,0,0,0,0,855
2023,RM-1102,4/27/2015,855,0,0,0,0,0,855
2028,RM-1102,5/2/2015,855,0,0,0,0,0,855
2032,RM-1102,5/6/2015,855,0,0,0,0,0,855
2036,RM-1102,5/10/2015,855,0,0,0,0,0,855
2038,RM-1102,5/12/2015,855,0,0,0,0,0,855
2053,RM-1102,5/27/2015,855,0,0,0,0,0,855
2055,RM-1102,5/29/2015,855,0,0,0,0,0,855
4620,RM-1108,1/19/2015,0,0,855,0,0,0,855
4647,RM-1108,2/15/2015,0,0,855,0,0,0,855
4649,RM-1108,2/17/2015,0,0,855,0,0,0,855
4661,RM-1108,3/1/2015,0,0,855,0,0,0,855
4718,RM-1108,4/27/2015,0,0,855,0,0,0,855
4723,RM-1108,5/2/2015,0,0,855,0,0,0,855
4727,RM-1108,5/6/2015,0,0,855,0,0,0,855
4731,RM-1108,5/10/2015,0,0,855,0,0,0,855
4733,RM-1108,5/12/2015,0,0,855,0,0,0,855
4748,RM-1108,5/27/2015,0,0,855,0,0,0,855
4750,RM-1108,5/29/2015,0,0,855,0,0,0,855
5791,RM-1110,6/30/2014,0,0,855,0,0,0,855
6704,RM-1113,2/15/2015,855,0,0,0,0,0,855
6706,RM-1113,2/17/2015,855,0,0,0,0,0,855
6718,RM-1113,3/1/2015,855,0,0,0,0,0,855
8121,RM-1116,4/27/2015,0,0,855,0,0,0,855
8126,RM-1116,5/2/2015,0,0,855,0,0,0,855
8130,RM-1116,5/6/2015,0,0,855,0,0,0,855
8134,RM-1116,5/10/2015,0,0,855,0,0,0,855
8136,RM-1116,5/12/2015,0,0,855,0,0,0,855
8151,RM-1116,5/27/2015,0,0,855,0,0,0,855
8153,RM-1116,5/29/2015,0,0,855,0,0,0,855
9494,RM-1122,4/27/2015,0,0,855,0,0,0,855
9499,RM-1122,5/2/2015,0,0,855,0,0,0,855
9503,RM-1122,5/6/2015,0,0,855,0,0,0,855
9507,RM-1122,5/10/2015,0,0,855,0,0,0,855
9509,RM-1122,5/12/2015,0,0,855,0,0,0,855
9524,RM-1122,5/27/2015,0,0,855,0,0,0,855
9526,RM-1122,5/29/2015,0,0,855,0,0,0,855
9625,RM-1123,10/15/2013,0,0,855,0,0,0,855
10081,RM-1123,1/19/2015,855,0,0,0,0,0,855
10108,RM-1123,2/15/2015,855,0,0,0,0,0,855
10110,RM-1123,2/17/2015,855,0,0,0,0,0,855
10122,RM-1123,3/1/2015,855,0,0,0,0,0,855
12683,RM-1130,1/19/2015,0,0,855,0,0,0,855
12710,RM-1130,2/15/2015,0,0,855,0,0,0,855
12712,RM-1130,2/17/2015,0,0,855,0,0,0,855
12724,RM-1130,3/1/2015,0,0,855,0,0,0,855
13371,RM-1132,1/19/2015,0,0,855,0,0,0,855
13398,RM-1132,2/15/2015,0,0,855,0,0,0,855
13400,RM-1132,2/17/2015,0,0,855,0,0,0,855
13412,RM-1132,3/1/2015,0,0,855,0,0,0,855
13469,RM-1132,4/27/2015,0,0,855,0,0,0,855
13474,RM-1132,5/2/2015,0,0,855,0,0,0,855
13478,RM-1132,5/6/2015,0,0,855,0,0,0,855
13482,RM-1132,5/10/2015,0,0,855,0,0,0,855
13484,RM-1132,5/12/2015,0,0,855,0,0,0,855
13499,RM-1132,5/27/2015,0,0,855,0,0,0,855
13501,RM-1132,5/29/2015,0,0,855,0,0,0,855
13600,RM-1133,10/15/2013,0,0,855,0,0,0,855
14377,RM-1134,6/30/2014,855,0,0,0,0,0,855
16506,RM-1145,1/19/2015,0,0,855,0,0,0,855
16533,RM-1145,2/15/2015,0,0,855,0,0,0,855
16535,RM-1145,2/17/2015,0,0,855,0,0,0,855
16547,RM-1145,3/1/2015,0,0,855,0,0,0,855
19047,RM-1155,6/30/2014,855,0,0,0,0,0,855
19248,RM-1155,1/19/2015,855,0,0,0,0,0,855
19924,RM-1156,1/19/2015,0,0,855,0,0,0,855
20681,RM-1200A,5/2/2015,855,0,0,0,0,0,855
20685,RM-1200A,5/6/2015,855,0,0,0,0,0,855
20689,RM-1200A,5/10/2015,855,0,0,0,0,0,855
20691,RM-1200A,5/12/2015,855,0,0,0,0,0,855
20706,RM-1200A,5/27/2015,855,0,0,0,0,0,855
20708,RM-1200A,5/29/2015,855,0,0,0,0,0,855
21953,RM-1200C,2/15/2015,855,0,0,0,0,0,855
21955,RM-1200C,2/17/2015,855,0,0,0,0,0,855
21967,RM-1200C,3/1/2015,855,0,0,0,0,0,855
22024,RM-1200C,4/27/2015,855,0,0,0,0,0,855
22029,RM-1200C,5/2/2015,855,0,0,0,0,0,855
22033,RM-1200C,5/6/2015,855,0,0,0,0,0,855
22037,RM-1200C,5/10/2015,855,0,0,0,0,0,855
22039,RM-1200C,5/12/2015,855,0,0,0,0,0,855
22054,RM-1200C,5/27/2015,855,0,0,0,0,0,855
22056,RM-1200C,5/29/2015,855,0,0,0,0,0,855
23041,RM-1207,6/30/2014,855,0,0,0,0,0,855
24615,RM-1208B,1/19/2015,855,0,0,0,0,0,855
24642,RM-1208B,2/15/2015,855,0,0,0,0,0,855
24644,RM-1208B,2/17/2015,855,0,0,0,0,0,855
24656,RM-1208B,3/1/2015,855,0,0,0,0,0,855
24713,RM-1208B,4/27/2015,855,0,0,0,0,0,855
24718,RM-1208B,5/2/2015,855,0,0,0,0,0,855
24722,RM-1208B,5/6/2015,855,0,0,0,0,0,855
24726,RM-1208B,5/10/2015,855,0,0,0,0,0,855
24728,RM-1208B,5/12/2015,855,0,0,0,0,0,855
24743,RM-1208B,5/27/2015,855,0,0,0,0,0,855
24745,RM-1208B,5/29/2015,855,0,0,0,0,0,855
28028,RM-1218,1/19/2015,855,0,0,0,0,0,855
28055,RM-1218,2/15/2015,855,0,0,0,0,0,855
28057,RM-1218,2/17/2015,855,0,0,0,0,0,855
28069,RM-1218,3/1/2015,855,0,0,0,0,0,855
28126,RM-1218,4/27/2015,855,0,0,0,0,0,855
28131,RM-1218,5/2/2015,855,0,0,0,0,0,855
28135,RM-1218,5/6/2015,855,0,0,0,0,0,855
28139,RM-1218,5/10/2015,855,0,0,0,0,0,855
28141,RM-1218,5/12/2015,855,0,0,0,0,0,855
28156,RM-1218,5/27/2015,855,0,0,0,0,0,855
28158,RM-1218,5/29/2015,855,0,0,0,0,0,855
28260,RM-1221,10/15/2013,0,0,855,0,0,0,855
29200,RM-1223,6/30/2014,855,0,0,0,0,0,855
29499,RM-1223,4/27/2015,0,0,855,0,0,0,855
29504,RM-1223,5/2/2015,0,0,855,0,0,0,855
29508,RM-1223,5/6/2015,0,0,855,0,0,0,855
29512,RM-1223,5/10/2015,0,0,855,0,0,0,855
29514,RM-1223,5/12/2015,0,0,855,0,0,0,855
29529,RM-1223,5/27/2015,0,0,855,0,0,0,855
29531,RM-1223,5/29/2015,0,0,855,0,0,0,855
30086,RM-1224,1/19/2015,855,0,0,0,0,0,855
30113,RM-1224,2/15/2015,855,0,0,0,0,0,855
30115,RM-1224,2/17/2015,855,0,0,0,0,0,855
30127,RM-1224,3/1/2015,855,0,0,0,0,0,855
30184,RM-1224,4/27/2015,855,0,0,0,0,0,855
30189,RM-1224,5/2/2015,855,0,0,0,0,0,855
30193,RM-1224,5/6/2015,855,0,0,0,0,0,855
30197,RM-1224,5/10/2015,855,0,0,0,0,0,855
30199,RM-1224,5/12/2015,855,0,0,0,0,0,855
30214,RM-1224,5/27/2015,855,0,0,0,0,0,855
30216,RM-1224,5/29/2015,855,0,0,0,0,0,855
30774,RM-1229,1/19/2015,0,0,855,0,0,0,855
30801,RM-1229,2/15/2015,0,0,855,0,0,0,855
30803,RM-1229,2/17/2015,0,0,855,0,0,0,855
30815,RM-1229,3/1/2015,0,0,855,0,0,0,855
30872,RM-1229,4/27/2015,0,0,855,0,0,0,855
30877,RM-1229,5/2/2015,0,0,855,0,0,0,855
30881,RM-1229,5/6/2015,0,0,855,0,0,0,855
30885,RM-1229,5/10/2015,0,0,855,0,0,0,855
32216,RM-1231,5/2/2015,0,0,855,0,0,0,855
32220,RM-1231,5/6/2015,0,0,855,0,0,0,855
32224,RM-1231,5/10/2015,0,0,855,0,0,0,855
32226,RM-1231,5/12/2015,0,0,855,0,0,0,855
32241,RM-1231,5/27/2015,0,0,855,0,0,0,855
32243,RM-1231,5/29/2015,0,0,855,0,0,0,855
32801,RM-1236,1/19/2015,855,0,0,0,0,0,855
32828,RM-1236,2/15/2015,855,0,0,0,0,0,855
32830,RM-1236,2/17/2015,855,0,0,0,0,0,855
32842,RM-1236,3/1/2015,855,0,0,0,0,0,855
32899,RM-1236,4/27/2015,855,0,0,0,0,0,855
32904,RM-1236,5/2/2015,855,0,0,0,0,0,855
32908,RM-1236,5/6/2015,855,0,0,0,0,0,855
33639,RM-4xxx,1/19/2015,0,0,0,0,855,0,855
34062,RM-B102C,1/19/2015,855,0,0,0,0,0,855
34089,RM-B102C,2/15/2015,855,0,0,0,0,0,855
34091,RM-B102C,2/17/2015,855,0,0,0,0,0,855
34160,RM-B102C,4/27/2015,855,0,0,0,0,0,855
34165,RM-B102C,5/2/2015,855,0,0,0,0,0,855
34169,RM-B102C,5/6/2015,855,0,0,0,0,0,855
34173,RM-B102C,5/10/2015,855,0,0,0,0,0,855
34175,RM-B102C,5/12/2015,855,0,0,0,0,0,855
34176,RM-B102C,5/13/2015,855,0,0,0,0,0,855
34177,RM-B102C,5/14/2015,855,0,0,0,0,0,855
34192,RM-B102C,5/29/2015,855,0,0,0,0,0,855
34842,RM-B103,4/27/2015,0,0,855,0,0,0,855
34847,RM-B103,5/2/2015,0,0,855,0,0,0,855
34851,RM-B103,5/6/2015,0,0,855,0,0,0,855
34852,RM-B103,5/7/2015,0,0,855,0,0,0,855
34855,RM-B103,5/10/2015,0,0,855,0,0,0,855
34857,RM-B103,5/12/2015,0,0,855,0,0,0,855
34872,RM-B103,5/27/2015,0,0,855,0,0,0,855
34874,RM-B103,5/29/2015,0,0,855,0,0,0,855
36106,RM-B109,5/27/2015,0,0,855,0,0,0,855
36108,RM-B109,5/29/2015,0,0,855,0,0,0,855
36688,RM-B200B,2/15/2015,0,0,855,0,0,0,855
36690,RM-B200B,2/17/2015,0,0,855,0,0,0,855
36702,RM-B200B,3/1/2015,0,0,855,0,0,0,855
37145,RM-B200C,6/30/2014,855,0,0,0,0,0,855
37346,RM-B200C,1/19/2015,855,0,0,0,0,0,855
37373,RM-B200C,2/15/2015,855,0,0,0,0,0,855
37375,RM-B200C,2/17/2015,855,0,0,0,0,0,855
37379,RM-B200C,2/21/2015,855,0,0,0,0,0,855
37387,RM-B200C,3/1/2015,855,0,0,0,0,0,855
37444,RM-B200C,4/27/2015,855,0,0,0,0,0,855
37449,RM-B200C,5/2/2015,855,0,0,0,0,0,855
37453,RM-B200C,5/6/2015,855,0,0,0,0,0,855
37454,RM-B200C,5/7/2015,855,0,0,0,0,0,855
37457,RM-B200C,5/10/2015,855,0,0,0,0,0,855
37459,RM-B200C,5/12/2015,855,0,0,0,0,0,855
37474,RM-B200C,5/27/2015,855,0,0,0,0,0,855
37476,RM-B200C,5/29/2015,855,0,0,0,0,0,855
38722,RM-B215,1/19/2015,855,0,0,0,0,0,855
38749,RM-B215,2/15/2015,855,0,0,0,0,0,855
38751,RM-B215,2/17/2015,855,0,0,0,0,0,855
38763,RM-B215,3/1/2015,855,0,0,0,0,0,855
39206,RM-B220,6/30/2014,855,0,0,0,0,0,855
41955,RM-B230,6/30/2014,855,0,0,0,0,0,855
43407,RM-B240,1/19/2015,0,0,855,0,0,0,855
43434,RM-B240,2/15/2015,0,0,855,0,0,0,855
43436,RM-B240,2/17/2015,0,0,855,0,0,0,855
43440,RM-B240,2/21/2015,0,0,855,0,0,0,855
43448,RM-B240,3/1/2015,0,0,855,0,0,0,855
43505,RM-B240,4/27/2015,0,0,855,0,0,0,855
43510,RM-B240,5/2/2015,0,0,855,0,0,0,855
43514,RM-B240,5/6/2015,0,0,855,0,0,0,855
43515,RM-B240,5/7/2015,0,0,855,0,0,0,855
43518,RM-B240,5/10/2015,0,0,855,0,0,0,855
43520,RM-B240,5/12/2015,0,0,855,0,0,0,855
43535,RM-B240,5/27/2015,0,0,855,0,0,0,855
43537,RM-B240,5/29/2015,0,0,855,0,0,0,855
44017,RM-B240A,1/19/2015,0,0,855,0,0,0,855
44044,RM-B240A,2/15/2015,0,0,855,0,0,0,855
44046,RM-B240A,2/17/2015,0,0,855,0,0,0,855
44058,RM-B240A,3/1/2015,0,0,855,0,0,0,855
44115,RM-B240A,4/27/2015,0,0,855,0,0,0,855
44120,RM-B240A,5/2/2015,0,0,855,0,0,0,855
44124,RM-B240A,5/6/2015,0,0,855,0,0,0,855
44128,RM-B240A,5/10/2015,0,0,855,0,0,0,855
44130,RM-B240A,5/12/2015,0,0,855,0,0,0,855
44145,RM-B240A,5/27/2015,0,0,855,0,0,0,855
44147,RM-B240A,5/29/2015,0,0,855,0,0,0,855
45185,RM-B250A,6/30/2014,855,0,0,0,0,0,855
45386,RM-B250A,1/19/2015,855,0,0,0,0,0,855
45413,RM-B250A,2/15/2015,855,0,0,0,0,0,855
45415,RM-B250A,2/17/2015,855,0,0,0,0,0,855
45427,RM-B250A,3/1/2015,855,0,0,0,0,0,855
45484,RM-B250A,4/27/2015,855,0,0,0,0,0,855
45489,RM-B250A,5/2/2015,855,0,0,0,0,0,855
45493,RM-B250A,5/6/2015,855,0,0,0,0,0,855
45497,RM-B250A,5/10/2015,855,0,0,0,0,0,855
45499,RM-B250A,5/12/2015,855,0,0,0,0,0,855
45514,RM-B250A,5/27/2015,855,0,0,0,0,0,855
45516,RM-B250A,5/29/2015,855,0,0,0,0,0,855
45983,RM-B260,10/23/2014,429,0,426,0,0,0,855
46071,RM-B260,1/19/2015,0,0,855,0,0,0,855
46098,RM-B260,2/15/2015,0,0,855,0,0,0,855
46100,RM-B260,2/17/2015,0,0,855,0,0,0,855
46104,RM-B260,2/21/2015,0,0,855,0,0,0,855
46112,RM-B260,3/1/2015,0,0,855,0,0,0,855
46169,RM-B260,4/27/2015,0,0,855,0,0,0,855
46174,RM-B260,5/2/2015,0,0,855,0,0,0,855
46178,RM-B260,5/6/2015,0,0,855,0,0,0,855
46179,RM-B260,5/7/2015,0,0,855,0,0,0,855
46182,RM-B260,5/10/2015,0,0,855,0,0,0,855
46184,RM-B260,5/12/2015,0,0,855,0,0,0,855
46199,RM-B260,5/27/2015,0,0,855,0,0,0,855
46201,RM-B260,5/29/2015,0,0,855,0,0,0,855
46985,RM-B270,10/15/2013,0,0,855,0,0,0,855
48109,RM-B275,1/19/2015,855,0,0,0,0,0,855
48136,RM-B275,2/15/2015,855,0,0,0,0,0,855
48138,RM-B275,2/17/2015,855,0,0,0,0,0,855
48150,RM-B275,3/1/2015,855,0,0,0,0,0,855
48207,RM-B275,4/27/2015,855,0,0,0,0,0,855
48212,RM-B275,5/2/2015,855,0,0,0,0,0,855
48216,RM-B275,5/6/2015,855,0,0,0,0,0,855
48220,RM-B275,5/10/2015,855,0,0,0,0,0,855
48222,RM-B275,5/12/2015,855,0,0,0,0,0,855
48237,RM-B275,5/27/2015,855,0,0,0,0,0,855
48239,RM-B275,5/29/2015,855,0,0,0,0,0,855
552,RM-1100A,1/16/2015,852,0,0,0,0,0,852
994,RM-1100D,5/16/2014,0,0,0,852,0,0,852
1922,RM-1102,1/16/2015,852,0,0,0,0,0,852
1973,RM-1102,3/8/2015,852,0,0,0,0,0,852
2021,RM-1102,4/25/2015,852,0,0,0,0,0,852
2022,RM-1102,4/26/2015,852,0,0,0,0,0,852
2026,RM-1102,4/30/2015,852,0,0,0,0,0,852
2033,RM-1102,5/7/2015,852,0,0,0,0,0,852
2034,RM-1102,5/8/2015,852,0,0,0,0,0,852
2040,RM-1102,5/14/2015,852,0,0,0,0,0,852
2041,RM-1102,5/15/2015,852,0,0,0,0,0,852
2043,RM-1102,5/17/2015,852,0,0,0,0,0,852
2050,RM-1102,5/24/2015,852,0,0,0,0,0,852
2056,RM-1102,5/30/2015,852,0,0,0,0,0,852
2795,RM-1106,10/15/2013,0,0,0,0,0,852,852
4617,RM-1108,1/16/2015,0,0,852,0,0,0,852
4668,RM-1108,3/8/2015,0,0,852,0,0,0,852
4716,RM-1108,4/25/2015,0,0,852,0,0,0,852
4717,RM-1108,4/26/2015,0,0,852,0,0,0,852
4721,RM-1108,4/30/2015,0,0,852,0,0,0,852
4728,RM-1108,5/7/2015,0,0,852,0,0,0,852
4729,RM-1108,5/8/2015,0,0,852,0,0,0,852
4735,RM-1108,5/14/2015,0,0,852,0,0,0,852
4736,RM-1108,5/15/2015,0,0,852,0,0,0,852
4738,RM-1108,5/17/2015,0,0,852,0,0,0,852
4745,RM-1108,5/24/2015,0,0,852,0,0,0,852
4751,RM-1108,5/30/2015,0,0,852,0,0,0,852
4852,RM-1109,10/15/2013,0,0,0,0,0,852,852
6725,RM-1113,3/8/2015,852,0,0,0,0,0,852
8119,RM-1116,4/25/2015,0,0,852,0,0,0,852
8120,RM-1116,4/26/2015,0,0,852,0,0,0,852
8124,RM-1116,4/30/2015,0,0,852,0,0,0,852
8131,RM-1116,5/7/2015,0,0,852,0,0,0,852
8132,RM-1116,5/8/2015,0,0,852,0,0,0,852
8138,RM-1116,5/14/2015,0,0,852,0,0,0,852
8139,RM-1116,5/15/2015,0,0,852,0,0,0,852
8141,RM-1116,5/17/2015,0,0,852,0,0,0,852
8148,RM-1116,5/24/2015,0,0,852,0,0,0,852
8154,RM-1116,5/30/2015,0,0,852,0,0,0,852
9492,RM-1122,4/25/2015,0,0,852,0,0,0,852
9493,RM-1122,4/26/2015,0,0,852,0,0,0,852
9497,RM-1122,4/30/2015,0,0,852,0,0,0,852
9504,RM-1122,5/7/2015,0,0,852,0,0,0,852
9505,RM-1122,5/8/2015,0,0,852,0,0,0,852
9511,RM-1122,5/14/2015,0,0,852,0,0,0,852
9512,RM-1122,5/15/2015,0,0,852,0,0,0,852
9514,RM-1122,5/17/2015,0,0,852,0,0,0,852
9521,RM-1122,5/24/2015,0,0,852,0,0,0,852
9527,RM-1122,5/30/2015,0,0,852,0,0,0,852
10078,RM-1123,1/16/2015,852,0,0,0,0,0,852
10129,RM-1123,3/8/2015,852,0,0,0,0,0,852
12228,RM-1130,10/15/2013,0,0,0,0,0,852,852
12680,RM-1130,1/16/2015,0,0,852,0,0,0,852
12731,RM-1130,3/8/2015,0,0,852,0,0,0,852
12915,RM-1132,10/15/2013,0,0,852,0,0,0,852
13368,RM-1132,1/16/2015,0,0,852,0,0,0,852
13419,RM-1132,3/8/2015,0,0,852,0,0,0,852
13467,RM-1132,4/25/2015,0,0,852,0,0,0,852
13468,RM-1132,4/26/2015,0,0,852,0,0,0,852
13472,RM-1132,4/30/2015,0,0,852,0,0,0,852
13479,RM-1132,5/7/2015,0,0,852,0,0,0,852
13480,RM-1132,5/8/2015,0,0,852,0,0,0,852
13486,RM-1132,5/14/2015,0,0,852,0,0,0,852
13487,RM-1132,5/15/2015,0,0,852,0,0,0,852
13489,RM-1132,5/17/2015,0,0,852,0,0,0,852
13496,RM-1132,5/24/2015,0,0,852,0,0,0,852
13502,RM-1132,5/30/2015,0,0,852,0,0,0,852
15392,RM-1144,10/15/2013,0,0,0,0,0,852,852
16077,RM-1145,10/15/2013,0,0,0,0,0,852,852
16503,RM-1145,1/16/2015,0,0,852,0,0,0,852
16554,RM-1145,3/8/2015,0,0,852,0,0,0,852
19245,RM-1155,1/16/2015,852,0,0,0,0,0,852
19921,RM-1156,1/16/2015,0,0,852,0,0,0,852
20686,RM-1200A,5/7/2015,852,0,0,0,0,0,852
20687,RM-1200A,5/8/2015,852,0,0,0,0,0,852
20693,RM-1200A,5/14/2015,852,0,0,0,0,0,852
20694,RM-1200A,5/15/2015,852,0,0,0,0,0,852
20696,RM-1200A,5/17/2015,852,0,0,0,0,0,852
20703,RM-1200A,5/24/2015,852,0,0,0,0,0,852
20709,RM-1200A,5/30/2015,852,0,0,0,0,0,852
20785,RM-1200B,10/15/2013,0,0,0,0,0,852,852
20989,RM-1200B,5/10/2014,0,852,0,0,0,0,852
21974,RM-1200C,3/8/2015,852,0,0,0,0,0,852
22022,RM-1200C,4/25/2015,852,0,0,0,0,0,852
22023,RM-1200C,4/26/2015,852,0,0,0,0,0,852
22027,RM-1200C,4/30/2015,852,0,0,0,0,0,852
22034,RM-1200C,5/7/2015,852,0,0,0,0,0,852
22035,RM-1200C,5/8/2015,852,0,0,0,0,0,852
22041,RM-1200C,5/14/2015,852,0,0,0,0,0,852
22042,RM-1200C,5/15/2015,852,0,0,0,0,0,852
22044,RM-1200C,5/17/2015,852,0,0,0,0,0,852
22051,RM-1200C,5/24/2015,852,0,0,0,0,0,852
22057,RM-1200C,5/30/2015,852,0,0,0,0,0,852
22786,RM-1207,10/15/2013,0,0,0,0,0,852,852
24612,RM-1208B,1/16/2015,852,0,0,0,0,0,852
24663,RM-1208B,3/8/2015,852,0,0,0,0,0,852
24711,RM-1208B,4/25/2015,852,0,0,0,0,0,852
24712,RM-1208B,4/26/2015,852,0,0,0,0,0,852
24716,RM-1208B,4/30/2015,852,0,0,0,0,0,852
24723,RM-1208B,5/7/2015,852,0,0,0,0,0,852
24724,RM-1208B,5/8/2015,852,0,0,0,0,0,852
24730,RM-1208B,5/14/2015,852,0,0,0,0,0,852
24731,RM-1208B,5/15/2015,852,0,0,0,0,0,852
24733,RM-1208B,5/17/2015,852,0,0,0,0,0,852
24740,RM-1208B,5/24/2015,852,0,0,0,0,0,852
24746,RM-1208B,5/30/2015,852,0,0,0,0,0,852
25099,RM-1212,6/30/2014,852,0,0,0,0,0,852
25514,RM-1213,10/15/2013,0,0,0,0,0,852,852
26884,RM-1217,10/15/2013,852,0,0,0,0,0,852
28025,RM-1218,1/16/2015,852,0,0,0,0,0,852
28076,RM-1218,3/8/2015,852,0,0,0,0,0,852
28124,RM-1218,4/25/2015,852,0,0,0,0,0,852
28125,RM-1218,4/26/2015,852,0,0,0,0,0,852
28129,RM-1218,4/30/2015,852,0,0,0,0,0,852
28136,RM-1218,5/7/2015,852,0,0,0,0,0,852
28137,RM-1218,5/8/2015,852,0,0,0,0,0,852
28143,RM-1218,5/14/2015,852,0,0,0,0,0,852
28144,RM-1218,5/15/2015,852,0,0,0,0,0,852
28146,RM-1218,5/17/2015,852,0,0,0,0,0,852
28153,RM-1218,5/24/2015,852,0,0,0,0,0,852
28159,RM-1218,5/30/2015,852,0,0,0,0,0,852
29449,RM-1223,3/8/2015,0,0,852,0,0,0,852
29497,RM-1223,4/25/2015,0,0,852,0,0,0,852
29498,RM-1223,4/26/2015,0,0,852,0,0,0,852
29502,RM-1223,4/30/2015,0,0,852,0,0,0,852
29509,RM-1223,5/7/2015,0,0,852,0,0,0,852
29510,RM-1223,5/8/2015,0,0,852,0,0,0,852
29516,RM-1223,5/14/2015,0,0,852,0,0,0,852
29517,RM-1223,5/15/2015,0,0,852,0,0,0,852
29519,RM-1223,5/17/2015,0,0,852,0,0,0,852
29526,RM-1223,5/24/2015,0,0,852,0,0,0,852
29532,RM-1223,5/30/2015,0,0,852,0,0,0,852
30083,RM-1224,1/16/2015,852,0,0,0,0,0,852
30134,RM-1224,3/8/2015,852,0,0,0,0,0,852
30182,RM-1224,4/25/2015,852,0,0,0,0,0,852
30183,RM-1224,4/26/2015,852,0,0,0,0,0,852
30187,RM-1224,4/30/2015,852,0,0,0,0,0,852
30194,RM-1224,5/7/2015,852,0,0,0,0,0,852
30195,RM-1224,5/8/2015,852,0,0,0,0,0,852
30201,RM-1224,5/14/2015,852,0,0,0,0,0,852
30202,RM-1224,5/15/2015,852,0,0,0,0,0,852
30204,RM-1224,5/17/2015,852,0,0,0,0,0,852
30211,RM-1224,5/24/2015,852,0,0,0,0,0,852
30217,RM-1224,5/30/2015,852,0,0,0,0,0,852
30771,RM-1229,1/16/2015,0,0,852,0,0,0,852
30822,RM-1229,3/8/2015,0,0,852,0,0,0,852
30870,RM-1229,4/25/2015,0,0,852,0,0,0,852
30871,RM-1229,4/26/2015,0,0,852,0,0,0,852
30875,RM-1229,4/30/2015,0,0,852,0,0,0,852
30882,RM-1229,5/7/2015,0,0,852,0,0,0,852
30883,RM-1229,5/8/2015,0,0,852,0,0,0,852
31655,RM-1231,10/15/2013,0,0,0,0,0,852,852
32214,RM-1231,4/30/2015,0,0,852,0,0,0,852
32221,RM-1231,5/7/2015,0,0,852,0,0,0,852
32222,RM-1231,5/8/2015,0,0,852,0,0,0,852
32228,RM-1231,5/14/2015,0,0,852,0,0,0,852
32229,RM-1231,5/15/2015,0,0,852,0,0,0,852
32231,RM-1231,5/17/2015,0,0,852,0,0,0,852
32238,RM-1231,5/24/2015,0,0,852,0,0,0,852
32244,RM-1231,5/30/2015,0,0,852,0,0,0,852
32798,RM-1236,1/16/2015,852,0,0,0,0,0,852
32849,RM-1236,3/8/2015,852,0,0,0,0,0,852
32897,RM-1236,4/25/2015,852,0,0,0,0,0,852
32898,RM-1236,4/26/2015,852,0,0,0,0,0,852
32902,RM-1236,4/30/2015,852,0,0,0,0,0,852
32909,RM-1236,5/7/2015,852,0,0,0,0,0,852
32910,RM-1236,5/8/2015,852,0,0,0,0,0,852
33636,RM-4xxx,1/16/2015,0,0,0,0,852,0,852
34059,RM-B102C,1/16/2015,852,0,0,0,0,0,852
34110,RM-B102C,3/8/2015,852,0,0,0,0,0,852
34158,RM-B102C,4/25/2015,852,0,0,0,0,0,852
34159,RM-B102C,4/26/2015,852,0,0,0,0,0,852
34163,RM-B102C,4/30/2015,852,0,0,0,0,0,852
34170,RM-B102C,5/7/2015,852,0,0,0,0,0,852
34171,RM-B102C,5/8/2015,852,0,0,0,0,0,852
34178,RM-B102C,5/15/2015,852,0,0,0,0,0,852
34180,RM-B102C,5/17/2015,852,0,0,0,0,0,852
34187,RM-B102C,5/24/2015,852,0,0,0,0,0,852
34190,RM-B102C,5/27/2015,852,0,0,0,0,0,852
34191,RM-B102C,5/28/2015,852,0,0,0,0,0,852
34193,RM-B102C,5/30/2015,852,0,0,0,0,0,852
34840,RM-B103,4/25/2015,0,0,852,0,0,0,852
34841,RM-B103,4/26/2015,0,0,852,0,0,0,852
34845,RM-B103,4/30/2015,0,0,852,0,0,0,852
34859,RM-B103,5/14/2015,0,0,852,0,0,0,852
34860,RM-B103,5/15/2015,0,0,852,0,0,0,852
34862,RM-B103,5/17/2015,0,0,852,0,0,0,852
34869,RM-B103,5/24/2015,0,0,852,0,0,0,852
34875,RM-B103,5/30/2015,0,0,852,0,0,0,852
34973,RM-B103A,10/15/2013,0,0,0,0,0,852,852
35803,RM-B109,7/26/2014,426,0,426,0,0,0,852
35890,RM-B109,10/23/2014,426,0,426,0,0,0,852
36109,RM-B109,5/30/2015,0,0,852,0,0,0,852
36209,RM-B200B,10/15/2013,0,0,0,0,0,852,852
36418,RM-B200B,5/15/2014,0,852,0,0,0,0,852
36709,RM-B200B,3/8/2015,0,0,852,0,0,0,852
37343,RM-B200C,1/16/2015,852,0,0,0,0,0,852
37388,RM-B200C,3/2/2015,852,0,0,0,0,0,852
37394,RM-B200C,3/8/2015,852,0,0,0,0,0,852
37442,RM-B200C,4/25/2015,852,0,0,0,0,0,852
37443,RM-B200C,4/26/2015,852,0,0,0,0,0,852
37447,RM-B200C,4/30/2015,852,0,0,0,0,0,852
37461,RM-B200C,5/14/2015,852,0,0,0,0,0,852
37462,RM-B200C,5/15/2015,852,0,0,0,0,0,852
37464,RM-B200C,5/17/2015,852,0,0,0,0,0,852
37471,RM-B200C,5/24/2015,852,0,0,0,0,0,852
37477,RM-B200C,5/30/2015,852,0,0,0,0,0,852
38719,RM-B215,1/16/2015,852,0,0,0,0,0,852
38764,RM-B215,3/2/2015,852,0,0,0,0,0,852
38770,RM-B215,3/8/2015,852,0,0,0,0,0,852
39639,RM-B222,10/15/2013,852,0,0,0,0,0,852
40086,RM-B222,1/10/2015,852,0,0,0,0,0,852
40327,RM-B224,10/15/2013,0,0,0,0,0,852,852
41015,RM-B225,10/15/2013,0,0,0,0,0,852,852
42385,RM-B230A,10/15/2013,0,0,0,0,0,852,852
43404,RM-B240,1/16/2015,0,0,852,0,0,0,852
43449,RM-B240,3/2/2015,0,0,852,0,0,0,852
43455,RM-B240,3/8/2015,0,0,852,0,0,0,852
43503,RM-B240,4/25/2015,0,0,852,0,0,0,852
43504,RM-B240,4/26/2015,0,0,852,0,0,0,852
43508,RM-B240,4/30/2015,0,0,852,0,0,0,852
43522,RM-B240,5/14/2015,0,0,852,0,0,0,852
43523,RM-B240,5/15/2015,0,0,852,0,0,0,852
43525,RM-B240,5/17/2015,0,0,852,0,0,0,852
43532,RM-B240,5/24/2015,0,0,852,0,0,0,852
43538,RM-B240,5/30/2015,0,0,852,0,0,0,852
44014,RM-B240A,1/16/2015,0,0,852,0,0,0,852
44065,RM-B240A,3/8/2015,0,0,852,0,0,0,852
44113,RM-B240A,4/25/2015,0,0,852,0,0,0,852
44114,RM-B240A,4/26/2015,0,0,852,0,0,0,852
44118,RM-B240A,4/30/2015,0,0,852,0,0,0,852
44125,RM-B240A,5/7/2015,0,0,852,0,0,0,852
44126,RM-B240A,5/8/2015,0,0,852,0,0,0,852
44132,RM-B240A,5/14/2015,0,0,852,0,0,0,852
44133,RM-B240A,5/15/2015,0,0,852,0,0,0,852
44135,RM-B240A,5/17/2015,0,0,852,0,0,0,852
44142,RM-B240A,5/24/2015,0,0,852,0,0,0,852
44148,RM-B240A,5/30/2015,0,0,852,0,0,0,852
45383,RM-B250A,1/16/2015,852,0,0,0,0,0,852
45434,RM-B250A,3/8/2015,852,0,0,0,0,0,852
45482,RM-B250A,4/25/2015,852,0,0,0,0,0,852
45483,RM-B250A,4/26/2015,852,0,0,0,0,0,852
45487,RM-B250A,4/30/2015,852,0,0,0,0,0,852
45494,RM-B250A,5/7/2015,852,0,0,0,0,0,852
45495,RM-B250A,5/8/2015,852,0,0,0,0,0,852
45501,RM-B250A,5/14/2015,852,0,0,0,0,0,852
45502,RM-B250A,5/15/2015,852,0,0,0,0,0,852
45504,RM-B250A,5/17/2015,852,0,0,0,0,0,852
45511,RM-B250A,5/24/2015,852,0,0,0,0,0,852
45517,RM-B250A,5/30/2015,852,0,0,0,0,0,852
46068,RM-B260,1/16/2015,0,0,852,0,0,0,852
46113,RM-B260,3/2/2015,0,0,852,0,0,0,852
46119,RM-B260,3/8/2015,0,0,852,0,0,0,852
46167,RM-B260,4/25/2015,0,0,852,0,0,0,852
46168,RM-B260,4/26/2015,0,0,852,0,0,0,852
46172,RM-B260,4/30/2015,0,0,852,0,0,0,852
46186,RM-B260,5/14/2015,0,0,852,0,0,0,852
46187,RM-B260,5/15/2015,0,0,852,0,0,0,852
46189,RM-B260,5/17/2015,0,0,852,0,0,0,852
46196,RM-B260,5/24/2015,0,0,852,0,0,0,852
46202,RM-B260,5/30/2015,0,0,852,0,0,0,852
48106,RM-B275,1/16/2015,852,0,0,0,0,0,852
48157,RM-B275,3/8/2015,852,0,0,0,0,0,852
48205,RM-B275,4/25/2015,852,0,0,0,0,0,852
48206,RM-B275,4/26/2015,852,0,0,0,0,0,852
48210,RM-B275,4/30/2015,852,0,0,0,0,0,852
48217,RM-B275,5/7/2015,852,0,0,0,0,0,852
48218,RM-B275,5/8/2015,852,0,0,0,0,0,852
48224,RM-B275,5/14/2015,852,0,0,0,0,0,852
48225,RM-B275,5/15/2015,852,0,0,0,0,0,852
48227,RM-B275,5/17/2015,852,0,0,0,0,0,852
48234,RM-B275,5/24/2015,852,0,0,0,0,0,852
48240,RM-B275,5/30/2015,852,0,0,0,0,0,852
1953,RM-1102,2/16/2015,849,0,0,0,0,0,849
1955,RM-1102,2/18/2015,849,0,0,0,0,0,849
1967,RM-1102,3/2/2015,849,0,0,0,0,0,849
1969,RM-1102,3/4/2015,849,0,0,0,0,0,849
1971,RM-1102,3/6/2015,849,0,0,0,0,0,849
1972,RM-1102,3/7/2015,849,0,0,0,0,0,849
1974,RM-1102,3/9/2015,849,0,0,0,0,0,849
2007,RM-1102,4/11/2015,849,0,0,0,0,0,849
2009,RM-1102,4/13/2015,849,0,0,0,0,0,849
2020,RM-1102,4/24/2015,849,0,0,0,0,0,849
2024,RM-1102,4/28/2015,849,0,0,0,0,0,849
2025,RM-1102,4/29/2015,849,0,0,0,0,0,849
2047,RM-1102,5/21/2015,849,0,0,0,0,0,849
2048,RM-1102,5/22/2015,849,0,0,0,0,0,849
2049,RM-1102,5/23/2015,849,0,0,0,0,0,849
2052,RM-1102,5/26/2015,849,0,0,0,0,0,849
2054,RM-1102,5/28/2015,849,0,0,0,0,0,849
4648,RM-1108,2/16/2015,0,0,849,0,0,0,849
4650,RM-1108,2/18/2015,0,0,849,0,0,0,849
4662,RM-1108,3/2/2015,0,0,849,0,0,0,849
4664,RM-1108,3/4/2015,0,0,849,0,0,0,849
4666,RM-1108,3/6/2015,0,0,849,0,0,0,849
4667,RM-1108,3/7/2015,0,0,849,0,0,0,849
4669,RM-1108,3/9/2015,0,0,849,0,0,0,849
4702,RM-1108,4/11/2015,0,0,849,0,0,0,849
4704,RM-1108,4/13/2015,0,0,849,0,0,0,849
4719,RM-1108,4/28/2015,0,0,849,0,0,0,849
4720,RM-1108,4/29/2015,0,0,849,0,0,0,849
4740,RM-1108,5/19/2015,0,0,849,0,0,0,849
4742,RM-1108,5/21/2015,0,0,849,0,0,0,849
4743,RM-1108,5/22/2015,0,0,849,0,0,0,849
4744,RM-1108,5/23/2015,0,0,849,0,0,0,849
4747,RM-1108,5/26/2015,0,0,849,0,0,0,849
4749,RM-1108,5/28/2015,0,0,849,0,0,0,849
6705,RM-1113,2/16/2015,849,0,0,0,0,0,849
6707,RM-1113,2/18/2015,849,0,0,0,0,0,849
6719,RM-1113,3/2/2015,849,0,0,0,0,0,849
6721,RM-1113,3/4/2015,849,0,0,0,0,0,849
6723,RM-1113,3/6/2015,849,0,0,0,0,0,849
6724,RM-1113,3/7/2015,849,0,0,0,0,0,849
6726,RM-1113,3/9/2015,849,0,0,0,0,0,849
8105,RM-1116,4/11/2015,0,0,849,0,0,0,849
8107,RM-1116,4/13/2015,0,0,849,0,0,0,849
8122,RM-1116,4/28/2015,0,0,849,0,0,0,849
8123,RM-1116,4/29/2015,0,0,849,0,0,0,849
8143,RM-1116,5/19/2015,0,0,849,0,0,0,849
8145,RM-1116,5/21/2015,0,0,849,0,0,0,849
8146,RM-1116,5/22/2015,0,0,849,0,0,0,849
8147,RM-1116,5/23/2015,0,0,849,0,0,0,849
8150,RM-1116,5/26/2015,0,0,849,0,0,0,849
8152,RM-1116,5/28/2015,0,0,849,0,0,0,849
9478,RM-1122,4/11/2015,0,0,849,0,0,0,849
9480,RM-1122,4/13/2015,0,0,849,0,0,0,849
9495,RM-1122,4/28/2015,0,0,849,0,0,0,849
9496,RM-1122,4/29/2015,0,0,849,0,0,0,849
9516,RM-1122,5/19/2015,0,0,849,0,0,0,849
9518,RM-1122,5/21/2015,0,0,849,0,0,0,849
9519,RM-1122,5/22/2015,0,0,849,0,0,0,849
9520,RM-1122,5/23/2015,0,0,849,0,0,0,849
9523,RM-1122,5/26/2015,0,0,849,0,0,0,849
9525,RM-1122,5/28/2015,0,0,849,0,0,0,849
10109,RM-1123,2/16/2015,849,0,0,0,0,0,849
10111,RM-1123,2/18/2015,849,0,0,0,0,0,849
10123,RM-1123,3/2/2015,849,0,0,0,0,0,849
10125,RM-1123,3/4/2015,849,0,0,0,0,0,849
10127,RM-1123,3/6/2015,849,0,0,0,0,0,849
10128,RM-1123,3/7/2015,849,0,0,0,0,0,849
10130,RM-1123,3/9/2015,849,0,0,0,0,0,849
12711,RM-1130,2/16/2015,0,0,849,0,0,0,849
12713,RM-1130,2/18/2015,0,0,849,0,0,0,849
12725,RM-1130,3/2/2015,0,0,849,0,0,0,849
12727,RM-1130,3/4/2015,0,0,849,0,0,0,849
12729,RM-1130,3/6/2015,0,0,849,0,0,0,849
12730,RM-1130,3/7/2015,0,0,849,0,0,0,849
12732,RM-1130,3/9/2015,0,0,849,0,0,0,849
13399,RM-1132,2/16/2015,0,0,849,0,0,0,849
13401,RM-1132,2/18/2015,0,0,849,0,0,0,849
13413,RM-1132,3/2/2015,0,0,849,0,0,0,849
13415,RM-1132,3/4/2015,0,0,849,0,0,0,849
13417,RM-1132,3/6/2015,0,0,849,0,0,0,849
13418,RM-1132,3/7/2015,0,0,849,0,0,0,849
13420,RM-1132,3/9/2015,0,0,849,0,0,0,849
13453,RM-1132,4/11/2015,0,0,849,0,0,0,849
13455,RM-1132,4/13/2015,0,0,849,0,0,0,849
13470,RM-1132,4/28/2015,0,0,849,0,0,0,849
13471,RM-1132,4/29/2015,0,0,849,0,0,0,849
13491,RM-1132,5/19/2015,0,0,849,0,0,0,849
13493,RM-1132,5/21/2015,0,0,849,0,0,0,849
13494,RM-1132,5/22/2015,0,0,849,0,0,0,849
13495,RM-1132,5/23/2015,0,0,849,0,0,0,849
13498,RM-1132,5/26/2015,0,0,849,0,0,0,849
13500,RM-1132,5/28/2015,0,0,849,0,0,0,849
16534,RM-1145,2/16/2015,0,0,849,0,0,0,849
16536,RM-1145,2/18/2015,0,0,849,0,0,0,849
16548,RM-1145,3/2/2015,0,0,849,0,0,0,849
16550,RM-1145,3/4/2015,0,0,849,0,0,0,849
16552,RM-1145,3/6/2015,0,0,849,0,0,0,849
16553,RM-1145,3/7/2015,0,0,849,0,0,0,849
16555,RM-1145,3/9/2015,0,0,849,0,0,0,849
20698,RM-1200A,5/19/2015,849,0,0,0,0,0,849
20700,RM-1200A,5/21/2015,849,0,0,0,0,0,849
20701,RM-1200A,5/22/2015,849,0,0,0,0,0,849
20702,RM-1200A,5/23/2015,849,0,0,0,0,0,849
20705,RM-1200A,5/26/2015,849,0,0,0,0,0,849
20707,RM-1200A,5/28/2015,849,0,0,0,0,0,849
21954,RM-1200C,2/16/2015,849,0,0,0,0,0,849
21956,RM-1200C,2/18/2015,849,0,0,0,0,0,849
21968,RM-1200C,3/2/2015,849,0,0,0,0,0,849
21970,RM-1200C,3/4/2015,849,0,0,0,0,0,849
21972,RM-1200C,3/6/2015,849,0,0,0,0,0,849
21973,RM-1200C,3/7/2015,849,0,0,0,0,0,849
21975,RM-1200C,3/9/2015,849,0,0,0,0,0,849
22008,RM-1200C,4/11/2015,849,0,0,0,0,0,849
22010,RM-1200C,4/13/2015,849,0,0,0,0,0,849
22025,RM-1200C,4/28/2015,849,0,0,0,0,0,849
22026,RM-1200C,4/29/2015,849,0,0,0,0,0,849
22046,RM-1200C,5/19/2015,849,0,0,0,0,0,849
22048,RM-1200C,5/21/2015,849,0,0,0,0,0,849
22049,RM-1200C,5/22/2015,849,0,0,0,0,0,849
22050,RM-1200C,5/23/2015,849,0,0,0,0,0,849
22053,RM-1200C,5/26/2015,849,0,0,0,0,0,849
22055,RM-1200C,5/28/2015,849,0,0,0,0,0,849
24643,RM-1208B,2/16/2015,849,0,0,0,0,0,849
24645,RM-1208B,2/18/2015,849,0,0,0,0,0,849
24657,RM-1208B,3/2/2015,849,0,0,0,0,0,849
24659,RM-1208B,3/4/2015,849,0,0,0,0,0,849
24661,RM-1208B,3/6/2015,849,0,0,0,0,0,849
24662,RM-1208B,3/7/2015,849,0,0,0,0,0,849
24664,RM-1208B,3/9/2015,849,0,0,0,0,0,849
24697,RM-1208B,4/11/2015,849,0,0,0,0,0,849
24699,RM-1208B,4/13/2015,849,0,0,0,0,0,849
24710,RM-1208B,4/24/2015,849,0,0,0,0,0,849
24714,RM-1208B,4/28/2015,849,0,0,0,0,0,849
24715,RM-1208B,4/29/2015,849,0,0,0,0,0,849
24737,RM-1208B,5/21/2015,849,0,0,0,0,0,849
24738,RM-1208B,5/22/2015,849,0,0,0,0,0,849
24739,RM-1208B,5/23/2015,849,0,0,0,0,0,849
24742,RM-1208B,5/26/2015,849,0,0,0,0,0,849
24744,RM-1208B,5/28/2015,849,0,0,0,0,0,849
28056,RM-1218,2/16/2015,849,0,0,0,0,0,849
28058,RM-1218,2/18/2015,849,0,0,0,0,0,849
28070,RM-1218,3/2/2015,849,0,0,0,0,0,849
28072,RM-1218,3/4/2015,849,0,0,0,0,0,849
28074,RM-1218,3/6/2015,849,0,0,0,0,0,849
28075,RM-1218,3/7/2015,849,0,0,0,0,0,849
28077,RM-1218,3/9/2015,849,0,0,0,0,0,849
28110,RM-1218,4/11/2015,849,0,0,0,0,0,849
28112,RM-1218,4/13/2015,849,0,0,0,0,0,849
28127,RM-1218,4/28/2015,849,0,0,0,0,0,849
28128,RM-1218,4/29/2015,849,0,0,0,0,0,849
28150,RM-1218,5/21/2015,849,0,0,0,0,0,849
28151,RM-1218,5/22/2015,849,0,0,0,0,0,849
28152,RM-1218,5/23/2015,849,0,0,0,0,0,849
28155,RM-1218,5/26/2015,849,0,0,0,0,0,849
28157,RM-1218,5/28/2015,849,0,0,0,0,0,849
29445,RM-1223,3/4/2015,0,0,849,0,0,0,849
29447,RM-1223,3/6/2015,0,0,849,0,0,0,849
29448,RM-1223,3/7/2015,0,0,849,0,0,0,849
29450,RM-1223,3/9/2015,0,0,849,0,0,0,849
29483,RM-1223,4/11/2015,0,0,849,0,0,0,849
29485,RM-1223,4/13/2015,0,0,849,0,0,0,849
29496,RM-1223,4/24/2015,0,0,849,0,0,0,849
29500,RM-1223,4/28/2015,0,0,849,0,0,0,849
29501,RM-1223,4/29/2015,0,0,849,0,0,0,849
29523,RM-1223,5/21/2015,0,0,849,0,0,0,849
29524,RM-1223,5/22/2015,0,0,849,0,0,0,849
29525,RM-1223,5/23/2015,0,0,849,0,0,0,849
29528,RM-1223,5/26/2015,0,0,849,0,0,0,849
29530,RM-1223,5/28/2015,0,0,849,0,0,0,849
30114,RM-1224,2/16/2015,849,0,0,0,0,0,849
30116,RM-1224,2/18/2015,849,0,0,0,0,0,849
30128,RM-1224,3/2/2015,849,0,0,0,0,0,849
30130,RM-1224,3/4/2015,849,0,0,0,0,0,849
30132,RM-1224,3/6/2015,849,0,0,0,0,0,849
30133,RM-1224,3/7/2015,849,0,0,0,0,0,849
30135,RM-1224,3/9/2015,849,0,0,0,0,0,849
30168,RM-1224,4/11/2015,849,0,0,0,0,0,849
30170,RM-1224,4/13/2015,849,0,0,0,0,0,849
30185,RM-1224,4/28/2015,849,0,0,0,0,0,849
30186,RM-1224,4/29/2015,849,0,0,0,0,0,849
30208,RM-1224,5/21/2015,849,0,0,0,0,0,849
30209,RM-1224,5/22/2015,849,0,0,0,0,0,849
30210,RM-1224,5/23/2015,849,0,0,0,0,0,849
30213,RM-1224,5/26/2015,849,0,0,0,0,0,849
30215,RM-1224,5/28/2015,849,0,0,0,0,0,849
30802,RM-1229,2/16/2015,0,0,849,0,0,0,849
30804,RM-1229,2/18/2015,0,0,849,0,0,0,849
30816,RM-1229,3/2/2015,0,0,849,0,0,0,849
30818,RM-1229,3/4/2015,0,0,849,0,0,0,849
30820,RM-1229,3/6/2015,0,0,849,0,0,0,849
30821,RM-1229,3/7/2015,0,0,849,0,0,0,849
30823,RM-1229,3/9/2015,0,0,849,0,0,0,849
30856,RM-1229,4/11/2015,0,0,849,0,0,0,849
30858,RM-1229,4/13/2015,0,0,849,0,0,0,849
30873,RM-1229,4/28/2015,0,0,849,0,0,0,849
30874,RM-1229,4/29/2015,0,0,849,0,0,0,849
32212,RM-1231,4/28/2015,0,0,849,0,0,0,849
32213,RM-1231,4/29/2015,0,0,849,0,0,0,849
32235,RM-1231,5/21/2015,0,0,849,0,0,0,849
32236,RM-1231,5/22/2015,0,0,849,0,0,0,849
32237,RM-1231,5/23/2015,0,0,849,0,0,0,849
32240,RM-1231,5/26/2015,0,0,849,0,0,0,849
32242,RM-1231,5/28/2015,0,0,849,0,0,0,849
32829,RM-1236,2/16/2015,849,0,0,0,0,0,849
32831,RM-1236,2/18/2015,849,0,0,0,0,0,849
32843,RM-1236,3/2/2015,849,0,0,0,0,0,849
32845,RM-1236,3/4/2015,849,0,0,0,0,0,849
32847,RM-1236,3/6/2015,849,0,0,0,0,0,849
32848,RM-1236,3/7/2015,849,0,0,0,0,0,849
32850,RM-1236,3/9/2015,849,0,0,0,0,0,849
32883,RM-1236,4/11/2015,849,0,0,0,0,0,849
32885,RM-1236,4/13/2015,849,0,0,0,0,0,849
32900,RM-1236,4/28/2015,849,0,0,0,0,0,849
32901,RM-1236,4/29/2015,849,0,0,0,0,0,849
34090,RM-B102C,2/16/2015,849,0,0,0,0,0,849
34092,RM-B102C,2/18/2015,849,0,0,0,0,0,849
34104,RM-B102C,3/2/2015,849,0,0,0,0,0,849
34106,RM-B102C,3/4/2015,849,0,0,0,0,0,849
34108,RM-B102C,3/6/2015,849,0,0,0,0,0,849
34109,RM-B102C,3/7/2015,849,0,0,0,0,0,849
34111,RM-B102C,3/9/2015,849,0,0,0,0,0,849
34144,RM-B102C,4/11/2015,849,0,0,0,0,0,849
34146,RM-B102C,4/13/2015,849,0,0,0,0,0,849
34157,RM-B102C,4/24/2015,849,0,0,0,0,0,849
34161,RM-B102C,4/28/2015,849,0,0,0,0,0,849
34162,RM-B102C,4/29/2015,849,0,0,0,0,0,849
34184,RM-B102C,5/21/2015,849,0,0,0,0,0,849
34185,RM-B102C,5/22/2015,849,0,0,0,0,0,849
34186,RM-B102C,5/23/2015,849,0,0,0,0,0,849
34189,RM-B102C,5/26/2015,849,0,0,0,0,0,849
34826,RM-B103,4/11/2015,0,0,849,0,0,0,849
34828,RM-B103,4/13/2015,0,0,849,0,0,0,849
34843,RM-B103,4/28/2015,0,0,849,0,0,0,849
34844,RM-B103,4/29/2015,0,0,849,0,0,0,849
34853,RM-B103,5/8/2015,0,0,849,0,0,0,849
34864,RM-B103,5/19/2015,0,0,849,0,0,0,849
34866,RM-B103,5/21/2015,0,0,849,0,0,0,849
34867,RM-B103,5/22/2015,0,0,849,0,0,0,849
34868,RM-B103,5/23/2015,0,0,849,0,0,0,849
34871,RM-B103,5/26/2015,0,0,849,0,0,0,849
34873,RM-B103,5/28/2015,0,0,849,0,0,0,849
36107,RM-B109,5/28/2015,0,0,849,0,0,0,849
36689,RM-B200B,2/16/2015,0,0,849,0,0,0,849
36691,RM-B200B,2/18/2015,0,0,849,0,0,0,849
36703,RM-B200B,3/2/2015,0,0,849,0,0,0,849
36705,RM-B200B,3/4/2015,0,0,849,0,0,0,849
36707,RM-B200B,3/6/2015,0,0,849,0,0,0,849
36708,RM-B200B,3/7/2015,0,0,849,0,0,0,849
36710,RM-B200B,3/9/2015,0,0,849,0,0,0,849
36743,RM-B200B,4/11/2015,0,0,849,0,0,0,849
36745,RM-B200B,4/13/2015,0,0,849,0,0,0,849
37374,RM-B200C,2/16/2015,849,0,0,0,0,0,849
37376,RM-B200C,2/18/2015,849,0,0,0,0,0,849
37390,RM-B200C,3/4/2015,849,0,0,0,0,0,849
37392,RM-B200C,3/6/2015,849,0,0,0,0,0,849
37393,RM-B200C,3/7/2015,849,0,0,0,0,0,849
37395,RM-B200C,3/9/2015,849,0,0,0,0,0,849
37428,RM-B200C,4/11/2015,849,0,0,0,0,0,849
37430,RM-B200C,4/13/2015,849,0,0,0,0,0,849
37445,RM-B200C,4/28/2015,849,0,0,0,0,0,849
37446,RM-B200C,4/29/2015,849,0,0,0,0,0,849
37455,RM-B200C,5/8/2015,849,0,0,0,0,0,849
37466,RM-B200C,5/19/2015,849,0,0,0,0,0,849
37468,RM-B200C,5/21/2015,849,0,0,0,0,0,849
37469,RM-B200C,5/22/2015,849,0,0,0,0,0,849
37470,RM-B200C,5/23/2015,849,0,0,0,0,0,849
37473,RM-B200C,5/26/2015,849,0,0,0,0,0,849
37475,RM-B200C,5/28/2015,849,0,0,0,0,0,849
38750,RM-B215,2/16/2015,849,0,0,0,0,0,849
38752,RM-B215,2/18/2015,849,0,0,0,0,0,849
38766,RM-B215,3/4/2015,849,0,0,0,0,0,849
38768,RM-B215,3/6/2015,849,0,0,0,0,0,849
38769,RM-B215,3/7/2015,849,0,0,0,0,0,849
38771,RM-B215,3/9/2015,849,0,0,0,0,0,849
43435,RM-B240,2/16/2015,0,0,849,0,0,0,849
43437,RM-B240,2/18/2015,0,0,849,0,0,0,849
43451,RM-B240,3/4/2015,0,0,849,0,0,0,849
43453,RM-B240,3/6/2015,0,0,849,0,0,0,849
43454,RM-B240,3/7/2015,0,0,849,0,0,0,849
43456,RM-B240,3/9/2015,0,0,849,0,0,0,849
43489,RM-B240,4/11/2015,0,0,849,0,0,0,849
43491,RM-B240,4/13/2015,0,0,849,0,0,0,849
43506,RM-B240,4/28/2015,0,0,849,0,0,0,849
43507,RM-B240,4/29/2015,0,0,849,0,0,0,849
43516,RM-B240,5/8/2015,0,0,849,0,0,0,849
43527,RM-B240,5/19/2015,0,0,849,0,0,0,849
43529,RM-B240,5/21/2015,0,0,849,0,0,0,849
43530,RM-B240,5/22/2015,0,0,849,0,0,0,849
43531,RM-B240,5/23/2015,0,0,849,0,0,0,849
43534,RM-B240,5/26/2015,0,0,849,0,0,0,849
43536,RM-B240,5/28/2015,0,0,849,0,0,0,849
44045,RM-B240A,2/16/2015,0,0,849,0,0,0,849
44047,RM-B240A,2/18/2015,0,0,849,0,0,0,849
44059,RM-B240A,3/2/2015,0,0,849,0,0,0,849
44061,RM-B240A,3/4/2015,0,0,849,0,0,0,849
44063,RM-B240A,3/6/2015,0,0,849,0,0,0,849
44064,RM-B240A,3/7/2015,0,0,849,0,0,0,849
44066,RM-B240A,3/9/2015,0,0,849,0,0,0,849
44099,RM-B240A,4/11/2015,0,0,849,0,0,0,849
44101,RM-B240A,4/13/2015,0,0,849,0,0,0,849
44116,RM-B240A,4/28/2015,0,0,849,0,0,0,849
44117,RM-B240A,4/29/2015,0,0,849,0,0,0,849
44137,RM-B240A,5/19/2015,0,0,849,0,0,0,849
44139,RM-B240A,5/21/2015,0,0,849,0,0,0,849
44140,RM-B240A,5/22/2015,0,0,849,0,0,0,849
44141,RM-B240A,5/23/2015,0,0,849,0,0,0,849
44144,RM-B240A,5/26/2015,0,0,849,0,0,0,849
44146,RM-B240A,5/28/2015,0,0,849,0,0,0,849
45414,RM-B250A,2/16/2015,849,0,0,0,0,0,849
45416,RM-B250A,2/18/2015,849,0,0,0,0,0,849
45428,RM-B250A,3/2/2015,849,0,0,0,0,0,849
45430,RM-B250A,3/4/2015,849,0,0,0,0,0,849
45432,RM-B250A,3/6/2015,849,0,0,0,0,0,849
45433,RM-B250A,3/7/2015,849,0,0,0,0,0,849
45435,RM-B250A,3/9/2015,849,0,0,0,0,0,849
45468,RM-B250A,4/11/2015,849,0,0,0,0,0,849
45470,RM-B250A,4/13/2015,849,0,0,0,0,0,849
45485,RM-B250A,4/28/2015,849,0,0,0,0,0,849
45486,RM-B250A,4/29/2015,849,0,0,0,0,0,849
45506,RM-B250A,5/19/2015,849,0,0,0,0,0,849
45508,RM-B250A,5/21/2015,849,0,0,0,0,0,849
45509,RM-B250A,5/22/2015,849,0,0,0,0,0,849
45510,RM-B250A,5/23/2015,849,0,0,0,0,0,849
45513,RM-B250A,5/26/2015,849,0,0,0,0,0,849
45515,RM-B250A,5/28/2015,849,0,0,0,0,0,849
46099,RM-B260,2/16/2015,0,0,849,0,0,0,849
46101,RM-B260,2/18/2015,0,0,849,0,0,0,849
46115,RM-B260,3/4/2015,0,0,849,0,0,0,849
46117,RM-B260,3/6/2015,0,0,849,0,0,0,849
46118,RM-B260,3/7/2015,0,0,849,0,0,0,849
46120,RM-B260,3/9/2015,0,0,849,0,0,0,849
46153,RM-B260,4/11/2015,0,0,849,0,0,0,849
46155,RM-B260,4/13/2015,0,0,849,0,0,0,849
46170,RM-B260,4/28/2015,0,0,849,0,0,0,849
46171,RM-B260,4/29/2015,0,0,849,0,0,0,849
46180,RM-B260,5/8/2015,0,0,849,0,0,0,849
46191,RM-B260,5/19/2015,0,0,849,0,0,0,849
46193,RM-B260,5/21/2015,0,0,849,0,0,0,849
46194,RM-B260,5/22/2015,0,0,849,0,0,0,849
46195,RM-B260,5/23/2015,0,0,849,0,0,0,849
46198,RM-B260,5/26/2015,0,0,849,0,0,0,849
46200,RM-B260,5/28/2015,0,0,849,0,0,0,849
48137,RM-B275,2/16/2015,849,0,0,0,0,0,849
48139,RM-B275,2/18/2015,849,0,0,0,0,0,849
48151,RM-B275,3/2/2015,849,0,0,0,0,0,849
48153,RM-B275,3/4/2015,849,0,0,0,0,0,849
48155,RM-B275,3/6/2015,849,0,0,0,0,0,849
48156,RM-B275,3/7/2015,849,0,0,0,0,0,849
48158,RM-B275,3/9/2015,849,0,0,0,0,0,849
48191,RM-B275,4/11/2015,849,0,0,0,0,0,849
48193,RM-B275,4/13/2015,849,0,0,0,0,0,849
48208,RM-B275,4/28/2015,849,0,0,0,0,0,849
48209,RM-B275,4/29/2015,849,0,0,0,0,0,849
48229,RM-B275,5/19/2015,849,0,0,0,0,0,849
48231,RM-B275,5/21/2015,849,0,0,0,0,0,849
48232,RM-B275,5/22/2015,849,0,0,0,0,0,849
48233,RM-B275,5/23/2015,849,0,0,0,0,0,849
48236,RM-B275,5/26/2015,849,0,0,0,0,0,849
48238,RM-B275,5/28/2015,849,0,0,0,0,0,849
1968,RM-1102,3/3/2015,846,0,0,0,0,0,846
1970,RM-1102,3/5/2015,846,0,0,0,0,0,846
1975,RM-1102,3/10/2015,846,0,0,0,0,0,846
1976,RM-1102,3/11/2015,846,0,0,0,0,0,846
1977,RM-1102,3/12/2015,846,0,0,0,0,0,846
1985,RM-1102,3/20/2015,846,0,0,0,0,0,846
2008,RM-1102,4/12/2015,846,0,0,0,0,0,846
2012,RM-1102,4/16/2015,846,0,0,0,0,0,846
2045,RM-1102,5/19/2015,846,0,0,0,0,0,846
2046,RM-1102,5/20/2015,846,0,0,0,0,0,846
4663,RM-1108,3/3/2015,0,0,846,0,0,0,846
4665,RM-1108,3/5/2015,0,0,846,0,0,0,846
4670,RM-1108,3/10/2015,0,0,846,0,0,0,846
4671,RM-1108,3/11/2015,0,0,846,0,0,0,846
4672,RM-1108,3/12/2015,0,0,846,0,0,0,846
4680,RM-1108,3/20/2015,0,0,846,0,0,0,846
4703,RM-1108,4/12/2015,0,0,846,0,0,0,846
4707,RM-1108,4/16/2015,0,0,846,0,0,0,846
4715,RM-1108,4/24/2015,0,0,846,0,0,0,846
6720,RM-1113,3/3/2015,846,0,0,0,0,0,846
6722,RM-1113,3/5/2015,846,0,0,0,0,0,846
6727,RM-1113,3/10/2015,846,0,0,0,0,0,846
8106,RM-1116,4/12/2015,0,0,846,0,0,0,846
8110,RM-1116,4/16/2015,0,0,846,0,0,0,846
8118,RM-1116,4/24/2015,0,0,846,0,0,0,846
9479,RM-1122,4/12/2015,0,0,846,0,0,0,846
9483,RM-1122,4/16/2015,0,0,846,0,0,0,846
9491,RM-1122,4/24/2015,0,0,846,0,0,0,846
10124,RM-1123,3/3/2015,846,0,0,0,0,0,846
10126,RM-1123,3/5/2015,846,0,0,0,0,0,846
10131,RM-1123,3/10/2015,846,0,0,0,0,0,846
10132,RM-1123,3/11/2015,846,0,0,0,0,0,846
10133,RM-1123,3/12/2015,846,0,0,0,0,0,846
12726,RM-1130,3/3/2015,0,0,846,0,0,0,846
12728,RM-1130,3/5/2015,0,0,846,0,0,0,846
12733,RM-1130,3/10/2015,0,0,846,0,0,0,846
13414,RM-1132,3/3/2015,0,0,846,0,0,0,846
13416,RM-1132,3/5/2015,0,0,846,0,0,0,846
13421,RM-1132,3/10/2015,0,0,846,0,0,0,846
13422,RM-1132,3/11/2015,0,0,846,0,0,0,846
13423,RM-1132,3/12/2015,0,0,846,0,0,0,846
13431,RM-1132,3/20/2015,0,0,846,0,0,0,846
13454,RM-1132,4/12/2015,0,0,846,0,0,0,846
13458,RM-1132,4/16/2015,0,0,846,0,0,0,846
13466,RM-1132,4/24/2015,0,0,846,0,0,0,846
16549,RM-1145,3/3/2015,0,0,846,0,0,0,846
16551,RM-1145,3/5/2015,0,0,846,0,0,0,846
16556,RM-1145,3/10/2015,0,0,846,0,0,0,846
16557,RM-1145,3/11/2015,0,0,846,0,0,0,846
16558,RM-1145,3/12/2015,0,0,846,0,0,0,846
21969,RM-1200C,3/3/2015,846,0,0,0,0,0,846
21971,RM-1200C,3/5/2015,846,0,0,0,0,0,846
21976,RM-1200C,3/10/2015,846,0,0,0,0,0,846
21977,RM-1200C,3/11/2015,846,0,0,0,0,0,846
21978,RM-1200C,3/12/2015,846,0,0,0,0,0,846
21986,RM-1200C,3/20/2015,846,0,0,0,0,0,846
22009,RM-1200C,4/12/2015,846,0,0,0,0,0,846
22013,RM-1200C,4/16/2015,846,0,0,0,0,0,846
22021,RM-1200C,4/24/2015,846,0,0,0,0,0,846
24440,RM-1208B,7/26/2014,423,0,423,0,0,0,846
24658,RM-1208B,3/3/2015,846,0,0,0,0,0,846
24660,RM-1208B,3/5/2015,846,0,0,0,0,0,846
24665,RM-1208B,3/10/2015,846,0,0,0,0,0,846
24666,RM-1208B,3/11/2015,846,0,0,0,0,0,846
24667,RM-1208B,3/12/2015,846,0,0,0,0,0,846
24675,RM-1208B,3/20/2015,846,0,0,0,0,0,846
24698,RM-1208B,4/12/2015,846,0,0,0,0,0,846
24702,RM-1208B,4/16/2015,846,0,0,0,0,0,846
24735,RM-1208B,5/19/2015,846,0,0,0,0,0,846
24736,RM-1208B,5/20/2015,846,0,0,0,0,0,846
28071,RM-1218,3/3/2015,846,0,0,0,0,0,846
28073,RM-1218,3/5/2015,846,0,0,0,0,0,846
28078,RM-1218,3/10/2015,846,0,0,0,0,0,846
28079,RM-1218,3/11/2015,846,0,0,0,0,0,846
28080,RM-1218,3/12/2015,846,0,0,0,0,0,846
28088,RM-1218,3/20/2015,846,0,0,0,0,0,846
28111,RM-1218,4/12/2015,846,0,0,0,0,0,846
28115,RM-1218,4/16/2015,846,0,0,0,0,0,846
28123,RM-1218,4/24/2015,846,0,0,0,0,0,846
28148,RM-1218,5/19/2015,846,0,0,0,0,0,846
28149,RM-1218,5/20/2015,846,0,0,0,0,0,846
29444,RM-1223,3/3/2015,0,0,846,0,0,0,846
29446,RM-1223,3/5/2015,0,0,846,0,0,0,846
29451,RM-1223,3/10/2015,0,0,846,0,0,0,846
29452,RM-1223,3/11/2015,0,0,846,0,0,0,846
29453,RM-1223,3/12/2015,0,0,846,0,0,0,846
29461,RM-1223,3/20/2015,0,0,846,0,0,0,846
29484,RM-1223,4/12/2015,0,0,846,0,0,0,846
29488,RM-1223,4/16/2015,0,0,846,0,0,0,846
29521,RM-1223,5/19/2015,0,0,846,0,0,0,846
29522,RM-1223,5/20/2015,0,0,846,0,0,0,846
30129,RM-1224,3/3/2015,846,0,0,0,0,0,846
30131,RM-1224,3/5/2015,846,0,0,0,0,0,846
30136,RM-1224,3/10/2015,846,0,0,0,0,0,846
30137,RM-1224,3/11/2015,846,0,0,0,0,0,846
30138,RM-1224,3/12/2015,846,0,0,0,0,0,846
30146,RM-1224,3/20/2015,846,0,0,0,0,0,846
30169,RM-1224,4/12/2015,846,0,0,0,0,0,846
30173,RM-1224,4/16/2015,846,0,0,0,0,0,846
30181,RM-1224,4/24/2015,846,0,0,0,0,0,846
30206,RM-1224,5/19/2015,846,0,0,0,0,0,846
30207,RM-1224,5/20/2015,846,0,0,0,0,0,846
30817,RM-1229,3/3/2015,0,0,846,0,0,0,846
30819,RM-1229,3/5/2015,0,0,846,0,0,0,846
30824,RM-1229,3/10/2015,0,0,846,0,0,0,846
30825,RM-1229,3/11/2015,0,0,846,0,0,0,846
30826,RM-1229,3/12/2015,0,0,846,0,0,0,846
30834,RM-1229,3/20/2015,0,0,846,0,0,0,846
30857,RM-1229,4/12/2015,0,0,846,0,0,0,846
30861,RM-1229,4/16/2015,0,0,846,0,0,0,846
30869,RM-1229,4/24/2015,0,0,846,0,0,0,846
32233,RM-1231,5/19/2015,0,0,846,0,0,0,846
32234,RM-1231,5/20/2015,0,0,846,0,0,0,846
32844,RM-1236,3/3/2015,846,0,0,0,0,0,846
32846,RM-1236,3/5/2015,846,0,0,0,0,0,846
32851,RM-1236,3/10/2015,846,0,0,0,0,0,846
32852,RM-1236,3/11/2015,846,0,0,0,0,0,846
32853,RM-1236,3/12/2015,846,0,0,0,0,0,846
32861,RM-1236,3/20/2015,846,0,0,0,0,0,846
32884,RM-1236,4/12/2015,846,0,0,0,0,0,846
32888,RM-1236,4/16/2015,846,0,0,0,0,0,846
32896,RM-1236,4/24/2015,846,0,0,0,0,0,846
34105,RM-B102C,3/3/2015,846,0,0,0,0,0,846
34107,RM-B102C,3/5/2015,846,0,0,0,0,0,846
34112,RM-B102C,3/10/2015,846,0,0,0,0,0,846
34113,RM-B102C,3/11/2015,846,0,0,0,0,0,846
34114,RM-B102C,3/12/2015,846,0,0,0,0,0,846
34122,RM-B102C,3/20/2015,846,0,0,0,0,0,846
34145,RM-B102C,4/12/2015,846,0,0,0,0,0,846
34149,RM-B102C,4/16/2015,846,0,0,0,0,0,846
34182,RM-B102C,5/19/2015,846,0,0,0,0,0,846
34183,RM-B102C,5/20/2015,846,0,0,0,0,0,846
34827,RM-B103,4/12/2015,0,0,846,0,0,0,846
34831,RM-B103,4/16/2015,0,0,846,0,0,0,846
34839,RM-B103,4/24/2015,0,0,846,0,0,0,846
36416,RM-B200B,5/13/2014,0,846,0,0,0,0,846
36704,RM-B200B,3/3/2015,0,0,846,0,0,0,846
36706,RM-B200B,3/5/2015,0,0,846,0,0,0,846
36711,RM-B200B,3/10/2015,0,0,846,0,0,0,846
36712,RM-B200B,3/11/2015,0,0,846,0,0,0,846
36713,RM-B200B,3/12/2015,0,0,846,0,0,0,846
36721,RM-B200B,3/20/2015,0,0,846,0,0,0,846
36744,RM-B200B,4/12/2015,0,0,846,0,0,0,846
36748,RM-B200B,4/16/2015,0,0,846,0,0,0,846
37391,RM-B200C,3/5/2015,846,0,0,0,0,0,846
37396,RM-B200C,3/10/2015,846,0,0,0,0,0,846
37397,RM-B200C,3/11/2015,846,0,0,0,0,0,846
37398,RM-B200C,3/12/2015,846,0,0,0,0,0,846
37406,RM-B200C,3/20/2015,846,0,0,0,0,0,846
37429,RM-B200C,4/12/2015,846,0,0,0,0,0,846
37433,RM-B200C,4/16/2015,846,0,0,0,0,0,846
37441,RM-B200C,4/24/2015,846,0,0,0,0,0,846
38767,RM-B215,3/5/2015,846,0,0,0,0,0,846
38772,RM-B215,3/10/2015,846,0,0,0,0,0,846
38773,RM-B215,3/11/2015,846,0,0,0,0,0,846
38774,RM-B215,3/12/2015,846,0,0,0,0,0,846
43452,RM-B240,3/5/2015,0,0,846,0,0,0,846
43457,RM-B240,3/10/2015,0,0,846,0,0,0,846
43458,RM-B240,3/11/2015,0,0,846,0,0,0,846
43459,RM-B240,3/12/2015,0,0,846,0,0,0,846
43467,RM-B240,3/20/2015,0,0,846,0,0,0,846
43490,RM-B240,4/12/2015,0,0,846,0,0,0,846
43494,RM-B240,4/16/2015,0,0,846,0,0,0,846
43502,RM-B240,4/24/2015,0,0,846,0,0,0,846
44060,RM-B240A,3/3/2015,0,0,846,0,0,0,846
44062,RM-B240A,3/5/2015,0,0,846,0,0,0,846
44067,RM-B240A,3/10/2015,0,0,846,0,0,0,846
44068,RM-B240A,3/11/2015,0,0,846,0,0,0,846
44069,RM-B240A,3/12/2015,0,0,846,0,0,0,846
44077,RM-B240A,3/20/2015,0,0,846,0,0,0,846
44100,RM-B240A,4/12/2015,0,0,846,0,0,0,846
44104,RM-B240A,4/16/2015,0,0,846,0,0,0,846
44112,RM-B240A,4/24/2015,0,0,846,0,0,0,846
45429,RM-B250A,3/3/2015,846,0,0,0,0,0,846
45431,RM-B250A,3/5/2015,846,0,0,0,0,0,846
45436,RM-B250A,3/10/2015,846,0,0,0,0,0,846
45437,RM-B250A,3/11/2015,846,0,0,0,0,0,846
45438,RM-B250A,3/12/2015,846,0,0,0,0,0,846
45446,RM-B250A,3/20/2015,846,0,0,0,0,0,846
45469,RM-B250A,4/12/2015,846,0,0,0,0,0,846
45473,RM-B250A,4/16/2015,846,0,0,0,0,0,846
45481,RM-B250A,4/24/2015,846,0,0,0,0,0,846
46116,RM-B260,3/5/2015,0,0,846,0,0,0,846
46121,RM-B260,3/10/2015,0,0,846,0,0,0,846
46122,RM-B260,3/11/2015,0,0,846,0,0,0,846
46123,RM-B260,3/12/2015,0,0,846,0,0,0,846
46131,RM-B260,3/20/2015,0,0,846,0,0,0,846
46154,RM-B260,4/12/2015,0,0,846,0,0,0,846
46158,RM-B260,4/16/2015,0,0,846,0,0,0,846
46166,RM-B260,4/24/2015,0,0,846,0,0,0,846
48152,RM-B275,3/3/2015,846,0,0,0,0,0,846
48154,RM-B275,3/5/2015,846,0,0,0,0,0,846
48159,RM-B275,3/10/2015,846,0,0,0,0,0,846
48160,RM-B275,3/11/2015,846,0,0,0,0,0,846
48161,RM-B275,3/12/2015,846,0,0,0,0,0,846
48169,RM-B275,3/20/2015,846,0,0,0,0,0,846
48192,RM-B275,4/12/2015,846,0,0,0,0,0,846
48196,RM-B275,4/16/2015,846,0,0,0,0,0,846
48204,RM-B275,4/24/2015,846,0,0,0,0,0,846
286,RM-1100A,4/23/2014,843,0,0,0,0,0,843
1656,RM-1102,4/23/2014,843,0,0,0,0,0,843
1978,RM-1102,3/13/2015,843,0,0,0,0,0,843
1987,RM-1102,3/22/2015,843,0,0,0,0,0,843
2006,RM-1102,4/10/2015,843,0,0,0,0,0,843
2010,RM-1102,4/14/2015,843,0,0,0,0,0,843
2044,RM-1102,5/18/2015,843,0,0,0,0,0,843
4673,RM-1108,3/13/2015,0,0,843,0,0,0,843
4682,RM-1108,3/22/2015,0,0,843,0,0,0,843
4701,RM-1108,4/10/2015,0,0,843,0,0,0,843
4705,RM-1108,4/14/2015,0,0,843,0,0,0,843
4714,RM-1108,4/23/2015,0,0,843,0,0,0,843
4739,RM-1108,5/18/2015,0,0,843,0,0,0,843
4741,RM-1108,5/20/2015,0,0,843,0,0,0,843
5724,RM-1110,4/23/2014,0,0,843,0,0,0,843
6408,RM-1113,4/23/2014,0,0,843,0,0,0,843
7067,RM-1115,4/23/2014,843,0,0,0,0,0,843
7754,RM-1116,4/23/2014,843,0,0,0,0,0,843
8104,RM-1116,4/10/2015,0,0,843,0,0,0,843
8108,RM-1116,4/14/2015,0,0,843,0,0,0,843
8117,RM-1116,4/23/2015,0,0,843,0,0,0,843
8142,RM-1116,5/18/2015,0,0,843,0,0,0,843
8144,RM-1116,5/20/2015,0,0,843,0,0,0,843
9477,RM-1122,4/10/2015,0,0,843,0,0,0,843
9481,RM-1122,4/14/2015,0,0,843,0,0,0,843
9490,RM-1122,4/23/2015,0,0,843,0,0,0,843
9515,RM-1122,5/18/2015,0,0,843,0,0,0,843
9517,RM-1122,5/20/2015,0,0,843,0,0,0,843
10134,RM-1123,3/13/2015,843,0,0,0,0,0,843
13424,RM-1132,3/13/2015,0,0,843,0,0,0,843
13433,RM-1132,3/22/2015,0,0,843,0,0,0,843
13452,RM-1132,4/10/2015,0,0,843,0,0,0,843
13456,RM-1132,4/14/2015,0,0,843,0,0,0,843
13465,RM-1132,4/23/2015,0,0,843,0,0,0,843
13490,RM-1132,5/18/2015,0,0,843,0,0,0,843
13492,RM-1132,5/20/2015,0,0,843,0,0,0,843
14310,RM-1134,4/23/2014,843,0,0,0,0,0,843
15579,RM-1144,4/23/2014,0,0,843,0,0,0,843
16559,RM-1145,3/13/2015,0,0,843,0,0,0,843
18979,RM-1155,4/23/2014,843,0,0,0,0,0,843
20697,RM-1200A,5/18/2015,843,0,0,0,0,0,843
20699,RM-1200A,5/20/2015,843,0,0,0,0,0,843
21979,RM-1200C,3/13/2015,843,0,0,0,0,0,843
21988,RM-1200C,3/22/2015,843,0,0,0,0,0,843
22007,RM-1200C,4/10/2015,843,0,0,0,0,0,843
22011,RM-1200C,4/14/2015,843,0,0,0,0,0,843
22020,RM-1200C,4/23/2015,843,0,0,0,0,0,843
22045,RM-1200C,5/18/2015,843,0,0,0,0,0,843
22047,RM-1200C,5/20/2015,843,0,0,0,0,0,843
22973,RM-1207,4/23/2014,843,0,0,0,0,0,843
24668,RM-1208B,3/13/2015,843,0,0,0,0,0,843
24677,RM-1208B,3/22/2015,843,0,0,0,0,0,843
24696,RM-1208B,4/10/2015,843,0,0,0,0,0,843
24700,RM-1208B,4/14/2015,843,0,0,0,0,0,843
24734,RM-1208B,5/18/2015,843,0,0,0,0,0,843
25031,RM-1212,4/23/2014,843,0,0,0,0,0,843
26386,RM-1213A,4/23/2014,0,0,843,0,0,0,843
28081,RM-1218,3/13/2015,843,0,0,0,0,0,843
28090,RM-1218,3/22/2015,843,0,0,0,0,0,843
28109,RM-1218,4/10/2015,843,0,0,0,0,0,843
28113,RM-1218,4/14/2015,843,0,0,0,0,0,843
28122,RM-1218,4/23/2015,843,0,0,0,0,0,843
28147,RM-1218,5/18/2015,843,0,0,0,0,0,843
29454,RM-1223,3/13/2015,0,0,843,0,0,0,843
29463,RM-1223,3/22/2015,0,0,843,0,0,0,843
29482,RM-1223,4/10/2015,0,0,843,0,0,0,843
29486,RM-1223,4/14/2015,0,0,843,0,0,0,843
29520,RM-1223,5/18/2015,0,0,843,0,0,0,843
30139,RM-1224,3/13/2015,843,0,0,0,0,0,843
30148,RM-1224,3/22/2015,843,0,0,0,0,0,843
30167,RM-1224,4/10/2015,843,0,0,0,0,0,843
30171,RM-1224,4/14/2015,843,0,0,0,0,0,843
30180,RM-1224,4/23/2015,843,0,0,0,0,0,843
30205,RM-1224,5/18/2015,843,0,0,0,0,0,843
30827,RM-1229,3/13/2015,0,0,843,0,0,0,843
30836,RM-1229,3/22/2015,0,0,843,0,0,0,843
30855,RM-1229,4/10/2015,0,0,843,0,0,0,843
30859,RM-1229,4/14/2015,0,0,843,0,0,0,843
30868,RM-1229,4/23/2015,0,0,843,0,0,0,843
32232,RM-1231,5/18/2015,0,0,843,0,0,0,843
32854,RM-1236,3/13/2015,843,0,0,0,0,0,843
32863,RM-1236,3/22/2015,843,0,0,0,0,0,843
32882,RM-1236,4/10/2015,843,0,0,0,0,0,843
32886,RM-1236,4/14/2015,843,0,0,0,0,0,843
32895,RM-1236,4/23/2015,843,0,0,0,0,0,843
34115,RM-B102C,3/13/2015,843,0,0,0,0,0,843
34124,RM-B102C,3/22/2015,843,0,0,0,0,0,843
34143,RM-B102C,4/10/2015,843,0,0,0,0,0,843
34147,RM-B102C,4/14/2015,843,0,0,0,0,0,843
34181,RM-B102C,5/18/2015,843,0,0,0,0,0,843
34829,RM-B103,4/14/2015,0,0,843,0,0,0,843
34838,RM-B103,4/23/2015,0,0,843,0,0,0,843
34863,RM-B103,5/18/2015,0,0,843,0,0,0,843
34865,RM-B103,5/20/2015,0,0,843,0,0,0,843
36714,RM-B200B,3/13/2015,0,0,843,0,0,0,843
36723,RM-B200B,3/22/2015,0,0,843,0,0,0,843
36742,RM-B200B,4/10/2015,0,0,843,0,0,0,843
36746,RM-B200B,4/14/2015,0,0,843,0,0,0,843
37389,RM-B200C,3/3/2015,843,0,0,0,0,0,843
37399,RM-B200C,3/13/2015,843,0,0,0,0,0,843
37408,RM-B200C,3/22/2015,843,0,0,0,0,0,843
37427,RM-B200C,4/10/2015,843,0,0,0,0,0,843
37431,RM-B200C,4/14/2015,843,0,0,0,0,0,843
37440,RM-B200C,4/23/2015,843,0,0,0,0,0,843
37465,RM-B200C,5/18/2015,843,0,0,0,0,0,843
37467,RM-B200C,5/20/2015,843,0,0,0,0,0,843
38453,RM-B215,4/23/2014,0,0,843,0,0,0,843
38765,RM-B215,3/3/2015,843,0,0,0,0,0,843
38775,RM-B215,3/13/2015,843,0,0,0,0,0,843
39138,RM-B220,4/23/2014,843,0,0,0,0,0,843
39826,RM-B222,4/23/2014,843,0,0,0,0,0,843
43138,RM-B240,4/23/2014,0,0,843,0,0,0,843
43450,RM-B240,3/3/2015,0,0,843,0,0,0,843
43460,RM-B240,3/13/2015,0,0,843,0,0,0,843
43469,RM-B240,3/22/2015,0,0,843,0,0,0,843
43488,RM-B240,4/10/2015,0,0,843,0,0,0,843
43492,RM-B240,4/14/2015,0,0,843,0,0,0,843
43501,RM-B240,4/23/2015,0,0,843,0,0,0,843
43526,RM-B240,5/18/2015,0,0,843,0,0,0,843
43528,RM-B240,5/20/2015,0,0,843,0,0,0,843
44070,RM-B240A,3/13/2015,0,0,843,0,0,0,843
44079,RM-B240A,3/22/2015,0,0,843,0,0,0,843
44098,RM-B240A,4/10/2015,0,0,843,0,0,0,843
44102,RM-B240A,4/14/2015,0,0,843,0,0,0,843
44111,RM-B240A,4/23/2015,0,0,843,0,0,0,843
44136,RM-B240A,5/18/2015,0,0,843,0,0,0,843
44138,RM-B240A,5/20/2015,0,0,843,0,0,0,843
45118,RM-B250A,4/23/2014,843,0,0,0,0,0,843
45439,RM-B250A,3/13/2015,843,0,0,0,0,0,843
45448,RM-B250A,3/22/2015,843,0,0,0,0,0,843
45467,RM-B250A,4/10/2015,843,0,0,0,0,0,843
45471,RM-B250A,4/14/2015,843,0,0,0,0,0,843
45480,RM-B250A,4/23/2015,843,0,0,0,0,0,843
45505,RM-B250A,5/18/2015,843,0,0,0,0,0,843
45507,RM-B250A,5/20/2015,843,0,0,0,0,0,843
46114,RM-B260,3/3/2015,0,0,843,0,0,0,843
46124,RM-B260,3/13/2015,0,0,843,0,0,0,843
46133,RM-B260,3/22/2015,0,0,843,0,0,0,843
46152,RM-B260,4/10/2015,0,0,843,0,0,0,843
46156,RM-B260,4/14/2015,0,0,843,0,0,0,843
46165,RM-B260,4/23/2015,0,0,843,0,0,0,843
46190,RM-B260,5/18/2015,0,0,843,0,0,0,843
46192,RM-B260,5/20/2015,0,0,843,0,0,0,843
48162,RM-B275,3/13/2015,843,0,0,0,0,0,843
48171,RM-B275,3/22/2015,843,0,0,0,0,0,843
48190,RM-B275,4/10/2015,843,0,0,0,0,0,843
48194,RM-B275,4/14/2015,843,0,0,0,0,0,843
48203,RM-B275,4/23/2015,843,0,0,0,0,0,843
48228,RM-B275,5/18/2015,843,0,0,0,0,0,843
48230,RM-B275,5/20/2015,843,0,0,0,0,0,843
1940,RM-1102,2/3/2015,840,0,0,0,0,0,840
1983,RM-1102,3/18/2015,840,0,0,0,0,0,840
1986,RM-1102,3/21/2015,840,0,0,0,0,0,840
1993,RM-1102,3/28/2015,840,0,0,0,0,0,840
2011,RM-1102,4/15/2015,840,0,0,0,0,0,840
2019,RM-1102,4/23/2015,840,0,0,0,0,0,840
2057,RM-1102,5/31/2015,840,0,0,0,0,0,840
4635,RM-1108,2/3/2015,0,0,840,0,0,0,840
4678,RM-1108,3/18/2015,0,0,840,0,0,0,840
4681,RM-1108,3/21/2015,0,0,840,0,0,0,840
4688,RM-1108,3/28/2015,0,0,840,0,0,0,840
4706,RM-1108,4/15/2015,0,0,840,0,0,0,840
4752,RM-1108,5/31/2015,0,0,840,0,0,0,840
6360,RM-1113,3/6/2014,0,0,840,0,0,0,840
8109,RM-1116,4/15/2015,0,0,840,0,0,0,840
8155,RM-1116,5/31/2015,0,0,840,0,0,0,840
8463,RM-1117,5/14/2014,0,840,0,0,0,0,840
9482,RM-1122,4/15/2015,0,0,840,0,0,0,840
9528,RM-1122,5/31/2015,0,0,840,0,0,0,840
10096,RM-1123,2/3/2015,840,0,0,0,0,0,840
12698,RM-1130,2/3/2015,0,0,840,0,0,0,840
13386,RM-1132,2/3/2015,0,0,840,0,0,0,840
13429,RM-1132,3/18/2015,0,0,840,0,0,0,840
13432,RM-1132,3/21/2015,0,0,840,0,0,0,840
13439,RM-1132,3/28/2015,0,0,840,0,0,0,840
13457,RM-1132,4/15/2015,0,0,840,0,0,0,840
13503,RM-1132,5/31/2015,0,0,840,0,0,0,840
15531,RM-1144,3/6/2014,0,0,840,0,0,0,840
16521,RM-1145,2/3/2015,0,0,840,0,0,0,840
19263,RM-1155,2/3/2015,840,0,0,0,0,0,840
19939,RM-1156,2/3/2015,0,0,840,0,0,0,840
20710,RM-1200A,5/31/2015,840,0,0,0,0,0,840
21984,RM-1200C,3/18/2015,840,0,0,0,0,0,840
21987,RM-1200C,3/21/2015,840,0,0,0,0,0,840
21994,RM-1200C,3/28/2015,840,0,0,0,0,0,840
22012,RM-1200C,4/15/2015,840,0,0,0,0,0,840
22058,RM-1200C,5/31/2015,840,0,0,0,0,0,840
24630,RM-1208B,2/3/2015,840,0,0,0,0,0,840
24673,RM-1208B,3/18/2015,840,0,0,0,0,0,840
24676,RM-1208B,3/21/2015,840,0,0,0,0,0,840
24683,RM-1208B,3/28/2015,840,0,0,0,0,0,840
24701,RM-1208B,4/15/2015,840,0,0,0,0,0,840
24709,RM-1208B,4/23/2015,840,0,0,0,0,0,840
24747,RM-1208B,5/31/2015,840,0,0,0,0,0,840
26338,RM-1213A,3/6/2014,0,0,840,0,0,0,840
28043,RM-1218,2/3/2015,840,0,0,0,0,0,840
28086,RM-1218,3/18/2015,840,0,0,0,0,0,840
28089,RM-1218,3/21/2015,840,0,0,0,0,0,840
28096,RM-1218,3/28/2015,840,0,0,0,0,0,840
28114,RM-1218,4/15/2015,840,0,0,0,0,0,840
28160,RM-1218,5/31/2015,840,0,0,0,0,0,840
29459,RM-1223,3/18/2015,0,0,840,0,0,0,840
29462,RM-1223,3/21/2015,0,0,840,0,0,0,840
29469,RM-1223,3/28/2015,0,0,840,0,0,0,840
29487,RM-1223,4/15/2015,0,0,840,0,0,0,840
29495,RM-1223,4/23/2015,0,0,840,0,0,0,840
29533,RM-1223,5/31/2015,0,0,840,0,0,0,840
30101,RM-1224,2/3/2015,840,0,0,0,0,0,840
30144,RM-1224,3/18/2015,840,0,0,0,0,0,840
30147,RM-1224,3/21/2015,840,0,0,0,0,0,840
30154,RM-1224,3/28/2015,840,0,0,0,0,0,840
30172,RM-1224,4/15/2015,840,0,0,0,0,0,840
30218,RM-1224,5/31/2015,840,0,0,0,0,0,840
30789,RM-1229,2/3/2015,0,0,840,0,0,0,840
30832,RM-1229,3/18/2015,0,0,840,0,0,0,840
30835,RM-1229,3/21/2015,0,0,840,0,0,0,840
30842,RM-1229,3/28/2015,0,0,840,0,0,0,840
30860,RM-1229,4/15/2015,0,0,840,0,0,0,840
32245,RM-1231,5/31/2015,0,0,840,0,0,0,840
32484,RM-1236,3/6/2014,0,0,840,0,0,0,840
32816,RM-1236,2/3/2015,840,0,0,0,0,0,840
32859,RM-1236,3/18/2015,840,0,0,0,0,0,840
32862,RM-1236,3/21/2015,840,0,0,0,0,0,840
32869,RM-1236,3/28/2015,840,0,0,0,0,0,840
32887,RM-1236,4/15/2015,840,0,0,0,0,0,840
34077,RM-B102C,2/3/2015,840,0,0,0,0,0,840
34123,RM-B102C,3/21/2015,840,0,0,0,0,0,840
34130,RM-B102C,3/28/2015,840,0,0,0,0,0,840
34142,RM-B102C,4/9/2015,840,0,0,0,0,0,840
34148,RM-B102C,4/15/2015,840,0,0,0,0,0,840
34156,RM-B102C,4/23/2015,840,0,0,0,0,0,840
34194,RM-B102C,5/31/2015,840,0,0,0,0,0,840
34830,RM-B103,4/15/2015,0,0,840,0,0,0,840
34832,RM-B103,4/17/2015,0,0,840,0,0,0,840
34876,RM-B103,5/31/2015,0,0,840,0,0,0,840
35661,RM-B109,3/6/2014,0,0,840,0,0,0,840
36110,RM-B109,5/31/2015,0,0,840,0,0,0,840
36676,RM-B200B,2/3/2015,0,0,840,0,0,0,840
36719,RM-B200B,3/18/2015,0,0,840,0,0,0,840
36722,RM-B200B,3/21/2015,0,0,840,0,0,0,840
36729,RM-B200B,3/28/2015,0,0,840,0,0,0,840
36747,RM-B200B,4/15/2015,0,0,840,0,0,0,840
37361,RM-B200C,2/3/2015,840,0,0,0,0,0,840
37370,RM-B200C,2/12/2015,840,0,0,0,0,0,840
37404,RM-B200C,3/18/2015,840,0,0,0,0,0,840
37407,RM-B200C,3/21/2015,840,0,0,0,0,0,840
37414,RM-B200C,3/28/2015,840,0,0,0,0,0,840
37432,RM-B200C,4/15/2015,840,0,0,0,0,0,840
37434,RM-B200C,4/17/2015,840,0,0,0,0,0,840
37478,RM-B200C,5/31/2015,840,0,0,0,0,0,840
38405,RM-B215,3/6/2014,0,0,840,0,0,0,840
38737,RM-B215,2/3/2015,840,0,0,0,0,0,840
38780,RM-B215,3/18/2015,840,0,0,0,0,0,840
43090,RM-B240,3/6/2014,0,0,840,0,0,0,840
43422,RM-B240,2/3/2015,0,0,840,0,0,0,840
43431,RM-B240,2/12/2015,0,0,840,0,0,0,840
43465,RM-B240,3/18/2015,0,0,840,0,0,0,840
43468,RM-B240,3/21/2015,0,0,840,0,0,0,840
43475,RM-B240,3/28/2015,0,0,840,0,0,0,840
43493,RM-B240,4/15/2015,0,0,840,0,0,0,840
43495,RM-B240,4/17/2015,0,0,840,0,0,0,840
43539,RM-B240,5/31/2015,0,0,840,0,0,0,840
44032,RM-B240A,2/3/2015,0,0,840,0,0,0,840
44075,RM-B240A,3/18/2015,0,0,840,0,0,0,840
44078,RM-B240A,3/21/2015,0,0,840,0,0,0,840
44085,RM-B240A,3/28/2015,0,0,840,0,0,0,840
44103,RM-B240A,4/15/2015,0,0,840,0,0,0,840
44149,RM-B240A,5/31/2015,0,0,840,0,0,0,840
44385,RM-B250,3/6/2014,0,0,840,0,0,0,840
45401,RM-B250A,2/3/2015,840,0,0,0,0,0,840
45444,RM-B250A,3/18/2015,840,0,0,0,0,0,840
45447,RM-B250A,3/21/2015,840,0,0,0,0,0,840
45454,RM-B250A,3/28/2015,840,0,0,0,0,0,840
45472,RM-B250A,4/15/2015,840,0,0,0,0,0,840
45518,RM-B250A,5/31/2015,840,0,0,0,0,0,840
46086,RM-B260,2/3/2015,0,0,840,0,0,0,840
46095,RM-B260,2/12/2015,0,0,840,0,0,0,840
46129,RM-B260,3/18/2015,0,0,840,0,0,0,840
46132,RM-B260,3/21/2015,0,0,840,0,0,0,840
46139,RM-B260,3/28/2015,0,0,840,0,0,0,840
46157,RM-B260,4/15/2015,0,0,840,0,0,0,840
46159,RM-B260,4/17/2015,0,0,840,0,0,0,840
46203,RM-B260,5/31/2015,0,0,840,0,0,0,840
48124,RM-B275,2/3/2015,840,0,0,0,0,0,840
48167,RM-B275,3/18/2015,840,0,0,0,0,0,840
48170,RM-B275,3/21/2015,840,0,0,0,0,0,840
48177,RM-B275,3/28/2015,840,0,0,0,0,0,840
48195,RM-B275,4/15/2015,840,0,0,0,0,0,840
48241,RM-B275,5/31/2015,840,0,0,0,0,0,840
306,RM-1100A,5/13/2014,837,0,0,0,0,0,837
1676,RM-1102,5/13/2014,837,0,0,0,0,0,837
1949,RM-1102,2/12/2015,837,0,0,0,0,0,837
1979,RM-1102,3/14/2015,837,0,0,0,0,0,837
1982,RM-1102,3/17/2015,837,0,0,0,0,0,837
1989,RM-1102,3/24/2015,837,0,0,0,0,0,837
1992,RM-1102,3/27/2015,837,0,0,0,0,0,837
2005,RM-1102,4/9/2015,837,0,0,0,0,0,837
2013,RM-1102,4/17/2015,837,0,0,0,0,0,837
2015,RM-1102,4/19/2015,837,0,0,0,0,0,837
2836,RM-1106,11/28/2013,0,0,0,0,0,837,837
4644,RM-1108,2/12/2015,0,0,837,0,0,0,837
4674,RM-1108,3/14/2015,0,0,837,0,0,0,837
4677,RM-1108,3/17/2015,0,0,837,0,0,0,837
4684,RM-1108,3/24/2015,0,0,837,0,0,0,837
4687,RM-1108,3/27/2015,0,0,837,0,0,0,837
4700,RM-1108,4/9/2015,0,0,837,0,0,0,837
4708,RM-1108,4/17/2015,0,0,837,0,0,0,837
4710,RM-1108,4/19/2015,0,0,837,0,0,0,837
4893,RM-1109,11/28/2013,0,0,0,0,0,837,837
4955,RM-1109,1/29/2014,0,0,0,0,0,837,837
4991,RM-1109,3/6/2014,0,0,0,0,0,837,837
5743,RM-1110,5/13/2014,0,0,837,0,0,0,837
6324,RM-1113,1/29/2014,0,0,837,0,0,0,837
6428,RM-1113,5/13/2014,0,0,837,0,0,0,837
6451,RM-1113,6/5/2014,0,0,837,0,0,0,837
6701,RM-1113,2/12/2015,837,0,0,0,0,0,837
6983,RM-1115,1/29/2014,0,0,0,0,0,837,837
7087,RM-1115,5/13/2014,837,0,0,0,0,0,837
7670,RM-1116,1/29/2014,837,0,0,0,0,0,837
7706,RM-1116,3/6/2014,837,0,0,0,0,0,837
7774,RM-1116,5/13/2014,837,0,0,0,0,0,837
8103,RM-1116,4/9/2015,0,0,837,0,0,0,837
8111,RM-1116,4/17/2015,0,0,837,0,0,0,837
8113,RM-1116,4/19/2015,0,0,837,0,0,0,837
8981,RM-1122,11/28/2013,0,0,0,0,0,837,837
9043,RM-1122,1/29/2014,0,0,0,0,0,837,837
9079,RM-1122,3/6/2014,0,0,0,0,0,837,837
9476,RM-1122,4/9/2015,0,0,837,0,0,0,837
9484,RM-1122,4/17/2015,0,0,837,0,0,0,837
9486,RM-1122,4/19/2015,0,0,837,0,0,0,837
10105,RM-1123,2/12/2015,837,0,0,0,0,0,837
10135,RM-1123,3/14/2015,837,0,0,0,0,0,837
10351,RM-1124,11/28/2013,0,0,0,0,0,837,837
10413,RM-1124,1/29/2014,0,0,0,0,0,837,837
12269,RM-1130,11/28/2013,0,0,0,0,0,837,837
12707,RM-1130,2/12/2015,0,0,837,0,0,0,837
13395,RM-1132,2/12/2015,0,0,837,0,0,0,837
13425,RM-1132,3/14/2015,0,0,837,0,0,0,837
13428,RM-1132,3/17/2015,0,0,837,0,0,0,837
13435,RM-1132,3/24/2015,0,0,837,0,0,0,837
13438,RM-1132,3/27/2015,0,0,837,0,0,0,837
13451,RM-1132,4/9/2015,0,0,837,0,0,0,837
13459,RM-1132,4/17/2015,0,0,837,0,0,0,837
13461,RM-1132,4/19/2015,0,0,837,0,0,0,837
14329,RM-1134,5/13/2014,837,0,0,0,0,0,837
15495,RM-1144,1/29/2014,0,0,837,0,0,0,837
15599,RM-1144,5/13/2014,0,0,837,0,0,0,837
15622,RM-1144,6/5/2014,0,0,837,0,0,0,837
16118,RM-1145,11/28/2013,0,0,0,0,0,837,837
16180,RM-1145,1/29/2014,0,0,0,0,0,837,837
16216,RM-1145,3/6/2014,0,0,0,0,0,837,837
16257,RM-1145,5/13/2014,0,0,837,0,0,0,837
16280,RM-1145,6/5/2014,0,0,837,0,0,0,837
16530,RM-1145,2/12/2015,0,0,837,0,0,0,837
16560,RM-1145,3/14/2015,0,0,837,0,0,0,837
18999,RM-1155,5/13/2014,837,0,0,0,0,0,837
19571,RM-1156,1/29/2014,837,0,0,0,0,0,837
21950,RM-1200C,2/12/2015,837,0,0,0,0,0,837
21980,RM-1200C,3/14/2015,837,0,0,0,0,0,837
21983,RM-1200C,3/17/2015,837,0,0,0,0,0,837
21990,RM-1200C,3/24/2015,837,0,0,0,0,0,837
21993,RM-1200C,3/27/2015,837,0,0,0,0,0,837
22006,RM-1200C,4/9/2015,837,0,0,0,0,0,837
22014,RM-1200C,4/17/2015,837,0,0,0,0,0,837
22016,RM-1200C,4/19/2015,837,0,0,0,0,0,837
22827,RM-1207,11/28/2013,0,0,0,0,0,837,837
22993,RM-1207,5/13/2014,837,0,0,0,0,0,837
24639,RM-1208B,2/12/2015,837,0,0,0,0,0,837
24669,RM-1208B,3/14/2015,837,0,0,0,0,0,837
24672,RM-1208B,3/17/2015,837,0,0,0,0,0,837
24679,RM-1208B,3/24/2015,837,0,0,0,0,0,837
24682,RM-1208B,3/27/2015,837,0,0,0,0,0,837
24695,RM-1208B,4/9/2015,837,0,0,0,0,0,837
24703,RM-1208B,4/17/2015,837,0,0,0,0,0,837
24705,RM-1208B,4/19/2015,837,0,0,0,0,0,837
25051,RM-1212,5/13/2014,837,0,0,0,0,0,837
25555,RM-1213,11/28/2013,0,0,0,0,0,837,837
25617,RM-1213,1/29/2014,0,0,0,0,0,837,837
25653,RM-1213,3/6/2014,0,0,0,0,0,837,837
26302,RM-1213A,1/29/2014,0,0,837,0,0,0,837
26406,RM-1213A,5/13/2014,0,0,837,0,0,0,837
26429,RM-1213A,6/5/2014,0,0,837,0,0,0,837
27023,RM-1217,3/6/2014,837,0,0,0,0,0,837
28052,RM-1218,2/12/2015,837,0,0,0,0,0,837
28082,RM-1218,3/14/2015,837,0,0,0,0,0,837
28085,RM-1218,3/17/2015,837,0,0,0,0,0,837
28092,RM-1218,3/24/2015,837,0,0,0,0,0,837
28095,RM-1218,3/27/2015,837,0,0,0,0,0,837
28108,RM-1218,4/9/2015,837,0,0,0,0,0,837
28116,RM-1218,4/17/2015,837,0,0,0,0,0,837
28118,RM-1218,4/19/2015,837,0,0,0,0,0,837
28399,RM-1221,3/6/2014,0,0,0,0,0,837,837
28490,RM-1221,6/5/2014,0,0,837,0,0,0,837
29152,RM-1223,5/13/2014,837,0,0,0,0,0,837
29455,RM-1223,3/14/2015,0,0,837,0,0,0,837
29458,RM-1223,3/17/2015,0,0,837,0,0,0,837
29465,RM-1223,3/24/2015,0,0,837,0,0,0,837
29468,RM-1223,3/27/2015,0,0,837,0,0,0,837
29481,RM-1223,4/9/2015,0,0,837,0,0,0,837
29489,RM-1223,4/17/2015,0,0,837,0,0,0,837
29491,RM-1223,4/19/2015,0,0,837,0,0,0,837
30110,RM-1224,2/12/2015,837,0,0,0,0,0,837
30140,RM-1224,3/14/2015,837,0,0,0,0,0,837
30143,RM-1224,3/17/2015,837,0,0,0,0,0,837
30150,RM-1224,3/24/2015,837,0,0,0,0,0,837
30153,RM-1224,3/27/2015,837,0,0,0,0,0,837
30166,RM-1224,4/9/2015,837,0,0,0,0,0,837
30174,RM-1224,4/17/2015,837,0,0,0,0,0,837
30176,RM-1224,4/19/2015,837,0,0,0,0,0,837
30798,RM-1229,2/12/2015,0,0,837,0,0,0,837
30828,RM-1229,3/14/2015,0,0,837,0,0,0,837
30831,RM-1229,3/17/2015,0,0,837,0,0,0,837
30838,RM-1229,3/24/2015,0,0,837,0,0,0,837
30841,RM-1229,3/27/2015,0,0,837,0,0,0,837
30854,RM-1229,4/9/2015,0,0,837,0,0,0,837
30862,RM-1229,4/17/2015,0,0,837,0,0,0,837
30864,RM-1229,4/19/2015,0,0,837,0,0,0,837
31696,RM-1231,11/28/2013,0,0,0,0,0,837,837
31758,RM-1231,1/29/2014,0,0,0,0,0,837,837
31794,RM-1231,3/6/2014,0,0,0,0,0,837,837
32448,RM-1236,1/29/2014,0,0,837,0,0,0,837
32825,RM-1236,2/12/2015,837,0,0,0,0,0,837
32855,RM-1236,3/14/2015,837,0,0,0,0,0,837
32858,RM-1236,3/17/2015,837,0,0,0,0,0,837
32865,RM-1236,3/24/2015,837,0,0,0,0,0,837
32868,RM-1236,3/27/2015,837,0,0,0,0,0,837
32881,RM-1236,4/9/2015,837,0,0,0,0,0,837
32889,RM-1236,4/17/2015,837,0,0,0,0,0,837
32891,RM-1236,4/19/2015,837,0,0,0,0,0,837
33654,RM-4xxx,2/3/2015,0,0,0,0,837,0,837
34086,RM-B102C,2/12/2015,837,0,0,0,0,0,837
34116,RM-B102C,3/14/2015,837,0,0,0,0,0,837
34119,RM-B102C,3/17/2015,837,0,0,0,0,0,837
34120,RM-B102C,3/18/2015,837,0,0,0,0,0,837
34126,RM-B102C,3/24/2015,837,0,0,0,0,0,837
34129,RM-B102C,3/27/2015,837,0,0,0,0,0,837
34150,RM-B102C,4/17/2015,837,0,0,0,0,0,837
34152,RM-B102C,4/19/2015,837,0,0,0,0,0,837
34834,RM-B103,4/19/2015,0,0,837,0,0,0,837
35014,RM-B103A,11/28/2013,0,0,0,0,0,837,837
36250,RM-B200B,11/28/2013,0,0,0,0,0,837,837
36685,RM-B200B,2/12/2015,0,0,837,0,0,0,837
36715,RM-B200B,3/14/2015,0,0,837,0,0,0,837
36718,RM-B200B,3/17/2015,0,0,837,0,0,0,837
36725,RM-B200B,3/24/2015,0,0,837,0,0,0,837
36728,RM-B200B,3/27/2015,0,0,837,0,0,0,837
36741,RM-B200B,4/9/2015,0,0,837,0,0,0,837
36749,RM-B200B,4/17/2015,0,0,837,0,0,0,837
36751,RM-B200B,4/19/2015,0,0,837,0,0,0,837
37400,RM-B200C,3/14/2015,837,0,0,0,0,0,837
37413,RM-B200C,3/27/2015,837,0,0,0,0,0,837
37426,RM-B200C,4/9/2015,837,0,0,0,0,0,837
37436,RM-B200C,4/19/2015,837,0,0,0,0,0,837
38369,RM-B215,1/29/2014,0,0,837,0,0,0,837
38473,RM-B215,5/13/2014,0,0,837,0,0,0,837
38746,RM-B215,2/12/2015,837,0,0,0,0,0,837
38776,RM-B215,3/14/2015,837,0,0,0,0,0,837
38779,RM-B215,3/17/2015,837,0,0,0,0,0,837
39054,RM-B220,1/29/2014,837,0,0,0,0,0,837
39090,RM-B220,3/6/2014,837,0,0,0,0,0,837
39158,RM-B220,5/13/2014,837,0,0,0,0,0,837
39846,RM-B222,5/13/2014,837,0,0,0,0,0,837
40368,RM-B224,11/28/2013,0,0,0,0,0,837,837
40430,RM-B224,1/29/2014,0,0,0,0,0,837,837
40466,RM-B224,3/6/2014,0,0,0,0,0,837,837
41056,RM-B225,11/28/2013,0,0,0,0,0,837,837
41118,RM-B225,1/29/2014,0,0,0,0,0,837,837
42426,RM-B230A,11/28/2013,0,0,0,0,0,837,837
42488,RM-B230A,1/29/2014,0,0,0,0,0,837,837
42524,RM-B230A,3/6/2014,0,0,0,0,0,837,837
43158,RM-B240,5/13/2014,0,0,837,0,0,0,837
43181,RM-B240,6/5/2014,0,0,837,0,0,0,837
43461,RM-B240,3/14/2015,0,0,837,0,0,0,837
43464,RM-B240,3/17/2015,0,0,837,0,0,0,837
43474,RM-B240,3/27/2015,0,0,837,0,0,0,837
43487,RM-B240,4/9/2015,0,0,837,0,0,0,837
43497,RM-B240,4/19/2015,0,0,837,0,0,0,837
44041,RM-B240A,2/12/2015,0,0,837,0,0,0,837
44071,RM-B240A,3/14/2015,0,0,837,0,0,0,837
44074,RM-B240A,3/17/2015,0,0,837,0,0,0,837
44084,RM-B240A,3/27/2015,0,0,837,0,0,0,837
44097,RM-B240A,4/9/2015,0,0,837,0,0,0,837
44105,RM-B240A,4/17/2015,0,0,837,0,0,0,837
44107,RM-B240A,4/19/2015,0,0,837,0,0,0,837
44349,RM-B250,1/29/2014,0,0,837,0,0,0,837
45070,RM-B250A,3/6/2014,837,0,0,0,0,0,837
45137,RM-B250A,5/13/2014,837,0,0,0,0,0,837
45410,RM-B250A,2/12/2015,837,0,0,0,0,0,837
45440,RM-B250A,3/14/2015,837,0,0,0,0,0,837
45443,RM-B250A,3/17/2015,837,0,0,0,0,0,837
45453,RM-B250A,3/27/2015,837,0,0,0,0,0,837
45466,RM-B250A,4/9/2015,837,0,0,0,0,0,837
45474,RM-B250A,4/17/2015,837,0,0,0,0,0,837
45476,RM-B250A,4/19/2015,837,0,0,0,0,0,837
46125,RM-B260,3/14/2015,0,0,837,0,0,0,837
46128,RM-B260,3/17/2015,0,0,837,0,0,0,837
46138,RM-B260,3/27/2015,0,0,837,0,0,0,837
46151,RM-B260,4/9/2015,0,0,837,0,0,0,837
46161,RM-B260,4/19/2015,0,0,837,0,0,0,837
47694,RM-B275,11/28/2013,0,0,0,0,0,837,837
47792,RM-B275,3/6/2014,0,0,0,0,0,837,837
48133,RM-B275,2/12/2015,837,0,0,0,0,0,837
48163,RM-B275,3/14/2015,837,0,0,0,0,0,837
48166,RM-B275,3/17/2015,837,0,0,0,0,0,837
48173,RM-B275,3/24/2015,837,0,0,0,0,0,837
48176,RM-B275,3/27/2015,837,0,0,0,0,0,837
48189,RM-B275,4/9/2015,837,0,0,0,0,0,837
48197,RM-B275,4/17/2015,837,0,0,0,0,0,837
48199,RM-B275,4/19/2015,837,0,0,0,0,0,837
1980,RM-1102,3/15/2015,834,0,0,0,0,0,834
1990,RM-1102,3/25/2015,834,0,0,0,0,0,834
1991,RM-1102,3/26/2015,834,0,0,0,0,0,834
1994,RM-1102,3/29/2015,834,0,0,0,0,0,834
2000,RM-1102,4/4/2015,834,0,0,0,0,0,834
2001,RM-1102,4/5/2015,834,0,0,0,0,0,834
2018,RM-1102,4/22/2015,834,0,0,0,0,0,834
4675,RM-1108,3/15/2015,0,0,834,0,0,0,834
4685,RM-1108,3/25/2015,0,0,834,0,0,0,834
4686,RM-1108,3/26/2015,0,0,834,0,0,0,834
4689,RM-1108,3/29/2015,0,0,834,0,0,0,834
4695,RM-1108,4/4/2015,0,0,834,0,0,0,834
4696,RM-1108,4/5/2015,0,0,834,0,0,0,834
4713,RM-1108,4/22/2015,0,0,834,0,0,0,834
5766,RM-1110,6/5/2014,0,0,834,0,0,0,834
8116,RM-1116,4/22/2015,0,0,834,0,0,0,834
9471,RM-1122,4/4/2015,0,0,834,0,0,0,834
9472,RM-1122,4/5/2015,0,0,834,0,0,0,834
9489,RM-1122,4/22/2015,0,0,834,0,0,0,834
9666,RM-1123,11/28/2013,0,0,834,0,0,0,834
12956,RM-1132,11/28/2013,0,0,834,0,0,0,834
13426,RM-1132,3/15/2015,0,0,834,0,0,0,834
13436,RM-1132,3/25/2015,0,0,834,0,0,0,834
13437,RM-1132,3/26/2015,0,0,834,0,0,0,834
13440,RM-1132,3/29/2015,0,0,834,0,0,0,834
13446,RM-1132,4/4/2015,0,0,834,0,0,0,834
13447,RM-1132,4/5/2015,0,0,834,0,0,0,834
13464,RM-1132,4/22/2015,0,0,834,0,0,0,834
13641,RM-1133,11/28/2013,0,0,834,0,0,0,834
14352,RM-1134,6/5/2014,834,0,0,0,0,0,834
19022,RM-1155,6/5/2014,834,0,0,0,0,0,834
21981,RM-1200C,3/15/2015,834,0,0,0,0,0,834
21991,RM-1200C,3/25/2015,834,0,0,0,0,0,834
21992,RM-1200C,3/26/2015,834,0,0,0,0,0,834
21995,RM-1200C,3/29/2015,834,0,0,0,0,0,834
22001,RM-1200C,4/4/2015,834,0,0,0,0,0,834
22002,RM-1200C,4/5/2015,834,0,0,0,0,0,834
22019,RM-1200C,4/22/2015,834,0,0,0,0,0,834
23016,RM-1207,6/5/2014,834,0,0,0,0,0,834
24670,RM-1208B,3/15/2015,834,0,0,0,0,0,834
24680,RM-1208B,3/25/2015,834,0,0,0,0,0,834
24681,RM-1208B,3/26/2015,834,0,0,0,0,0,834
24684,RM-1208B,3/29/2015,834,0,0,0,0,0,834
24690,RM-1208B,4/4/2015,834,0,0,0,0,0,834
24691,RM-1208B,4/5/2015,834,0,0,0,0,0,834
24708,RM-1208B,4/22/2015,834,0,0,0,0,0,834
24885,RM-1212,11/28/2013,0,0,834,0,0,0,834
25074,RM-1212,6/5/2014,834,0,0,0,0,0,834
26925,RM-1217,11/28/2013,834,0,0,0,0,0,834
27776,RM-1218,5/10/2014,0,0,0,834,0,0,834
28083,RM-1218,3/15/2015,834,0,0,0,0,0,834
28093,RM-1218,3/25/2015,834,0,0,0,0,0,834
28094,RM-1218,3/26/2015,834,0,0,0,0,0,834
28097,RM-1218,3/29/2015,834,0,0,0,0,0,834
28103,RM-1218,4/4/2015,834,0,0,0,0,0,834
28104,RM-1218,4/5/2015,834,0,0,0,0,0,834
28121,RM-1218,4/22/2015,834,0,0,0,0,0,834
28301,RM-1221,11/28/2013,0,0,834,0,0,0,834
29175,RM-1223,6/5/2014,834,0,0,0,0,0,834
29456,RM-1223,3/15/2015,0,0,834,0,0,0,834
29466,RM-1223,3/25/2015,0,0,834,0,0,0,834
29467,RM-1223,3/26/2015,0,0,834,0,0,0,834
29470,RM-1223,3/29/2015,0,0,834,0,0,0,834
29476,RM-1223,4/4/2015,0,0,834,0,0,0,834
29477,RM-1223,4/5/2015,0,0,834,0,0,0,834
29494,RM-1223,4/22/2015,0,0,834,0,0,0,834
30141,RM-1224,3/15/2015,834,0,0,0,0,0,834
30151,RM-1224,3/25/2015,834,0,0,0,0,0,834
30152,RM-1224,3/26/2015,834,0,0,0,0,0,834
30155,RM-1224,3/29/2015,834,0,0,0,0,0,834
30161,RM-1224,4/4/2015,834,0,0,0,0,0,834
30162,RM-1224,4/5/2015,834,0,0,0,0,0,834
30179,RM-1224,4/22/2015,834,0,0,0,0,0,834
30829,RM-1229,3/15/2015,0,0,834,0,0,0,834
30839,RM-1229,3/25/2015,0,0,834,0,0,0,834
30840,RM-1229,3/26/2015,0,0,834,0,0,0,834
30843,RM-1229,3/29/2015,0,0,834,0,0,0,834
30849,RM-1229,4/4/2015,0,0,834,0,0,0,834
30850,RM-1229,4/5/2015,0,0,834,0,0,0,834
30867,RM-1229,4/22/2015,0,0,834,0,0,0,834
32386,RM-1236,11/28/2013,0,0,834,0,0,0,834
32856,RM-1236,3/15/2015,834,0,0,0,0,0,834
32866,RM-1236,3/25/2015,834,0,0,0,0,0,834
32867,RM-1236,3/26/2015,834,0,0,0,0,0,834
32870,RM-1236,3/29/2015,834,0,0,0,0,0,834
32876,RM-1236,4/4/2015,834,0,0,0,0,0,834
32877,RM-1236,4/5/2015,834,0,0,0,0,0,834
32894,RM-1236,4/22/2015,834,0,0,0,0,0,834
34117,RM-B102C,3/15/2015,834,0,0,0,0,0,834
34127,RM-B102C,3/25/2015,834,0,0,0,0,0,834
34128,RM-B102C,3/26/2015,834,0,0,0,0,0,834
34131,RM-B102C,3/29/2015,834,0,0,0,0,0,834
34137,RM-B102C,4/4/2015,834,0,0,0,0,0,834
34138,RM-B102C,4/5/2015,834,0,0,0,0,0,834
34155,RM-B102C,4/22/2015,834,0,0,0,0,0,834
34837,RM-B103,4/22/2015,0,0,834,0,0,0,834
36716,RM-B200B,3/15/2015,0,0,834,0,0,0,834
36726,RM-B200B,3/25/2015,0,0,834,0,0,0,834
36727,RM-B200B,3/26/2015,0,0,834,0,0,0,834
36730,RM-B200B,3/29/2015,0,0,834,0,0,0,834
36736,RM-B200B,4/4/2015,0,0,834,0,0,0,834
36737,RM-B200B,4/5/2015,0,0,834,0,0,0,834
37120,RM-B200C,6/5/2014,834,0,0,0,0,0,834
37401,RM-B200C,3/15/2015,834,0,0,0,0,0,834
37403,RM-B200C,3/17/2015,834,0,0,0,0,0,834
37410,RM-B200C,3/24/2015,834,0,0,0,0,0,834
37411,RM-B200C,3/25/2015,834,0,0,0,0,0,834
37412,RM-B200C,3/26/2015,834,0,0,0,0,0,834
37415,RM-B200C,3/29/2015,834,0,0,0,0,0,834
37421,RM-B200C,4/4/2015,834,0,0,0,0,0,834
37422,RM-B200C,4/5/2015,834,0,0,0,0,0,834
37439,RM-B200C,4/22/2015,834,0,0,0,0,0,834
38777,RM-B215,3/15/2015,834,0,0,0,0,0,834
39181,RM-B220,6/5/2014,834,0,0,0,0,0,834
39680,RM-B222,11/28/2013,834,0,0,0,0,0,834
41930,RM-B230,6/5/2014,834,0,0,0,0,0,834
43462,RM-B240,3/15/2015,0,0,834,0,0,0,834
43471,RM-B240,3/24/2015,0,0,834,0,0,0,834
43472,RM-B240,3/25/2015,0,0,834,0,0,0,834
43473,RM-B240,3/26/2015,0,0,834,0,0,0,834
43476,RM-B240,3/29/2015,0,0,834,0,0,0,834
43482,RM-B240,4/4/2015,0,0,834,0,0,0,834
43483,RM-B240,4/5/2015,0,0,834,0,0,0,834
43500,RM-B240,4/22/2015,0,0,834,0,0,0,834
44072,RM-B240A,3/15/2015,0,0,834,0,0,0,834
44081,RM-B240A,3/24/2015,0,0,834,0,0,0,834
44082,RM-B240A,3/25/2015,0,0,834,0,0,0,834
44083,RM-B240A,3/26/2015,0,0,834,0,0,0,834
44086,RM-B240A,3/29/2015,0,0,834,0,0,0,834
44092,RM-B240A,4/4/2015,0,0,834,0,0,0,834
44093,RM-B240A,4/5/2015,0,0,834,0,0,0,834
44110,RM-B240A,4/22/2015,0,0,834,0,0,0,834
45160,RM-B250A,6/5/2014,834,0,0,0,0,0,834
45441,RM-B250A,3/15/2015,834,0,0,0,0,0,834
45450,RM-B250A,3/24/2015,834,0,0,0,0,0,834
45451,RM-B250A,3/25/2015,834,0,0,0,0,0,834
45452,RM-B250A,3/26/2015,834,0,0,0,0,0,834
45455,RM-B250A,3/29/2015,834,0,0,0,0,0,834
45461,RM-B250A,4/4/2015,834,0,0,0,0,0,834
45462,RM-B250A,4/5/2015,834,0,0,0,0,0,834
45479,RM-B250A,4/22/2015,834,0,0,0,0,0,834
46126,RM-B260,3/15/2015,0,0,834,0,0,0,834
46135,RM-B260,3/24/2015,0,0,834,0,0,0,834
46136,RM-B260,3/25/2015,0,0,834,0,0,0,834
46137,RM-B260,3/26/2015,0,0,834,0,0,0,834
46140,RM-B260,3/29/2015,0,0,834,0,0,0,834
46146,RM-B260,4/4/2015,0,0,834,0,0,0,834
46147,RM-B260,4/5/2015,0,0,834,0,0,0,834
46164,RM-B260,4/22/2015,0,0,834,0,0,0,834
47195,RM-B270,5/16/2014,0,0,0,834,0,0,834
48164,RM-B275,3/15/2015,834,0,0,0,0,0,834
48174,RM-B275,3/25/2015,834,0,0,0,0,0,834
48175,RM-B275,3/26/2015,834,0,0,0,0,0,834
48178,RM-B275,3/29/2015,834,0,0,0,0,0,834
48184,RM-B275,4/4/2015,834,0,0,0,0,0,834
48185,RM-B275,4/5/2015,834,0,0,0,0,0,834
48202,RM-B275,4/22/2015,834,0,0,0,0,0,834
307,RM-1100A,5/14/2014,831,0,0,0,0,0,831
1677,RM-1102,5/14/2014,831,0,0,0,0,0,831
2004,RM-1102,4/8/2015,831,0,0,0,0,0,831
2880,RM-1106,1/11/2014,0,0,0,0,0,831,831
4699,RM-1108,4/8/2015,0,0,831,0,0,0,831
4937,RM-1109,1/11/2014,0,0,0,0,0,831,831
5744,RM-1110,5/14/2014,0,0,831,0,0,0,831
6306,RM-1113,1/11/2014,0,0,831,0,0,0,831
6429,RM-1113,5/14/2014,0,0,831,0,0,0,831
6965,RM-1115,1/11/2014,0,0,0,0,0,831,831
7088,RM-1115,5/14/2014,831,0,0,0,0,0,831
7652,RM-1116,1/11/2014,831,0,0,0,0,0,831
7775,RM-1116,5/14/2014,831,0,0,0,0,0,831
8102,RM-1116,4/8/2015,0,0,831,0,0,0,831
9025,RM-1122,1/11/2014,0,0,0,0,0,831,831
9475,RM-1122,4/8/2015,0,0,831,0,0,0,831
9710,RM-1123,1/11/2014,0,0,831,0,0,0,831
10395,RM-1124,1/11/2014,0,0,0,0,0,831,831
13000,RM-1132,1/11/2014,0,0,831,0,0,0,831
13450,RM-1132,4/8/2015,0,0,831,0,0,0,831
14330,RM-1134,5/14/2014,831,0,0,0,0,0,831
15477,RM-1144,1/11/2014,0,0,831,0,0,0,831
15600,RM-1144,5/14/2014,0,0,831,0,0,0,831
16162,RM-1145,1/11/2014,0,0,0,0,0,831,831
16258,RM-1145,5/14/2014,0,0,831,0,0,0,831
19000,RM-1155,5/14/2014,831,0,0,0,0,0,831
19553,RM-1156,1/11/2014,831,0,0,0,0,0,831
22005,RM-1200C,4/8/2015,831,0,0,0,0,0,831
22994,RM-1207,5/14/2014,831,0,0,0,0,0,831
24244,RM-1208B,1/11/2014,0,0,831,0,0,0,831
24694,RM-1208B,4/8/2015,831,0,0,0,0,0,831
25052,RM-1212,5/14/2014,831,0,0,0,0,0,831
25599,RM-1213,1/11/2014,0,0,0,0,0,831,831
26407,RM-1213A,5/14/2014,0,0,831,0,0,0,831
28107,RM-1218,4/8/2015,831,0,0,0,0,0,831
29153,RM-1223,5/14/2014,831,0,0,0,0,0,831
29480,RM-1223,4/8/2015,0,0,831,0,0,0,831
30165,RM-1224,4/8/2015,831,0,0,0,0,0,831
30853,RM-1229,4/8/2015,0,0,831,0,0,0,831
31740,RM-1231,1/11/2014,0,0,0,0,0,831,831
32430,RM-1236,1/11/2014,0,0,831,0,0,0,831
32880,RM-1236,4/8/2015,831,0,0,0,0,0,831
36740,RM-B200B,4/8/2015,0,0,831,0,0,0,831
37425,RM-B200C,4/8/2015,831,0,0,0,0,0,831
38474,RM-B215,5/14/2014,0,0,831,0,0,0,831
39036,RM-B220,1/11/2014,831,0,0,0,0,0,831
39159,RM-B220,5/14/2014,831,0,0,0,0,0,831
39724,RM-B222,1/11/2014,831,0,0,0,0,0,831
39847,RM-B222,5/14/2014,831,0,0,0,0,0,831
40412,RM-B224,1/11/2014,0,0,0,0,0,831,831
41100,RM-B225,1/11/2014,0,0,0,0,0,831,831
42470,RM-B230A,1/11/2014,0,0,0,0,0,831,831
43159,RM-B240,5/14/2014,0,0,831,0,0,0,831
43486,RM-B240,4/8/2015,0,0,831,0,0,0,831
44096,RM-B240A,4/8/2015,0,0,831,0,0,0,831
44331,RM-B250,1/11/2014,0,0,831,0,0,0,831
45138,RM-B250A,5/14/2014,831,0,0,0,0,0,831
45465,RM-B250A,4/8/2015,831,0,0,0,0,0,831
46150,RM-B260,4/8/2015,0,0,831,0,0,0,831
48188,RM-B275,4/8/2015,831,0,0,0,0,0,831
1937,RM-1102,1/31/2015,828,0,0,0,0,0,828
1997,RM-1102,4/1/2015,828,0,0,0,0,0,828
2002,RM-1102,4/6/2015,828,0,0,0,0,0,828
2003,RM-1102,4/7/2015,828,0,0,0,0,0,828
2014,RM-1102,4/18/2015,828,0,0,0,0,0,828
4632,RM-1108,1/31/2015,0,0,828,0,0,0,828
4692,RM-1108,4/1/2015,0,0,828,0,0,0,828
4697,RM-1108,4/6/2015,0,0,828,0,0,0,828
4698,RM-1108,4/7/2015,0,0,828,0,0,0,828
4709,RM-1108,4/18/2015,0,0,828,0,0,0,828
6621,RM-1113,11/24/2014,18,0,810,0,0,0,828
8100,RM-1116,4/6/2015,0,0,828,0,0,0,828
8101,RM-1116,4/7/2015,0,0,828,0,0,0,828
8112,RM-1116,4/18/2015,0,0,828,0,0,0,828
9468,RM-1122,4/1/2015,0,0,828,0,0,0,828
9473,RM-1122,4/6/2015,0,0,828,0,0,0,828
9474,RM-1122,4/7/2015,0,0,828,0,0,0,828
9485,RM-1122,4/18/2015,0,0,828,0,0,0,828
10093,RM-1123,1/31/2015,828,0,0,0,0,0,828
12695,RM-1130,1/31/2015,0,0,828,0,0,0,828
13383,RM-1132,1/31/2015,0,0,828,0,0,0,828
13443,RM-1132,4/1/2015,0,0,828,0,0,0,828
13448,RM-1132,4/6/2015,0,0,828,0,0,0,828
13449,RM-1132,4/7/2015,0,0,828,0,0,0,828
13460,RM-1132,4/18/2015,0,0,828,0,0,0,828
16518,RM-1145,1/31/2015,0,0,828,0,0,0,828
19260,RM-1155,1/31/2015,828,0,0,0,0,0,828
19936,RM-1156,1/31/2015,0,0,828,0,0,0,828
21998,RM-1200C,4/1/2015,828,0,0,0,0,0,828
22003,RM-1200C,4/6/2015,828,0,0,0,0,0,828
22004,RM-1200C,4/7/2015,828,0,0,0,0,0,828
22015,RM-1200C,4/18/2015,828,0,0,0,0,0,828
24627,RM-1208B,1/31/2015,828,0,0,0,0,0,828
24687,RM-1208B,4/1/2015,828,0,0,0,0,0,828
24692,RM-1208B,4/6/2015,828,0,0,0,0,0,828
24693,RM-1208B,4/7/2015,828,0,0,0,0,0,828
24704,RM-1208B,4/18/2015,828,0,0,0,0,0,828
28040,RM-1218,1/31/2015,828,0,0,0,0,0,828
28100,RM-1218,4/1/2015,828,0,0,0,0,0,828
28105,RM-1218,4/6/2015,828,0,0,0,0,0,828
28106,RM-1218,4/7/2015,828,0,0,0,0,0,828
28117,RM-1218,4/18/2015,828,0,0,0,0,0,828
29473,RM-1223,4/1/2015,0,0,828,0,0,0,828
29478,RM-1223,4/6/2015,0,0,828,0,0,0,828
29479,RM-1223,4/7/2015,0,0,828,0,0,0,828
29490,RM-1223,4/18/2015,0,0,828,0,0,0,828
30098,RM-1224,1/31/2015,828,0,0,0,0,0,828
30158,RM-1224,4/1/2015,828,0,0,0,0,0,828
30163,RM-1224,4/6/2015,828,0,0,0,0,0,828
30164,RM-1224,4/7/2015,828,0,0,0,0,0,828
30175,RM-1224,4/18/2015,828,0,0,0,0,0,828
30786,RM-1229,1/31/2015,0,0,828,0,0,0,828
30846,RM-1229,4/1/2015,0,0,828,0,0,0,828
30851,RM-1229,4/6/2015,0,0,828,0,0,0,828
30852,RM-1229,4/7/2015,0,0,828,0,0,0,828
30863,RM-1229,4/18/2015,0,0,828,0,0,0,828
32813,RM-1236,1/31/2015,828,0,0,0,0,0,828
32873,RM-1236,4/1/2015,828,0,0,0,0,0,828
32878,RM-1236,4/6/2015,828,0,0,0,0,0,828
32879,RM-1236,4/7/2015,828,0,0,0,0,0,828
32890,RM-1236,4/18/2015,828,0,0,0,0,0,828
33530,RM-4xxx,10/2/2014,0,0,0,0,828,0,828
33640,RM-4xxx,1/20/2015,0,0,0,0,828,0,828
33651,RM-4xxx,1/31/2015,0,0,0,0,828,0,828
34074,RM-B102C,1/31/2015,828,0,0,0,0,0,828
34134,RM-B102C,4/1/2015,828,0,0,0,0,0,828
34139,RM-B102C,4/6/2015,828,0,0,0,0,0,828
34140,RM-B102C,4/7/2015,828,0,0,0,0,0,828
34141,RM-B102C,4/8/2015,828,0,0,0,0,0,828
34151,RM-B102C,4/18/2015,828,0,0,0,0,0,828
34835,RM-B103,4/20/2015,0,0,828,0,0,0,828
36673,RM-B200B,1/31/2015,0,0,828,0,0,0,828
36733,RM-B200B,4/1/2015,0,0,828,0,0,0,828
36738,RM-B200B,4/6/2015,0,0,828,0,0,0,828
36739,RM-B200B,4/7/2015,0,0,828,0,0,0,828
36750,RM-B200B,4/18/2015,0,0,828,0,0,0,828
37237,RM-B200C,10/2/2014,828,0,0,0,0,0,828
37358,RM-B200C,1/31/2015,828,0,0,0,0,0,828
37402,RM-B200C,3/16/2015,828,0,0,0,0,0,828
37418,RM-B200C,4/1/2015,828,0,0,0,0,0,828
37423,RM-B200C,4/6/2015,828,0,0,0,0,0,828
37424,RM-B200C,4/7/2015,828,0,0,0,0,0,828
37437,RM-B200C,4/20/2015,828,0,0,0,0,0,828
38734,RM-B215,1/31/2015,828,0,0,0,0,0,828
42047,RM-B230,10/2/2014,828,0,0,0,0,0,828
43298,RM-B240,10/2/2014,0,0,828,0,0,0,828
43419,RM-B240,1/31/2015,0,0,828,0,0,0,828
43479,RM-B240,4/1/2015,0,0,828,0,0,0,828
43484,RM-B240,4/6/2015,0,0,828,0,0,0,828
43485,RM-B240,4/7/2015,0,0,828,0,0,0,828
43498,RM-B240,4/20/2015,0,0,828,0,0,0,828
43983,RM-B240A,12/16/2014,0,0,828,0,0,0,828
44029,RM-B240A,1/31/2015,0,0,828,0,0,0,828
44089,RM-B240A,4/1/2015,0,0,828,0,0,0,828
44094,RM-B240A,4/6/2015,0,0,828,0,0,0,828
44095,RM-B240A,4/7/2015,0,0,828,0,0,0,828
44106,RM-B240A,4/18/2015,0,0,828,0,0,0,828
44593,RM-B250,10/2/2014,0,0,828,0,0,0,828
45398,RM-B250A,1/31/2015,828,0,0,0,0,0,828
45458,RM-B250A,4/1/2015,828,0,0,0,0,0,828
45463,RM-B250A,4/6/2015,828,0,0,0,0,0,828
45464,RM-B250A,4/7/2015,828,0,0,0,0,0,828
45475,RM-B250A,4/18/2015,828,0,0,0,0,0,828
45825,RM-B260,5/16/2014,0,0,0,828,0,0,828
46083,RM-B260,1/31/2015,0,0,828,0,0,0,828
46143,RM-B260,4/1/2015,0,0,828,0,0,0,828
46148,RM-B260,4/6/2015,0,0,828,0,0,0,828
46149,RM-B260,4/7/2015,0,0,828,0,0,0,828
46162,RM-B260,4/20/2015,0,0,828,0,0,0,828
48121,RM-B275,1/31/2015,828,0,0,0,0,0,828
48181,RM-B275,4/1/2015,828,0,0,0,0,0,828
48186,RM-B275,4/6/2015,828,0,0,0,0,0,828
48187,RM-B275,4/7/2015,828,0,0,0,0,0,828
48198,RM-B275,4/18/2015,828,0,0,0,0,0,828
445,RM-1100A,10/1/2014,825,0,0,0,0,0,825
446,RM-1100A,10/2/2014,825,0,0,0,0,0,825
521,RM-1100A,12/16/2014,825,0,0,0,0,0,825
556,RM-1100A,1/20/2015,825,0,0,0,0,0,825
1815,RM-1102,10/1/2014,825,0,0,0,0,0,825
1816,RM-1102,10/2/2014,825,0,0,0,0,0,825
1891,RM-1102,12/16/2014,825,0,0,0,0,0,825
1926,RM-1102,1/20/2015,825,0,0,0,0,0,825
1981,RM-1102,3/16/2015,825,0,0,0,0,0,825
1998,RM-1102,4/2/2015,825,0,0,0,0,0,825
1999,RM-1102,4/3/2015,825,0,0,0,0,0,825
2016,RM-1102,4/20/2015,825,0,0,0,0,0,825
2017,RM-1102,4/21/2015,825,0,0,0,0,0,825
4586,RM-1108,12/16/2014,0,0,825,0,0,0,825
4621,RM-1108,1/20/2015,0,0,825,0,0,0,825
4676,RM-1108,3/16/2015,0,0,825,0,0,0,825
4693,RM-1108,4/2/2015,0,0,825,0,0,0,825
4694,RM-1108,4/3/2015,0,0,825,0,0,0,825
4711,RM-1108,4/20/2015,0,0,825,0,0,0,825
4712,RM-1108,4/21/2015,0,0,825,0,0,0,825
6567,RM-1113,10/1/2014,0,0,825,0,0,0,825
6568,RM-1113,10/2/2014,0,0,825,0,0,0,825
8114,RM-1116,4/20/2015,0,0,825,0,0,0,825
8115,RM-1116,4/21/2015,0,0,825,0,0,0,825
9469,RM-1122,4/2/2015,0,0,825,0,0,0,825
9470,RM-1122,4/3/2015,0,0,825,0,0,0,825
9487,RM-1122,4/20/2015,0,0,825,0,0,0,825
9488,RM-1122,4/21/2015,0,0,825,0,0,0,825
9971,RM-1123,10/1/2014,825,0,0,0,0,0,825
9972,RM-1123,10/2/2014,825,0,0,0,0,0,825
10047,RM-1123,12/16/2014,825,0,0,0,0,0,825
10082,RM-1123,1/20/2015,825,0,0,0,0,0,825
12573,RM-1130,10/1/2014,0,0,825,0,0,0,825
12574,RM-1130,10/2/2014,0,0,825,0,0,0,825
12649,RM-1130,12/16/2014,0,0,825,0,0,0,825
12684,RM-1130,1/20/2015,0,0,825,0,0,0,825
13261,RM-1132,10/1/2014,0,0,825,0,0,0,825
13262,RM-1132,10/2/2014,0,0,825,0,0,0,825
13337,RM-1132,12/16/2014,0,0,825,0,0,0,825
13372,RM-1132,1/20/2015,0,0,825,0,0,0,825
13427,RM-1132,3/16/2015,0,0,825,0,0,0,825
13444,RM-1132,4/2/2015,0,0,825,0,0,0,825
13445,RM-1132,4/3/2015,0,0,825,0,0,0,825
13462,RM-1132,4/20/2015,0,0,825,0,0,0,825
13463,RM-1132,4/21/2015,0,0,825,0,0,0,825
14468,RM-1134,10/1/2014,825,0,0,0,0,0,825
14469,RM-1134,10/2/2014,825,0,0,0,0,0,825
14544,RM-1134,12/16/2014,825,0,0,0,0,0,825
15738,RM-1144,10/1/2014,0,0,825,0,0,0,825
15739,RM-1144,10/2/2014,0,0,825,0,0,0,825
15814,RM-1144,12/16/2014,0,0,825,0,0,0,825
16396,RM-1145,10/1/2014,0,0,825,0,0,0,825
16397,RM-1145,10/2/2014,0,0,825,0,0,0,825
16472,RM-1145,12/16/2014,0,0,825,0,0,0,825
16507,RM-1145,1/20/2015,0,0,825,0,0,0,825
17765,RM-1151,10/1/2014,825,0,0,0,0,0,825
17766,RM-1151,10/2/2014,825,0,0,0,0,0,825
19138,RM-1155,10/1/2014,825,0,0,0,0,0,825
19139,RM-1155,10/2/2014,825,0,0,0,0,0,825
19214,RM-1155,12/16/2014,825,0,0,0,0,0,825
19249,RM-1155,1/20/2015,825,0,0,0,0,0,825
19814,RM-1156,10/1/2014,0,0,825,0,0,0,825
19815,RM-1156,10/2/2014,0,0,825,0,0,0,825
19890,RM-1156,12/16/2014,0,0,825,0,0,0,825
19925,RM-1156,1/20/2015,0,0,825,0,0,0,825
21982,RM-1200C,3/16/2015,825,0,0,0,0,0,825
21999,RM-1200C,4/2/2015,825,0,0,0,0,0,825
22000,RM-1200C,4/3/2015,825,0,0,0,0,0,825
22017,RM-1200C,4/20/2015,825,0,0,0,0,0,825
22018,RM-1200C,4/21/2015,825,0,0,0,0,0,825
24505,RM-1208B,10/1/2014,825,0,0,0,0,0,825
24506,RM-1208B,10/2/2014,825,0,0,0,0,0,825
24581,RM-1208B,12/16/2014,825,0,0,0,0,0,825
24616,RM-1208B,1/20/2015,825,0,0,0,0,0,825
24671,RM-1208B,3/16/2015,825,0,0,0,0,0,825
24688,RM-1208B,4/2/2015,825,0,0,0,0,0,825
24689,RM-1208B,4/3/2015,825,0,0,0,0,0,825
24706,RM-1208B,4/20/2015,825,0,0,0,0,0,825
24707,RM-1208B,4/21/2015,825,0,0,0,0,0,825
25190,RM-1212,10/1/2014,825,0,0,0,0,0,825
25191,RM-1212,10/2/2014,825,0,0,0,0,0,825
25266,RM-1212,12/16/2014,825,0,0,0,0,0,825
27994,RM-1218,12/16/2014,825,0,0,0,0,0,825
28029,RM-1218,1/20/2015,825,0,0,0,0,0,825
28084,RM-1218,3/16/2015,825,0,0,0,0,0,825
28101,RM-1218,4/2/2015,825,0,0,0,0,0,825
28102,RM-1218,4/3/2015,825,0,0,0,0,0,825
28119,RM-1218,4/20/2015,825,0,0,0,0,0,825
28120,RM-1218,4/21/2015,825,0,0,0,0,0,825
28606,RM-1221,10/1/2014,0,0,825,0,0,0,825
28607,RM-1221,10/2/2014,0,0,825,0,0,0,825
29291,RM-1223,10/1/2014,825,0,0,0,0,0,825
29292,RM-1223,10/2/2014,825,0,0,0,0,0,825
29367,RM-1223,12/16/2014,825,0,0,0,0,0,825
29457,RM-1223,3/16/2015,0,0,825,0,0,0,825
29474,RM-1223,4/2/2015,0,0,825,0,0,0,825
29475,RM-1223,4/3/2015,0,0,825,0,0,0,825
29492,RM-1223,4/20/2015,0,0,825,0,0,0,825
29493,RM-1223,4/21/2015,0,0,825,0,0,0,825
30087,RM-1224,1/20/2015,825,0,0,0,0,0,825
30142,RM-1224,3/16/2015,825,0,0,0,0,0,825
30159,RM-1224,4/2/2015,825,0,0,0,0,0,825
30160,RM-1224,4/3/2015,825,0,0,0,0,0,825
30177,RM-1224,4/20/2015,825,0,0,0,0,0,825
30178,RM-1224,4/21/2015,825,0,0,0,0,0,825
30664,RM-1229,10/1/2014,0,0,825,0,0,0,825
30665,RM-1229,10/2/2014,0,0,825,0,0,0,825
30740,RM-1229,12/16/2014,0,0,825,0,0,0,825
30775,RM-1229,1/20/2015,0,0,825,0,0,0,825
30830,RM-1229,3/16/2015,0,0,825,0,0,0,825
30847,RM-1229,4/2/2015,0,0,825,0,0,0,825
30848,RM-1229,4/3/2015,0,0,825,0,0,0,825
30865,RM-1229,4/20/2015,0,0,825,0,0,0,825
30866,RM-1229,4/21/2015,0,0,825,0,0,0,825
32691,RM-1236,10/1/2014,825,0,0,0,0,0,825
32692,RM-1236,10/2/2014,825,0,0,0,0,0,825
32767,RM-1236,12/16/2014,825,0,0,0,0,0,825
32802,RM-1236,1/20/2015,825,0,0,0,0,0,825
32857,RM-1236,3/16/2015,825,0,0,0,0,0,825
32874,RM-1236,4/2/2015,825,0,0,0,0,0,825
32875,RM-1236,4/3/2015,825,0,0,0,0,0,825
32892,RM-1236,4/20/2015,825,0,0,0,0,0,825
32893,RM-1236,4/21/2015,825,0,0,0,0,0,825
33529,RM-4xxx,10/1/2014,0,0,0,0,825,0,825
34028,RM-B102C,12/16/2014,825,0,0,0,0,0,825
34063,RM-B102C,1/20/2015,825,0,0,0,0,0,825
34118,RM-B102C,3/16/2015,825,0,0,0,0,0,825
34135,RM-B102C,4/2/2015,825,0,0,0,0,0,825
34136,RM-B102C,4/3/2015,825,0,0,0,0,0,825
34153,RM-B102C,4/20/2015,825,0,0,0,0,0,825
34154,RM-B102C,4/21/2015,825,0,0,0,0,0,825
34833,RM-B103,4/18/2015,0,0,825,0,0,0,825
36555,RM-B200B,10/1/2014,0,0,825,0,0,0,825
36556,RM-B200B,10/2/2014,0,0,825,0,0,0,825
36717,RM-B200B,3/16/2015,0,0,825,0,0,0,825
36734,RM-B200B,4/2/2015,0,0,825,0,0,0,825
36735,RM-B200B,4/3/2015,0,0,825,0,0,0,825
36752,RM-B200B,4/20/2015,0,0,825,0,0,0,825
37236,RM-B200C,10/1/2014,825,0,0,0,0,0,825
37312,RM-B200C,12/16/2014,825,0,0,0,0,0,825
37347,RM-B200C,1/20/2015,825,0,0,0,0,0,825
37419,RM-B200C,4/2/2015,825,0,0,0,0,0,825
37420,RM-B200C,4/3/2015,825,0,0,0,0,0,825
37435,RM-B200C,4/18/2015,825,0,0,0,0,0,825
38723,RM-B215,1/20/2015,825,0,0,0,0,0,825
38778,RM-B215,3/16/2015,825,0,0,0,0,0,825
39985,RM-B222,10/1/2014,825,0,0,0,0,0,825
39986,RM-B222,10/2/2014,825,0,0,0,0,0,825
40061,RM-B222,12/16/2014,825,0,0,0,0,0,825
42046,RM-B230,10/1/2014,825,0,0,0,0,0,825
43297,RM-B240,10/1/2014,0,0,825,0,0,0,825
43373,RM-B240,12/16/2014,0,0,825,0,0,0,825
43408,RM-B240,1/20/2015,0,0,825,0,0,0,825
43463,RM-B240,3/16/2015,0,0,825,0,0,0,825
43480,RM-B240,4/2/2015,0,0,825,0,0,0,825
43481,RM-B240,4/3/2015,0,0,825,0,0,0,825
43496,RM-B240,4/18/2015,0,0,825,0,0,0,825
43907,RM-B240A,10/1/2014,0,0,825,0,0,0,825
43908,RM-B240A,10/2/2014,0,0,825,0,0,0,825
44018,RM-B240A,1/20/2015,0,0,825,0,0,0,825
44073,RM-B240A,3/16/2015,0,0,825,0,0,0,825
44090,RM-B240A,4/2/2015,0,0,825,0,0,0,825
44091,RM-B240A,4/3/2015,0,0,825,0,0,0,825
44108,RM-B240A,4/20/2015,0,0,825,0,0,0,825
44109,RM-B240A,4/21/2015,0,0,825,0,0,0,825
44592,RM-B250,10/1/2014,0,0,825,0,0,0,825
45276,RM-B250A,10/1/2014,825,0,0,0,0,0,825
45277,RM-B250A,10/2/2014,825,0,0,0,0,0,825
45352,RM-B250A,12/16/2014,825,0,0,0,0,0,825
45387,RM-B250A,1/20/2015,825,0,0,0,0,0,825
45442,RM-B250A,3/16/2015,825,0,0,0,0,0,825
45459,RM-B250A,4/2/2015,825,0,0,0,0,0,825
45460,RM-B250A,4/3/2015,825,0,0,0,0,0,825
45477,RM-B250A,4/20/2015,825,0,0,0,0,0,825
45478,RM-B250A,4/21/2015,825,0,0,0,0,0,825
46037,RM-B260,12/16/2014,0,0,825,0,0,0,825
46072,RM-B260,1/20/2015,0,0,825,0,0,0,825
46127,RM-B260,3/16/2015,0,0,825,0,0,0,825
46144,RM-B260,4/2/2015,0,0,825,0,0,0,825
46145,RM-B260,4/3/2015,0,0,825,0,0,0,825
46160,RM-B260,4/18/2015,0,0,825,0,0,0,825
48075,RM-B275,12/16/2014,825,0,0,0,0,0,825
48110,RM-B275,1/20/2015,825,0,0,0,0,0,825
48165,RM-B275,3/16/2015,825,0,0,0,0,0,825
48182,RM-B275,4/2/2015,825,0,0,0,0,0,825
48183,RM-B275,4/3/2015,825,0,0,0,0,0,825
48200,RM-B275,4/20/2015,825,0,0,0,0,0,825
48201,RM-B275,4/21/2015,825,0,0,0,0,0,825
444,RM-1100A,9/30/2014,822,0,0,0,0,0,822
989,RM-1100D,5/11/2014,0,0,0,822,0,0,822
1814,RM-1102,9/30/2014,822,0,0,0,0,0,822
2354,RM-1104,5/6/2014,0,822,0,0,0,0,822
6386,RM-1113,4/1/2014,0,0,822,0,0,0,822
6566,RM-1113,9/30/2014,0,0,822,0,0,0,822
9970,RM-1123,9/30/2014,822,0,0,0,0,0,822
12572,RM-1130,9/30/2014,0,0,822,0,0,0,822
13260,RM-1132,9/30/2014,0,0,822,0,0,0,822
14467,RM-1134,9/30/2014,822,0,0,0,0,0,822
15557,RM-1144,4/1/2014,0,0,822,0,0,0,822
15737,RM-1144,9/30/2014,0,0,822,0,0,0,822
16395,RM-1145,9/30/2014,0,0,822,0,0,0,822
17764,RM-1151,9/30/2014,822,0,0,0,0,0,822
19137,RM-1155,9/30/2014,822,0,0,0,0,0,822
19813,RM-1156,9/30/2014,0,0,822,0,0,0,822
20327,RM-1200A,5/11/2014,0,0,0,822,0,0,822
24504,RM-1208B,9/30/2014,822,0,0,0,0,0,822
25189,RM-1212,9/30/2014,822,0,0,0,0,0,822
26364,RM-1213A,4/1/2014,0,0,822,0,0,0,822
28605,RM-1221,9/30/2014,0,0,822,0,0,0,822
29290,RM-1223,9/30/2014,822,0,0,0,0,0,822
30663,RM-1229,9/30/2014,0,0,822,0,0,0,822
32510,RM-1236,4/1/2014,0,0,822,0,0,0,822
32690,RM-1236,9/30/2014,822,0,0,0,0,0,822
33528,RM-4xxx,9/30/2014,0,0,0,0,822,0,822
33605,RM-4xxx,12/16/2014,0,0,0,0,822,0,822
34836,RM-B103,4/21/2015,0,0,822,0,0,0,822
35687,RM-B109,4/1/2014,0,0,822,0,0,0,822
36415,RM-B200B,5/12/2014,0,822,0,0,0,0,822
36554,RM-B200B,9/30/2014,0,0,822,0,0,0,822
37235,RM-B200C,9/30/2014,822,0,0,0,0,0,822
37409,RM-B200C,3/23/2015,822,0,0,0,0,0,822
37438,RM-B200C,4/21/2015,822,0,0,0,0,0,822
39984,RM-B222,9/30/2014,822,0,0,0,0,0,822
42045,RM-B230,9/30/2014,822,0,0,0,0,0,822
43116,RM-B240,4/1/2014,0,0,822,0,0,0,822
43296,RM-B240,9/30/2014,0,0,822,0,0,0,822
43470,RM-B240,3/23/2015,0,0,822,0,0,0,822
43499,RM-B240,4/21/2015,0,0,822,0,0,0,822
43906,RM-B240A,9/30/2014,0,0,822,0,0,0,822
44080,RM-B240A,3/23/2015,0,0,822,0,0,0,822
44591,RM-B250,9/30/2014,0,0,822,0,0,0,822
45275,RM-B250A,9/30/2014,822,0,0,0,0,0,822
45449,RM-B250A,3/23/2015,822,0,0,0,0,0,822
46134,RM-B260,3/23/2015,0,0,822,0,0,0,822
46163,RM-B260,4/21/2015,0,0,822,0,0,0,822
443,RM-1100A,9/29/2014,819,0,0,0,0,0,819
1813,RM-1102,9/29/2014,819,0,0,0,0,0,819
1988,RM-1102,3/23/2015,819,0,0,0,0,0,819
1996,RM-1102,3/31/2015,819,0,0,0,0,0,819
4683,RM-1108,3/23/2015,0,0,819,0,0,0,819
4691,RM-1108,3/31/2015,0,0,819,0,0,0,819
4985,RM-1109,2/28/2014,0,0,0,0,0,819,819
4995,RM-1109,3/10/2014,0,0,0,0,0,819,819
6354,RM-1113,2/28/2014,0,0,819,0,0,0,819
6364,RM-1113,3/10/2014,0,0,819,0,0,0,819
6565,RM-1113,9/29/2014,0,0,819,0,0,0,819
7700,RM-1116,2/28/2014,819,0,0,0,0,0,819
7710,RM-1116,3/10/2014,819,0,0,0,0,0,819
9073,RM-1122,2/28/2014,0,0,0,0,0,819,819
9083,RM-1122,3/10/2014,0,0,0,0,0,819,819
9467,RM-1122,3/31/2015,0,0,819,0,0,0,819
9969,RM-1123,9/29/2014,819,0,0,0,0,0,819
12571,RM-1130,9/29/2014,0,0,819,0,0,0,819
13259,RM-1132,9/29/2014,0,0,819,0,0,0,819
13434,RM-1132,3/23/2015,0,0,819,0,0,0,819
13442,RM-1132,3/31/2015,0,0,819,0,0,0,819
14466,RM-1134,9/29/2014,819,0,0,0,0,0,819
15525,RM-1144,2/28/2014,0,0,819,0,0,0,819
15535,RM-1144,3/10/2014,0,0,819,0,0,0,819
15736,RM-1144,9/29/2014,0,0,819,0,0,0,819
16210,RM-1145,2/28/2014,0,0,0,0,0,819,819
16220,RM-1145,3/10/2014,0,0,0,0,0,819,819
16394,RM-1145,9/29/2014,0,0,819,0,0,0,819
17763,RM-1151,9/29/2014,819,0,0,0,0,0,819
19136,RM-1155,9/29/2014,819,0,0,0,0,0,819
19812,RM-1156,9/29/2014,0,0,819,0,0,0,819
21989,RM-1200C,3/23/2015,819,0,0,0,0,0,819
21997,RM-1200C,3/31/2015,819,0,0,0,0,0,819
24503,RM-1208B,9/29/2014,819,0,0,0,0,0,819
24678,RM-1208B,3/23/2015,819,0,0,0,0,0,819
24686,RM-1208B,3/31/2015,819,0,0,0,0,0,819
25188,RM-1212,9/29/2014,819,0,0,0,0,0,819
25647,RM-1213,2/28/2014,0,0,0,0,0,819,819
25657,RM-1213,3/10/2014,0,0,0,0,0,819,819
26332,RM-1213A,2/28/2014,0,0,819,0,0,0,819
26342,RM-1213A,3/10/2014,0,0,819,0,0,0,819
27027,RM-1217,3/10/2014,819,0,0,0,0,0,819
28091,RM-1218,3/23/2015,819,0,0,0,0,0,819
28099,RM-1218,3/31/2015,819,0,0,0,0,0,819
28393,RM-1221,2/28/2014,0,0,0,0,0,819,819
28403,RM-1221,3/10/2014,0,0,0,0,0,819,819
28604,RM-1221,9/29/2014,0,0,819,0,0,0,819
29289,RM-1223,9/29/2014,819,0,0,0,0,0,819
29464,RM-1223,3/23/2015,0,0,819,0,0,0,819
29472,RM-1223,3/31/2015,0,0,819,0,0,0,819
30149,RM-1224,3/23/2015,819,0,0,0,0,0,819
30157,RM-1224,3/31/2015,819,0,0,0,0,0,819
30662,RM-1229,9/29/2014,0,0,819,0,0,0,819
30837,RM-1229,3/23/2015,0,0,819,0,0,0,819
30845,RM-1229,3/31/2015,0,0,819,0,0,0,819
31788,RM-1231,2/28/2014,0,0,0,0,0,819,819
31798,RM-1231,3/10/2014,0,0,0,0,0,819,819
32478,RM-1236,2/28/2014,0,0,819,0,0,0,819
32488,RM-1236,3/10/2014,0,0,819,0,0,0,819
32689,RM-1236,9/29/2014,819,0,0,0,0,0,819
32864,RM-1236,3/23/2015,819,0,0,0,0,0,819
32872,RM-1236,3/31/2015,819,0,0,0,0,0,819
33527,RM-4xxx,9/29/2014,0,0,0,0,819,0,819
34125,RM-B102C,3/23/2015,819,0,0,0,0,0,819
34133,RM-B102C,3/31/2015,819,0,0,0,0,0,819
35655,RM-B109,2/28/2014,0,0,819,0,0,0,819
35665,RM-B109,3/10/2014,0,0,819,0,0,0,819
36553,RM-B200B,9/29/2014,0,0,819,0,0,0,819
36724,RM-B200B,3/23/2015,0,0,819,0,0,0,819
36732,RM-B200B,3/31/2015,0,0,819,0,0,0,819
37234,RM-B200C,9/29/2014,819,0,0,0,0,0,819
37417,RM-B200C,3/31/2015,819,0,0,0,0,0,819
38399,RM-B215,2/28/2014,0,0,819,0,0,0,819
38409,RM-B215,3/10/2014,0,0,819,0,0,0,819
39084,RM-B220,2/28/2014,819,0,0,0,0,0,819
39094,RM-B220,3/10/2014,819,0,0,0,0,0,819
39983,RM-B222,9/29/2014,819,0,0,0,0,0,819
40460,RM-B224,2/28/2014,0,0,0,0,0,819,819
40470,RM-B224,3/10/2014,0,0,0,0,0,819,819
42044,RM-B230,9/29/2014,819,0,0,0,0,0,819
42518,RM-B230A,2/28/2014,0,0,0,0,0,819,819
42528,RM-B230A,3/10/2014,0,0,0,0,0,819,819
43084,RM-B240,2/28/2014,0,0,819,0,0,0,819
43094,RM-B240,3/10/2014,0,0,819,0,0,0,819
43295,RM-B240,9/29/2014,0,0,819,0,0,0,819
43478,RM-B240,3/31/2015,0,0,819,0,0,0,819
43905,RM-B240A,9/29/2014,0,0,819,0,0,0,819
43976,RM-B240A,12/9/2014,0,0,819,0,0,0,819
44088,RM-B240A,3/31/2015,0,0,819,0,0,0,819
44379,RM-B250,2/28/2014,0,0,819,0,0,0,819
44389,RM-B250,3/10/2014,0,0,819,0,0,0,819
44590,RM-B250,9/29/2014,0,0,819,0,0,0,819
45064,RM-B250A,2/28/2014,819,0,0,0,0,0,819
45074,RM-B250A,3/10/2014,819,0,0,0,0,0,819
45274,RM-B250A,9/29/2014,819,0,0,0,0,0,819
45457,RM-B250A,3/31/2015,819,0,0,0,0,0,819
46142,RM-B260,3/31/2015,0,0,819,0,0,0,819
47786,RM-B275,2/28/2014,0,0,0,0,0,819,819
47796,RM-B275,3/10/2014,0,0,0,0,0,819,819
48172,RM-B275,3/23/2015,819,0,0,0,0,0,819
48180,RM-B275,3/31/2015,819,0,0,0,0,0,819
384,RM-1100A,7/30/2014,816,0,0,0,0,0,816
514,RM-1100A,12/9/2014,816,0,0,0,0,0,816
1754,RM-1102,7/30/2014,816,0,0,0,0,0,816
1884,RM-1102,12/9/2014,816,0,0,0,0,0,816
1995,RM-1102,3/30/2015,816,0,0,0,0,0,816
4690,RM-1108,3/30/2015,0,0,816,0,0,0,816
5702,RM-1110,4/1/2014,0,0,816,0,0,0,816
5821,RM-1110,7/30/2014,0,0,816,0,0,0,816
6506,RM-1113,7/30/2014,0,0,816,0,0,0,816
7045,RM-1115,4/1/2014,816,0,0,0,0,0,816
7732,RM-1116,4/1/2014,816,0,0,0,0,0,816
9466,RM-1122,3/30/2015,0,0,816,0,0,0,816
9910,RM-1123,7/30/2014,816,0,0,0,0,0,816
10040,RM-1123,12/9/2014,816,0,0,0,0,0,816
12642,RM-1130,12/9/2014,0,0,816,0,0,0,816
13200,RM-1132,7/30/2014,0,0,816,0,0,0,816
13330,RM-1132,12/9/2014,0,0,816,0,0,0,816
13441,RM-1132,3/30/2015,0,0,816,0,0,0,816
14288,RM-1134,4/1/2014,816,0,0,0,0,0,816
14407,RM-1134,7/30/2014,816,0,0,0,0,0,816
14537,RM-1134,12/9/2014,816,0,0,0,0,0,816
15677,RM-1144,7/30/2014,0,0,816,0,0,0,816
15807,RM-1144,12/9/2014,0,0,816,0,0,0,816
16335,RM-1145,7/30/2014,0,0,816,0,0,0,816
16465,RM-1145,12/9/2014,0,0,816,0,0,0,816
16942,RM-1150,5/14/2014,0,0,0,816,0,0,816
17704,RM-1151,7/30/2014,816,0,0,0,0,0,816
18957,RM-1155,4/1/2014,816,0,0,0,0,0,816
19077,RM-1155,7/30/2014,816,0,0,0,0,0,816
19207,RM-1155,12/9/2014,816,0,0,0,0,0,816
19633,RM-1156,4/1/2014,816,0,0,0,0,0,816
19883,RM-1156,12/9/2014,0,0,816,0,0,0,816
20331,RM-1200A,5/15/2014,0,0,0,816,0,0,816
21996,RM-1200C,3/30/2015,816,0,0,0,0,0,816
22951,RM-1207,4/1/2014,816,0,0,0,0,0,816
23071,RM-1207,7/30/2014,816,0,0,0,0,0,816
23756,RM-1208,7/30/2014,816,0,0,0,0,0,816
24437,RM-1208B,7/23/2014,408,0,408,0,0,0,816
24574,RM-1208B,12/9/2014,816,0,0,0,0,0,816
24685,RM-1208B,3/30/2015,816,0,0,0,0,0,816
25129,RM-1212,7/30/2014,816,0,0,0,0,0,816
25259,RM-1212,12/9/2014,816,0,0,0,0,0,816
26484,RM-1213A,7/30/2014,0,0,816,0,0,0,816
27017,RM-1217,2/28/2014,816,0,0,0,0,0,816
27049,RM-1217,4/1/2014,816,0,0,0,0,0,816
27169,RM-1217,7/30/2014,816,0,0,0,0,0,816
27777,RM-1218,5/11/2014,0,0,0,816,0,0,816
27987,RM-1218,12/9/2014,816,0,0,0,0,0,816
28098,RM-1218,3/30/2015,816,0,0,0,0,0,816
28545,RM-1221,7/30/2014,0,0,816,0,0,0,816
29230,RM-1223,7/30/2014,816,0,0,0,0,0,816
29360,RM-1223,12/9/2014,816,0,0,0,0,0,816
29471,RM-1223,3/30/2015,0,0,816,0,0,0,816
30156,RM-1224,3/30/2015,816,0,0,0,0,0,816
30603,RM-1229,7/30/2014,0,0,816,0,0,0,816
30733,RM-1229,12/9/2014,0,0,816,0,0,0,816
30844,RM-1229,3/30/2015,0,0,816,0,0,0,816
32630,RM-1236,7/30/2014,0,0,816,0,0,0,816
32760,RM-1236,12/9/2014,816,0,0,0,0,0,816
32871,RM-1236,3/30/2015,816,0,0,0,0,0,816
33598,RM-4xxx,12/9/2014,0,0,0,0,816,0,816
33653,RM-4xxx,2/2/2015,0,0,0,0,816,0,816
34021,RM-B102C,12/9/2014,816,0,0,0,0,0,816
34132,RM-B102C,3/30/2015,816,0,0,0,0,0,816
35800,RM-B109,7/23/2014,408,0,408,0,0,0,816
36413,RM-B200B,5/10/2014,0,816,0,0,0,0,816
36494,RM-B200B,7/30/2014,0,0,816,0,0,0,816
36731,RM-B200B,3/30/2015,0,0,816,0,0,0,816
37175,RM-B200C,7/30/2014,816,0,0,0,0,0,816
37305,RM-B200C,12/9/2014,816,0,0,0,0,0,816
37416,RM-B200C,3/30/2015,816,0,0,0,0,0,816
39116,RM-B220,4/1/2014,816,0,0,0,0,0,816
39236,RM-B220,7/30/2014,816,0,0,0,0,0,816
39924,RM-B222,7/30/2014,816,0,0,0,0,0,816
40054,RM-B222,12/9/2014,816,0,0,0,0,0,816
41985,RM-B230,7/30/2014,816,0,0,0,0,0,816
43236,RM-B240,7/30/2014,0,0,816,0,0,0,816
43366,RM-B240,12/9/2014,0,0,816,0,0,0,816
43477,RM-B240,3/30/2015,0,0,816,0,0,0,816
44087,RM-B240A,3/30/2015,0,0,816,0,0,0,816
44531,RM-B250,7/30/2014,0,0,816,0,0,0,816
45096,RM-B250A,4/1/2014,816,0,0,0,0,0,816
45215,RM-B250A,7/30/2014,816,0,0,0,0,0,816
45345,RM-B250A,12/9/2014,816,0,0,0,0,0,816
45456,RM-B250A,3/30/2015,816,0,0,0,0,0,816
45900,RM-B260,7/30/2014,816,0,0,0,0,0,816
46141,RM-B260,3/30/2015,0,0,816,0,0,0,816
48068,RM-B275,12/9/2014,816,0,0,0,0,0,816
48179,RM-B275,3/30/2015,816,0,0,0,0,0,816
389,RM-1100A,8/4/2014,813,0,0,0,0,0,813
403,RM-1100A,8/18/2014,813,0,0,0,0,0,813
1759,RM-1102,8/4/2014,813,0,0,0,0,0,813
1773,RM-1102,8/18/2014,813,0,0,0,0,0,813
1939,RM-1102,2/2/2015,813,0,0,0,0,0,813
4634,RM-1108,2/2/2015,0,0,813,0,0,0,813
5826,RM-1110,8/4/2014,0,0,813,0,0,0,813
5840,RM-1110,8/18/2014,0,0,813,0,0,0,813
6511,RM-1113,8/4/2014,0,0,813,0,0,0,813
6525,RM-1113,8/18/2014,0,0,813,0,0,0,813
9915,RM-1123,8/4/2014,813,0,0,0,0,0,813
9929,RM-1123,8/18/2014,813,0,0,0,0,0,813
10095,RM-1123,2/2/2015,813,0,0,0,0,0,813
12697,RM-1130,2/2/2015,0,0,813,0,0,0,813
13205,RM-1132,8/4/2014,0,0,813,0,0,0,813
13219,RM-1132,8/18/2014,0,0,813,0,0,0,813
13385,RM-1132,2/2/2015,0,0,813,0,0,0,813
14412,RM-1134,8/4/2014,813,0,0,0,0,0,813
14426,RM-1134,8/18/2014,813,0,0,0,0,0,813
15682,RM-1144,8/4/2014,0,0,813,0,0,0,813
15696,RM-1144,8/18/2014,0,0,813,0,0,0,813
16340,RM-1145,8/4/2014,0,0,813,0,0,0,813
16354,RM-1145,8/18/2014,0,0,813,0,0,0,813
16520,RM-1145,2/2/2015,0,0,813,0,0,0,813
17709,RM-1151,8/4/2014,813,0,0,0,0,0,813
17723,RM-1151,8/18/2014,813,0,0,0,0,0,813
19082,RM-1155,8/4/2014,813,0,0,0,0,0,813
19096,RM-1155,8/18/2014,813,0,0,0,0,0,813
19262,RM-1155,2/2/2015,813,0,0,0,0,0,813
19938,RM-1156,2/2/2015,0,0,813,0,0,0,813
23761,RM-1208,8/4/2014,813,0,0,0,0,0,813
23775,RM-1208,8/18/2014,813,0,0,0,0,0,813
24629,RM-1208B,2/2/2015,813,0,0,0,0,0,813
25134,RM-1212,8/4/2014,813,0,0,0,0,0,813
25148,RM-1212,8/18/2014,813,0,0,0,0,0,813
26489,RM-1213A,8/4/2014,0,0,813,0,0,0,813
26503,RM-1213A,8/18/2014,0,0,813,0,0,0,813
27174,RM-1217,8/4/2014,813,0,0,0,0,0,813
27188,RM-1217,8/18/2014,813,0,0,0,0,0,813
28042,RM-1218,2/2/2015,813,0,0,0,0,0,813
28550,RM-1221,8/4/2014,0,0,813,0,0,0,813
28564,RM-1221,8/18/2014,0,0,813,0,0,0,813
29235,RM-1223,8/4/2014,813,0,0,0,0,0,813
29249,RM-1223,8/18/2014,813,0,0,0,0,0,813
30100,RM-1224,2/2/2015,813,0,0,0,0,0,813
30608,RM-1229,8/4/2014,0,0,813,0,0,0,813
30622,RM-1229,8/18/2014,0,0,813,0,0,0,813
30788,RM-1229,2/2/2015,0,0,813,0,0,0,813
32815,RM-1236,2/2/2015,813,0,0,0,0,0,813
34076,RM-B102C,2/2/2015,813,0,0,0,0,0,813
36499,RM-B200B,8/4/2014,0,0,813,0,0,0,813
36513,RM-B200B,8/18/2014,0,0,813,0,0,0,813
36675,RM-B200B,2/2/2015,0,0,813,0,0,0,813
37180,RM-B200C,8/4/2014,813,0,0,0,0,0,813
37194,RM-B200C,8/18/2014,813,0,0,0,0,0,813
37360,RM-B200C,2/2/2015,813,0,0,0,0,0,813
38736,RM-B215,2/2/2015,813,0,0,0,0,0,813
39241,RM-B220,8/4/2014,813,0,0,0,0,0,813
39255,RM-B220,8/18/2014,813,0,0,0,0,0,813
39929,RM-B222,8/4/2014,813,0,0,0,0,0,813
39943,RM-B222,8/18/2014,813,0,0,0,0,0,813
41990,RM-B230,8/4/2014,813,0,0,0,0,0,813
42004,RM-B230,8/18/2014,813,0,0,0,0,0,813
43241,RM-B240,8/4/2014,0,0,813,0,0,0,813
43255,RM-B240,8/18/2014,0,0,813,0,0,0,813
43421,RM-B240,2/2/2015,0,0,813,0,0,0,813
44031,RM-B240A,2/2/2015,0,0,813,0,0,0,813
44536,RM-B250,8/4/2014,0,0,813,0,0,0,813
44550,RM-B250,8/18/2014,0,0,813,0,0,0,813
45220,RM-B250A,8/4/2014,813,0,0,0,0,0,813
45234,RM-B250A,8/18/2014,813,0,0,0,0,0,813
45400,RM-B250A,2/2/2015,813,0,0,0,0,0,813
45905,RM-B260,8/4/2014,813,0,0,0,0,0,813
45919,RM-B260,8/18/2014,813,0,0,0,0,0,813
46085,RM-B260,2/2/2015,0,0,813,0,0,0,813
48123,RM-B275,2/2/2015,813,0,0,0,0,0,813
404,RM-1100A,8/19/2014,810,0,0,0,0,0,810
499,RM-1100A,11/24/2014,810,0,0,0,0,0,810
500,RM-1100A,11/25/2014,810,0,0,0,0,0,810
993,RM-1100D,5/15/2014,0,0,0,810,0,0,810
1774,RM-1102,8/19/2014,810,0,0,0,0,0,810
1869,RM-1102,11/24/2014,810,0,0,0,0,0,810
1870,RM-1102,11/25/2014,810,0,0,0,0,0,810
5841,RM-1110,8/19/2014,0,0,810,0,0,0,810
6526,RM-1113,8/19/2014,0,0,810,0,0,0,810
9930,RM-1123,8/19/2014,810,0,0,0,0,0,810
10025,RM-1123,11/24/2014,810,0,0,0,0,0,810
10026,RM-1123,11/25/2014,810,0,0,0,0,0,810
12627,RM-1130,11/24/2014,0,0,810,0,0,0,810
12628,RM-1130,11/25/2014,0,0,810,0,0,0,810
13220,RM-1132,8/19/2014,0,0,810,0,0,0,810
13315,RM-1132,11/24/2014,0,0,810,0,0,0,810
13316,RM-1132,11/25/2014,0,0,810,0,0,0,810
14427,RM-1134,8/19/2014,810,0,0,0,0,0,810
14522,RM-1134,11/24/2014,810,0,0,0,0,0,810
14523,RM-1134,11/25/2014,810,0,0,0,0,0,810
15697,RM-1144,8/19/2014,0,0,810,0,0,0,810
15792,RM-1144,11/24/2014,0,0,810,0,0,0,810
15793,RM-1144,11/25/2014,0,0,810,0,0,0,810
16355,RM-1145,8/19/2014,0,0,810,0,0,0,810
16450,RM-1145,11/24/2014,0,0,810,0,0,0,810
16451,RM-1145,11/25/2014,0,0,810,0,0,0,810
17724,RM-1151,8/19/2014,810,0,0,0,0,0,810
19097,RM-1155,8/19/2014,810,0,0,0,0,0,810
19192,RM-1155,11/24/2014,810,0,0,0,0,0,810
19193,RM-1155,11/25/2014,810,0,0,0,0,0,810
19868,RM-1156,11/24/2014,0,0,810,0,0,0,810
19869,RM-1156,11/25/2014,0,0,810,0,0,0,810
24559,RM-1208B,11/24/2014,810,0,0,0,0,0,810
24560,RM-1208B,11/25/2014,810,0,0,0,0,0,810
25149,RM-1212,8/19/2014,810,0,0,0,0,0,810
25244,RM-1212,11/24/2014,810,0,0,0,0,0,810
25245,RM-1212,11/25/2014,810,0,0,0,0,0,810
26504,RM-1213A,8/19/2014,0,0,810,0,0,0,810
27189,RM-1217,8/19/2014,810,0,0,0,0,0,810
27775,RM-1218,5/9/2014,0,0,0,810,0,0,810
27972,RM-1218,11/24/2014,810,0,0,0,0,0,810
27973,RM-1218,11/25/2014,810,0,0,0,0,0,810
28565,RM-1221,8/19/2014,0,0,810,0,0,0,810
29250,RM-1223,8/19/2014,810,0,0,0,0,0,810
29345,RM-1223,11/24/2014,810,0,0,0,0,0,810
29346,RM-1223,11/25/2014,810,0,0,0,0,0,810
30623,RM-1229,8/19/2014,0,0,810,0,0,0,810
30718,RM-1229,11/24/2014,0,0,810,0,0,0,810
30719,RM-1229,11/25/2014,0,0,810,0,0,0,810
32745,RM-1236,11/24/2014,810,0,0,0,0,0,810
32746,RM-1236,11/25/2014,810,0,0,0,0,0,810
33583,RM-4xxx,11/24/2014,0,0,0,0,810,0,810
33584,RM-4xxx,11/25/2014,0,0,0,0,810,0,810
36514,RM-B200B,8/19/2014,0,0,810,0,0,0,810
37195,RM-B200C,8/19/2014,810,0,0,0,0,0,810
37290,RM-B200C,11/24/2014,810,0,0,0,0,0,810
37291,RM-B200C,11/25/2014,810,0,0,0,0,0,810
39256,RM-B220,8/19/2014,810,0,0,0,0,0,810
39944,RM-B222,8/19/2014,810,0,0,0,0,0,810
40039,RM-B222,11/24/2014,810,0,0,0,0,0,810
40040,RM-B222,11/25/2014,810,0,0,0,0,0,810
42005,RM-B230,8/19/2014,810,0,0,0,0,0,810
43256,RM-B240,8/19/2014,0,0,810,0,0,0,810
43351,RM-B240,11/24/2014,0,0,810,0,0,0,810
43352,RM-B240,11/25/2014,0,0,810,0,0,0,810
43961,RM-B240A,11/24/2014,0,0,810,0,0,0,810
43962,RM-B240A,11/25/2014,0,0,810,0,0,0,810
44551,RM-B250,8/19/2014,0,0,810,0,0,0,810
45235,RM-B250A,8/19/2014,810,0,0,0,0,0,810
45330,RM-B250A,11/24/2014,810,0,0,0,0,0,810
45331,RM-B250A,11/25/2014,810,0,0,0,0,0,810
45822,RM-B260,5/13/2014,0,0,0,810,0,0,810
45920,RM-B260,8/19/2014,810,0,0,0,0,0,810
47190,RM-B270,5/11/2014,0,0,0,810,0,0,810
47194,RM-B270,5/15/2014,0,0,0,810,0,0,810
48053,RM-B275,11/24/2014,810,0,0,0,0,0,810
48054,RM-B275,11/25/2014,810,0,0,0,0,0,810
1934,RM-1102,1/28/2015,807,0,0,0,0,0,807
4629,RM-1108,1/28/2015,0,0,807,0,0,0,807
10090,RM-1123,1/28/2015,807,0,0,0,0,0,807
12692,RM-1130,1/28/2015,0,0,807,0,0,0,807
13380,RM-1132,1/28/2015,0,0,807,0,0,0,807
16515,RM-1145,1/28/2015,0,0,807,0,0,0,807
19257,RM-1155,1/28/2015,807,0,0,0,0,0,807
19933,RM-1156,1/28/2015,0,0,807,0,0,0,807
24624,RM-1208B,1/28/2015,807,0,0,0,0,0,807
28037,RM-1218,1/28/2015,807,0,0,0,0,0,807
30095,RM-1224,1/28/2015,807,0,0,0,0,0,807
30783,RM-1229,1/28/2015,0,0,807,0,0,0,807
32810,RM-1236,1/28/2015,807,0,0,0,0,0,807
33648,RM-4xxx,1/28/2015,0,0,0,0,807,0,807
34071,RM-B102C,1/28/2015,807,0,0,0,0,0,807
36670,RM-B200B,1/28/2015,0,0,807,0,0,0,807
37355,RM-B200C,1/28/2015,807,0,0,0,0,0,807
38731,RM-B215,1/28/2015,807,0,0,0,0,0,807
43416,RM-B240,1/28/2015,0,0,807,0,0,0,807
44026,RM-B240A,1/28/2015,0,0,807,0,0,0,807
45395,RM-B250A,1/28/2015,807,0,0,0,0,0,807
46080,RM-B260,1/28/2015,0,0,807,0,0,0,807
48118,RM-B275,1/28/2015,807,0,0,0,0,0,807
496,RM-1100A,11/21/2014,804,0,0,0,0,0,804
497,RM-1100A,11/22/2014,804,0,0,0,0,0,804
498,RM-1100A,11/23/2014,804,0,0,0,0,0,804
1866,RM-1102,11/21/2014,804,0,0,0,0,0,804
1867,RM-1102,11/22/2014,804,0,0,0,0,0,804
1868,RM-1102,11/23/2014,804,0,0,0,0,0,804
1938,RM-1102,2/1/2015,804,0,0,0,0,0,804
1943,RM-1102,2/6/2015,804,0,0,0,0,0,804
1946,RM-1102,2/9/2015,804,0,0,0,0,0,804
4633,RM-1108,2/1/2015,0,0,804,0,0,0,804
4638,RM-1108,2/6/2015,0,0,804,0,0,0,804
4641,RM-1108,2/9/2015,0,0,804,0,0,0,804
6618,RM-1113,11/21/2014,0,0,804,0,0,0,804
6619,RM-1113,11/22/2014,0,0,804,0,0,0,804
6620,RM-1113,11/23/2014,0,0,804,0,0,0,804
6695,RM-1113,2/6/2015,804,0,0,0,0,0,804
6698,RM-1113,2/9/2015,804,0,0,0,0,0,804
10022,RM-1123,11/21/2014,804,0,0,0,0,0,804
10023,RM-1123,11/22/2014,804,0,0,0,0,0,804
10024,RM-1123,11/23/2014,804,0,0,0,0,0,804
10094,RM-1123,2/1/2015,804,0,0,0,0,0,804
10099,RM-1123,2/6/2015,804,0,0,0,0,0,804
10102,RM-1123,2/9/2015,804,0,0,0,0,0,804
12624,RM-1130,11/21/2014,0,0,804,0,0,0,804
12625,RM-1130,11/22/2014,0,0,804,0,0,0,804
12626,RM-1130,11/23/2014,0,0,804,0,0,0,804
12696,RM-1130,2/1/2015,0,0,804,0,0,0,804
12701,RM-1130,2/6/2015,0,0,804,0,0,0,804
12704,RM-1130,2/9/2015,0,0,804,0,0,0,804
13312,RM-1132,11/21/2014,0,0,804,0,0,0,804
13313,RM-1132,11/22/2014,0,0,804,0,0,0,804
13314,RM-1132,11/23/2014,0,0,804,0,0,0,804
13384,RM-1132,2/1/2015,0,0,804,0,0,0,804
13389,RM-1132,2/6/2015,0,0,804,0,0,0,804
13392,RM-1132,2/9/2015,0,0,804,0,0,0,804
14519,RM-1134,11/21/2014,804,0,0,0,0,0,804
14520,RM-1134,11/22/2014,804,0,0,0,0,0,804
14521,RM-1134,11/23/2014,804,0,0,0,0,0,804
15789,RM-1144,11/21/2014,0,0,804,0,0,0,804
15790,RM-1144,11/22/2014,0,0,804,0,0,0,804
15791,RM-1144,11/23/2014,0,0,804,0,0,0,804
16447,RM-1145,11/21/2014,0,0,804,0,0,0,804
16448,RM-1145,11/22/2014,0,0,804,0,0,0,804
16449,RM-1145,11/23/2014,0,0,804,0,0,0,804
16519,RM-1145,2/1/2015,0,0,804,0,0,0,804
16524,RM-1145,2/6/2015,0,0,804,0,0,0,804
16527,RM-1145,2/9/2015,0,0,804,0,0,0,804
19189,RM-1155,11/21/2014,804,0,0,0,0,0,804
19190,RM-1155,11/22/2014,804,0,0,0,0,0,804
19191,RM-1155,11/23/2014,804,0,0,0,0,0,804
19261,RM-1155,2/1/2015,804,0,0,0,0,0,804
19266,RM-1155,2/6/2015,804,0,0,0,0,0,804
19269,RM-1155,2/9/2015,804,0,0,0,0,0,804
19865,RM-1156,11/21/2014,0,0,804,0,0,0,804
19866,RM-1156,11/22/2014,0,0,804,0,0,0,804
19867,RM-1156,11/23/2014,0,0,804,0,0,0,804
19937,RM-1156,2/1/2015,0,0,804,0,0,0,804
20987,RM-1200B,5/8/2014,0,804,0,0,0,0,804
21947,RM-1200C,2/9/2015,804,0,0,0,0,0,804
24556,RM-1208B,11/21/2014,804,0,0,0,0,0,804
24557,RM-1208B,11/22/2014,804,0,0,0,0,0,804
24558,RM-1208B,11/23/2014,804,0,0,0,0,0,804
24628,RM-1208B,2/1/2015,804,0,0,0,0,0,804
24633,RM-1208B,2/6/2015,804,0,0,0,0,0,804
24636,RM-1208B,2/9/2015,804,0,0,0,0,0,804
25241,RM-1212,11/21/2014,804,0,0,0,0,0,804
25242,RM-1212,11/22/2014,804,0,0,0,0,0,804
25243,RM-1212,11/23/2014,804,0,0,0,0,0,804
27969,RM-1218,11/21/2014,804,0,0,0,0,0,804
27970,RM-1218,11/22/2014,804,0,0,0,0,0,804
27971,RM-1218,11/23/2014,804,0,0,0,0,0,804
28041,RM-1218,2/1/2015,804,0,0,0,0,0,804
28046,RM-1218,2/6/2015,804,0,0,0,0,0,804
28049,RM-1218,2/9/2015,804,0,0,0,0,0,804
29342,RM-1223,11/21/2014,804,0,0,0,0,0,804
29343,RM-1223,11/22/2014,804,0,0,0,0,0,804
29344,RM-1223,11/23/2014,804,0,0,0,0,0,804
29833,RM-1224,5/9/2014,0,0,0,804,0,0,804
30099,RM-1224,2/1/2015,804,0,0,0,0,0,804
30104,RM-1224,2/6/2015,804,0,0,0,0,0,804
30107,RM-1224,2/9/2015,804,0,0,0,0,0,804
30715,RM-1229,11/21/2014,0,0,804,0,0,0,804
30716,RM-1229,11/22/2014,0,0,804,0,0,0,804
30717,RM-1229,11/23/2014,0,0,804,0,0,0,804
30787,RM-1229,2/1/2015,0,0,804,0,0,0,804
30792,RM-1229,2/6/2015,0,0,804,0,0,0,804
30795,RM-1229,2/9/2015,0,0,804,0,0,0,804
32742,RM-1236,11/21/2014,804,0,0,0,0,0,804
32743,RM-1236,11/22/2014,804,0,0,0,0,0,804
32744,RM-1236,11/23/2014,804,0,0,0,0,0,804
32814,RM-1236,2/1/2015,804,0,0,0,0,0,804
32819,RM-1236,2/6/2015,804,0,0,0,0,0,804
32822,RM-1236,2/9/2015,804,0,0,0,0,0,804
33580,RM-4xxx,11/21/2014,0,0,0,0,804,0,804
33581,RM-4xxx,11/22/2014,0,0,0,0,804,0,804
33582,RM-4xxx,11/23/2014,0,0,0,0,804,0,804
33652,RM-4xxx,2/1/2015,0,0,0,0,804,0,804
33657,RM-4xxx,2/6/2015,0,0,0,0,804,0,804
34075,RM-B102C,2/1/2015,804,0,0,0,0,0,804
34083,RM-B102C,2/9/2015,804,0,0,0,0,0,804
36674,RM-B200B,2/1/2015,0,0,804,0,0,0,804
36679,RM-B200B,2/6/2015,0,0,804,0,0,0,804
36682,RM-B200B,2/9/2015,0,0,804,0,0,0,804
37287,RM-B200C,11/21/2014,804,0,0,0,0,0,804
37288,RM-B200C,11/22/2014,804,0,0,0,0,0,804
37289,RM-B200C,11/23/2014,804,0,0,0,0,0,804
37359,RM-B200C,2/1/2015,804,0,0,0,0,0,804
37364,RM-B200C,2/6/2015,804,0,0,0,0,0,804
37367,RM-B200C,2/9/2015,804,0,0,0,0,0,804
38735,RM-B215,2/1/2015,804,0,0,0,0,0,804
38740,RM-B215,2/6/2015,804,0,0,0,0,0,804
38743,RM-B215,2/9/2015,804,0,0,0,0,0,804
40036,RM-B222,11/21/2014,804,0,0,0,0,0,804
40037,RM-B222,11/22/2014,804,0,0,0,0,0,804
40038,RM-B222,11/23/2014,804,0,0,0,0,0,804
43348,RM-B240,11/21/2014,0,0,804,0,0,0,804
43349,RM-B240,11/22/2014,0,0,804,0,0,0,804
43350,RM-B240,11/23/2014,0,0,804,0,0,0,804
43420,RM-B240,2/1/2015,0,0,804,0,0,0,804
43425,RM-B240,2/6/2015,0,0,804,0,0,0,804
43428,RM-B240,2/9/2015,0,0,804,0,0,0,804
43958,RM-B240A,11/21/2014,0,0,804,0,0,0,804
43959,RM-B240A,11/22/2014,0,0,804,0,0,0,804
43960,RM-B240A,11/23/2014,0,0,804,0,0,0,804
44030,RM-B240A,2/1/2015,0,0,804,0,0,0,804
44035,RM-B240A,2/6/2015,0,0,804,0,0,0,804
44038,RM-B240A,2/9/2015,0,0,804,0,0,0,804
45327,RM-B250A,11/21/2014,804,0,0,0,0,0,804
45328,RM-B250A,11/22/2014,804,0,0,0,0,0,804
45329,RM-B250A,11/23/2014,804,0,0,0,0,0,804
45399,RM-B250A,2/1/2015,804,0,0,0,0,0,804
45404,RM-B250A,2/6/2015,804,0,0,0,0,0,804
45407,RM-B250A,2/9/2015,804,0,0,0,0,0,804
45820,RM-B260,5/11/2014,0,0,0,804,0,0,804
45824,RM-B260,5/15/2014,0,0,0,804,0,0,804
46084,RM-B260,2/1/2015,0,0,804,0,0,0,804
46089,RM-B260,2/6/2015,0,0,804,0,0,0,804
46092,RM-B260,2/9/2015,0,0,804,0,0,0,804
48052,RM-B275,11/23/2014,804,0,0,0,0,0,804
48122,RM-B275,2/1/2015,804,0,0,0,0,0,804
48127,RM-B275,2/6/2015,804,0,0,0,0,0,804
48130,RM-B275,2/9/2015,804,0,0,0,0,0,804
494,RM-1100A,11/19/2014,801,0,0,0,0,0,801
1864,RM-1102,11/19/2014,801,0,0,0,0,0,801
1947,RM-1102,2/10/2015,801,0,0,0,0,0,801
4642,RM-1108,2/10/2015,0,0,801,0,0,0,801
6616,RM-1113,11/19/2014,0,0,801,0,0,0,801
6699,RM-1113,2/10/2015,801,0,0,0,0,0,801
10020,RM-1123,11/19/2014,801,0,0,0,0,0,801
10103,RM-1123,2/10/2015,801,0,0,0,0,0,801
12622,RM-1130,11/19/2014,0,0,801,0,0,0,801
12705,RM-1130,2/10/2015,0,0,801,0,0,0,801
13310,RM-1132,11/19/2014,0,0,801,0,0,0,801
13393,RM-1132,2/10/2015,0,0,801,0,0,0,801
14517,RM-1134,11/19/2014,801,0,0,0,0,0,801
15787,RM-1144,11/19/2014,0,0,801,0,0,0,801
16445,RM-1145,11/19/2014,0,0,801,0,0,0,801
16528,RM-1145,2/10/2015,0,0,801,0,0,0,801
19187,RM-1155,11/19/2014,801,0,0,0,0,0,801
19270,RM-1155,2/10/2015,801,0,0,0,0,0,801
19863,RM-1156,11/19/2014,0,0,801,0,0,0,801
21948,RM-1200C,2/10/2015,801,0,0,0,0,0,801
24554,RM-1208B,11/19/2014,801,0,0,0,0,0,801
24637,RM-1208B,2/10/2015,801,0,0,0,0,0,801
25239,RM-1212,11/19/2014,801,0,0,0,0,0,801
27967,RM-1218,11/19/2014,801,0,0,0,0,0,801
28050,RM-1218,2/10/2015,801,0,0,0,0,0,801
29340,RM-1223,11/19/2014,801,0,0,0,0,0,801
30108,RM-1224,2/10/2015,801,0,0,0,0,0,801
30713,RM-1229,11/19/2014,0,0,801,0,0,0,801
30796,RM-1229,2/10/2015,0,0,801,0,0,0,801
32740,RM-1236,11/19/2014,801,0,0,0,0,0,801
32823,RM-1236,2/10/2015,801,0,0,0,0,0,801
33577,RM-4xxx,11/18/2014,0,0,0,0,801,0,801
34080,RM-B102C,2/6/2015,801,0,0,0,0,0,801
34084,RM-B102C,2/10/2015,801,0,0,0,0,0,801
36683,RM-B200B,2/10/2015,0,0,801,0,0,0,801
37285,RM-B200C,11/19/2014,801,0,0,0,0,0,801
37368,RM-B200C,2/10/2015,801,0,0,0,0,0,801
38744,RM-B215,2/10/2015,801,0,0,0,0,0,801
40034,RM-B222,11/19/2014,801,0,0,0,0,0,801
43346,RM-B240,11/19/2014,0,0,801,0,0,0,801
43429,RM-B240,2/10/2015,0,0,801,0,0,0,801
43956,RM-B240A,11/19/2014,0,0,801,0,0,0,801
44039,RM-B240A,2/10/2015,0,0,801,0,0,0,801
45325,RM-B250A,11/19/2014,801,0,0,0,0,0,801
45408,RM-B250A,2/10/2015,801,0,0,0,0,0,801
46093,RM-B260,2/10/2015,0,0,801,0,0,0,801
48131,RM-B275,2/10/2015,801,0,0,0,0,0,801
491,RM-1100A,11/16/2014,798,0,0,0,0,0,798
493,RM-1100A,11/18/2014,798,0,0,0,0,0,798
495,RM-1100A,11/20/2014,798,0,0,0,0,0,798
990,RM-1100D,5/12/2014,0,0,0,798,0,0,798
1861,RM-1102,11/16/2014,798,0,0,0,0,0,798
1863,RM-1102,11/18/2014,798,0,0,0,0,0,798
1865,RM-1102,11/20/2014,798,0,0,0,0,0,798
1948,RM-1102,2/11/2015,798,0,0,0,0,0,798
4643,RM-1108,2/11/2015,0,0,798,0,0,0,798
6613,RM-1113,11/16/2014,0,0,798,0,0,0,798
6615,RM-1113,11/18/2014,0,0,798,0,0,0,798
6617,RM-1113,11/20/2014,0,0,798,0,0,0,798
6700,RM-1113,2/11/2015,798,0,0,0,0,0,798
8099,RM-1116,4/5/2015,0,0,798,0,0,0,798
10017,RM-1123,11/16/2014,798,0,0,0,0,0,798
10019,RM-1123,11/18/2014,798,0,0,0,0,0,798
10021,RM-1123,11/20/2014,798,0,0,0,0,0,798
10104,RM-1123,2/11/2015,798,0,0,0,0,0,798
12619,RM-1130,11/16/2014,0,0,798,0,0,0,798
12621,RM-1130,11/18/2014,0,0,798,0,0,0,798
12623,RM-1130,11/20/2014,0,0,798,0,0,0,798
12706,RM-1130,2/11/2015,0,0,798,0,0,0,798
13307,RM-1132,11/16/2014,0,0,798,0,0,0,798
13309,RM-1132,11/18/2014,0,0,798,0,0,0,798
13311,RM-1132,11/20/2014,0,0,798,0,0,0,798
13394,RM-1132,2/11/2015,0,0,798,0,0,0,798
14514,RM-1134,11/16/2014,798,0,0,0,0,0,798
14516,RM-1134,11/18/2014,798,0,0,0,0,0,798
14518,RM-1134,11/20/2014,798,0,0,0,0,0,798
15784,RM-1144,11/16/2014,0,0,798,0,0,0,798
15786,RM-1144,11/18/2014,0,0,798,0,0,0,798
15788,RM-1144,11/20/2014,0,0,798,0,0,0,798
16442,RM-1145,11/16/2014,0,0,798,0,0,0,798
16444,RM-1145,11/18/2014,0,0,798,0,0,0,798
16446,RM-1145,11/20/2014,0,0,798,0,0,0,798
16529,RM-1145,2/11/2015,0,0,798,0,0,0,798
19184,RM-1155,11/16/2014,798,0,0,0,0,0,798
19186,RM-1155,11/18/2014,798,0,0,0,0,0,798
19188,RM-1155,11/20/2014,798,0,0,0,0,0,798
19860,RM-1156,11/16/2014,0,0,798,0,0,0,798
19862,RM-1156,11/18/2014,0,0,798,0,0,0,798
19864,RM-1156,11/20/2014,0,0,798,0,0,0,798
20328,RM-1200A,5/12/2014,0,0,0,798,0,0,798
21949,RM-1200C,2/11/2015,798,0,0,0,0,0,798
24551,RM-1208B,11/16/2014,798,0,0,0,0,0,798
24553,RM-1208B,11/18/2014,798,0,0,0,0,0,798
24555,RM-1208B,11/20/2014,798,0,0,0,0,0,798
24638,RM-1208B,2/11/2015,798,0,0,0,0,0,798
25236,RM-1212,11/16/2014,798,0,0,0,0,0,798
25238,RM-1212,11/18/2014,798,0,0,0,0,0,798
25240,RM-1212,11/20/2014,798,0,0,0,0,0,798
27964,RM-1218,11/16/2014,798,0,0,0,0,0,798
27966,RM-1218,11/18/2014,798,0,0,0,0,0,798
27968,RM-1218,11/20/2014,798,0,0,0,0,0,798
28051,RM-1218,2/11/2015,798,0,0,0,0,0,798
29337,RM-1223,11/16/2014,798,0,0,0,0,0,798
29339,RM-1223,11/18/2014,798,0,0,0,0,0,798
29341,RM-1223,11/20/2014,798,0,0,0,0,0,798
30109,RM-1224,2/11/2015,798,0,0,0,0,0,798
30710,RM-1229,11/16/2014,0,0,798,0,0,0,798
30712,RM-1229,11/18/2014,0,0,798,0,0,0,798
30714,RM-1229,11/20/2014,0,0,798,0,0,0,798
30797,RM-1229,2/11/2015,0,0,798,0,0,0,798
32737,RM-1236,11/16/2014,798,0,0,0,0,0,798
32739,RM-1236,11/18/2014,798,0,0,0,0,0,798
32741,RM-1236,11/20/2014,798,0,0,0,0,0,798
32824,RM-1236,2/11/2015,798,0,0,0,0,0,798
33578,RM-4xxx,11/19/2014,0,0,0,0,798,0,798
33579,RM-4xxx,11/20/2014,0,0,0,0,798,0,798
34085,RM-B102C,2/11/2015,798,0,0,0,0,0,798
36684,RM-B200B,2/11/2015,0,0,798,0,0,0,798
37284,RM-B200C,11/18/2014,798,0,0,0,0,0,798
37286,RM-B200C,11/20/2014,798,0,0,0,0,0,798
37369,RM-B200C,2/11/2015,798,0,0,0,0,0,798
38745,RM-B215,2/11/2015,798,0,0,0,0,0,798
40031,RM-B222,11/16/2014,798,0,0,0,0,0,798
40033,RM-B222,11/18/2014,798,0,0,0,0,0,798
40035,RM-B222,11/20/2014,798,0,0,0,0,0,798
43345,RM-B240,11/18/2014,0,0,798,0,0,0,798
43347,RM-B240,11/20/2014,0,0,798,0,0,0,798
43430,RM-B240,2/11/2015,0,0,798,0,0,0,798
43953,RM-B240A,11/16/2014,0,0,798,0,0,0,798
43955,RM-B240A,11/18/2014,0,0,798,0,0,0,798
43957,RM-B240A,11/20/2014,0,0,798,0,0,0,798
44040,RM-B240A,2/11/2015,0,0,798,0,0,0,798
45322,RM-B250A,11/16/2014,798,0,0,0,0,0,798
45324,RM-B250A,11/18/2014,798,0,0,0,0,0,798
45326,RM-B250A,11/20/2014,798,0,0,0,0,0,798
45409,RM-B250A,2/11/2015,798,0,0,0,0,0,798
46094,RM-B260,2/11/2015,0,0,798,0,0,0,798
47192,RM-B270,5/13/2014,0,0,0,798,0,0,798
48132,RM-B275,2/11/2015,798,0,0,0,0,0,798
562,RM-1100A,1/26/2015,795,0,0,0,0,0,795
1945,RM-1102,2/8/2015,795,0,0,0,0,0,795
4640,RM-1108,2/8/2015,0,0,795,0,0,0,795
6697,RM-1113,2/8/2015,795,0,0,0,0,0,795
10101,RM-1123,2/8/2015,795,0,0,0,0,0,795
12703,RM-1130,2/8/2015,0,0,795,0,0,0,795
12734,RM-1130,3/11/2015,0,0,795,0,0,0,795
13391,RM-1132,2/8/2015,0,0,795,0,0,0,795
16526,RM-1145,2/8/2015,0,0,795,0,0,0,795
19268,RM-1155,2/8/2015,795,0,0,0,0,0,795
21946,RM-1200C,2/8/2015,795,0,0,0,0,0,795
24635,RM-1208B,2/8/2015,795,0,0,0,0,0,795
28048,RM-1218,2/8/2015,795,0,0,0,0,0,795
30106,RM-1224,2/8/2015,795,0,0,0,0,0,795
30794,RM-1229,2/8/2015,0,0,795,0,0,0,795
32821,RM-1236,2/8/2015,795,0,0,0,0,0,795
33574,RM-4xxx,11/15/2014,0,0,0,0,795,0,795
33575,RM-4xxx,11/16/2014,0,0,0,0,795,0,795
33658,RM-4xxx,2/7/2015,0,0,0,0,795,0,795
34081,RM-B102C,2/7/2015,795,0,0,0,0,0,795
34082,RM-B102C,2/8/2015,795,0,0,0,0,0,795
36681,RM-B200B,2/8/2015,0,0,795,0,0,0,795
37281,RM-B200C,11/15/2014,795,0,0,0,0,0,795
37282,RM-B200C,11/16/2014,795,0,0,0,0,0,795
37366,RM-B200C,2/8/2015,795,0,0,0,0,0,795
38742,RM-B215,2/8/2015,795,0,0,0,0,0,795
43342,RM-B240,11/15/2014,0,0,795,0,0,0,795
43343,RM-B240,11/16/2014,0,0,795,0,0,0,795
43427,RM-B240,2/8/2015,0,0,795,0,0,0,795
44037,RM-B240A,2/8/2015,0,0,795,0,0,0,795
45406,RM-B250A,2/8/2015,795,0,0,0,0,0,795
46091,RM-B260,2/8/2015,0,0,795,0,0,0,795
48129,RM-B275,2/8/2015,795,0,0,0,0,0,795
489,RM-1100A,11/14/2014,792,0,0,0,0,0,792
490,RM-1100A,11/15/2014,792,0,0,0,0,0,792
492,RM-1100A,11/17/2014,792,0,0,0,0,0,792
1859,RM-1102,11/14/2014,792,0,0,0,0,0,792
1860,RM-1102,11/15/2014,792,0,0,0,0,0,792
1862,RM-1102,11/17/2014,792,0,0,0,0,0,792
1933,RM-1102,1/27/2015,792,0,0,0,0,0,792
1944,RM-1102,2/7/2015,792,0,0,0,0,0,792
3046,RM-1106,6/26/2014,0,0,0,792,0,0,792
4628,RM-1108,1/27/2015,0,0,792,0,0,0,792
4639,RM-1108,2/7/2015,0,0,792,0,0,0,792
6611,RM-1113,11/14/2014,0,0,792,0,0,0,792
6612,RM-1113,11/15/2014,0,0,792,0,0,0,792
6614,RM-1113,11/17/2014,0,0,792,0,0,0,792
6696,RM-1113,2/7/2015,792,0,0,0,0,0,792
10015,RM-1123,11/14/2014,792,0,0,0,0,0,792
10016,RM-1123,11/15/2014,792,0,0,0,0,0,792
10018,RM-1123,11/17/2014,792,0,0,0,0,0,792
10089,RM-1123,1/27/2015,792,0,0,0,0,0,792
10100,RM-1123,2/7/2015,792,0,0,0,0,0,792
12617,RM-1130,11/14/2014,0,0,792,0,0,0,792
12618,RM-1130,11/15/2014,0,0,792,0,0,0,792
12620,RM-1130,11/17/2014,0,0,792,0,0,0,792
12691,RM-1130,1/27/2015,0,0,792,0,0,0,792
12702,RM-1130,2/7/2015,0,0,792,0,0,0,792
13305,RM-1132,11/14/2014,0,0,792,0,0,0,792
13306,RM-1132,11/15/2014,0,0,792,0,0,0,792
13308,RM-1132,11/17/2014,0,0,792,0,0,0,792
13379,RM-1132,1/27/2015,0,0,792,0,0,0,792
13390,RM-1132,2/7/2015,0,0,792,0,0,0,792
14512,RM-1134,11/14/2014,792,0,0,0,0,0,792
14513,RM-1134,11/15/2014,792,0,0,0,0,0,792
14515,RM-1134,11/17/2014,792,0,0,0,0,0,792
15782,RM-1144,11/14/2014,0,0,792,0,0,0,792
15783,RM-1144,11/15/2014,0,0,792,0,0,0,792
15785,RM-1144,11/17/2014,0,0,792,0,0,0,792
16440,RM-1145,11/14/2014,0,0,792,0,0,0,792
16441,RM-1145,11/15/2014,0,0,792,0,0,0,792
16443,RM-1145,11/17/2014,0,0,792,0,0,0,792
16514,RM-1145,1/27/2015,0,0,792,0,0,0,792
16525,RM-1145,2/7/2015,0,0,792,0,0,0,792
16943,RM-1150,5/15/2014,0,0,0,792,0,0,792
19182,RM-1155,11/14/2014,792,0,0,0,0,0,792
19183,RM-1155,11/15/2014,792,0,0,0,0,0,792
19185,RM-1155,11/17/2014,792,0,0,0,0,0,792
19256,RM-1155,1/27/2015,792,0,0,0,0,0,792
19267,RM-1155,2/7/2015,792,0,0,0,0,0,792
19858,RM-1156,11/14/2014,0,0,792,0,0,0,792
19859,RM-1156,11/15/2014,0,0,792,0,0,0,792
19861,RM-1156,11/17/2014,0,0,792,0,0,0,792
19932,RM-1156,1/27/2015,0,0,792,0,0,0,792
21945,RM-1200C,2/7/2015,792,0,0,0,0,0,792
24549,RM-1208B,11/14/2014,792,0,0,0,0,0,792
24550,RM-1208B,11/15/2014,792,0,0,0,0,0,792
24552,RM-1208B,11/17/2014,792,0,0,0,0,0,792
24623,RM-1208B,1/27/2015,792,0,0,0,0,0,792
24634,RM-1208B,2/7/2015,792,0,0,0,0,0,792
25234,RM-1212,11/14/2014,792,0,0,0,0,0,792
25235,RM-1212,11/15/2014,792,0,0,0,0,0,792
25237,RM-1212,11/17/2014,792,0,0,0,0,0,792
27962,RM-1218,11/14/2014,792,0,0,0,0,0,792
27963,RM-1218,11/15/2014,792,0,0,0,0,0,792
27965,RM-1218,11/17/2014,792,0,0,0,0,0,792
28036,RM-1218,1/27/2015,792,0,0,0,0,0,792
28047,RM-1218,2/7/2015,792,0,0,0,0,0,792
29335,RM-1223,11/14/2014,792,0,0,0,0,0,792
29336,RM-1223,11/15/2014,792,0,0,0,0,0,792
29338,RM-1223,11/17/2014,792,0,0,0,0,0,792
30094,RM-1224,1/27/2015,792,0,0,0,0,0,792
30105,RM-1224,2/7/2015,792,0,0,0,0,0,792
30708,RM-1229,11/14/2014,0,0,792,0,0,0,792
30709,RM-1229,11/15/2014,0,0,792,0,0,0,792
30711,RM-1229,11/17/2014,0,0,792,0,0,0,792
30782,RM-1229,1/27/2015,0,0,792,0,0,0,792
30793,RM-1229,2/7/2015,0,0,792,0,0,0,792
32735,RM-1236,11/14/2014,792,0,0,0,0,0,792
32736,RM-1236,11/15/2014,792,0,0,0,0,0,792
32738,RM-1236,11/17/2014,792,0,0,0,0,0,792
32809,RM-1236,1/27/2015,792,0,0,0,0,0,792
32820,RM-1236,2/7/2015,792,0,0,0,0,0,792
33573,RM-4xxx,11/14/2014,0,0,0,0,792,0,792
33576,RM-4xxx,11/17/2014,0,0,0,0,792,0,792
33647,RM-4xxx,1/27/2015,0,0,0,0,792,0,792
33659,RM-4xxx,2/8/2015,0,0,0,0,792,0,792
34070,RM-B102C,1/27/2015,792,0,0,0,0,0,792
36669,RM-B200B,1/27/2015,0,0,792,0,0,0,792
36680,RM-B200B,2/7/2015,0,0,792,0,0,0,792
37280,RM-B200C,11/14/2014,792,0,0,0,0,0,792
37283,RM-B200C,11/17/2014,792,0,0,0,0,0,792
37354,RM-B200C,1/27/2015,792,0,0,0,0,0,792
37365,RM-B200C,2/7/2015,792,0,0,0,0,0,792
38730,RM-B215,1/27/2015,792,0,0,0,0,0,792
38741,RM-B215,2/7/2015,792,0,0,0,0,0,792
40029,RM-B222,11/14/2014,792,0,0,0,0,0,792
40030,RM-B222,11/15/2014,792,0,0,0,0,0,792
40032,RM-B222,11/17/2014,792,0,0,0,0,0,792
43341,RM-B240,11/14/2014,0,0,792,0,0,0,792
43344,RM-B240,11/17/2014,0,0,792,0,0,0,792
43415,RM-B240,1/27/2015,0,0,792,0,0,0,792
43426,RM-B240,2/7/2015,0,0,792,0,0,0,792
43951,RM-B240A,11/14/2014,0,0,792,0,0,0,792
43952,RM-B240A,11/15/2014,0,0,792,0,0,0,792
43954,RM-B240A,11/17/2014,0,0,792,0,0,0,792
44025,RM-B240A,1/27/2015,0,0,792,0,0,0,792
44036,RM-B240A,2/7/2015,0,0,792,0,0,0,792
45320,RM-B250A,11/14/2014,792,0,0,0,0,0,792
45321,RM-B250A,11/15/2014,792,0,0,0,0,0,792
45323,RM-B250A,11/17/2014,792,0,0,0,0,0,792
45394,RM-B250A,1/27/2015,792,0,0,0,0,0,792
45405,RM-B250A,2/7/2015,792,0,0,0,0,0,792
46079,RM-B260,1/27/2015,0,0,792,0,0,0,792
46090,RM-B260,2/7/2015,0,0,792,0,0,0,792
48117,RM-B275,1/27/2015,792,0,0,0,0,0,792
48128,RM-B275,2/7/2015,792,0,0,0,0,0,792
6728,RM-1113,3/11/2015,789,0,0,0,0,0,789
991,RM-1100D,5/13/2014,0,0,0,786,0,0,786
20324,RM-1200A,5/8/2014,0,0,0,786,0,0,786
20329,RM-1200A,5/13/2014,0,0,0,786,0,0,786
29835,RM-1224,5/11/2014,0,0,0,786,0,0,786
36412,RM-B200B,5/9/2014,0,786,0,0,0,0,786
43840,RM-B240A,5/10/2014,0,786,0,0,0,0,786
43841,RM-B240A,5/11/2014,0,786,0,0,0,0,786
45819,RM-B260,5/10/2014,0,0,0,786,0,0,786
47191,RM-B270,5/12/2014,0,0,0,786,0,0,786
411,RM-1100A,8/26/2014,783,0,0,0,0,0,783
1781,RM-1102,8/26/2014,783,0,0,0,0,0,783
5767,RM-1110,6/6/2014,0,0,783,0,0,0,783
5848,RM-1110,8/26/2014,0,0,783,0,0,0,783
6533,RM-1113,8/26/2014,0,0,783,0,0,0,783
9937,RM-1123,8/26/2014,783,0,0,0,0,0,783
13227,RM-1132,8/26/2014,0,0,783,0,0,0,783
14353,RM-1134,6/6/2014,783,0,0,0,0,0,783
14434,RM-1134,8/26/2014,783,0,0,0,0,0,783
15704,RM-1144,8/26/2014,0,0,783,0,0,0,783
16362,RM-1145,8/26/2014,0,0,783,0,0,0,783
17731,RM-1151,8/26/2014,783,0,0,0,0,0,783
19023,RM-1155,6/6/2014,783,0,0,0,0,0,783
19104,RM-1155,8/26/2014,783,0,0,0,0,0,783
19780,RM-1156,8/26/2014,0,0,783,0,0,0,783
23017,RM-1207,6/6/2014,783,0,0,0,0,0,783
25075,RM-1212,6/6/2014,783,0,0,0,0,0,783
25156,RM-1212,8/26/2014,783,0,0,0,0,0,783
26511,RM-1213A,8/26/2014,0,0,783,0,0,0,783
27196,RM-1217,8/26/2014,783,0,0,0,0,0,783
28572,RM-1221,8/26/2014,0,0,783,0,0,0,783
29176,RM-1223,6/6/2014,783,0,0,0,0,0,783
29257,RM-1223,8/26/2014,783,0,0,0,0,0,783
30630,RM-1229,8/26/2014,0,0,783,0,0,0,783
32657,RM-1236,8/26/2014,783,0,0,0,0,0,783
33495,RM-4xxx,8/26/2014,0,0,0,0,783,0,783
36521,RM-B200B,8/26/2014,0,0,783,0,0,0,783
37121,RM-B200C,6/6/2014,783,0,0,0,0,0,783
37202,RM-B200C,8/26/2014,783,0,0,0,0,0,783
39182,RM-B220,6/6/2014,783,0,0,0,0,0,783
39951,RM-B222,8/26/2014,783,0,0,0,0,0,783
41931,RM-B230,6/6/2014,783,0,0,0,0,0,783
42012,RM-B230,8/26/2014,783,0,0,0,0,0,783
43263,RM-B240,8/26/2014,0,0,783,0,0,0,783
44558,RM-B250,8/26/2014,0,0,783,0,0,0,783
45161,RM-B250A,6/6/2014,783,0,0,0,0,0,783
45242,RM-B250A,8/26/2014,783,0,0,0,0,0,783
45927,RM-B260,8/26/2014,783,0,0,0,0,0,783
287,RM-1100A,4/24/2014,780,0,0,0,0,0,780
402,RM-1100A,8/17/2014,780,0,0,0,0,0,780
415,RM-1100A,8/30/2014,780,0,0,0,0,0,780
427,RM-1100A,9/11/2014,780,0,0,0,0,0,780
479,RM-1100A,11/4/2014,780,0,0,0,0,0,780
480,RM-1100A,11/5/2014,780,0,0,0,0,0,780
488,RM-1100A,11/13/2014,780,0,0,0,0,0,780
986,RM-1100D,5/8/2014,0,0,0,780,0,0,780
987,RM-1100D,5/9/2014,0,0,0,780,0,0,780
1657,RM-1102,4/24/2014,780,0,0,0,0,0,780
1772,RM-1102,8/17/2014,780,0,0,0,0,0,780
1785,RM-1102,8/30/2014,780,0,0,0,0,0,780
1797,RM-1102,9/11/2014,780,0,0,0,0,0,780
1849,RM-1102,11/4/2014,780,0,0,0,0,0,780
1851,RM-1102,11/6/2014,780,0,0,0,0,0,780
1858,RM-1102,11/13/2014,780,0,0,0,0,0,780
5725,RM-1110,4/24/2014,0,0,780,0,0,0,780
5839,RM-1110,8/17/2014,0,0,780,0,0,0,780
5852,RM-1110,8/30/2014,0,0,780,0,0,0,780
5864,RM-1110,9/11/2014,0,0,780,0,0,0,780
6409,RM-1113,4/24/2014,0,0,780,0,0,0,780
6452,RM-1113,6/6/2014,0,0,780,0,0,0,780
6524,RM-1113,8/17/2014,0,0,780,0,0,0,780
6537,RM-1113,8/30/2014,0,0,780,0,0,0,780
6549,RM-1113,9/11/2014,0,0,780,0,0,0,780
6601,RM-1113,11/4/2014,0,0,780,0,0,0,780
6602,RM-1113,11/5/2014,0,0,780,0,0,0,780
6610,RM-1113,11/13/2014,0,0,780,0,0,0,780
7068,RM-1115,4/24/2014,780,0,0,0,0,0,780
7755,RM-1116,4/24/2014,780,0,0,0,0,0,780
9928,RM-1123,8/17/2014,780,0,0,0,0,0,780
9941,RM-1123,8/30/2014,780,0,0,0,0,0,780
9953,RM-1123,9/11/2014,780,0,0,0,0,0,780
10005,RM-1123,11/4/2014,780,0,0,0,0,0,780
10006,RM-1123,11/5/2014,780,0,0,0,0,0,780
10014,RM-1123,11/13/2014,780,0,0,0,0,0,780
12607,RM-1130,11/4/2014,0,0,780,0,0,0,780
12608,RM-1130,11/5/2014,0,0,780,0,0,0,780
12616,RM-1130,11/13/2014,0,0,780,0,0,0,780
13218,RM-1132,8/17/2014,0,0,780,0,0,0,780
13231,RM-1132,8/30/2014,0,0,780,0,0,0,780
13243,RM-1132,9/11/2014,0,0,780,0,0,0,780
13295,RM-1132,11/4/2014,0,0,780,0,0,0,780
13296,RM-1132,11/5/2014,0,0,780,0,0,0,780
13304,RM-1132,11/13/2014,0,0,780,0,0,0,780
14311,RM-1134,4/24/2014,780,0,0,0,0,0,780
14425,RM-1134,8/17/2014,780,0,0,0,0,0,780
14438,RM-1134,8/30/2014,780,0,0,0,0,0,780
14450,RM-1134,9/11/2014,780,0,0,0,0,0,780
14502,RM-1134,11/4/2014,780,0,0,0,0,0,780
14503,RM-1134,11/5/2014,780,0,0,0,0,0,780
14511,RM-1134,11/13/2014,780,0,0,0,0,0,780
15580,RM-1144,4/24/2014,0,0,780,0,0,0,780
15623,RM-1144,6/6/2014,0,0,780,0,0,0,780
15695,RM-1144,8/17/2014,0,0,780,0,0,0,780
15708,RM-1144,8/30/2014,0,0,780,0,0,0,780
15720,RM-1144,9/11/2014,0,0,780,0,0,0,780
15772,RM-1144,11/4/2014,0,0,780,0,0,0,780
15773,RM-1144,11/5/2014,0,0,780,0,0,0,780
15781,RM-1144,11/13/2014,0,0,780,0,0,0,780
16281,RM-1145,6/6/2014,0,0,780,0,0,0,780
16353,RM-1145,8/17/2014,0,0,780,0,0,0,780
16366,RM-1145,8/30/2014,0,0,780,0,0,0,780
16378,RM-1145,9/11/2014,0,0,780,0,0,0,780
16430,RM-1145,11/4/2014,0,0,780,0,0,0,780
16431,RM-1145,11/5/2014,0,0,780,0,0,0,780
16439,RM-1145,11/13/2014,0,0,780,0,0,0,780
17722,RM-1151,8/17/2014,780,0,0,0,0,0,780
17735,RM-1151,8/30/2014,780,0,0,0,0,0,780
17747,RM-1151,9/11/2014,780,0,0,0,0,0,780
18980,RM-1155,4/24/2014,780,0,0,0,0,0,780
19095,RM-1155,8/17/2014,780,0,0,0,0,0,780
19108,RM-1155,8/30/2014,780,0,0,0,0,0,780
19120,RM-1155,9/11/2014,780,0,0,0,0,0,780
19172,RM-1155,11/4/2014,780,0,0,0,0,0,780
19173,RM-1155,11/5/2014,780,0,0,0,0,0,780
19181,RM-1155,11/13/2014,780,0,0,0,0,0,780
19784,RM-1156,8/30/2014,0,0,780,0,0,0,780
19796,RM-1156,9/11/2014,0,0,780,0,0,0,780
19848,RM-1156,11/4/2014,0,0,780,0,0,0,780
19849,RM-1156,11/5/2014,0,0,780,0,0,0,780
19857,RM-1156,11/13/2014,0,0,780,0,0,0,780
22974,RM-1207,4/24/2014,780,0,0,0,0,0,780
23774,RM-1208,8/17/2014,780,0,0,0,0,0,780
24539,RM-1208B,11/4/2014,780,0,0,0,0,0,780
24541,RM-1208B,11/6/2014,780,0,0,0,0,0,780
24548,RM-1208B,11/13/2014,780,0,0,0,0,0,780
25032,RM-1212,4/24/2014,780,0,0,0,0,0,780
25147,RM-1212,8/17/2014,780,0,0,0,0,0,780
25160,RM-1212,8/30/2014,780,0,0,0,0,0,780
25172,RM-1212,9/11/2014,780,0,0,0,0,0,780
25224,RM-1212,11/4/2014,780,0,0,0,0,0,780
25226,RM-1212,11/6/2014,780,0,0,0,0,0,780
25233,RM-1212,11/13/2014,780,0,0,0,0,0,780
26387,RM-1213A,4/24/2014,0,0,780,0,0,0,780
26430,RM-1213A,6/6/2014,0,0,780,0,0,0,780
26502,RM-1213A,8/17/2014,0,0,780,0,0,0,780
26515,RM-1213A,8/30/2014,0,0,780,0,0,0,780
26527,RM-1213A,9/11/2014,0,0,780,0,0,0,780
27187,RM-1217,8/17/2014,780,0,0,0,0,0,780
27200,RM-1217,8/30/2014,780,0,0,0,0,0,780
27212,RM-1217,9/11/2014,780,0,0,0,0,0,780
27952,RM-1218,11/4/2014,780,0,0,0,0,0,780
27954,RM-1218,11/6/2014,780,0,0,0,0,0,780
27961,RM-1218,11/13/2014,780,0,0,0,0,0,780
28491,RM-1221,6/6/2014,0,0,780,0,0,0,780
28563,RM-1221,8/17/2014,0,0,780,0,0,0,780
28576,RM-1221,8/30/2014,0,0,780,0,0,0,780
28588,RM-1221,9/11/2014,0,0,780,0,0,0,780
29248,RM-1223,8/17/2014,780,0,0,0,0,0,780
29261,RM-1223,8/30/2014,780,0,0,0,0,0,780
29273,RM-1223,9/11/2014,780,0,0,0,0,0,780
29325,RM-1223,11/4/2014,780,0,0,0,0,0,780
29327,RM-1223,11/6/2014,780,0,0,0,0,0,780
29334,RM-1223,11/13/2014,780,0,0,0,0,0,780
30621,RM-1229,8/17/2014,0,0,780,0,0,0,780
30634,RM-1229,8/30/2014,0,0,780,0,0,0,780
30646,RM-1229,9/11/2014,0,0,780,0,0,0,780
30698,RM-1229,11/4/2014,0,0,780,0,0,0,780
30700,RM-1229,11/6/2014,0,0,780,0,0,0,780
30707,RM-1229,11/13/2014,0,0,780,0,0,0,780
32661,RM-1236,8/30/2014,780,0,0,0,0,0,780
32673,RM-1236,9/11/2014,780,0,0,0,0,0,780
32725,RM-1236,11/4/2014,780,0,0,0,0,0,780
32727,RM-1236,11/6/2014,780,0,0,0,0,0,780
32734,RM-1236,11/13/2014,780,0,0,0,0,0,780
33499,RM-4xxx,8/30/2014,0,0,0,0,780,0,780
33563,RM-4xxx,11/4/2014,0,0,0,0,780,0,780
33564,RM-4xxx,11/5/2014,0,0,0,0,780,0,780
33572,RM-4xxx,11/13/2014,0,0,0,0,780,0,780
36512,RM-B200B,8/17/2014,0,0,780,0,0,0,780
36525,RM-B200B,8/30/2014,0,0,780,0,0,0,780
36537,RM-B200B,9/11/2014,0,0,780,0,0,0,780
37193,RM-B200C,8/17/2014,780,0,0,0,0,0,780
37206,RM-B200C,8/30/2014,780,0,0,0,0,0,780
37218,RM-B200C,9/11/2014,780,0,0,0,0,0,780
37270,RM-B200C,11/4/2014,780,0,0,0,0,0,780
37271,RM-B200C,11/5/2014,780,0,0,0,0,0,780
37275,RM-B200C,11/9/2014,780,0,0,0,0,0,780
37279,RM-B200C,11/13/2014,780,0,0,0,0,0,780
38454,RM-B215,4/24/2014,0,0,780,0,0,0,780
39139,RM-B220,4/24/2014,780,0,0,0,0,0,780
39254,RM-B220,8/17/2014,780,0,0,0,0,0,780
39827,RM-B222,4/24/2014,780,0,0,0,0,0,780
39942,RM-B222,8/17/2014,780,0,0,0,0,0,780
39955,RM-B222,8/30/2014,780,0,0,0,0,0,780
39967,RM-B222,9/11/2014,780,0,0,0,0,0,780
40019,RM-B222,11/4/2014,780,0,0,0,0,0,780
40020,RM-B222,11/5/2014,780,0,0,0,0,0,780
40024,RM-B222,11/9/2014,780,0,0,0,0,0,780
40028,RM-B222,11/13/2014,780,0,0,0,0,0,780
42003,RM-B230,8/17/2014,780,0,0,0,0,0,780
42016,RM-B230,8/30/2014,780,0,0,0,0,0,780
42028,RM-B230,9/11/2014,780,0,0,0,0,0,780
43139,RM-B240,4/24/2014,0,0,780,0,0,0,780
43182,RM-B240,6/6/2014,0,0,780,0,0,0,780
43254,RM-B240,8/17/2014,0,0,780,0,0,0,780
43267,RM-B240,8/30/2014,0,0,780,0,0,0,780
43279,RM-B240,9/11/2014,0,0,780,0,0,0,780
43331,RM-B240,11/4/2014,0,0,780,0,0,0,780
43332,RM-B240,11/5/2014,0,0,780,0,0,0,780
43336,RM-B240,11/9/2014,0,0,780,0,0,0,780
43340,RM-B240,11/13/2014,0,0,780,0,0,0,780
43941,RM-B240A,11/4/2014,0,0,780,0,0,0,780
43942,RM-B240A,11/5/2014,0,0,780,0,0,0,780
43946,RM-B240A,11/9/2014,0,0,780,0,0,0,780
43950,RM-B240A,11/13/2014,0,0,780,0,0,0,780
44549,RM-B250,8/17/2014,0,0,780,0,0,0,780
44562,RM-B250,8/30/2014,0,0,780,0,0,0,780
44574,RM-B250,9/11/2014,0,0,780,0,0,0,780
45119,RM-B250A,4/24/2014,780,0,0,0,0,0,780
45233,RM-B250A,8/17/2014,780,0,0,0,0,0,780
45246,RM-B250A,8/30/2014,780,0,0,0,0,0,780
45258,RM-B250A,9/11/2014,780,0,0,0,0,0,780
45310,RM-B250A,11/4/2014,780,0,0,0,0,0,780
45311,RM-B250A,11/5/2014,780,0,0,0,0,0,780
45315,RM-B250A,11/9/2014,780,0,0,0,0,0,780
45319,RM-B250A,11/13/2014,780,0,0,0,0,0,780
45918,RM-B260,8/17/2014,780,0,0,0,0,0,780
45931,RM-B260,8/30/2014,780,0,0,0,0,0,780
47187,RM-B270,5/8/2014,0,0,0,780,0,0,780
47188,RM-B270,5/9/2014,0,0,0,780,0,0,780
47189,RM-B270,5/10/2014,0,0,0,780,0,0,780
405,RM-1100A,8/20/2014,777,0,0,0,0,0,777
416,RM-1100A,8/31/2014,777,0,0,0,0,0,777
418,RM-1100A,9/2/2014,777,0,0,0,0,0,777
419,RM-1100A,9/3/2014,777,0,0,0,0,0,777
481,RM-1100A,11/6/2014,777,0,0,0,0,0,777
482,RM-1100A,11/7/2014,777,0,0,0,0,0,777
484,RM-1100A,11/9/2014,777,0,0,0,0,0,777
485,RM-1100A,11/10/2014,777,0,0,0,0,0,777
1775,RM-1102,8/20/2014,777,0,0,0,0,0,777
1786,RM-1102,8/31/2014,777,0,0,0,0,0,777
1788,RM-1102,9/2/2014,777,0,0,0,0,0,777
1789,RM-1102,9/3/2014,777,0,0,0,0,0,777
1850,RM-1102,11/5/2014,777,0,0,0,0,0,777
1852,RM-1102,11/7/2014,777,0,0,0,0,0,777
1854,RM-1102,11/9/2014,777,0,0,0,0,0,777
1855,RM-1102,11/10/2014,777,0,0,0,0,0,777
5842,RM-1110,8/20/2014,0,0,777,0,0,0,777
5853,RM-1110,8/31/2014,0,0,777,0,0,0,777
5854,RM-1110,9/1/2014,0,0,777,0,0,0,777
5856,RM-1110,9/3/2014,0,0,777,0,0,0,777
6527,RM-1113,8/20/2014,0,0,777,0,0,0,777
6538,RM-1113,8/31/2014,0,0,777,0,0,0,777
6540,RM-1113,9/2/2014,0,0,777,0,0,0,777
6541,RM-1113,9/3/2014,0,0,777,0,0,0,777
6603,RM-1113,11/6/2014,0,0,777,0,0,0,777
6604,RM-1113,11/7/2014,0,0,777,0,0,0,777
6606,RM-1113,11/9/2014,0,0,777,0,0,0,777
6607,RM-1113,11/10/2014,0,0,777,0,0,0,777
8360,RM-1117,1/31/2014,0,0,153,624,0,0,777
9730,RM-1123,1/31/2014,0,624,153,0,0,0,777
9931,RM-1123,8/20/2014,777,0,0,0,0,0,777
9942,RM-1123,8/31/2014,777,0,0,0,0,0,777
9943,RM-1123,9/1/2014,777,0,0,0,0,0,777
9945,RM-1123,9/3/2014,777,0,0,0,0,0,777
10007,RM-1123,11/6/2014,777,0,0,0,0,0,777
10008,RM-1123,11/7/2014,777,0,0,0,0,0,777
10010,RM-1123,11/9/2014,777,0,0,0,0,0,777
10011,RM-1123,11/10/2014,777,0,0,0,0,0,777
12609,RM-1130,11/6/2014,0,0,777,0,0,0,777
12610,RM-1130,11/7/2014,0,0,777,0,0,0,777
12612,RM-1130,11/9/2014,0,0,777,0,0,0,777
12613,RM-1130,11/10/2014,0,0,777,0,0,0,777
13221,RM-1132,8/20/2014,0,0,777,0,0,0,777
13232,RM-1132,8/31/2014,0,0,777,0,0,0,777
13234,RM-1132,9/2/2014,0,0,777,0,0,0,777
13235,RM-1132,9/3/2014,0,0,777,0,0,0,777
13297,RM-1132,11/6/2014,0,0,777,0,0,0,777
13298,RM-1132,11/7/2014,0,0,777,0,0,0,777
13300,RM-1132,11/9/2014,0,0,777,0,0,0,777
13301,RM-1132,11/10/2014,0,0,777,0,0,0,777
13705,RM-1133,1/31/2014,0,624,153,0,0,0,777
14428,RM-1134,8/20/2014,777,0,0,0,0,0,777
14439,RM-1134,8/31/2014,777,0,0,0,0,0,777
14441,RM-1134,9/2/2014,777,0,0,0,0,0,777
14442,RM-1134,9/3/2014,777,0,0,0,0,0,777
14504,RM-1134,11/6/2014,777,0,0,0,0,0,777
14505,RM-1134,11/7/2014,777,0,0,0,0,0,777
14507,RM-1134,11/9/2014,777,0,0,0,0,0,777
14508,RM-1134,11/10/2014,777,0,0,0,0,0,777
15698,RM-1144,8/20/2014,0,0,777,0,0,0,777
15709,RM-1144,8/31/2014,0,0,777,0,0,0,777
15711,RM-1144,9/2/2014,0,0,777,0,0,0,777
15712,RM-1144,9/3/2014,0,0,777,0,0,0,777
15774,RM-1144,11/6/2014,0,0,777,0,0,0,777
15775,RM-1144,11/7/2014,0,0,777,0,0,0,777
15777,RM-1144,11/9/2014,0,0,777,0,0,0,777
15778,RM-1144,11/10/2014,0,0,777,0,0,0,777
16356,RM-1145,8/20/2014,0,0,777,0,0,0,777
16367,RM-1145,8/31/2014,0,0,777,0,0,0,777
16368,RM-1145,9/1/2014,0,0,777,0,0,0,777
16370,RM-1145,9/3/2014,0,0,777,0,0,0,777
16432,RM-1145,11/6/2014,0,0,777,0,0,0,777
16433,RM-1145,11/7/2014,0,0,777,0,0,0,777
16435,RM-1145,11/9/2014,0,0,777,0,0,0,777
16436,RM-1145,11/10/2014,0,0,777,0,0,0,777
17725,RM-1151,8/20/2014,777,0,0,0,0,0,777
17736,RM-1151,8/31/2014,777,0,0,0,0,0,777
17737,RM-1151,9/1/2014,777,0,0,0,0,0,777
17739,RM-1151,9/3/2014,777,0,0,0,0,0,777
19098,RM-1155,8/20/2014,777,0,0,0,0,0,777
19109,RM-1155,8/31/2014,777,0,0,0,0,0,777
19110,RM-1155,9/1/2014,777,0,0,0,0,0,777
19112,RM-1155,9/3/2014,777,0,0,0,0,0,777
19174,RM-1155,11/6/2014,777,0,0,0,0,0,777
19175,RM-1155,11/7/2014,777,0,0,0,0,0,777
19177,RM-1155,11/9/2014,777,0,0,0,0,0,777
19178,RM-1155,11/10/2014,777,0,0,0,0,0,777
19785,RM-1156,8/31/2014,0,0,777,0,0,0,777
19786,RM-1156,9/1/2014,0,0,777,0,0,0,777
19788,RM-1156,9/3/2014,0,0,777,0,0,0,777
19850,RM-1156,11/6/2014,0,0,777,0,0,0,777
19851,RM-1156,11/7/2014,0,0,777,0,0,0,777
19853,RM-1156,11/9/2014,0,0,777,0,0,0,777
19854,RM-1156,11/10/2014,0,0,777,0,0,0,777
24264,RM-1208B,1/31/2014,0,0,153,624,0,0,777
24540,RM-1208B,11/5/2014,777,0,0,0,0,0,777
24542,RM-1208B,11/7/2014,777,0,0,0,0,0,777
24544,RM-1208B,11/9/2014,777,0,0,0,0,0,777
24545,RM-1208B,11/10/2014,777,0,0,0,0,0,777
25150,RM-1212,8/20/2014,777,0,0,0,0,0,777
25161,RM-1212,8/31/2014,777,0,0,0,0,0,777
25163,RM-1212,9/2/2014,777,0,0,0,0,0,777
25164,RM-1212,9/3/2014,777,0,0,0,0,0,777
25225,RM-1212,11/5/2014,777,0,0,0,0,0,777
25227,RM-1212,11/7/2014,777,0,0,0,0,0,777
25229,RM-1212,11/9/2014,777,0,0,0,0,0,777
25230,RM-1212,11/10/2014,777,0,0,0,0,0,777
26505,RM-1213A,8/20/2014,0,0,777,0,0,0,777
26516,RM-1213A,8/31/2014,0,0,777,0,0,0,777
26518,RM-1213A,9/2/2014,0,0,777,0,0,0,777
26519,RM-1213A,9/3/2014,0,0,777,0,0,0,777
27190,RM-1217,8/20/2014,777,0,0,0,0,0,777
27201,RM-1217,8/31/2014,777,0,0,0,0,0,777
27203,RM-1217,9/2/2014,777,0,0,0,0,0,777
27204,RM-1217,9/3/2014,777,0,0,0,0,0,777
27953,RM-1218,11/5/2014,777,0,0,0,0,0,777
27955,RM-1218,11/7/2014,777,0,0,0,0,0,777
27957,RM-1218,11/9/2014,777,0,0,0,0,0,777
27958,RM-1218,11/10/2014,777,0,0,0,0,0,777
28566,RM-1221,8/20/2014,0,0,777,0,0,0,777
28577,RM-1221,8/31/2014,0,0,777,0,0,0,777
28579,RM-1221,9/2/2014,0,0,777,0,0,0,777
28580,RM-1221,9/3/2014,0,0,777,0,0,0,777
29251,RM-1223,8/20/2014,777,0,0,0,0,0,777
29262,RM-1223,8/31/2014,777,0,0,0,0,0,777
29264,RM-1223,9/2/2014,777,0,0,0,0,0,777
29265,RM-1223,9/3/2014,777,0,0,0,0,0,777
29326,RM-1223,11/5/2014,777,0,0,0,0,0,777
29328,RM-1223,11/7/2014,777,0,0,0,0,0,777
29330,RM-1223,11/9/2014,777,0,0,0,0,0,777
29331,RM-1223,11/10/2014,777,0,0,0,0,0,777
30624,RM-1229,8/20/2014,0,0,777,0,0,0,777
30635,RM-1229,8/31/2014,0,0,777,0,0,0,777
30637,RM-1229,9/2/2014,0,0,777,0,0,0,777
30638,RM-1229,9/3/2014,0,0,777,0,0,0,777
30699,RM-1229,11/5/2014,0,0,777,0,0,0,777
30701,RM-1229,11/7/2014,0,0,777,0,0,0,777
30703,RM-1229,11/9/2014,0,0,777,0,0,0,777
30704,RM-1229,11/10/2014,0,0,777,0,0,0,777
32662,RM-1236,8/31/2014,777,0,0,0,0,0,777
32664,RM-1236,9/2/2014,777,0,0,0,0,0,777
32665,RM-1236,9/3/2014,777,0,0,0,0,0,777
32726,RM-1236,11/5/2014,777,0,0,0,0,0,777
32728,RM-1236,11/7/2014,777,0,0,0,0,0,777
32730,RM-1236,11/9/2014,777,0,0,0,0,0,777
32731,RM-1236,11/10/2014,777,0,0,0,0,0,777
33500,RM-4xxx,8/31/2014,0,0,0,0,777,0,777
33501,RM-4xxx,9/1/2014,0,0,0,0,777,0,777
33503,RM-4xxx,9/3/2014,0,0,0,0,777,0,777
33509,RM-4xxx,9/9/2014,0,0,0,0,777,0,777
33511,RM-4xxx,9/11/2014,0,0,0,0,777,0,777
33565,RM-4xxx,11/6/2014,0,0,0,0,777,0,777
33566,RM-4xxx,11/7/2014,0,0,0,0,777,0,777
33567,RM-4xxx,11/8/2014,0,0,0,0,777,0,777
33568,RM-4xxx,11/9/2014,0,0,0,0,777,0,777
34121,RM-B102C,3/19/2015,777,0,0,0,0,0,777
35627,RM-B109,1/31/2014,0,624,153,0,0,0,777
36515,RM-B200B,8/20/2014,0,0,777,0,0,0,777
36526,RM-B200B,8/31/2014,0,0,777,0,0,0,777
36527,RM-B200B,9/1/2014,0,0,777,0,0,0,777
36529,RM-B200B,9/3/2014,0,0,777,0,0,0,777
37196,RM-B200C,8/20/2014,777,0,0,0,0,0,777
37207,RM-B200C,8/31/2014,777,0,0,0,0,0,777
37208,RM-B200C,9/1/2014,777,0,0,0,0,0,777
37210,RM-B200C,9/3/2014,777,0,0,0,0,0,777
37216,RM-B200C,9/9/2014,777,0,0,0,0,0,777
37272,RM-B200C,11/6/2014,777,0,0,0,0,0,777
37273,RM-B200C,11/7/2014,777,0,0,0,0,0,777
39257,RM-B220,8/20/2014,777,0,0,0,0,0,777
39945,RM-B222,8/20/2014,777,0,0,0,0,0,777
39956,RM-B222,8/31/2014,777,0,0,0,0,0,777
39957,RM-B222,9/1/2014,777,0,0,0,0,0,777
39959,RM-B222,9/3/2014,777,0,0,0,0,0,777
40021,RM-B222,11/6/2014,777,0,0,0,0,0,777
40022,RM-B222,11/7/2014,777,0,0,0,0,0,777
41805,RM-B230,1/31/2014,0,624,153,0,0,0,777
42006,RM-B230,8/20/2014,777,0,0,0,0,0,777
42017,RM-B230,8/31/2014,777,0,0,0,0,0,777
42018,RM-B230,9/1/2014,777,0,0,0,0,0,777
42020,RM-B230,9/3/2014,777,0,0,0,0,0,777
42026,RM-B230,9/9/2014,777,0,0,0,0,0,777
43257,RM-B240,8/20/2014,0,0,777,0,0,0,777
43268,RM-B240,8/31/2014,0,0,777,0,0,0,777
43269,RM-B240,9/1/2014,0,0,777,0,0,0,777
43271,RM-B240,9/3/2014,0,0,777,0,0,0,777
43277,RM-B240,9/9/2014,0,0,777,0,0,0,777
43333,RM-B240,11/6/2014,0,0,777,0,0,0,777
43334,RM-B240,11/7/2014,0,0,777,0,0,0,777
43943,RM-B240A,11/6/2014,0,0,777,0,0,0,777
43944,RM-B240A,11/7/2014,0,0,777,0,0,0,777
44552,RM-B250,8/20/2014,0,0,777,0,0,0,777
44563,RM-B250,8/31/2014,0,0,777,0,0,0,777
44564,RM-B250,9/1/2014,0,0,777,0,0,0,777
44566,RM-B250,9/3/2014,0,0,777,0,0,0,777
44572,RM-B250,9/9/2014,0,0,777,0,0,0,777
45236,RM-B250A,8/20/2014,777,0,0,0,0,0,777
45247,RM-B250A,8/31/2014,777,0,0,0,0,0,777
45248,RM-B250A,9/1/2014,777,0,0,0,0,0,777
45250,RM-B250A,9/3/2014,777,0,0,0,0,0,777
45312,RM-B250A,11/6/2014,777,0,0,0,0,0,777
45313,RM-B250A,11/7/2014,777,0,0,0,0,0,777
45921,RM-B260,8/20/2014,777,0,0,0,0,0,777
45932,RM-B260,8/31/2014,777,0,0,0,0,0,777
45933,RM-B260,9/1/2014,777,0,0,0,0,0,777
45935,RM-B260,9/3/2014,777,0,0,0,0,0,777
45941,RM-B260,9/9/2014,777,0,0,0,0,0,777
406,RM-1100A,8/21/2014,774,0,0,0,0,0,774
413,RM-1100A,8/28/2014,774,0,0,0,0,0,774
417,RM-1100A,9/1/2014,774,0,0,0,0,0,774
421,RM-1100A,9/5/2014,774,0,0,0,0,0,774
423,RM-1100A,9/7/2014,774,0,0,0,0,0,774
424,RM-1100A,9/8/2014,774,0,0,0,0,0,774
425,RM-1100A,9/9/2014,774,0,0,0,0,0,774
483,RM-1100A,11/8/2014,774,0,0,0,0,0,774
1776,RM-1102,8/21/2014,774,0,0,0,0,0,774
1783,RM-1102,8/28/2014,774,0,0,0,0,0,774
1787,RM-1102,9/1/2014,774,0,0,0,0,0,774
1791,RM-1102,9/5/2014,774,0,0,0,0,0,774
1793,RM-1102,9/7/2014,774,0,0,0,0,0,774
1794,RM-1102,9/8/2014,774,0,0,0,0,0,774
1795,RM-1102,9/9/2014,774,0,0,0,0,0,774
1853,RM-1102,11/8/2014,774,0,0,0,0,0,774
1984,RM-1102,3/19/2015,774,0,0,0,0,0,774
2900,RM-1106,1/31/2014,0,0,0,624,0,150,774
4364,RM-1108,5/6/2014,0,774,0,0,0,0,774
4679,RM-1108,3/19/2015,0,0,774,0,0,0,774
5843,RM-1110,8/21/2014,0,0,774,0,0,0,774
5850,RM-1110,8/28/2014,0,0,774,0,0,0,774
5855,RM-1110,9/2/2014,0,0,774,0,0,0,774
5858,RM-1110,9/5/2014,0,0,774,0,0,0,774
5860,RM-1110,9/7/2014,0,0,774,0,0,0,774
5861,RM-1110,9/8/2014,0,0,774,0,0,0,774
5862,RM-1110,9/9/2014,0,0,774,0,0,0,774
6528,RM-1113,8/21/2014,0,0,774,0,0,0,774
6535,RM-1113,8/28/2014,0,0,774,0,0,0,774
6539,RM-1113,9/1/2014,0,0,774,0,0,0,774
6543,RM-1113,9/5/2014,0,0,774,0,0,0,774
6545,RM-1113,9/7/2014,0,0,774,0,0,0,774
6546,RM-1113,9/8/2014,0,0,774,0,0,0,774
6547,RM-1113,9/9/2014,0,0,774,0,0,0,774
6605,RM-1113,11/8/2014,0,0,774,0,0,0,774
9932,RM-1123,8/21/2014,774,0,0,0,0,0,774
9939,RM-1123,8/28/2014,774,0,0,0,0,0,774
9944,RM-1123,9/2/2014,774,0,0,0,0,0,774
9947,RM-1123,9/5/2014,774,0,0,0,0,0,774
9949,RM-1123,9/7/2014,774,0,0,0,0,0,774
9950,RM-1123,9/8/2014,774,0,0,0,0,0,774
9951,RM-1123,9/9/2014,774,0,0,0,0,0,774
10009,RM-1123,11/8/2014,774,0,0,0,0,0,774
12611,RM-1130,11/8/2014,0,0,774,0,0,0,774
13020,RM-1132,1/31/2014,0,0,150,624,0,0,774
13222,RM-1132,8/21/2014,0,0,774,0,0,0,774
13229,RM-1132,8/28/2014,0,0,774,0,0,0,774
13233,RM-1132,9/1/2014,0,0,774,0,0,0,774
13237,RM-1132,9/5/2014,0,0,774,0,0,0,774
13239,RM-1132,9/7/2014,0,0,774,0,0,0,774
13240,RM-1132,9/8/2014,0,0,774,0,0,0,774
13241,RM-1132,9/9/2014,0,0,774,0,0,0,774
13299,RM-1132,11/8/2014,0,0,774,0,0,0,774
13430,RM-1132,3/19/2015,0,0,774,0,0,0,774
14429,RM-1134,8/21/2014,774,0,0,0,0,0,774
14436,RM-1134,8/28/2014,774,0,0,0,0,0,774
14440,RM-1134,9/1/2014,774,0,0,0,0,0,774
14444,RM-1134,9/5/2014,774,0,0,0,0,0,774
14446,RM-1134,9/7/2014,774,0,0,0,0,0,774
14447,RM-1134,9/8/2014,774,0,0,0,0,0,774
14448,RM-1134,9/9/2014,774,0,0,0,0,0,774
14506,RM-1134,11/8/2014,774,0,0,0,0,0,774
15699,RM-1144,8/21/2014,0,0,774,0,0,0,774
15706,RM-1144,8/28/2014,0,0,774,0,0,0,774
15710,RM-1144,9/1/2014,0,0,774,0,0,0,774
15714,RM-1144,9/5/2014,0,0,774,0,0,0,774
15716,RM-1144,9/7/2014,0,0,774,0,0,0,774
15717,RM-1144,9/8/2014,0,0,774,0,0,0,774
15718,RM-1144,9/9/2014,0,0,774,0,0,0,774
15776,RM-1144,11/8/2014,0,0,774,0,0,0,774
16357,RM-1145,8/21/2014,0,0,774,0,0,0,774
16364,RM-1145,8/28/2014,0,0,774,0,0,0,774
16369,RM-1145,9/2/2014,0,0,774,0,0,0,774
16372,RM-1145,9/5/2014,0,0,774,0,0,0,774
16374,RM-1145,9/7/2014,0,0,774,0,0,0,774
16375,RM-1145,9/8/2014,0,0,774,0,0,0,774
16376,RM-1145,9/9/2014,0,0,774,0,0,0,774
16434,RM-1145,11/8/2014,0,0,774,0,0,0,774
17726,RM-1151,8/21/2014,774,0,0,0,0,0,774
17733,RM-1151,8/28/2014,774,0,0,0,0,0,774
17738,RM-1151,9/2/2014,774,0,0,0,0,0,774
17741,RM-1151,9/5/2014,774,0,0,0,0,0,774
17743,RM-1151,9/7/2014,774,0,0,0,0,0,774
17744,RM-1151,9/8/2014,774,0,0,0,0,0,774
17745,RM-1151,9/9/2014,774,0,0,0,0,0,774
19099,RM-1155,8/21/2014,774,0,0,0,0,0,774
19106,RM-1155,8/28/2014,774,0,0,0,0,0,774
19111,RM-1155,9/2/2014,774,0,0,0,0,0,774
19114,RM-1155,9/5/2014,774,0,0,0,0,0,774
19116,RM-1155,9/7/2014,774,0,0,0,0,0,774
19117,RM-1155,9/8/2014,774,0,0,0,0,0,774
19118,RM-1155,9/9/2014,774,0,0,0,0,0,774
19176,RM-1155,11/8/2014,774,0,0,0,0,0,774
19782,RM-1156,8/28/2014,0,0,774,0,0,0,774
19787,RM-1156,9/2/2014,0,0,774,0,0,0,774
19790,RM-1156,9/5/2014,0,0,774,0,0,0,774
19792,RM-1156,9/7/2014,0,0,774,0,0,0,774
19793,RM-1156,9/8/2014,0,0,774,0,0,0,774
19794,RM-1156,9/9/2014,0,0,774,0,0,0,774
19852,RM-1156,11/8/2014,0,0,774,0,0,0,774
20325,RM-1200A,5/9/2014,0,0,0,774,0,0,774
21985,RM-1200C,3/19/2015,774,0,0,0,0,0,774
24543,RM-1208B,11/8/2014,774,0,0,0,0,0,774
24674,RM-1208B,3/19/2015,774,0,0,0,0,0,774
25151,RM-1212,8/21/2014,774,0,0,0,0,0,774
25158,RM-1212,8/28/2014,774,0,0,0,0,0,774
25162,RM-1212,9/1/2014,774,0,0,0,0,0,774
25166,RM-1212,9/5/2014,774,0,0,0,0,0,774
25168,RM-1212,9/7/2014,774,0,0,0,0,0,774
25169,RM-1212,9/8/2014,774,0,0,0,0,0,774
25170,RM-1212,9/9/2014,774,0,0,0,0,0,774
25228,RM-1212,11/8/2014,774,0,0,0,0,0,774
26506,RM-1213A,8/21/2014,0,0,774,0,0,0,774
26513,RM-1213A,8/28/2014,0,0,774,0,0,0,774
26517,RM-1213A,9/1/2014,0,0,774,0,0,0,774
26521,RM-1213A,9/5/2014,0,0,774,0,0,0,774
26523,RM-1213A,9/7/2014,0,0,774,0,0,0,774
26524,RM-1213A,9/8/2014,0,0,774,0,0,0,774
26525,RM-1213A,9/9/2014,0,0,774,0,0,0,774
26989,RM-1217,1/31/2014,150,0,0,624,0,0,774
27191,RM-1217,8/21/2014,774,0,0,0,0,0,774
27198,RM-1217,8/28/2014,774,0,0,0,0,0,774
27202,RM-1217,9/1/2014,774,0,0,0,0,0,774
27206,RM-1217,9/5/2014,774,0,0,0,0,0,774
27208,RM-1217,9/7/2014,774,0,0,0,0,0,774
27209,RM-1217,9/8/2014,774,0,0,0,0,0,774
27210,RM-1217,9/9/2014,774,0,0,0,0,0,774
27780,RM-1218,5/14/2014,0,0,0,774,0,0,774
27956,RM-1218,11/8/2014,774,0,0,0,0,0,774
28087,RM-1218,3/19/2015,774,0,0,0,0,0,774
28567,RM-1221,8/21/2014,0,0,774,0,0,0,774
28574,RM-1221,8/28/2014,0,0,774,0,0,0,774
28578,RM-1221,9/1/2014,0,0,774,0,0,0,774
28582,RM-1221,9/5/2014,0,0,774,0,0,0,774
28584,RM-1221,9/7/2014,0,0,774,0,0,0,774
28585,RM-1221,9/8/2014,0,0,774,0,0,0,774
28586,RM-1221,9/9/2014,0,0,774,0,0,0,774
29252,RM-1223,8/21/2014,774,0,0,0,0,0,774
29259,RM-1223,8/28/2014,774,0,0,0,0,0,774
29263,RM-1223,9/1/2014,774,0,0,0,0,0,774
29267,RM-1223,9/5/2014,774,0,0,0,0,0,774
29269,RM-1223,9/7/2014,774,0,0,0,0,0,774
29270,RM-1223,9/8/2014,774,0,0,0,0,0,774
29271,RM-1223,9/9/2014,774,0,0,0,0,0,774
29329,RM-1223,11/8/2014,774,0,0,0,0,0,774
29460,RM-1223,3/19/2015,0,0,774,0,0,0,774
30145,RM-1224,3/19/2015,774,0,0,0,0,0,774
30625,RM-1229,8/21/2014,0,0,774,0,0,0,774
30632,RM-1229,8/28/2014,0,0,774,0,0,0,774
30636,RM-1229,9/1/2014,0,0,774,0,0,0,774
30640,RM-1229,9/5/2014,0,0,774,0,0,0,774
30642,RM-1229,9/7/2014,0,0,774,0,0,0,774
30643,RM-1229,9/8/2014,0,0,774,0,0,0,774
30644,RM-1229,9/9/2014,0,0,774,0,0,0,774
30702,RM-1229,11/8/2014,0,0,774,0,0,0,774
30833,RM-1229,3/19/2015,0,0,774,0,0,0,774
31173,RM-1230,5/9/2014,0,774,0,0,0,0,774
31174,RM-1230,5/10/2014,0,774,0,0,0,0,774
31175,RM-1230,5/11/2014,0,774,0,0,0,0,774
32659,RM-1236,8/28/2014,774,0,0,0,0,0,774
32663,RM-1236,9/1/2014,774,0,0,0,0,0,774
32667,RM-1236,9/5/2014,774,0,0,0,0,0,774
32669,RM-1236,9/7/2014,774,0,0,0,0,0,774
32670,RM-1236,9/8/2014,774,0,0,0,0,0,774
32671,RM-1236,9/9/2014,774,0,0,0,0,0,774
32729,RM-1236,11/8/2014,774,0,0,0,0,0,774
32860,RM-1236,3/19/2015,774,0,0,0,0,0,774
33497,RM-4xxx,8/28/2014,0,0,0,0,774,0,774
33502,RM-4xxx,9/2/2014,0,0,0,0,774,0,774
33505,RM-4xxx,9/5/2014,0,0,0,0,774,0,774
33507,RM-4xxx,9/7/2014,0,0,0,0,774,0,774
33508,RM-4xxx,9/8/2014,0,0,0,0,774,0,774
33569,RM-4xxx,11/10/2014,0,0,0,0,774,0,774
36516,RM-B200B,8/21/2014,0,0,774,0,0,0,774
36523,RM-B200B,8/28/2014,0,0,774,0,0,0,774
36528,RM-B200B,9/2/2014,0,0,774,0,0,0,774
36531,RM-B200B,9/5/2014,0,0,774,0,0,0,774
36533,RM-B200B,9/7/2014,0,0,774,0,0,0,774
36534,RM-B200B,9/8/2014,0,0,774,0,0,0,774
36535,RM-B200B,9/9/2014,0,0,774,0,0,0,774
36720,RM-B200B,3/19/2015,0,0,774,0,0,0,774
37197,RM-B200C,8/21/2014,774,0,0,0,0,0,774
37204,RM-B200C,8/28/2014,774,0,0,0,0,0,774
37209,RM-B200C,9/2/2014,774,0,0,0,0,0,774
37212,RM-B200C,9/5/2014,774,0,0,0,0,0,774
37214,RM-B200C,9/7/2014,774,0,0,0,0,0,774
37215,RM-B200C,9/8/2014,774,0,0,0,0,0,774
37274,RM-B200C,11/8/2014,774,0,0,0,0,0,774
37276,RM-B200C,11/10/2014,774,0,0,0,0,0,774
37405,RM-B200C,3/19/2015,774,0,0,0,0,0,774
39258,RM-B220,8/21/2014,774,0,0,0,0,0,774
39744,RM-B222,1/31/2014,150,0,0,624,0,0,774
39946,RM-B222,8/21/2014,774,0,0,0,0,0,774
39953,RM-B222,8/28/2014,774,0,0,0,0,0,774
39958,RM-B222,9/2/2014,774,0,0,0,0,0,774
39961,RM-B222,9/5/2014,774,0,0,0,0,0,774
39963,RM-B222,9/7/2014,774,0,0,0,0,0,774
39964,RM-B222,9/8/2014,774,0,0,0,0,0,774
39965,RM-B222,9/9/2014,774,0,0,0,0,0,774
40023,RM-B222,11/8/2014,774,0,0,0,0,0,774
40025,RM-B222,11/10/2014,774,0,0,0,0,0,774
42007,RM-B230,8/21/2014,774,0,0,0,0,0,774
42014,RM-B230,8/28/2014,774,0,0,0,0,0,774
42019,RM-B230,9/2/2014,774,0,0,0,0,0,774
42022,RM-B230,9/5/2014,774,0,0,0,0,0,774
42024,RM-B230,9/7/2014,774,0,0,0,0,0,774
42025,RM-B230,9/8/2014,774,0,0,0,0,0,774
43258,RM-B240,8/21/2014,0,0,774,0,0,0,774
43265,RM-B240,8/28/2014,0,0,774,0,0,0,774
43270,RM-B240,9/2/2014,0,0,774,0,0,0,774
43273,RM-B240,9/5/2014,0,0,774,0,0,0,774
43275,RM-B240,9/7/2014,0,0,774,0,0,0,774
43276,RM-B240,9/8/2014,0,0,774,0,0,0,774
43335,RM-B240,11/8/2014,0,0,774,0,0,0,774
43337,RM-B240,11/10/2014,0,0,774,0,0,0,774
43466,RM-B240,3/19/2015,0,0,774,0,0,0,774
43945,RM-B240A,11/8/2014,0,0,774,0,0,0,774
43947,RM-B240A,11/10/2014,0,0,774,0,0,0,774
44076,RM-B240A,3/19/2015,0,0,774,0,0,0,774
44553,RM-B250,8/21/2014,0,0,774,0,0,0,774
44560,RM-B250,8/28/2014,0,0,774,0,0,0,774
44565,RM-B250,9/2/2014,0,0,774,0,0,0,774
44568,RM-B250,9/5/2014,0,0,774,0,0,0,774
44570,RM-B250,9/7/2014,0,0,774,0,0,0,774
44571,RM-B250,9/8/2014,0,0,774,0,0,0,774
45237,RM-B250A,8/21/2014,774,0,0,0,0,0,774
45244,RM-B250A,8/28/2014,774,0,0,0,0,0,774
45249,RM-B250A,9/2/2014,774,0,0,0,0,0,774
45252,RM-B250A,9/5/2014,774,0,0,0,0,0,774
45254,RM-B250A,9/7/2014,774,0,0,0,0,0,774
45255,RM-B250A,9/8/2014,774,0,0,0,0,0,774
45256,RM-B250A,9/9/2014,774,0,0,0,0,0,774
45314,RM-B250A,11/8/2014,774,0,0,0,0,0,774
45316,RM-B250A,11/10/2014,774,0,0,0,0,0,774
45445,RM-B250A,3/19/2015,774,0,0,0,0,0,774
45817,RM-B260,5/8/2014,0,0,0,774,0,0,774
45821,RM-B260,5/12/2014,0,0,0,774,0,0,774
45922,RM-B260,8/21/2014,774,0,0,0,0,0,774
45929,RM-B260,8/28/2014,774,0,0,0,0,0,774
45934,RM-B260,9/2/2014,774,0,0,0,0,0,774
45937,RM-B260,9/5/2014,774,0,0,0,0,0,774
45939,RM-B260,9/7/2014,774,0,0,0,0,0,774
45940,RM-B260,9/8/2014,774,0,0,0,0,0,774
46130,RM-B260,3/19/2015,0,0,774,0,0,0,774
47758,RM-B275,1/31/2014,0,624,0,0,0,150,774
48168,RM-B275,3/19/2015,774,0,0,0,0,0,774
410,RM-1100A,8/25/2014,771,0,0,0,0,0,771
428,RM-1100A,9/12/2014,771,0,0,0,0,0,771
1780,RM-1102,8/25/2014,771,0,0,0,0,0,771
1798,RM-1102,9/12/2014,771,0,0,0,0,0,771
5847,RM-1110,8/25/2014,0,0,771,0,0,0,771
5865,RM-1110,9/12/2014,0,0,771,0,0,0,771
6532,RM-1113,8/25/2014,0,0,771,0,0,0,771
6550,RM-1113,9/12/2014,0,0,771,0,0,0,771
9936,RM-1123,8/25/2014,771,0,0,0,0,0,771
9954,RM-1123,9/12/2014,771,0,0,0,0,0,771
12556,RM-1130,9/12/2014,0,0,771,0,0,0,771
13226,RM-1132,8/25/2014,0,0,771,0,0,0,771
13244,RM-1132,9/12/2014,0,0,771,0,0,0,771
14433,RM-1134,8/25/2014,771,0,0,0,0,0,771
14451,RM-1134,9/12/2014,771,0,0,0,0,0,771
15703,RM-1144,8/25/2014,0,0,771,0,0,0,771
15721,RM-1144,9/12/2014,0,0,771,0,0,0,771
16361,RM-1145,8/25/2014,0,0,771,0,0,0,771
16379,RM-1145,9/12/2014,0,0,771,0,0,0,771
17730,RM-1151,8/25/2014,771,0,0,0,0,0,771
17748,RM-1151,9/12/2014,771,0,0,0,0,0,771
19103,RM-1155,8/25/2014,771,0,0,0,0,0,771
19121,RM-1155,9/12/2014,771,0,0,0,0,0,771
19797,RM-1156,9/12/2014,0,0,771,0,0,0,771
25155,RM-1212,8/25/2014,771,0,0,0,0,0,771
25173,RM-1212,9/12/2014,771,0,0,0,0,0,771
26510,RM-1213A,8/25/2014,0,0,771,0,0,0,771
26528,RM-1213A,9/12/2014,0,0,771,0,0,0,771
27195,RM-1217,8/25/2014,771,0,0,0,0,0,771
27213,RM-1217,9/12/2014,771,0,0,0,0,0,771
28571,RM-1221,8/25/2014,0,0,771,0,0,0,771
28589,RM-1221,9/12/2014,0,0,771,0,0,0,771
29256,RM-1223,8/25/2014,771,0,0,0,0,0,771
29274,RM-1223,9/12/2014,771,0,0,0,0,0,771
30629,RM-1229,8/25/2014,0,0,771,0,0,0,771
30647,RM-1229,9/12/2014,0,0,771,0,0,0,771
32674,RM-1236,9/12/2014,771,0,0,0,0,0,771
33489,RM-4xxx,8/20/2014,0,0,0,0,771,0,771
33494,RM-4xxx,8/25/2014,0,0,0,0,771,0,771
33512,RM-4xxx,9/12/2014,0,0,0,0,771,0,771
36520,RM-B200B,8/25/2014,0,0,771,0,0,0,771
36538,RM-B200B,9/12/2014,0,0,771,0,0,0,771
37201,RM-B200C,8/25/2014,771,0,0,0,0,0,771
37219,RM-B200C,9/12/2014,771,0,0,0,0,0,771
39950,RM-B222,8/25/2014,771,0,0,0,0,0,771
39968,RM-B222,9/12/2014,771,0,0,0,0,0,771
42011,RM-B230,8/25/2014,771,0,0,0,0,0,771
42029,RM-B230,9/12/2014,771,0,0,0,0,0,771
43262,RM-B240,8/25/2014,0,0,771,0,0,0,771
43280,RM-B240,9/12/2014,0,0,771,0,0,0,771
44557,RM-B250,8/25/2014,0,0,771,0,0,0,771
44575,RM-B250,9/12/2014,0,0,771,0,0,0,771
45241,RM-B250A,8/25/2014,771,0,0,0,0,0,771
45259,RM-B250A,9/12/2014,771,0,0,0,0,0,771
45926,RM-B260,8/25/2014,771,0,0,0,0,0,771
407,RM-1100A,8/22/2014,768,0,0,0,0,0,768
408,RM-1100A,8/23/2014,768,0,0,0,0,0,768
409,RM-1100A,8/24/2014,768,0,0,0,0,0,768
412,RM-1100A,8/27/2014,768,0,0,0,0,0,768
414,RM-1100A,8/29/2014,768,0,0,0,0,0,768
420,RM-1100A,9/4/2014,768,0,0,0,0,0,768
426,RM-1100A,9/10/2014,768,0,0,0,0,0,768
1777,RM-1102,8/22/2014,768,0,0,0,0,0,768
1778,RM-1102,8/23/2014,768,0,0,0,0,0,768
1779,RM-1102,8/24/2014,768,0,0,0,0,0,768
1782,RM-1102,8/27/2014,768,0,0,0,0,0,768
1784,RM-1102,8/29/2014,768,0,0,0,0,0,768
1790,RM-1102,9/4/2014,768,0,0,0,0,0,768
1796,RM-1102,9/10/2014,768,0,0,0,0,0,768
5844,RM-1110,8/22/2014,0,0,768,0,0,0,768
5845,RM-1110,8/23/2014,0,0,768,0,0,0,768
5846,RM-1110,8/24/2014,0,0,768,0,0,0,768
5849,RM-1110,8/27/2014,0,0,768,0,0,0,768
5851,RM-1110,8/29/2014,0,0,768,0,0,0,768
5857,RM-1110,9/4/2014,0,0,768,0,0,0,768
6529,RM-1113,8/22/2014,0,0,768,0,0,0,768
6530,RM-1113,8/23/2014,0,0,768,0,0,0,768
6531,RM-1113,8/24/2014,0,0,768,0,0,0,768
6534,RM-1113,8/27/2014,0,0,768,0,0,0,768
6536,RM-1113,8/29/2014,0,0,768,0,0,0,768
6542,RM-1113,9/4/2014,0,0,768,0,0,0,768
6548,RM-1113,9/10/2014,0,0,768,0,0,0,768
9933,RM-1123,8/22/2014,768,0,0,0,0,0,768
9934,RM-1123,8/23/2014,768,0,0,0,0,0,768
9935,RM-1123,8/24/2014,768,0,0,0,0,0,768
9938,RM-1123,8/27/2014,768,0,0,0,0,0,768
9940,RM-1123,8/29/2014,768,0,0,0,0,0,768
9946,RM-1123,9/4/2014,768,0,0,0,0,0,768
13223,RM-1132,8/22/2014,0,0,768,0,0,0,768
13224,RM-1132,8/23/2014,0,0,768,0,0,0,768
13225,RM-1132,8/24/2014,0,0,768,0,0,0,768
13228,RM-1132,8/27/2014,0,0,768,0,0,0,768
13230,RM-1132,8/29/2014,0,0,768,0,0,0,768
13236,RM-1132,9/4/2014,0,0,768,0,0,0,768
13242,RM-1132,9/10/2014,0,0,768,0,0,0,768
14430,RM-1134,8/22/2014,768,0,0,0,0,0,768
14431,RM-1134,8/23/2014,768,0,0,0,0,0,768
14432,RM-1134,8/24/2014,768,0,0,0,0,0,768
14435,RM-1134,8/27/2014,768,0,0,0,0,0,768
14437,RM-1134,8/29/2014,768,0,0,0,0,0,768
14443,RM-1134,9/4/2014,768,0,0,0,0,0,768
15700,RM-1144,8/22/2014,0,0,768,0,0,0,768
15701,RM-1144,8/23/2014,0,0,768,0,0,0,768
15702,RM-1144,8/24/2014,0,0,768,0,0,0,768
15705,RM-1144,8/27/2014,0,0,768,0,0,0,768
15707,RM-1144,8/29/2014,0,0,768,0,0,0,768
15713,RM-1144,9/4/2014,0,0,768,0,0,0,768
16358,RM-1145,8/22/2014,0,0,768,0,0,0,768
16359,RM-1145,8/23/2014,0,0,768,0,0,0,768
16360,RM-1145,8/24/2014,0,0,768,0,0,0,768
16363,RM-1145,8/27/2014,0,0,768,0,0,0,768
16365,RM-1145,8/29/2014,0,0,768,0,0,0,768
16371,RM-1145,9/4/2014,0,0,768,0,0,0,768
17727,RM-1151,8/22/2014,768,0,0,0,0,0,768
17728,RM-1151,8/23/2014,768,0,0,0,0,0,768
17729,RM-1151,8/24/2014,768,0,0,0,0,0,768
17732,RM-1151,8/27/2014,768,0,0,0,0,0,768
17734,RM-1151,8/29/2014,768,0,0,0,0,0,768
17740,RM-1151,9/4/2014,768,0,0,0,0,0,768
19100,RM-1155,8/22/2014,768,0,0,0,0,0,768
19101,RM-1155,8/23/2014,768,0,0,0,0,0,768
19102,RM-1155,8/24/2014,768,0,0,0,0,0,768
19105,RM-1155,8/27/2014,768,0,0,0,0,0,768
19107,RM-1155,8/29/2014,768,0,0,0,0,0,768
19113,RM-1155,9/4/2014,768,0,0,0,0,0,768
19781,RM-1156,8/27/2014,0,0,768,0,0,0,768
19783,RM-1156,8/29/2014,0,0,768,0,0,0,768
19789,RM-1156,9/4/2014,0,0,768,0,0,0,768
25152,RM-1212,8/22/2014,768,0,0,0,0,0,768
25153,RM-1212,8/23/2014,768,0,0,0,0,0,768
25154,RM-1212,8/24/2014,768,0,0,0,0,0,768
25157,RM-1212,8/27/2014,768,0,0,0,0,0,768
25159,RM-1212,8/29/2014,768,0,0,0,0,0,768
25165,RM-1212,9/4/2014,768,0,0,0,0,0,768
25171,RM-1212,9/10/2014,768,0,0,0,0,0,768
26507,RM-1213A,8/22/2014,0,0,768,0,0,0,768
26508,RM-1213A,8/23/2014,0,0,768,0,0,0,768
26509,RM-1213A,8/24/2014,0,0,768,0,0,0,768
26512,RM-1213A,8/27/2014,0,0,768,0,0,0,768
26514,RM-1213A,8/29/2014,0,0,768,0,0,0,768
26520,RM-1213A,9/4/2014,0,0,768,0,0,0,768
26526,RM-1213A,9/10/2014,0,0,768,0,0,0,768
27192,RM-1217,8/22/2014,768,0,0,0,0,0,768
27193,RM-1217,8/23/2014,768,0,0,0,0,0,768
27194,RM-1217,8/24/2014,768,0,0,0,0,0,768
27197,RM-1217,8/27/2014,768,0,0,0,0,0,768
27199,RM-1217,8/29/2014,768,0,0,0,0,0,768
27205,RM-1217,9/4/2014,768,0,0,0,0,0,768
27211,RM-1217,9/10/2014,768,0,0,0,0,0,768
28568,RM-1221,8/22/2014,0,0,768,0,0,0,768
28569,RM-1221,8/23/2014,0,0,768,0,0,0,768
28570,RM-1221,8/24/2014,0,0,768,0,0,0,768
28573,RM-1221,8/27/2014,0,0,768,0,0,0,768
28575,RM-1221,8/29/2014,0,0,768,0,0,0,768
28581,RM-1221,9/4/2014,0,0,768,0,0,0,768
28587,RM-1221,9/10/2014,0,0,768,0,0,0,768
29253,RM-1223,8/22/2014,768,0,0,0,0,0,768
29254,RM-1223,8/23/2014,768,0,0,0,0,0,768
29255,RM-1223,8/24/2014,768,0,0,0,0,0,768
29258,RM-1223,8/27/2014,768,0,0,0,0,0,768
29260,RM-1223,8/29/2014,768,0,0,0,0,0,768
29266,RM-1223,9/4/2014,768,0,0,0,0,0,768
29272,RM-1223,9/10/2014,768,0,0,0,0,0,768
29834,RM-1224,5/10/2014,0,0,0,768,0,0,768
30626,RM-1229,8/22/2014,0,0,768,0,0,0,768
30627,RM-1229,8/23/2014,0,0,768,0,0,0,768
30628,RM-1229,8/24/2014,0,0,768,0,0,0,768
30631,RM-1229,8/27/2014,0,0,768,0,0,0,768
30633,RM-1229,8/29/2014,0,0,768,0,0,0,768
30639,RM-1229,9/4/2014,0,0,768,0,0,0,768
30645,RM-1229,9/10/2014,0,0,768,0,0,0,768
32658,RM-1236,8/27/2014,768,0,0,0,0,0,768
32660,RM-1236,8/29/2014,768,0,0,0,0,0,768
32666,RM-1236,9/4/2014,768,0,0,0,0,0,768
32672,RM-1236,9/10/2014,768,0,0,0,0,0,768
33491,RM-4xxx,8/22/2014,0,0,0,0,768,0,768
33492,RM-4xxx,8/23/2014,0,0,0,0,768,0,768
33493,RM-4xxx,8/24/2014,0,0,0,0,768,0,768
33496,RM-4xxx,8/27/2014,0,0,0,0,768,0,768
33498,RM-4xxx,8/29/2014,0,0,0,0,768,0,768
33504,RM-4xxx,9/4/2014,0,0,0,0,768,0,768
35761,RM-B109,6/14/2014,384,0,384,0,0,0,768
36517,RM-B200B,8/22/2014,0,0,768,0,0,0,768
36518,RM-B200B,8/23/2014,0,0,768,0,0,0,768
36519,RM-B200B,8/24/2014,0,0,768,0,0,0,768
36522,RM-B200B,8/27/2014,0,0,768,0,0,0,768
36524,RM-B200B,8/29/2014,0,0,768,0,0,0,768
36530,RM-B200B,9/4/2014,0,0,768,0,0,0,768
37198,RM-B200C,8/22/2014,768,0,0,0,0,0,768
37199,RM-B200C,8/23/2014,768,0,0,0,0,0,768
37200,RM-B200C,8/24/2014,768,0,0,0,0,0,768
37203,RM-B200C,8/27/2014,768,0,0,0,0,0,768
37205,RM-B200C,8/29/2014,768,0,0,0,0,0,768
37211,RM-B200C,9/4/2014,768,0,0,0,0,0,768
38495,RM-B215,6/4/2014,0,0,768,0,0,0,768
39947,RM-B222,8/22/2014,768,0,0,0,0,0,768
39948,RM-B222,8/23/2014,768,0,0,0,0,0,768
39949,RM-B222,8/24/2014,768,0,0,0,0,0,768
39952,RM-B222,8/27/2014,768,0,0,0,0,0,768
39954,RM-B222,8/29/2014,768,0,0,0,0,0,768
39960,RM-B222,9/4/2014,768,0,0,0,0,0,768
42008,RM-B230,8/22/2014,768,0,0,0,0,0,768
42009,RM-B230,8/23/2014,768,0,0,0,0,0,768
42010,RM-B230,8/24/2014,768,0,0,0,0,0,768
42013,RM-B230,8/27/2014,768,0,0,0,0,0,768
42015,RM-B230,8/29/2014,768,0,0,0,0,0,768
42021,RM-B230,9/4/2014,768,0,0,0,0,0,768
43259,RM-B240,8/22/2014,0,0,768,0,0,0,768
43260,RM-B240,8/23/2014,0,0,768,0,0,0,768
43261,RM-B240,8/24/2014,0,0,768,0,0,0,768
43264,RM-B240,8/27/2014,0,0,768,0,0,0,768
43266,RM-B240,8/29/2014,0,0,768,0,0,0,768
43272,RM-B240,9/4/2014,0,0,768,0,0,0,768
43842,RM-B240A,5/12/2014,0,768,0,0,0,0,768
43845,RM-B240A,5/15/2014,0,768,0,0,0,0,768
44554,RM-B250,8/22/2014,0,0,768,0,0,0,768
44555,RM-B250,8/23/2014,0,0,768,0,0,0,768
44556,RM-B250,8/24/2014,0,0,768,0,0,0,768
44559,RM-B250,8/27/2014,0,0,768,0,0,0,768
44561,RM-B250,8/29/2014,0,0,768,0,0,0,768
44567,RM-B250,9/4/2014,0,0,768,0,0,0,768
45238,RM-B250A,8/22/2014,768,0,0,0,0,0,768
45239,RM-B250A,8/23/2014,768,0,0,0,0,0,768
45240,RM-B250A,8/24/2014,768,0,0,0,0,0,768
45243,RM-B250A,8/27/2014,768,0,0,0,0,0,768
45245,RM-B250A,8/29/2014,768,0,0,0,0,0,768
45251,RM-B250A,9/4/2014,768,0,0,0,0,0,768
45818,RM-B260,5/9/2014,0,0,0,768,0,0,768
45923,RM-B260,8/22/2014,768,0,0,0,0,0,768
45924,RM-B260,8/23/2014,768,0,0,0,0,0,768
45925,RM-B260,8/24/2014,768,0,0,0,0,0,768
45928,RM-B260,8/27/2014,768,0,0,0,0,0,768
45930,RM-B260,8/29/2014,768,0,0,0,0,0,768
45936,RM-B260,9/4/2014,768,0,0,0,0,0,768
5863,RM-1110,9/10/2014,0,0,765,0,0,0,765
9952,RM-1123,9/10/2014,765,0,0,0,0,0,765
14449,RM-1134,9/10/2014,765,0,0,0,0,0,765
15719,RM-1144,9/10/2014,0,0,765,0,0,0,765
16377,RM-1145,9/10/2014,0,0,765,0,0,0,765
17746,RM-1151,9/10/2014,765,0,0,0,0,0,765
19119,RM-1155,9/10/2014,765,0,0,0,0,0,765
19795,RM-1156,9/10/2014,0,0,765,0,0,0,765
36536,RM-B200B,9/10/2014,0,0,765,0,0,0,765
39966,RM-B222,9/10/2014,765,0,0,0,0,0,765
45257,RM-B250A,9/10/2014,765,0,0,0,0,0,765
422,RM-1100A,9/6/2014,762,0,0,0,0,0,762
1792,RM-1102,9/6/2014,762,0,0,0,0,0,762
5859,RM-1110,9/6/2014,0,0,762,0,0,0,762
6544,RM-1113,9/6/2014,0,0,762,0,0,0,762
9948,RM-1123,9/6/2014,762,0,0,0,0,0,762
13238,RM-1132,9/6/2014,0,0,762,0,0,0,762
14445,RM-1134,9/6/2014,762,0,0,0,0,0,762
15715,RM-1144,9/6/2014,0,0,762,0,0,0,762
16373,RM-1145,9/6/2014,0,0,762,0,0,0,762
16941,RM-1150,5/13/2014,0,0,0,762,0,0,762
17742,RM-1151,9/6/2014,762,0,0,0,0,0,762
19115,RM-1155,9/6/2014,762,0,0,0,0,0,762
19791,RM-1156,9/6/2014,0,0,762,0,0,0,762
25167,RM-1212,9/6/2014,762,0,0,0,0,0,762
26522,RM-1213A,9/6/2014,0,0,762,0,0,0,762
27207,RM-1217,9/6/2014,762,0,0,0,0,0,762
28583,RM-1221,9/6/2014,0,0,762,0,0,0,762
29268,RM-1223,9/6/2014,762,0,0,0,0,0,762
29838,RM-1224,5/14/2014,0,0,0,762,0,0,762
30641,RM-1229,9/6/2014,0,0,762,0,0,0,762
32668,RM-1236,9/6/2014,762,0,0,0,0,0,762
33490,RM-4xxx,8/21/2014,0,0,0,0,762,0,762
33506,RM-4xxx,9/6/2014,0,0,0,0,762,0,762
33510,RM-4xxx,9/10/2014,0,0,0,0,762,0,762
36532,RM-B200B,9/6/2014,0,0,762,0,0,0,762
37213,RM-B200C,9/6/2014,762,0,0,0,0,0,762
37217,RM-B200C,9/10/2014,762,0,0,0,0,0,762
39962,RM-B222,9/6/2014,762,0,0,0,0,0,762
42023,RM-B230,9/6/2014,762,0,0,0,0,0,762
42027,RM-B230,9/10/2014,762,0,0,0,0,0,762
43274,RM-B240,9/6/2014,0,0,762,0,0,0,762
43278,RM-B240,9/10/2014,0,0,762,0,0,0,762
43843,RM-B240A,5/13/2014,0,762,0,0,0,0,762
44569,RM-B250,9/6/2014,0,0,762,0,0,0,762
44573,RM-B250,9/10/2014,0,0,762,0,0,0,762
45253,RM-B250A,9/6/2014,762,0,0,0,0,0,762
45938,RM-B260,9/6/2014,762,0,0,0,0,0,762
988,RM-1100D,5/10/2014,0,0,0,756,0,0,756
16944,RM-1150,5/16/2014,0,0,0,756,0,0,756
23776,RM-1208,8/19/2014,756,0,0,0,0,0,756
27781,RM-1218,5/15/2014,0,0,0,756,0,0,756
43838,RM-B240A,5/8/2014,0,756,0,0,0,0,756
43839,RM-B240A,5/9/2014,0,756,0,0,0,0,756
3392,RM-1107,7/9/2013,0,0,753,0,0,0,753
5880,RM-1110,9/29/2014,0,0,753,0,0,0,753
6133,RM-1113,7/9/2013,0,0,753,0,0,0,753
8852,RM-1122,7/9/2013,0,0,753,0,0,0,753
13512,RM-1133,7/9/2013,0,0,753,0,0,0,753
14567,RM-1134,1/8/2015,753,0,0,0,0,0,753
18016,RM-1154,7/9/2013,0,0,753,0,0,0,753
25426,RM-1213,7/9/2013,0,0,753,0,0,0,753
27484,RM-1218,7/9/2013,0,0,753,0,0,0,753
33669,RM-B102C,7/9/2013,0,0,753,0,0,0,753
37490,RM-B210,7/9/2013,0,0,753,0,0,0,753
46897,RM-B270,7/9/2013,0,0,753,0,0,0,753
47565,RM-B275,7/9/2013,0,0,753,0,0,0,753
487,RM-1100A,11/12/2014,750,0,0,0,0,0,750
1857,RM-1102,11/12/2014,750,0,0,0,0,0,750
6385,RM-1113,3/31/2014,0,0,750,0,0,0,750
6609,RM-1113,11/12/2014,0,0,750,0,0,0,750
10013,RM-1123,11/12/2014,750,0,0,0,0,0,750
12615,RM-1130,11/12/2014,0,0,750,0,0,0,750
13303,RM-1132,11/12/2014,0,0,750,0,0,0,750
14510,RM-1134,11/12/2014,750,0,0,0,0,0,750
15556,RM-1144,3/31/2014,0,0,750,0,0,0,750
15780,RM-1144,11/12/2014,0,0,750,0,0,0,750
16438,RM-1145,11/12/2014,0,0,750,0,0,0,750
19180,RM-1155,11/12/2014,750,0,0,0,0,0,750
19856,RM-1156,11/12/2014,0,0,750,0,0,0,750
20993,RM-1200B,5/14/2014,0,750,0,0,0,0,750
24547,RM-1208B,11/12/2014,750,0,0,0,0,0,750
25232,RM-1212,11/12/2014,750,0,0,0,0,0,750
26363,RM-1213A,3/31/2014,0,0,750,0,0,0,750
27960,RM-1218,11/12/2014,750,0,0,0,0,0,750
29333,RM-1223,11/12/2014,750,0,0,0,0,0,750
30706,RM-1229,11/12/2014,0,0,750,0,0,0,750
32509,RM-1236,3/31/2014,0,0,750,0,0,0,750
32733,RM-1236,11/12/2014,750,0,0,0,0,0,750
33513,RM-4xxx,9/13/2014,0,0,0,0,750,0,750
35686,RM-B109,3/31/2014,0,0,750,0,0,0,750
37278,RM-B200C,11/12/2014,750,0,0,0,0,0,750
38430,RM-B215,3/31/2014,0,0,750,0,0,0,750
40027,RM-B222,11/12/2014,750,0,0,0,0,0,750
43115,RM-B240,3/31/2014,0,0,750,0,0,0,750
43339,RM-B240,11/12/2014,0,0,750,0,0,0,750
43949,RM-B240A,11/12/2014,0,0,750,0,0,0,750
45318,RM-B250A,11/12/2014,750,0,0,0,0,0,750
429,RM-1100A,9/13/2014,747,0,0,0,0,0,747
1799,RM-1102,9/13/2014,747,0,0,0,0,0,747
4958,RM-1109,2/1/2014,0,0,0,0,0,747,747
5701,RM-1110,3/31/2014,0,0,747,0,0,0,747
5866,RM-1110,9/13/2014,0,0,747,0,0,0,747
6327,RM-1113,2/1/2014,0,0,747,0,0,0,747
6551,RM-1113,9/13/2014,0,0,747,0,0,0,747
6986,RM-1115,2/1/2014,0,0,0,0,0,747,747
7044,RM-1115,3/31/2014,747,0,0,0,0,0,747
7673,RM-1116,2/1/2014,747,0,0,0,0,0,747
7731,RM-1116,3/31/2014,747,0,0,0,0,0,747
9046,RM-1122,2/1/2014,0,0,0,0,0,747,747
9955,RM-1123,9/13/2014,747,0,0,0,0,0,747
10416,RM-1124,2/1/2014,0,0,0,0,0,747,747
12557,RM-1130,9/13/2014,0,0,747,0,0,0,747
13245,RM-1132,9/13/2014,0,0,747,0,0,0,747
14287,RM-1134,3/31/2014,747,0,0,0,0,0,747
14452,RM-1134,9/13/2014,747,0,0,0,0,0,747
15498,RM-1144,2/1/2014,0,0,747,0,0,0,747
15722,RM-1144,9/13/2014,0,0,747,0,0,0,747
16183,RM-1145,2/1/2014,0,0,0,0,0,747,747
16380,RM-1145,9/13/2014,0,0,747,0,0,0,747
17749,RM-1151,9/13/2014,747,0,0,0,0,0,747
18956,RM-1155,3/31/2014,747,0,0,0,0,0,747
19122,RM-1155,9/13/2014,747,0,0,0,0,0,747
19574,RM-1156,2/1/2014,747,0,0,0,0,0,747
19632,RM-1156,3/31/2014,747,0,0,0,0,0,747
19798,RM-1156,9/13/2014,0,0,747,0,0,0,747
22950,RM-1207,3/31/2014,747,0,0,0,0,0,747
25174,RM-1212,9/13/2014,747,0,0,0,0,0,747
25620,RM-1213,2/1/2014,0,0,0,0,0,747,747
26305,RM-1213A,2/1/2014,0,0,747,0,0,0,747
26529,RM-1213A,9/13/2014,0,0,747,0,0,0,747
27048,RM-1217,3/31/2014,747,0,0,0,0,0,747
27214,RM-1217,9/13/2014,747,0,0,0,0,0,747
28590,RM-1221,9/13/2014,0,0,747,0,0,0,747
29275,RM-1223,9/13/2014,747,0,0,0,0,0,747
30648,RM-1229,9/13/2014,0,0,747,0,0,0,747
31761,RM-1231,2/1/2014,0,0,0,0,0,747,747
32451,RM-1236,2/1/2014,0,0,747,0,0,0,747
32675,RM-1236,9/13/2014,747,0,0,0,0,0,747
33571,RM-4xxx,11/12/2014,0,0,0,0,747,0,747
36539,RM-B200B,9/13/2014,0,0,747,0,0,0,747
37220,RM-B200C,9/13/2014,747,0,0,0,0,0,747
38372,RM-B215,2/1/2014,0,0,747,0,0,0,747
39057,RM-B220,2/1/2014,747,0,0,0,0,0,747
39115,RM-B220,3/31/2014,747,0,0,0,0,0,747
39969,RM-B222,9/13/2014,747,0,0,0,0,0,747
40433,RM-B224,2/1/2014,0,0,0,0,0,747,747
41121,RM-B225,2/1/2014,0,0,0,0,0,747,747
42030,RM-B230,9/13/2014,747,0,0,0,0,0,747
42491,RM-B230A,2/1/2014,0,0,0,0,0,747,747
43281,RM-B240,9/13/2014,0,0,747,0,0,0,747
44352,RM-B250,2/1/2014,0,0,747,0,0,0,747
44576,RM-B250,9/13/2014,0,0,747,0,0,0,747
45095,RM-B250A,3/31/2014,747,0,0,0,0,0,747
45260,RM-B250A,9/13/2014,747,0,0,0,0,0,747
11,RM-1100A,7/9/2013,744,0,0,0,0,0,744
2707,RM-1106,7/9/2013,744,0,0,0,0,0,744
4764,RM-1109,7/9/2013,744,0,0,0,0,0,744
5449,RM-1110,7/9/2013,0,0,0,0,0,744,744
11592,RM-1126,7/9/2013,0,0,0,0,0,744,744
12140,RM-1130,7/9/2013,0,0,0,0,0,744,744
12827,RM-1132,7/9/2013,744,0,0,0,0,0,744
18071,RM-1154,9/12/2013,744,0,0,0,0,0,744
20326,RM-1200A,5/10/2014,0,0,0,744,0,0,744
23383,RM-1208,7/9/2013,0,0,0,0,0,744,744
26111,RM-1213A,7/9/2013,0,0,0,0,0,744,744
28172,RM-1221,7/9/2013,0,0,0,0,0,744,744
30230,RM-1229,7/9/2013,744,0,0,0,0,0,744
34885,RM-B103A,7/9/2013,0,0,0,0,0,744,744
36411,RM-B200B,5/8/2014,0,744,0,0,0,0,744
38178,RM-B215,7/9/2013,744,0,0,0,0,0,744
39551,RM-B222,7/9/2013,744,0,0,0,0,0,744
40927,RM-B225,7/9/2013,0,0,0,0,0,744,744
42297,RM-B230A,7/9/2013,0,0,0,0,0,744,744
43548,RM-B240A,7/9/2013,0,0,0,0,0,744,744
44158,RM-B250,7/9/2013,0,0,0,0,0,744,744
24497,RM-1208B,9/21/2014,594,0,144,0,0,0,738
45816,RM-B260,5/7/2014,0,0,0,738,0,0,738
12847,RM-1132,7/30/2013,735,0,0,0,0,0,735
2995,RM-1106,5/6/2014,0,0,0,732,0,0,732
20986,RM-1200B,5/7/2014,0,732,0,0,0,0,732
35762,RM-B109,6/15/2014,354,0,378,0,0,0,732
11596,RM-1126,7/13/2013,0,0,0,0,0,729,729
985,RM-1100D,5/7/2014,0,0,0,726,0,0,726
8455,RM-1117,5/6/2014,0,726,0,0,0,0,726
43837,RM-B240A,5/7/2014,0,726,0,0,0,0,726
47186,RM-B270,5/7/2014,0,0,0,726,0,0,726
20323,RM-1200A,5/7/2014,0,0,0,720,0,0,720
309,RM-1100A,5/16/2014,717,0,0,0,0,0,717
6431,RM-1113,5/16/2014,0,0,717,0,0,0,717
7090,RM-1115,5/16/2014,717,0,0,0,0,0,717
7777,RM-1116,5/16/2014,717,0,0,0,0,0,717
14332,RM-1134,5/16/2014,717,0,0,0,0,0,717
15602,RM-1144,5/16/2014,0,0,717,0,0,0,717
16260,RM-1145,5/16/2014,0,0,717,0,0,0,717
19002,RM-1155,5/16/2014,717,0,0,0,0,0,717
22996,RM-1207,5/16/2014,717,0,0,0,0,0,717
26409,RM-1213A,5/16/2014,0,0,717,0,0,0,717
38476,RM-B215,5/16/2014,0,0,717,0,0,0,717
39161,RM-B220,5/16/2014,717,0,0,0,0,0,717
39849,RM-B222,5/16/2014,717,0,0,0,0,0,717
43161,RM-B240,5/16/2014,0,0,717,0,0,0,717
45140,RM-B250A,5/16/2014,717,0,0,0,0,0,717
1679,RM-1102,5/16/2014,714,0,0,0,0,0,714
5746,RM-1110,5/16/2014,0,0,714,0,0,0,714
25054,RM-1212,5/16/2014,714,0,0,0,0,0,714
27778,RM-1218,5/12/2014,0,0,0,714,0,0,714
29155,RM-1223,5/16/2014,714,0,0,0,0,0,714
29839,RM-1224,5/15/2014,0,0,0,714,0,0,714
31180,RM-1230,5/16/2014,0,714,0,0,0,0,714
33660,RM-4xxx,2/9/2015,0,0,0,0,714,0,714
36410,RM-B200B,5/7/2014,0,714,0,0,0,0,714
43112,RM-B240,3/28/2014,0,0,714,0,0,0,714
6382,RM-1113,3/28/2014,0,0,711,0,0,0,711
15553,RM-1144,3/28/2014,0,0,711,0,0,0,711
26360,RM-1213A,3/28/2014,0,0,711,0,0,0,711
32506,RM-1236,3/28/2014,0,0,711,0,0,0,711
35683,RM-B109,3/28/2014,0,0,711,0,0,0,711
38427,RM-B215,3/28/2014,0,0,711,0,0,0,711
7476,RM-1116,7/6/2013,0,0,354,0,0,354,708
34017,RM-B102C,12/5/2014,708,0,0,0,0,0,708
36799,RM-B200C,7/6/2013,0,0,354,0,0,354,708
40236,RM-B224,7/6/2013,0,0,354,0,0,354,708
8164,RM-1117,7/6/2013,351,0,0,0,0,354,705
18701,RM-1155,7/6/2013,351,0,354,0,0,0,705
32254,RM-1236,7/6/2013,351,0,354,0,0,0,705
5013,RM-1109,3/28/2014,0,0,0,0,0,702,702
9101,RM-1122,3/28/2014,0,0,0,0,0,702,702
16238,RM-1145,3/28/2014,0,0,0,0,0,702,702
25675,RM-1213,3/28/2014,0,0,0,0,0,702,702
28421,RM-1221,3/28/2014,0,0,0,0,0,702,702
29836,RM-1224,5/12/2014,0,0,0,702,0,0,702
31178,RM-1230,5/14/2014,0,702,0,0,0,0,702
31816,RM-1231,3/28/2014,0,0,0,0,0,702,702
40488,RM-B224,3/28/2014,0,0,0,0,0,702,702
42546,RM-B230A,3/28/2014,0,0,0,0,0,702,702
47814,RM-B275,3/28/2014,0,0,0,0,0,702,702
6253,RM-1113,11/19/2013,348,0,348,0,0,0,696
8287,RM-1117,11/19/2013,348,0,348,0,0,0,696
8972,RM-1122,11/19/2013,0,0,348,0,0,348,696
9672,RM-1123,12/4/2013,0,0,696,0,0,0,696
12962,RM-1132,12/4/2013,0,0,696,0,0,0,696
13647,RM-1133,12/4/2013,0,0,696,0,0,0,696
18824,RM-1155,11/19/2013,348,0,348,0,0,0,696
24206,RM-1208B,12/4/2013,0,0,696,0,0,0,696
24891,RM-1212,12/4/2013,0,0,696,0,0,0,696
26931,RM-1217,12/4/2013,696,0,0,0,0,0,696
27779,RM-1218,5/13/2014,0,0,0,696,0,0,696
28307,RM-1221,12/4/2013,0,0,696,0,0,0,696
30350,RM-1229,11/19/2013,0,0,348,0,0,348,696
31179,RM-1230,5/15/2014,0,696,0,0,0,0,696
32392,RM-1236,12/4/2013,0,0,696,0,0,0,696
39686,RM-B222,12/4/2013,696,0,0,0,0,0,696
44278,RM-B250,11/19/2013,348,0,348,0,0,0,696
47685,RM-B275,11/19/2013,0,0,348,0,0,348,696
2842,RM-1106,12/4/2013,0,0,0,0,0,693,693
4899,RM-1109,12/4/2013,0,0,0,0,0,693,693
5698,RM-1110,3/28/2014,0,0,693,0,0,0,693
7728,RM-1116,3/28/2014,693,0,0,0,0,0,693
8987,RM-1122,12/4/2013,0,0,0,0,0,693,693
10357,RM-1124,12/4/2013,0,0,0,0,0,693,693
12275,RM-1130,12/4/2013,0,0,0,0,0,693,693
14284,RM-1134,3/28/2014,693,0,0,0,0,0,693
16124,RM-1145,12/4/2013,0,0,0,0,0,693,693
22833,RM-1207,12/4/2013,0,0,0,0,0,693,693
23503,RM-1208,11/19/2013,345,0,0,0,0,348,693
23728,RM-1208,7/2/2014,225,324,0,144,0,0,693
25561,RM-1213,12/4/2013,0,0,0,0,0,693,693
27045,RM-1217,3/28/2014,693,0,0,0,0,0,693
31702,RM-1231,12/4/2013,0,0,0,0,0,693,693
35760,RM-B109,6/13/2014,324,0,369,0,0,0,693
36256,RM-B200B,12/4/2013,0,0,0,0,0,693,693
39112,RM-B220,3/28/2014,693,0,0,0,0,0,693
40374,RM-B224,12/4/2013,0,0,0,0,0,693,693
41062,RM-B225,12/4/2013,0,0,0,0,0,693,693
42432,RM-B230A,12/4/2013,0,0,0,0,0,693,693
45092,RM-B250A,3/28/2014,693,0,0,0,0,0,693
47700,RM-B275,12/4/2013,0,0,0,0,0,693,693
478,RM-1100A,11/3/2014,690,0,0,0,0,0,690
1848,RM-1102,11/3/2014,690,0,0,0,0,0,690
6600,RM-1113,11/3/2014,0,0,690,0,0,0,690
10004,RM-1123,11/3/2014,690,0,0,0,0,0,690
12606,RM-1130,11/3/2014,0,0,690,0,0,0,690
13294,RM-1132,11/3/2014,0,0,690,0,0,0,690
14501,RM-1134,11/3/2014,690,0,0,0,0,0,690
15771,RM-1144,11/3/2014,0,0,690,0,0,0,690
16429,RM-1145,11/3/2014,0,0,690,0,0,0,690
17798,RM-1151,11/3/2014,690,0,0,0,0,0,690
19171,RM-1155,11/3/2014,690,0,0,0,0,0,690
19847,RM-1156,11/3/2014,0,0,690,0,0,0,690
24538,RM-1208B,11/3/2014,690,0,0,0,0,0,690
25223,RM-1212,11/3/2014,690,0,0,0,0,0,690
25273,RM-1212,12/23/2014,690,0,0,0,0,0,690
27782,RM-1218,5/16/2014,0,0,0,690,0,0,690
27951,RM-1218,11/3/2014,690,0,0,0,0,0,690
29324,RM-1223,11/3/2014,690,0,0,0,0,0,690
30697,RM-1229,11/3/2014,0,0,690,0,0,0,690
32724,RM-1236,11/3/2014,690,0,0,0,0,0,690
33562,RM-4xxx,11/3/2014,0,0,0,0,690,0,690
34447,RM-B103,3/20/2014,0,0,0,690,0,0,690
37269,RM-B200C,11/3/2014,690,0,0,0,0,0,690
40018,RM-B222,11/3/2014,690,0,0,0,0,0,690
43330,RM-B240,11/3/2014,0,0,690,0,0,0,690
43940,RM-B240A,11/3/2014,0,0,690,0,0,0,690
45309,RM-B250A,11/3/2014,690,0,0,0,0,0,690
6302,RM-1113,1/7/2014,0,0,687,0,0,0,687
9706,RM-1123,1/7/2014,0,0,687,0,0,0,687
13681,RM-1133,1/7/2014,0,0,687,0,0,0,687
15473,RM-1144,1/7/2014,0,0,687,0,0,0,687
24240,RM-1208B,1/7/2014,0,0,687,0,0,0,687
32426,RM-1236,1/7/2014,0,0,687,0,0,0,687
41781,RM-B230,1/7/2014,0,0,687,0,0,0,687
2876,RM-1106,1/7/2014,0,0,0,0,0,684,684
4933,RM-1109,1/7/2014,0,0,0,0,0,684,684
6961,RM-1115,1/7/2014,0,0,0,0,0,684,684
9021,RM-1122,1/7/2014,0,0,0,0,0,684,684
10391,RM-1124,1/7/2014,0,0,0,0,0,684,684
12996,RM-1132,1/7/2014,0,0,684,0,0,0,684
16158,RM-1145,1/7/2014,0,0,0,0,0,684,684
19549,RM-1156,1/7/2014,684,0,0,0,0,0,684
25595,RM-1213,1/7/2014,0,0,0,0,0,684,684
26965,RM-1217,1/7/2014,684,0,0,0,0,0,684
31736,RM-1231,1/7/2014,0,0,0,0,0,684,684
36290,RM-B200B,1/7/2014,0,0,0,0,0,684,684
39032,RM-B220,1/7/2014,684,0,0,0,0,0,684
39720,RM-B222,1/7/2014,684,0,0,0,0,0,684
40408,RM-B224,1/7/2014,0,0,0,0,0,684,684
41096,RM-B225,1/7/2014,0,0,0,0,0,684,684
42466,RM-B230A,1/7/2014,0,0,0,0,0,684,684
47734,RM-B275,1/7/2014,0,0,0,0,0,684,684
2884,RM-1106,1/15/2014,0,0,0,0,0,675,675
3443,RM-1107,9/7/2013,0,0,675,0,0,0,675
4941,RM-1109,1/15/2014,0,0,0,0,0,675,675
6184,RM-1113,9/7/2013,0,0,675,0,0,0,675
6310,RM-1113,1/15/2014,0,0,675,0,0,0,675
6969,RM-1115,1/15/2014,0,0,0,0,0,675,675
8903,RM-1122,9/7/2013,0,0,675,0,0,0,675
9029,RM-1122,1/15/2014,0,0,0,0,0,675,675
9588,RM-1123,9/7/2013,0,0,675,0,0,0,675
9714,RM-1123,1/15/2014,0,0,675,0,0,0,675
10399,RM-1124,1/15/2014,0,0,0,0,0,675,675
13563,RM-1133,9/7/2013,0,0,675,0,0,0,675
15481,RM-1144,1/15/2014,0,0,675,0,0,0,675
16166,RM-1145,1/15/2014,0,0,0,0,0,675,675
18067,RM-1154,9/7/2013,675,0,0,0,0,0,675
20748,RM-1200B,9/7/2013,0,0,0,0,0,675,675
24248,RM-1208B,1/15/2014,0,0,675,0,0,0,675
25477,RM-1213,9/7/2013,0,0,675,0,0,0,675
25603,RM-1213,1/15/2014,0,0,0,0,0,675,675
26847,RM-1217,9/7/2013,675,0,0,0,0,0,675
31744,RM-1231,1/15/2014,0,0,0,0,0,675,675
32434,RM-1236,1/15/2014,0,0,675,0,0,0,675
33720,RM-B102C,9/7/2013,0,0,675,0,0,0,675
35763,RM-B109,6/16/2014,327,0,348,0,0,0,675
40416,RM-B224,1/15/2014,0,0,0,0,0,675,675
41104,RM-B225,1/15/2014,0,0,0,0,0,675,675
42474,RM-B230A,1/15/2014,0,0,0,0,0,675,675
44335,RM-B250,1/15/2014,0,0,675,0,0,0,675
46948,RM-B270,9/7/2013,0,0,675,0,0,0,675
7656,RM-1116,1/15/2014,672,0,0,0,0,0,672
12191,RM-1130,9/7/2013,0,0,0,0,0,672,672
13004,RM-1132,1/15/2014,0,0,672,0,0,0,672
15355,RM-1144,9/7/2013,0,0,0,0,0,672,672
19557,RM-1156,1/15/2014,672,0,0,0,0,0,672
25483,RM-1213,9/14/2013,0,0,672,0,0,0,672
29840,RM-1224,5/16/2014,0,0,0,672,0,0,672
31176,RM-1230,5/12/2014,0,672,0,0,0,0,672
31618,RM-1231,9/7/2013,0,0,0,0,0,672,672
34936,RM-B103A,9/7/2013,0,0,0,0,0,672,672
36172,RM-B200B,9/7/2013,0,0,0,0,0,672,672
39040,RM-B220,1/15/2014,672,0,0,0,0,0,672
39728,RM-B222,1/15/2014,672,0,0,0,0,0,672
40290,RM-B224,9/7/2013,0,0,0,0,0,672,672
40978,RM-B225,9/7/2013,0,0,0,0,0,672,672
42348,RM-B230A,9/7/2013,0,0,0,0,0,672,672
43599,RM-B240A,9/7/2013,0,0,0,0,0,672,672
44209,RM-B250,9/7/2013,672,0,0,0,0,0,672
4956,RM-1109,1/30/2014,0,0,0,0,0,666,666
6984,RM-1115,1/30/2014,0,0,0,0,0,666,666
9044,RM-1122,1/30/2014,0,0,0,0,0,666,666
10414,RM-1124,1/30/2014,0,0,0,0,0,666,666
13005,RM-1132,1/16/2014,0,0,660,6,0,0,666
16181,RM-1145,1/30/2014,0,0,0,0,0,666,666
16935,RM-1150,5/7/2014,0,0,0,666,0,0,666
25618,RM-1213,1/30/2014,0,0,0,0,0,666,666
29837,RM-1224,5/13/2014,0,0,0,666,0,0,666
31177,RM-1230,5/13/2014,0,666,0,0,0,0,666
31759,RM-1231,1/30/2014,0,0,0,0,0,666,666
35764,RM-B109,6/17/2014,321,0,345,0,0,0,666
39729,RM-B222,1/16/2014,660,0,0,6,0,0,666
40431,RM-B224,1/30/2014,0,0,0,0,0,666,666
41119,RM-B225,1/30/2014,0,0,0,0,0,666,666
42489,RM-B230A,1/30/2014,0,0,0,0,0,666,666
2885,RM-1106,1/16/2014,0,0,0,6,0,657,663
6325,RM-1113,1/30/2014,0,0,663,0,0,0,663
7671,RM-1116,1/30/2014,663,0,0,0,0,0,663
9715,RM-1123,1/16/2014,0,6,657,0,0,0,663
15496,RM-1144,1/30/2014,0,0,663,0,0,0,663
19572,RM-1156,1/30/2014,663,0,0,0,0,0,663
24249,RM-1208B,1/16/2014,0,0,657,6,0,0,663
26303,RM-1213A,1/30/2014,0,0,663,0,0,0,663
32449,RM-1236,1/30/2014,0,0,663,0,0,0,663
35765,RM-B109,6/18/2014,330,0,333,0,0,0,663
38370,RM-B215,1/30/2014,0,0,663,0,0,0,663
39055,RM-B220,1/30/2014,663,0,0,0,0,0,663
44350,RM-B250,1/30/2014,0,0,663,0,0,0,663
7657,RM-1116,1/16/2014,660,0,0,0,0,0,660
19558,RM-1156,1/16/2014,660,0,0,0,0,0,660
39041,RM-B220,1/16/2014,660,0,0,0,0,0,660
4942,RM-1109,1/16/2014,0,0,0,0,0,657,657
6311,RM-1113,1/16/2014,0,0,657,0,0,0,657
6970,RM-1115,1/16/2014,0,0,0,0,0,657,657
9030,RM-1122,1/16/2014,0,0,0,0,0,657,657
10400,RM-1124,1/16/2014,0,0,0,0,0,657,657
15482,RM-1144,1/16/2014,0,0,657,0,0,0,657
16167,RM-1145,1/16/2014,0,0,0,0,0,657,657
25604,RM-1213,1/16/2014,0,0,0,0,0,657,657
31745,RM-1231,1/16/2014,0,0,0,0,0,657,657
32435,RM-1236,1/16/2014,0,0,657,0,0,0,657
40417,RM-B224,1/16/2014,0,0,0,0,0,657,657
41105,RM-B225,1/16/2014,0,0,0,0,0,657,657
42475,RM-B230A,1/16/2014,0,0,0,0,0,657,657
44336,RM-B250,1/16/2014,0,0,657,0,0,0,657
5770,RM-1110,6/9/2014,0,0,654,0,0,0,654
6455,RM-1113,6/9/2014,0,0,654,0,0,0,654
14356,RM-1134,6/9/2014,654,0,0,0,0,0,654
15626,RM-1144,6/9/2014,0,0,654,0,0,0,654
16284,RM-1145,6/9/2014,0,0,654,0,0,0,654
19026,RM-1155,6/9/2014,654,0,0,0,0,0,654
23020,RM-1207,6/9/2014,654,0,0,0,0,0,654
25078,RM-1212,6/9/2014,654,0,0,0,0,0,654
26433,RM-1213A,6/9/2014,0,0,654,0,0,0,654
28494,RM-1221,6/9/2014,0,0,654,0,0,0,654
29179,RM-1223,6/9/2014,654,0,0,0,0,0,654
36417,RM-B200B,5/14/2014,0,654,0,0,0,0,654
37124,RM-B200C,6/9/2014,654,0,0,0,0,0,654
39185,RM-B220,6/9/2014,654,0,0,0,0,0,654
41934,RM-B230,6/9/2014,654,0,0,0,0,0,654
43185,RM-B240,6/9/2014,0,0,654,0,0,0,654
45164,RM-B250A,6/9/2014,654,0,0,0,0,0,654
447,RM-1100A,10/3/2014,651,0,0,0,0,0,651
1817,RM-1102,10/3/2014,651,0,0,0,0,0,651
6569,RM-1113,10/3/2014,0,0,651,0,0,0,651
9973,RM-1123,10/3/2014,651,0,0,0,0,0,651
12575,RM-1130,10/3/2014,0,0,651,0,0,0,651
13263,RM-1132,10/3/2014,0,0,651,0,0,0,651
14470,RM-1134,10/3/2014,651,0,0,0,0,0,651
15740,RM-1144,10/3/2014,0,0,651,0,0,0,651
16398,RM-1145,10/3/2014,0,0,651,0,0,0,651
17767,RM-1151,10/3/2014,651,0,0,0,0,0,651
19140,RM-1155,10/3/2014,651,0,0,0,0,0,651
19816,RM-1156,10/3/2014,0,0,651,0,0,0,651
24507,RM-1208B,10/3/2014,651,0,0,0,0,0,651
25192,RM-1212,10/3/2014,651,0,0,0,0,0,651
28608,RM-1221,10/3/2014,0,0,651,0,0,0,651
29293,RM-1223,10/3/2014,651,0,0,0,0,0,651
30666,RM-1229,10/3/2014,0,0,651,0,0,0,651
32693,RM-1236,10/3/2014,651,0,0,0,0,0,651
33531,RM-4xxx,10/3/2014,0,0,0,0,651,0,651
36557,RM-B200B,10/3/2014,0,0,651,0,0,0,651
37238,RM-B200C,10/3/2014,651,0,0,0,0,0,651
39987,RM-B222,10/3/2014,651,0,0,0,0,0,651
42048,RM-B230,10/3/2014,651,0,0,0,0,0,651
43299,RM-B240,10/3/2014,0,0,651,0,0,0,651
43909,RM-B240A,10/3/2014,0,0,651,0,0,0,651
44594,RM-B250,10/3/2014,0,0,651,0,0,0,651
45278,RM-B250A,10/3/2014,651,0,0,0,0,0,651
24205,RM-1208B,12/3/2013,0,0,648,0,0,0,648
430,RM-1100A,9/14/2014,636,0,0,0,0,0,636
432,RM-1100A,9/16/2014,636,0,0,0,0,0,636
1800,RM-1102,9/14/2014,636,0,0,0,0,0,636
1802,RM-1102,9/16/2014,636,0,0,0,0,0,636
5472,RM-1110,8/2/2013,0,0,0,0,0,636,636
5867,RM-1110,9/14/2014,0,0,636,0,0,0,636
5868,RM-1110,9/15/2014,0,0,636,0,0,0,636
6552,RM-1113,9/14/2014,0,0,636,0,0,0,636
6554,RM-1113,9/16/2014,0,0,636,0,0,0,636
9956,RM-1123,9/14/2014,636,0,0,0,0,0,636
9957,RM-1123,9/15/2014,636,0,0,0,0,0,636
12558,RM-1130,9/14/2014,0,0,636,0,0,0,636
12559,RM-1130,9/15/2014,0,0,636,0,0,0,636
13246,RM-1132,9/14/2014,0,0,636,0,0,0,636
13248,RM-1132,9/16/2014,0,0,636,0,0,0,636
14453,RM-1134,9/14/2014,636,0,0,0,0,0,636
14455,RM-1134,9/16/2014,636,0,0,0,0,0,636
15723,RM-1144,9/14/2014,0,0,636,0,0,0,636
15724,RM-1144,9/15/2014,0,0,636,0,0,0,636
16381,RM-1145,9/14/2014,0,0,636,0,0,0,636
16382,RM-1145,9/15/2014,0,0,636,0,0,0,636
17750,RM-1151,9/14/2014,636,0,0,0,0,0,636
17751,RM-1151,9/15/2014,636,0,0,0,0,0,636
19123,RM-1155,9/14/2014,636,0,0,0,0,0,636
19124,RM-1155,9/15/2014,636,0,0,0,0,0,636
19799,RM-1156,9/14/2014,0,0,636,0,0,0,636
19800,RM-1156,9/15/2014,0,0,636,0,0,0,636
25175,RM-1212,9/14/2014,636,0,0,0,0,0,636
25177,RM-1212,9/16/2014,636,0,0,0,0,0,636
26530,RM-1213A,9/14/2014,0,0,636,0,0,0,636
26532,RM-1213A,9/16/2014,0,0,636,0,0,0,636
28591,RM-1221,9/14/2014,0,0,636,0,0,0,636
28593,RM-1221,9/16/2014,0,0,636,0,0,0,636
29276,RM-1223,9/14/2014,636,0,0,0,0,0,636
29278,RM-1223,9/16/2014,636,0,0,0,0,0,636
30649,RM-1229,9/14/2014,0,0,636,0,0,0,636
30651,RM-1229,9/16/2014,0,0,636,0,0,0,636
32676,RM-1236,9/14/2014,636,0,0,0,0,0,636
32678,RM-1236,9/16/2014,636,0,0,0,0,0,636
33515,RM-4xxx,9/15/2014,0,0,0,0,636,0,636
36540,RM-B200B,9/14/2014,0,0,636,0,0,0,636
36541,RM-B200B,9/15/2014,0,0,636,0,0,0,636
37221,RM-B200C,9/14/2014,636,0,0,0,0,0,636
37222,RM-B200C,9/15/2014,636,0,0,0,0,0,636
39970,RM-B222,9/14/2014,636,0,0,0,0,0,636
39971,RM-B222,9/15/2014,636,0,0,0,0,0,636
42031,RM-B230,9/14/2014,636,0,0,0,0,0,636
42032,RM-B230,9/15/2014,636,0,0,0,0,0,636
43282,RM-B240,9/14/2014,0,0,636,0,0,0,636
43283,RM-B240,9/15/2014,0,0,636,0,0,0,636
44577,RM-B250,9/14/2014,0,0,636,0,0,0,636
44578,RM-B250,9/15/2014,0,0,636,0,0,0,636
45261,RM-B250A,9/14/2014,636,0,0,0,0,0,636
45262,RM-B250A,9/15/2014,636,0,0,0,0,0,636
431,RM-1100A,9/15/2014,633,0,0,0,0,0,633
1801,RM-1102,9/15/2014,633,0,0,0,0,0,633
5869,RM-1110,9/16/2014,0,0,633,0,0,0,633
6553,RM-1113,9/15/2014,0,0,633,0,0,0,633
9958,RM-1123,9/16/2014,633,0,0,0,0,0,633
12560,RM-1130,9/16/2014,0,0,633,0,0,0,633
13247,RM-1132,9/15/2014,0,0,633,0,0,0,633
14454,RM-1134,9/15/2014,633,0,0,0,0,0,633
15725,RM-1144,9/16/2014,0,0,633,0,0,0,633
16383,RM-1145,9/16/2014,0,0,633,0,0,0,633
17752,RM-1151,9/16/2014,633,0,0,0,0,0,633
19125,RM-1155,9/16/2014,633,0,0,0,0,0,633
19801,RM-1156,9/16/2014,0,0,633,0,0,0,633
25176,RM-1212,9/15/2014,633,0,0,0,0,0,633
26531,RM-1213A,9/15/2014,0,0,633,0,0,0,633
28592,RM-1221,9/15/2014,0,0,633,0,0,0,633
29277,RM-1223,9/15/2014,633,0,0,0,0,0,633
30650,RM-1229,9/15/2014,0,0,633,0,0,0,633
32677,RM-1236,9/15/2014,633,0,0,0,0,0,633
33514,RM-4xxx,9/14/2014,0,0,0,0,633,0,633
33516,RM-4xxx,9/16/2014,0,0,0,0,633,0,633
36542,RM-B200B,9/16/2014,0,0,633,0,0,0,633
37223,RM-B200C,9/16/2014,633,0,0,0,0,0,633
39972,RM-B222,9/16/2014,633,0,0,0,0,0,633
42033,RM-B230,9/16/2014,633,0,0,0,0,0,633
43284,RM-B240,9/16/2014,0,0,633,0,0,0,633
44579,RM-B250,9/16/2014,0,0,633,0,0,0,633
45263,RM-B250A,9/16/2014,633,0,0,0,0,0,633
20,RM-1100A,7/19/2013,630,0,0,0,0,0,630
2716,RM-1106,7/19/2013,630,0,0,0,0,0,630
3401,RM-1107,7/19/2013,0,0,630,0,0,0,630
5458,RM-1110,7/19/2013,0,0,0,0,0,630,630
6142,RM-1113,7/19/2013,0,0,630,0,0,0,630
8861,RM-1122,7/19/2013,0,0,630,0,0,0,630
12149,RM-1130,7/19/2013,0,0,0,0,0,630,630
12836,RM-1132,7/19/2013,630,0,0,0,0,0,630
13521,RM-1133,7/19/2013,0,0,630,0,0,0,630
18025,RM-1154,7/19/2013,0,0,630,0,0,0,630
23392,RM-1208,7/19/2013,0,0,0,0,0,630,630
25435,RM-1213,7/19/2013,0,0,630,0,0,0,630
26120,RM-1213A,7/19/2013,0,0,0,0,0,630,630
28181,RM-1221,7/19/2013,0,0,0,0,0,630,630
30239,RM-1229,7/19/2013,630,0,0,0,0,0,630
33678,RM-B102C,7/19/2013,0,0,630,0,0,0,630
34894,RM-B103A,7/19/2013,0,0,0,0,0,630,630
37499,RM-B210,7/19/2013,0,0,630,0,0,0,630
39560,RM-B222,7/19/2013,630,0,0,0,0,0,630
40936,RM-B225,7/19/2013,0,0,0,0,0,630,630
42306,RM-B230A,7/19/2013,0,0,0,0,0,630,630
43557,RM-B240A,7/19/2013,0,0,0,0,0,630,630
46906,RM-B270,7/19/2013,0,0,630,0,0,0,630
47574,RM-B275,7/19/2013,0,0,630,0,0,0,630
204,RM-1100A,1/31/2014,0,624,0,0,0,0,624
2259,RM-1104,1/31/2014,0,624,0,0,0,0,624
16839,RM-1150,1/31/2014,0,0,0,624,0,0,624
17524,RM-1151,1/31/2014,0,0,0,624,0,0,624
20227,RM-1200A,1/31/2014,0,0,0,624,0,0,624
27677,RM-1218,1/31/2014,0,0,0,624,0,0,624
34399,RM-B103,1/31/2014,0,0,0,624,0,0,624
43741,RM-B240A,1/31/2014,0,624,0,0,0,0,624
45720,RM-B260,1/31/2014,0,0,0,624,0,0,624
35766,RM-B109,6/19/2014,309,0,309,0,0,0,618
6453,RM-1113,6/7/2014,0,0,615,0,0,0,615
15624,RM-1144,6/7/2014,0,0,615,0,0,0,615
16282,RM-1145,6/7/2014,0,0,615,0,0,0,615
26431,RM-1213A,6/7/2014,0,0,615,0,0,0,615
28492,RM-1221,6/7/2014,0,0,615,0,0,0,615
37277,RM-B200C,11/11/2014,615,0,0,0,0,0,615
43183,RM-B240,6/7/2014,0,0,615,0,0,0,615
43948,RM-B240A,11/11/2014,0,0,615,0,0,0,615
486,RM-1100A,11/11/2014,612,0,0,0,0,0,612
1856,RM-1102,11/11/2014,612,0,0,0,0,0,612
6608,RM-1113,11/11/2014,0,0,612,0,0,0,612
10012,RM-1123,11/11/2014,612,0,0,0,0,0,612
12614,RM-1130,11/11/2014,0,0,612,0,0,0,612
13302,RM-1132,11/11/2014,0,0,612,0,0,0,612
13851,RM-1133,6/26/2014,0,612,0,0,0,0,612
14509,RM-1134,11/11/2014,612,0,0,0,0,0,612
15779,RM-1144,11/11/2014,0,0,612,0,0,0,612
16437,RM-1145,11/11/2014,0,0,612,0,0,0,612
19179,RM-1155,11/11/2014,612,0,0,0,0,0,612
19855,RM-1156,11/11/2014,0,0,612,0,0,0,612
24546,RM-1208B,11/11/2014,612,0,0,0,0,0,612
25231,RM-1212,11/11/2014,612,0,0,0,0,0,612
27959,RM-1218,11/11/2014,612,0,0,0,0,0,612
29332,RM-1223,11/11/2014,612,0,0,0,0,0,612
30705,RM-1229,11/11/2014,0,0,612,0,0,0,612
32732,RM-1236,11/11/2014,612,0,0,0,0,0,612
33570,RM-4xxx,11/11/2014,0,0,0,0,612,0,612
40026,RM-B222,11/11/2014,612,0,0,0,0,0,612
43338,RM-B240,11/11/2014,0,0,612,0,0,0,612
45317,RM-B250A,11/11/2014,612,0,0,0,0,0,612
433,RM-1100A,9/17/2014,603,0,0,0,0,0,603
1803,RM-1102,9/17/2014,603,0,0,0,0,0,603
5870,RM-1110,9/17/2014,0,0,603,0,0,0,603
6555,RM-1113,9/17/2014,0,0,603,0,0,0,603
9959,RM-1123,9/17/2014,603,0,0,0,0,0,603
12561,RM-1130,9/17/2014,0,0,603,0,0,0,603
13249,RM-1132,9/17/2014,0,0,603,0,0,0,603
14456,RM-1134,9/17/2014,603,0,0,0,0,0,603
15726,RM-1144,9/17/2014,0,0,603,0,0,0,603
16384,RM-1145,9/17/2014,0,0,603,0,0,0,603
17753,RM-1151,9/17/2014,603,0,0,0,0,0,603
19126,RM-1155,9/17/2014,603,0,0,0,0,0,603
19802,RM-1156,9/17/2014,0,0,603,0,0,0,603
25178,RM-1212,9/17/2014,603,0,0,0,0,0,603
26533,RM-1213A,9/17/2014,0,0,603,0,0,0,603
28594,RM-1221,9/17/2014,0,0,603,0,0,0,603
29279,RM-1223,9/17/2014,603,0,0,0,0,0,603
30652,RM-1229,9/17/2014,0,0,603,0,0,0,603
32679,RM-1236,9/17/2014,603,0,0,0,0,0,603
33517,RM-4xxx,9/17/2014,0,0,0,0,603,0,603
35767,RM-B109,6/20/2014,303,0,300,0,0,0,603
36543,RM-B200B,9/17/2014,0,0,603,0,0,0,603
37224,RM-B200C,9/17/2014,603,0,0,0,0,0,603
39973,RM-B222,9/17/2014,603,0,0,0,0,0,603
42034,RM-B230,9/17/2014,603,0,0,0,0,0,603
43285,RM-B240,9/17/2014,0,0,603,0,0,0,603
43895,RM-B240A,9/17/2014,0,0,603,0,0,0,603
44580,RM-B250,9/17/2014,0,0,603,0,0,0,603
45264,RM-B250A,9/17/2014,603,0,0,0,0,0,603
5768,RM-1110,6/7/2014,0,0,600,0,0,0,600
13115,RM-1132,5/6/2014,0,0,0,600,0,0,600
14354,RM-1134,6/7/2014,600,0,0,0,0,0,600
19024,RM-1155,6/7/2014,600,0,0,0,0,0,600
23018,RM-1207,6/7/2014,600,0,0,0,0,0,600
24416,RM-1208B,7/2/2014,225,0,225,150,0,0,600
25076,RM-1212,6/7/2014,600,0,0,0,0,0,600
29177,RM-1223,6/7/2014,600,0,0,0,0,0,600
37122,RM-B200C,6/7/2014,600,0,0,0,0,0,600
39183,RM-B220,6/7/2014,600,0,0,0,0,0,600
41932,RM-B230,6/7/2014,600,0,0,0,0,0,600
45162,RM-B250A,6/7/2014,600,0,0,0,0,0,600
45823,RM-B260,5/14/2014,0,0,0,600,0,0,600
436,RM-1100A,9/20/2014,594,0,0,0,0,0,594
437,RM-1100A,9/21/2014,594,0,0,0,0,0,594
1806,RM-1102,9/20/2014,594,0,0,0,0,0,594
1807,RM-1102,9/21/2014,594,0,0,0,0,0,594
5873,RM-1110,9/20/2014,0,0,594,0,0,0,594
5874,RM-1110,9/21/2014,0,0,594,0,0,0,594
6456,RM-1113,6/10/2014,0,0,594,0,0,0,594
6558,RM-1113,9/20/2014,0,0,594,0,0,0,594
6559,RM-1113,9/21/2014,0,0,594,0,0,0,594
9962,RM-1123,9/20/2014,594,0,0,0,0,0,594
9963,RM-1123,9/21/2014,594,0,0,0,0,0,594
12564,RM-1130,9/20/2014,0,0,594,0,0,0,594
12565,RM-1130,9/21/2014,0,0,594,0,0,0,594
13252,RM-1132,9/20/2014,0,0,594,0,0,0,594
13253,RM-1132,9/21/2014,0,0,594,0,0,0,594
14459,RM-1134,9/20/2014,594,0,0,0,0,0,594
14460,RM-1134,9/21/2014,594,0,0,0,0,0,594
15627,RM-1144,6/10/2014,0,0,594,0,0,0,594
15729,RM-1144,9/20/2014,0,0,594,0,0,0,594
15730,RM-1144,9/21/2014,0,0,594,0,0,0,594
16285,RM-1145,6/10/2014,0,0,594,0,0,0,594
16387,RM-1145,9/20/2014,0,0,594,0,0,0,594
16388,RM-1145,9/21/2014,0,0,594,0,0,0,594
17756,RM-1151,9/20/2014,594,0,0,0,0,0,594
17757,RM-1151,9/21/2014,594,0,0,0,0,0,594
19129,RM-1155,9/20/2014,594,0,0,0,0,0,594
19130,RM-1155,9/21/2014,594,0,0,0,0,0,594
19805,RM-1156,9/20/2014,0,0,594,0,0,0,594
19806,RM-1156,9/21/2014,0,0,594,0,0,0,594
25181,RM-1212,9/20/2014,594,0,0,0,0,0,594
25182,RM-1212,9/21/2014,594,0,0,0,0,0,594
26434,RM-1213A,6/10/2014,0,0,594,0,0,0,594
28495,RM-1221,6/10/2014,0,0,594,0,0,0,594
28597,RM-1221,9/20/2014,0,0,594,0,0,0,594
28598,RM-1221,9/21/2014,0,0,594,0,0,0,594
29282,RM-1223,9/20/2014,594,0,0,0,0,0,594
29283,RM-1223,9/21/2014,594,0,0,0,0,0,594
30655,RM-1229,9/20/2014,0,0,594,0,0,0,594
30656,RM-1229,9/21/2014,0,0,594,0,0,0,594
32682,RM-1236,9/20/2014,594,0,0,0,0,0,594
32683,RM-1236,9/21/2014,594,0,0,0,0,0,594
33520,RM-4xxx,9/20/2014,0,0,0,0,594,0,594
33521,RM-4xxx,9/21/2014,0,0,0,0,594,0,594
36546,RM-B200B,9/20/2014,0,0,594,0,0,0,594
36547,RM-B200B,9/21/2014,0,0,594,0,0,0,594
37227,RM-B200C,9/20/2014,594,0,0,0,0,0,594
37228,RM-B200C,9/21/2014,594,0,0,0,0,0,594
39976,RM-B222,9/20/2014,594,0,0,0,0,0,594
39977,RM-B222,9/21/2014,594,0,0,0,0,0,594
42037,RM-B230,9/20/2014,594,0,0,0,0,0,594
42038,RM-B230,9/21/2014,594,0,0,0,0,0,594
43186,RM-B240,6/10/2014,0,0,594,0,0,0,594
43288,RM-B240,9/20/2014,0,0,594,0,0,0,594
43289,RM-B240,9/21/2014,0,0,594,0,0,0,594
43898,RM-B240A,9/20/2014,0,0,594,0,0,0,594
43899,RM-B240A,9/21/2014,0,0,594,0,0,0,594
44583,RM-B250,9/20/2014,0,0,594,0,0,0,594
44584,RM-B250,9/21/2014,0,0,594,0,0,0,594
45267,RM-B250A,9/20/2014,594,0,0,0,0,0,594
45268,RM-B250A,9/21/2014,594,0,0,0,0,0,594
47193,RM-B270,5/14/2014,0,0,0,594,0,0,594
438,RM-1100A,9/22/2014,591,0,0,0,0,0,591
1808,RM-1102,9/22/2014,591,0,0,0,0,0,591
5875,RM-1110,9/22/2014,0,0,591,0,0,0,591
6560,RM-1113,9/22/2014,0,0,591,0,0,0,591
9964,RM-1123,9/22/2014,591,0,0,0,0,0,591
12566,RM-1130,9/22/2014,0,0,591,0,0,0,591
13254,RM-1132,9/22/2014,0,0,591,0,0,0,591
14461,RM-1134,9/22/2014,591,0,0,0,0,0,591
15731,RM-1144,9/22/2014,0,0,591,0,0,0,591
16389,RM-1145,9/22/2014,0,0,591,0,0,0,591
17758,RM-1151,9/22/2014,591,0,0,0,0,0,591
19131,RM-1155,9/22/2014,591,0,0,0,0,0,591
19807,RM-1156,9/22/2014,0,0,591,0,0,0,591
24498,RM-1208B,9/22/2014,591,0,0,0,0,0,591
25183,RM-1212,9/22/2014,591,0,0,0,0,0,591
28599,RM-1221,9/22/2014,0,0,591,0,0,0,591
29284,RM-1223,9/22/2014,591,0,0,0,0,0,591
30657,RM-1229,9/22/2014,0,0,591,0,0,0,591
32684,RM-1236,9/22/2014,591,0,0,0,0,0,591
33522,RM-4xxx,9/22/2014,0,0,0,0,591,0,591
36548,RM-B200B,9/22/2014,0,0,591,0,0,0,591
37229,RM-B200C,9/22/2014,591,0,0,0,0,0,591
39978,RM-B222,9/22/2014,591,0,0,0,0,0,591
42039,RM-B230,9/22/2014,591,0,0,0,0,0,591
43290,RM-B240,9/22/2014,0,0,591,0,0,0,591
43900,RM-B240A,9/22/2014,0,0,591,0,0,0,591
44585,RM-B250,9/22/2014,0,0,591,0,0,0,591
45269,RM-B250A,9/22/2014,591,0,0,0,0,0,591
434,RM-1100A,9/18/2014,588,0,0,0,0,0,588
435,RM-1100A,9/19/2014,588,0,0,0,0,0,588
439,RM-1100A,9/23/2014,588,0,0,0,0,0,588
1804,RM-1102,9/18/2014,588,0,0,0,0,0,588
1805,RM-1102,9/19/2014,588,0,0,0,0,0,588
1809,RM-1102,9/23/2014,588,0,0,0,0,0,588
5771,RM-1110,6/10/2014,0,0,588,0,0,0,588
5871,RM-1110,9/18/2014,0,0,588,0,0,0,588
5872,RM-1110,9/19/2014,0,0,588,0,0,0,588
5876,RM-1110,9/23/2014,0,0,588,0,0,0,588
6556,RM-1113,9/18/2014,0,0,588,0,0,0,588
6557,RM-1113,9/19/2014,0,0,588,0,0,0,588
6561,RM-1113,9/23/2014,0,0,588,0,0,0,588
9960,RM-1123,9/18/2014,588,0,0,0,0,0,588
9961,RM-1123,9/19/2014,588,0,0,0,0,0,588
9965,RM-1123,9/23/2014,588,0,0,0,0,0,588
12562,RM-1130,9/18/2014,0,0,588,0,0,0,588
12563,RM-1130,9/19/2014,0,0,588,0,0,0,588
12567,RM-1130,9/23/2014,0,0,588,0,0,0,588
13250,RM-1132,9/18/2014,0,0,588,0,0,0,588
13251,RM-1132,9/19/2014,0,0,588,0,0,0,588
13255,RM-1132,9/23/2014,0,0,588,0,0,0,588
14357,RM-1134,6/10/2014,588,0,0,0,0,0,588
14457,RM-1134,9/18/2014,588,0,0,0,0,0,588
14458,RM-1134,9/19/2014,588,0,0,0,0,0,588
14462,RM-1134,9/23/2014,588,0,0,0,0,0,588
15727,RM-1144,9/18/2014,0,0,588,0,0,0,588
15728,RM-1144,9/19/2014,0,0,588,0,0,0,588
15732,RM-1144,9/23/2014,0,0,588,0,0,0,588
16385,RM-1145,9/18/2014,0,0,588,0,0,0,588
16386,RM-1145,9/19/2014,0,0,588,0,0,0,588
16390,RM-1145,9/23/2014,0,0,588,0,0,0,588
17754,RM-1151,9/18/2014,588,0,0,0,0,0,588
17755,RM-1151,9/19/2014,588,0,0,0,0,0,588
17759,RM-1151,9/23/2014,588,0,0,0,0,0,588
19027,RM-1155,6/10/2014,588,0,0,0,0,0,588
19127,RM-1155,9/18/2014,588,0,0,0,0,0,588
19128,RM-1155,9/19/2014,588,0,0,0,0,0,588
19132,RM-1155,9/23/2014,588,0,0,0,0,0,588
19803,RM-1156,9/18/2014,0,0,588,0,0,0,588
19804,RM-1156,9/19/2014,0,0,588,0,0,0,588
19808,RM-1156,9/23/2014,0,0,588,0,0,0,588
23021,RM-1207,6/10/2014,588,0,0,0,0,0,588
24499,RM-1208B,9/23/2014,588,0,0,0,0,0,588
25079,RM-1212,6/10/2014,588,0,0,0,0,0,588
25179,RM-1212,9/18/2014,588,0,0,0,0,0,588
25180,RM-1212,9/19/2014,588,0,0,0,0,0,588
25184,RM-1212,9/23/2014,588,0,0,0,0,0,588
26534,RM-1213A,9/18/2014,0,0,588,0,0,0,588
28595,RM-1221,9/18/2014,0,0,588,0,0,0,588
28596,RM-1221,9/19/2014,0,0,588,0,0,0,588
28600,RM-1221,9/23/2014,0,0,588,0,0,0,588
29180,RM-1223,6/10/2014,588,0,0,0,0,0,588
29280,RM-1223,9/18/2014,588,0,0,0,0,0,588
29281,RM-1223,9/19/2014,588,0,0,0,0,0,588
29285,RM-1223,9/23/2014,588,0,0,0,0,0,588
30653,RM-1229,9/18/2014,0,0,588,0,0,0,588
30654,RM-1229,9/19/2014,0,0,588,0,0,0,588
30658,RM-1229,9/23/2014,0,0,588,0,0,0,588
32680,RM-1236,9/18/2014,588,0,0,0,0,0,588
32681,RM-1236,9/19/2014,588,0,0,0,0,0,588
32685,RM-1236,9/23/2014,588,0,0,0,0,0,588
33518,RM-4xxx,9/18/2014,0,0,0,0,588,0,588
33519,RM-4xxx,9/19/2014,0,0,0,0,588,0,588
33523,RM-4xxx,9/23/2014,0,0,0,0,588,0,588
36544,RM-B200B,9/18/2014,0,0,588,0,0,0,588
36545,RM-B200B,9/19/2014,0,0,588,0,0,0,588
36549,RM-B200B,9/23/2014,0,0,588,0,0,0,588
37125,RM-B200C,6/10/2014,588,0,0,0,0,0,588
37225,RM-B200C,9/18/2014,588,0,0,0,0,0,588
37226,RM-B200C,9/19/2014,588,0,0,0,0,0,588
37230,RM-B200C,9/23/2014,588,0,0,0,0,0,588
39186,RM-B220,6/10/2014,588,0,0,0,0,0,588
39974,RM-B222,9/18/2014,588,0,0,0,0,0,588
39975,RM-B222,9/19/2014,588,0,0,0,0,0,588
39979,RM-B222,9/23/2014,588,0,0,0,0,0,588
41935,RM-B230,6/10/2014,588,0,0,0,0,0,588
42035,RM-B230,9/18/2014,588,0,0,0,0,0,588
42036,RM-B230,9/19/2014,588,0,0,0,0,0,588
42040,RM-B230,9/23/2014,588,0,0,0,0,0,588
43286,RM-B240,9/18/2014,0,0,588,0,0,0,588
43287,RM-B240,9/19/2014,0,0,588,0,0,0,588
43291,RM-B240,9/23/2014,0,0,588,0,0,0,588
43844,RM-B240A,5/14/2014,0,588,0,0,0,0,588
43896,RM-B240A,9/18/2014,0,0,588,0,0,0,588
43897,RM-B240A,9/19/2014,0,0,588,0,0,0,588
43901,RM-B240A,9/23/2014,0,0,588,0,0,0,588
44581,RM-B250,9/18/2014,0,0,588,0,0,0,588
44582,RM-B250,9/19/2014,0,0,588,0,0,0,588
44586,RM-B250,9/23/2014,0,0,588,0,0,0,588
45165,RM-B250A,6/10/2014,588,0,0,0,0,0,588
45265,RM-B250A,9/18/2014,588,0,0,0,0,0,588
45266,RM-B250A,9/19/2014,588,0,0,0,0,0,588
45270,RM-B250A,9/23/2014,588,0,0,0,0,0,588
33524,RM-4xxx,9/24/2014,0,0,0,0,585,0,585
37231,RM-B200C,9/24/2014,585,0,0,0,0,0,585
42041,RM-B230,9/24/2014,585,0,0,0,0,0,585
43292,RM-B240,9/24/2014,0,0,585,0,0,0,585
44587,RM-B250,9/24/2014,0,0,585,0,0,0,585
440,RM-1100A,9/24/2014,582,0,0,0,0,0,582
992,RM-1100D,5/14/2014,0,0,0,582,0,0,582
1810,RM-1102,9/24/2014,582,0,0,0,0,0,582
5877,RM-1110,9/24/2014,0,0,582,0,0,0,582
6562,RM-1113,9/24/2014,0,0,582,0,0,0,582
9966,RM-1123,9/24/2014,582,0,0,0,0,0,582
12568,RM-1130,9/24/2014,0,0,582,0,0,0,582
13256,RM-1132,9/24/2014,0,0,582,0,0,0,582
14463,RM-1134,9/24/2014,582,0,0,0,0,0,582
15733,RM-1144,9/24/2014,0,0,582,0,0,0,582
16391,RM-1145,9/24/2014,0,0,582,0,0,0,582
17760,RM-1151,9/24/2014,582,0,0,0,0,0,582
19133,RM-1155,9/24/2014,582,0,0,0,0,0,582
19809,RM-1156,9/24/2014,0,0,582,0,0,0,582
20330,RM-1200A,5/14/2014,0,0,0,582,0,0,582
24500,RM-1208B,9/24/2014,582,0,0,0,0,0,582
25185,RM-1212,9/24/2014,582,0,0,0,0,0,582
28201,RM-1221,8/8/2013,0,0,0,0,0,582,582
28601,RM-1221,9/24/2014,0,0,582,0,0,0,582
29286,RM-1223,9/24/2014,582,0,0,0,0,0,582
30659,RM-1229,9/24/2014,0,0,582,0,0,0,582
32686,RM-1236,9/24/2014,582,0,0,0,0,0,582
36550,RM-B200B,9/24/2014,0,0,582,0,0,0,582
39980,RM-B222,9/24/2014,582,0,0,0,0,0,582
43902,RM-B240A,9/24/2014,0,0,582,0,0,0,582
45271,RM-B250A,9/24/2014,582,0,0,0,0,0,582
22878,RM-1207,1/18/2014,285,0,0,0,0,288,573
24935,RM-1212,1/17/2014,285,0,288,0,0,0,573
28351,RM-1221,1/17/2014,0,0,288,0,0,285,573
28352,RM-1221,1/18/2014,0,0,285,0,0,288,573
33545,RM-4xxx,10/17/2014,0,0,0,0,573,0,573
36571,RM-B200B,10/17/2014,0,0,573,0,0,0,573
36981,RM-B200C,1/17/2014,285,0,288,0,0,0,573
37252,RM-B200C,10/17/2014,573,0,0,0,0,0,573
38357,RM-B215,1/17/2014,0,0,288,0,0,285,573
38358,RM-B215,1/18/2014,0,0,285,0,0,288,573
40001,RM-B222,10/17/2014,573,0,0,0,0,0,573
43313,RM-B240,10/17/2014,0,0,573,0,0,0,573
43923,RM-B240A,10/17/2014,0,0,573,0,0,0,573
44608,RM-B250,10/17/2014,0,0,573,0,0,0,573
45292,RM-B250A,10/17/2014,573,0,0,0,0,0,573
381,RM-1100A,7/27/2014,570,0,0,0,0,0,570
461,RM-1100A,10/17/2014,570,0,0,0,0,0,570
1751,RM-1102,7/27/2014,570,0,0,0,0,0,570
1831,RM-1102,10/17/2014,570,0,0,0,0,0,570
3435,RM-1107,8/22/2013,0,0,570,0,0,0,570
5818,RM-1110,7/27/2014,0,0,570,0,0,0,570
6176,RM-1113,8/22/2013,0,0,570,0,0,0,570
6503,RM-1113,7/27/2014,0,0,570,0,0,0,570
6583,RM-1113,10/17/2014,0,0,570,0,0,0,570
8895,RM-1122,8/22/2013,0,0,570,0,0,0,570
9580,RM-1123,8/22/2013,0,0,570,0,0,0,570
9907,RM-1123,7/27/2014,570,0,0,0,0,0,570
9987,RM-1123,10/17/2014,570,0,0,0,0,0,570
12589,RM-1130,10/17/2014,0,0,570,0,0,0,570
13197,RM-1132,7/27/2014,0,0,570,0,0,0,570
13277,RM-1132,10/17/2014,0,0,570,0,0,0,570
13555,RM-1133,8/22/2013,0,0,570,0,0,0,570
14404,RM-1134,7/27/2014,570,0,0,0,0,0,570
14484,RM-1134,10/17/2014,570,0,0,0,0,0,570
15674,RM-1144,7/27/2014,0,0,570,0,0,0,570
15754,RM-1144,10/17/2014,0,0,570,0,0,0,570
16332,RM-1145,7/27/2014,0,0,570,0,0,0,570
16412,RM-1145,10/17/2014,0,0,570,0,0,0,570
17701,RM-1151,7/27/2014,570,0,0,0,0,0,570
17781,RM-1151,10/17/2014,570,0,0,0,0,0,570
19074,RM-1155,7/27/2014,570,0,0,0,0,0,570
19154,RM-1155,10/17/2014,570,0,0,0,0,0,570
19653,RM-1156,4/21/2014,570,0,0,0,0,0,570
19830,RM-1156,10/17/2014,0,0,570,0,0,0,570
22877,RM-1207,1/17/2014,285,0,0,0,0,285,570
23068,RM-1207,7/27/2014,570,0,0,0,0,0,570
23753,RM-1208,7/27/2014,570,0,0,0,0,0,570
24521,RM-1208B,10/17/2014,570,0,0,0,0,0,570
24936,RM-1212,1/18/2014,285,0,285,0,0,0,570
25126,RM-1212,7/27/2014,570,0,0,0,0,0,570
25206,RM-1212,10/17/2014,570,0,0,0,0,0,570
25469,RM-1213,8/22/2013,0,0,570,0,0,0,570
26481,RM-1213A,7/27/2014,0,0,570,0,0,0,570
27166,RM-1217,7/27/2014,570,0,0,0,0,0,570
27934,RM-1218,10/17/2014,570,0,0,0,0,0,570
28542,RM-1221,7/27/2014,0,0,570,0,0,0,570
28622,RM-1221,10/17/2014,0,0,570,0,0,0,570
29227,RM-1223,7/27/2014,570,0,0,0,0,0,570
29307,RM-1223,10/17/2014,570,0,0,0,0,0,570
30600,RM-1229,7/27/2014,0,0,570,0,0,0,570
30680,RM-1229,10/17/2014,0,0,570,0,0,0,570
32627,RM-1236,7/27/2014,0,0,570,0,0,0,570
32707,RM-1236,10/17/2014,570,0,0,0,0,0,570
33712,RM-B102C,8/22/2013,0,0,570,0,0,0,570
36491,RM-B200B,7/27/2014,0,0,570,0,0,0,570
36982,RM-B200C,1/18/2014,285,0,285,0,0,0,570
37172,RM-B200C,7/27/2014,570,0,0,0,0,0,570
39233,RM-B220,7/27/2014,570,0,0,0,0,0,570
39921,RM-B222,7/27/2014,570,0,0,0,0,0,570
41982,RM-B230,7/27/2014,570,0,0,0,0,0,570
43233,RM-B240,7/27/2014,0,0,570,0,0,0,570
44528,RM-B250,7/27/2014,0,0,570,0,0,0,570
45212,RM-B250A,7/27/2014,570,0,0,0,0,0,570
45897,RM-B260,7/27/2014,570,0,0,0,0,0,570
46940,RM-B270,8/22/2013,0,0,570,0,0,0,570
12183,RM-1130,8/22/2013,0,0,0,0,0,567,567
15347,RM-1144,8/22/2013,0,0,0,0,0,567,567
18059,RM-1154,8/22/2013,567,0,0,0,0,0,567
20740,RM-1200B,8/22/2013,0,0,0,0,0,567,567
26839,RM-1217,8/22/2013,567,0,0,0,0,0,567
31610,RM-1231,8/22/2013,0,0,0,0,0,567,567
34928,RM-B103A,8/22/2013,0,0,0,0,0,567,567
40970,RM-B225,8/22/2013,0,0,0,0,0,567,567
42340,RM-B230A,8/22/2013,0,0,0,0,0,567,567
43591,RM-B240A,8/22/2013,0,0,0,0,0,567,567
44201,RM-B250,8/22/2013,567,0,0,0,0,0,567
462,RM-1100A,10/18/2014,564,0,0,0,0,0,564
1832,RM-1102,10/18/2014,564,0,0,0,0,0,564
6584,RM-1113,10/18/2014,0,0,564,0,0,0,564
9988,RM-1123,10/18/2014,564,0,0,0,0,0,564
12590,RM-1130,10/18/2014,0,0,564,0,0,0,564
13278,RM-1132,10/18/2014,0,0,564,0,0,0,564
14485,RM-1134,10/18/2014,564,0,0,0,0,0,564
15755,RM-1144,10/18/2014,0,0,564,0,0,0,564
16413,RM-1145,10/18/2014,0,0,564,0,0,0,564
17782,RM-1151,10/18/2014,564,0,0,0,0,0,564
19155,RM-1155,10/18/2014,564,0,0,0,0,0,564
19831,RM-1156,10/18/2014,0,0,564,0,0,0,564
24522,RM-1208B,10/18/2014,564,0,0,0,0,0,564
25207,RM-1212,10/18/2014,564,0,0,0,0,0,564
27935,RM-1218,10/18/2014,564,0,0,0,0,0,564
28623,RM-1221,10/18/2014,0,0,564,0,0,0,564
29308,RM-1223,10/18/2014,564,0,0,0,0,0,564
30681,RM-1229,10/18/2014,0,0,564,0,0,0,564
32708,RM-1236,10/18/2014,564,0,0,0,0,0,564
18,RM-1100A,7/17/2013,561,0,0,0,0,0,561
27,RM-1100A,7/26/2013,561,0,0,0,0,0,561
460,RM-1100A,10/16/2014,561,0,0,0,0,0,561
1830,RM-1102,10/16/2014,561,0,0,0,0,0,561
2714,RM-1106,7/17/2013,561,0,0,0,0,0,561
3399,RM-1107,7/17/2013,0,0,561,0,0,0,561
5456,RM-1110,7/17/2013,0,0,0,0,0,561,561
6140,RM-1113,7/17/2013,0,0,561,0,0,0,561
6582,RM-1113,10/16/2014,0,0,561,0,0,0,561
8859,RM-1122,7/17/2013,0,0,561,0,0,0,561
9986,RM-1123,10/16/2014,561,0,0,0,0,0,561
10424,RM-1124,2/9/2014,0,0,0,0,0,561,561
12147,RM-1130,7/17/2013,0,0,0,0,0,561,561
12588,RM-1130,10/16/2014,0,0,561,0,0,0,561
12834,RM-1132,7/17/2013,561,0,0,0,0,0,561
13276,RM-1132,10/16/2014,0,0,561,0,0,0,561
13519,RM-1133,7/17/2013,0,0,561,0,0,0,561
14483,RM-1134,10/16/2014,561,0,0,0,0,0,561
15753,RM-1144,10/16/2014,0,0,561,0,0,0,561
16411,RM-1145,10/16/2014,0,0,561,0,0,0,561
17780,RM-1151,10/16/2014,561,0,0,0,0,0,561
18023,RM-1154,7/17/2013,0,0,561,0,0,0,561
19153,RM-1155,10/16/2014,561,0,0,0,0,0,561
19829,RM-1156,10/16/2014,0,0,561,0,0,0,561
23390,RM-1208,7/17/2013,0,0,0,0,0,561,561
24520,RM-1208B,10/16/2014,561,0,0,0,0,0,561
25205,RM-1212,10/16/2014,561,0,0,0,0,0,561
25433,RM-1213,7/17/2013,0,0,561,0,0,0,561
26118,RM-1213A,7/17/2013,0,0,0,0,0,561,561
27933,RM-1218,10/16/2014,561,0,0,0,0,0,561
28179,RM-1221,7/17/2013,0,0,0,0,0,561,561
28621,RM-1221,10/16/2014,0,0,561,0,0,0,561
29306,RM-1223,10/16/2014,561,0,0,0,0,0,561
30237,RM-1229,7/17/2013,561,0,0,0,0,0,561
30679,RM-1229,10/16/2014,0,0,561,0,0,0,561
32706,RM-1236,10/16/2014,561,0,0,0,0,0,561
33544,RM-4xxx,10/16/2014,0,0,0,0,561,0,561
33546,RM-4xxx,10/18/2014,0,0,0,0,561,0,561
33676,RM-B102C,7/17/2013,0,0,561,0,0,0,561
34892,RM-B103A,7/17/2013,0,0,0,0,0,561,561
35768,RM-B109,6/21/2014,279,0,282,0,0,0,561
36570,RM-B200B,10/16/2014,0,0,561,0,0,0,561
36572,RM-B200B,10/18/2014,0,0,561,0,0,0,561
37251,RM-B200C,10/16/2014,561,0,0,0,0,0,561
37253,RM-B200C,10/18/2014,561,0,0,0,0,0,561
37497,RM-B210,7/17/2013,0,0,561,0,0,0,561
39558,RM-B222,7/17/2013,561,0,0,0,0,0,561
40000,RM-B222,10/16/2014,561,0,0,0,0,0,561
40002,RM-B222,10/18/2014,561,0,0,0,0,0,561
40934,RM-B225,7/17/2013,0,0,0,0,0,561,561
42304,RM-B230A,7/17/2013,0,0,0,0,0,561,561
43312,RM-B240,10/16/2014,0,0,561,0,0,0,561
43314,RM-B240,10/18/2014,0,0,561,0,0,0,561
43555,RM-B240A,7/17/2013,0,0,0,0,0,561,561
43922,RM-B240A,10/16/2014,0,0,561,0,0,0,561
43924,RM-B240A,10/18/2014,0,0,561,0,0,0,561
44607,RM-B250,10/16/2014,0,0,561,0,0,0,561
44609,RM-B250,10/18/2014,0,0,561,0,0,0,561
45291,RM-B250A,10/16/2014,561,0,0,0,0,0,561
45293,RM-B250A,10/18/2014,561,0,0,0,0,0,561
46904,RM-B270,7/17/2013,0,0,561,0,0,0,561
47572,RM-B275,7/17/2013,0,0,561,0,0,0,561
456,RM-1100A,10/12/2014,558,0,0,0,0,0,558
457,RM-1100A,10/13/2014,558,0,0,0,0,0,558
459,RM-1100A,10/15/2014,558,0,0,0,0,0,558
463,RM-1100A,10/19/2014,558,0,0,0,0,0,558
1826,RM-1102,10/12/2014,558,0,0,0,0,0,558
1827,RM-1102,10/13/2014,558,0,0,0,0,0,558
1829,RM-1102,10/15/2014,558,0,0,0,0,0,558
1833,RM-1102,10/19/2014,558,0,0,0,0,0,558
6578,RM-1113,10/12/2014,0,0,558,0,0,0,558
6579,RM-1113,10/13/2014,0,0,558,0,0,0,558
6581,RM-1113,10/15/2014,0,0,558,0,0,0,558
6585,RM-1113,10/19/2014,0,0,558,0,0,0,558
9982,RM-1123,10/12/2014,558,0,0,0,0,0,558
9983,RM-1123,10/13/2014,558,0,0,0,0,0,558
9985,RM-1123,10/15/2014,558,0,0,0,0,0,558
9989,RM-1123,10/19/2014,558,0,0,0,0,0,558
12584,RM-1130,10/12/2014,0,0,558,0,0,0,558
12585,RM-1130,10/13/2014,0,0,558,0,0,0,558
12587,RM-1130,10/15/2014,0,0,558,0,0,0,558
12591,RM-1130,10/19/2014,0,0,558,0,0,0,558
13272,RM-1132,10/12/2014,0,0,558,0,0,0,558
13273,RM-1132,10/13/2014,0,0,558,0,0,0,558
13275,RM-1132,10/15/2014,0,0,558,0,0,0,558
13279,RM-1132,10/19/2014,0,0,558,0,0,0,558
14479,RM-1134,10/12/2014,558,0,0,0,0,0,558
14480,RM-1134,10/13/2014,558,0,0,0,0,0,558
14482,RM-1134,10/15/2014,558,0,0,0,0,0,558
14486,RM-1134,10/19/2014,558,0,0,0,0,0,558
15749,RM-1144,10/12/2014,0,0,558,0,0,0,558
15750,RM-1144,10/13/2014,0,0,558,0,0,0,558
15752,RM-1144,10/15/2014,0,0,558,0,0,0,558
15756,RM-1144,10/19/2014,0,0,558,0,0,0,558
16407,RM-1145,10/12/2014,0,0,558,0,0,0,558
16408,RM-1145,10/13/2014,0,0,558,0,0,0,558
16410,RM-1145,10/15/2014,0,0,558,0,0,0,558
16414,RM-1145,10/19/2014,0,0,558,0,0,0,558
17776,RM-1151,10/12/2014,558,0,0,0,0,0,558
17777,RM-1151,10/13/2014,558,0,0,0,0,0,558
17779,RM-1151,10/15/2014,558,0,0,0,0,0,558
17783,RM-1151,10/19/2014,558,0,0,0,0,0,558
19149,RM-1155,10/12/2014,558,0,0,0,0,0,558
19150,RM-1155,10/13/2014,558,0,0,0,0,0,558
19152,RM-1155,10/15/2014,558,0,0,0,0,0,558
19156,RM-1155,10/19/2014,558,0,0,0,0,0,558
19825,RM-1156,10/12/2014,0,0,558,0,0,0,558
19826,RM-1156,10/13/2014,0,0,558,0,0,0,558
19828,RM-1156,10/15/2014,0,0,558,0,0,0,558
19832,RM-1156,10/19/2014,0,0,558,0,0,0,558
24516,RM-1208B,10/12/2014,558,0,0,0,0,0,558
24517,RM-1208B,10/13/2014,558,0,0,0,0,0,558
24519,RM-1208B,10/15/2014,558,0,0,0,0,0,558
24523,RM-1208B,10/19/2014,558,0,0,0,0,0,558
25201,RM-1212,10/12/2014,558,0,0,0,0,0,558
25202,RM-1212,10/13/2014,558,0,0,0,0,0,558
25204,RM-1212,10/15/2014,558,0,0,0,0,0,558
25208,RM-1212,10/19/2014,558,0,0,0,0,0,558
27932,RM-1218,10/15/2014,558,0,0,0,0,0,558
27936,RM-1218,10/19/2014,558,0,0,0,0,0,558
28617,RM-1221,10/12/2014,0,0,558,0,0,0,558
28618,RM-1221,10/13/2014,0,0,558,0,0,0,558
28620,RM-1221,10/15/2014,0,0,558,0,0,0,558
28624,RM-1221,10/19/2014,0,0,558,0,0,0,558
29302,RM-1223,10/12/2014,558,0,0,0,0,0,558
29303,RM-1223,10/13/2014,558,0,0,0,0,0,558
29305,RM-1223,10/15/2014,558,0,0,0,0,0,558
29309,RM-1223,10/19/2014,558,0,0,0,0,0,558
30675,RM-1229,10/12/2014,0,0,558,0,0,0,558
30676,RM-1229,10/13/2014,0,0,558,0,0,0,558
30678,RM-1229,10/15/2014,0,0,558,0,0,0,558
30682,RM-1229,10/19/2014,0,0,558,0,0,0,558
32702,RM-1236,10/12/2014,558,0,0,0,0,0,558
32703,RM-1236,10/13/2014,558,0,0,0,0,0,558
32705,RM-1236,10/15/2014,558,0,0,0,0,0,558
32709,RM-1236,10/19/2014,558,0,0,0,0,0,558
33540,RM-4xxx,10/12/2014,0,0,0,0,558,0,558
33541,RM-4xxx,10/13/2014,0,0,0,0,558,0,558
33543,RM-4xxx,10/15/2014,0,0,0,0,558,0,558
33547,RM-4xxx,10/19/2014,0,0,0,0,558,0,558
36566,RM-B200B,10/12/2014,0,0,558,0,0,0,558
36567,RM-B200B,10/13/2014,0,0,558,0,0,0,558
36569,RM-B200B,10/15/2014,0,0,558,0,0,0,558
36573,RM-B200B,10/19/2014,0,0,558,0,0,0,558
37247,RM-B200C,10/12/2014,558,0,0,0,0,0,558
37248,RM-B200C,10/13/2014,558,0,0,0,0,0,558
37250,RM-B200C,10/15/2014,558,0,0,0,0,0,558
37254,RM-B200C,10/19/2014,558,0,0,0,0,0,558
39996,RM-B222,10/12/2014,558,0,0,0,0,0,558
39997,RM-B222,10/13/2014,558,0,0,0,0,0,558
39999,RM-B222,10/15/2014,558,0,0,0,0,0,558
40003,RM-B222,10/19/2014,558,0,0,0,0,0,558
43308,RM-B240,10/12/2014,0,0,558,0,0,0,558
43309,RM-B240,10/13/2014,0,0,558,0,0,0,558
43311,RM-B240,10/15/2014,0,0,558,0,0,0,558
43315,RM-B240,10/19/2014,0,0,558,0,0,0,558
43918,RM-B240A,10/12/2014,0,0,558,0,0,0,558
43919,RM-B240A,10/13/2014,0,0,558,0,0,0,558
43921,RM-B240A,10/15/2014,0,0,558,0,0,0,558
43925,RM-B240A,10/19/2014,0,0,558,0,0,0,558
44603,RM-B250,10/12/2014,0,0,558,0,0,0,558
44604,RM-B250,10/13/2014,0,0,558,0,0,0,558
44606,RM-B250,10/15/2014,0,0,558,0,0,0,558
44610,RM-B250,10/19/2014,0,0,558,0,0,0,558
45287,RM-B250A,10/12/2014,558,0,0,0,0,0,558
45288,RM-B250A,10/13/2014,558,0,0,0,0,0,558
45290,RM-B250A,10/15/2014,558,0,0,0,0,0,558
45294,RM-B250A,10/19/2014,558,0,0,0,0,0,558
382,RM-1100A,7/28/2014,555,0,0,0,0,0,555
452,RM-1100A,10/8/2014,555,0,0,0,0,0,555
458,RM-1100A,10/14/2014,555,0,0,0,0,0,555
1752,RM-1102,7/28/2014,555,0,0,0,0,0,555
1822,RM-1102,10/8/2014,555,0,0,0,0,0,555
1828,RM-1102,10/14/2014,555,0,0,0,0,0,555
5819,RM-1110,7/28/2014,0,0,555,0,0,0,555
6504,RM-1113,7/28/2014,0,0,555,0,0,0,555
6574,RM-1113,10/8/2014,0,0,555,0,0,0,555
6580,RM-1113,10/14/2014,0,0,555,0,0,0,555
9908,RM-1123,7/28/2014,555,0,0,0,0,0,555
9978,RM-1123,10/8/2014,555,0,0,0,0,0,555
9984,RM-1123,10/14/2014,555,0,0,0,0,0,555
12580,RM-1130,10/8/2014,0,0,555,0,0,0,555
12586,RM-1130,10/14/2014,0,0,555,0,0,0,555
13198,RM-1132,7/28/2014,0,0,555,0,0,0,555
13268,RM-1132,10/8/2014,0,0,555,0,0,0,555
13274,RM-1132,10/14/2014,0,0,555,0,0,0,555
14405,RM-1134,7/28/2014,555,0,0,0,0,0,555
14475,RM-1134,10/8/2014,555,0,0,0,0,0,555
14481,RM-1134,10/14/2014,555,0,0,0,0,0,555
15675,RM-1144,7/28/2014,0,0,555,0,0,0,555
15745,RM-1144,10/8/2014,0,0,555,0,0,0,555
15751,RM-1144,10/14/2014,0,0,555,0,0,0,555
16333,RM-1145,7/28/2014,0,0,555,0,0,0,555
16403,RM-1145,10/8/2014,0,0,555,0,0,0,555
16409,RM-1145,10/14/2014,0,0,555,0,0,0,555
17702,RM-1151,7/28/2014,555,0,0,0,0,0,555
17772,RM-1151,10/8/2014,555,0,0,0,0,0,555
17778,RM-1151,10/14/2014,555,0,0,0,0,0,555
19075,RM-1155,7/28/2014,555,0,0,0,0,0,555
19145,RM-1155,10/8/2014,555,0,0,0,0,0,555
19151,RM-1155,10/14/2014,555,0,0,0,0,0,555
19821,RM-1156,10/8/2014,0,0,555,0,0,0,555
19827,RM-1156,10/14/2014,0,0,555,0,0,0,555
23069,RM-1207,7/28/2014,555,0,0,0,0,0,555
23754,RM-1208,7/28/2014,555,0,0,0,0,0,555
24512,RM-1208B,10/8/2014,555,0,0,0,0,0,555
24518,RM-1208B,10/14/2014,555,0,0,0,0,0,555
25127,RM-1212,7/28/2014,555,0,0,0,0,0,555
25197,RM-1212,10/8/2014,555,0,0,0,0,0,555
25203,RM-1212,10/14/2014,555,0,0,0,0,0,555
26482,RM-1213A,7/28/2014,0,0,555,0,0,0,555
27167,RM-1217,7/28/2014,555,0,0,0,0,0,555
28543,RM-1221,7/28/2014,0,0,555,0,0,0,555
28613,RM-1221,10/8/2014,0,0,555,0,0,0,555
28619,RM-1221,10/14/2014,0,0,555,0,0,0,555
29228,RM-1223,7/28/2014,555,0,0,0,0,0,555
29298,RM-1223,10/8/2014,555,0,0,0,0,0,555
29304,RM-1223,10/14/2014,555,0,0,0,0,0,555
30601,RM-1229,7/28/2014,0,0,555,0,0,0,555
30671,RM-1229,10/8/2014,0,0,555,0,0,0,555
30677,RM-1229,10/14/2014,0,0,555,0,0,0,555
32628,RM-1236,7/28/2014,0,0,555,0,0,0,555
32698,RM-1236,10/8/2014,555,0,0,0,0,0,555
32704,RM-1236,10/14/2014,555,0,0,0,0,0,555
33535,RM-4xxx,10/7/2014,0,0,0,0,555,0,555
33542,RM-4xxx,10/14/2014,0,0,0,0,555,0,555
35771,RM-B109,6/24/2014,273,0,282,0,0,0,555
35772,RM-B109,6/25/2014,273,0,282,0,0,0,555
36492,RM-B200B,7/28/2014,0,0,555,0,0,0,555
36562,RM-B200B,10/8/2014,0,0,555,0,0,0,555
36568,RM-B200B,10/14/2014,0,0,555,0,0,0,555
37173,RM-B200C,7/28/2014,555,0,0,0,0,0,555
37242,RM-B200C,10/7/2014,555,0,0,0,0,0,555
37249,RM-B200C,10/14/2014,555,0,0,0,0,0,555
39234,RM-B220,7/28/2014,555,0,0,0,0,0,555
39922,RM-B222,7/28/2014,555,0,0,0,0,0,555
39991,RM-B222,10/7/2014,555,0,0,0,0,0,555
39998,RM-B222,10/14/2014,555,0,0,0,0,0,555
41983,RM-B230,7/28/2014,555,0,0,0,0,0,555
42052,RM-B230,10/7/2014,555,0,0,0,0,0,555
43234,RM-B240,7/28/2014,0,0,555,0,0,0,555
43303,RM-B240,10/7/2014,0,0,555,0,0,0,555
43310,RM-B240,10/14/2014,0,0,555,0,0,0,555
43913,RM-B240A,10/7/2014,0,0,555,0,0,0,555
43920,RM-B240A,10/14/2014,0,0,555,0,0,0,555
44529,RM-B250,7/28/2014,0,0,555,0,0,0,555
44598,RM-B250,10/7/2014,0,0,555,0,0,0,555
44605,RM-B250,10/14/2014,0,0,555,0,0,0,555
45213,RM-B250A,7/28/2014,555,0,0,0,0,0,555
45282,RM-B250A,10/7/2014,555,0,0,0,0,0,555
45289,RM-B250A,10/14/2014,555,0,0,0,0,0,555
45898,RM-B260,7/28/2014,555,0,0,0,0,0,555
448,RM-1100A,10/4/2014,552,0,0,0,0,0,552
449,RM-1100A,10/5/2014,552,0,0,0,0,0,552
450,RM-1100A,10/6/2014,552,0,0,0,0,0,552
451,RM-1100A,10/7/2014,552,0,0,0,0,0,552
1818,RM-1102,10/4/2014,552,0,0,0,0,0,552
1819,RM-1102,10/5/2014,552,0,0,0,0,0,552
1820,RM-1102,10/6/2014,552,0,0,0,0,0,552
1821,RM-1102,10/7/2014,552,0,0,0,0,0,552
6570,RM-1113,10/4/2014,0,0,552,0,0,0,552
6571,RM-1113,10/5/2014,0,0,552,0,0,0,552
6572,RM-1113,10/6/2014,0,0,552,0,0,0,552
6573,RM-1113,10/7/2014,0,0,552,0,0,0,552
9974,RM-1123,10/4/2014,552,0,0,0,0,0,552
9975,RM-1123,10/5/2014,552,0,0,0,0,0,552
9976,RM-1123,10/6/2014,552,0,0,0,0,0,552
9977,RM-1123,10/7/2014,552,0,0,0,0,0,552
12576,RM-1130,10/4/2014,0,0,552,0,0,0,552
12577,RM-1130,10/5/2014,0,0,552,0,0,0,552
12578,RM-1130,10/6/2014,0,0,552,0,0,0,552
12579,RM-1130,10/7/2014,0,0,552,0,0,0,552
13264,RM-1132,10/4/2014,0,0,552,0,0,0,552
13265,RM-1132,10/5/2014,0,0,552,0,0,0,552
13266,RM-1132,10/6/2014,0,0,552,0,0,0,552
13267,RM-1132,10/7/2014,0,0,552,0,0,0,552
14471,RM-1134,10/4/2014,552,0,0,0,0,0,552
14472,RM-1134,10/5/2014,552,0,0,0,0,0,552
14473,RM-1134,10/6/2014,552,0,0,0,0,0,552
14474,RM-1134,10/7/2014,552,0,0,0,0,0,552
15741,RM-1144,10/4/2014,0,0,552,0,0,0,552
15742,RM-1144,10/5/2014,0,0,552,0,0,0,552
15743,RM-1144,10/6/2014,0,0,552,0,0,0,552
15744,RM-1144,10/7/2014,0,0,552,0,0,0,552
16399,RM-1145,10/4/2014,0,0,552,0,0,0,552
16400,RM-1145,10/5/2014,0,0,552,0,0,0,552
16401,RM-1145,10/6/2014,0,0,552,0,0,0,552
16402,RM-1145,10/7/2014,0,0,552,0,0,0,552
17768,RM-1151,10/4/2014,552,0,0,0,0,0,552
17769,RM-1151,10/5/2014,552,0,0,0,0,0,552
17770,RM-1151,10/6/2014,552,0,0,0,0,0,552
17771,RM-1151,10/7/2014,552,0,0,0,0,0,552
19141,RM-1155,10/4/2014,552,0,0,0,0,0,552
19142,RM-1155,10/5/2014,552,0,0,0,0,0,552
19143,RM-1155,10/6/2014,552,0,0,0,0,0,552
19144,RM-1155,10/7/2014,552,0,0,0,0,0,552
19817,RM-1156,10/4/2014,0,0,552,0,0,0,552
19818,RM-1156,10/5/2014,0,0,552,0,0,0,552
19819,RM-1156,10/6/2014,0,0,552,0,0,0,552
19820,RM-1156,10/7/2014,0,0,552,0,0,0,552
24508,RM-1208B,10/4/2014,552,0,0,0,0,0,552
24509,RM-1208B,10/5/2014,552,0,0,0,0,0,552
24510,RM-1208B,10/6/2014,552,0,0,0,0,0,552
24511,RM-1208B,10/7/2014,552,0,0,0,0,0,552
25193,RM-1212,10/4/2014,552,0,0,0,0,0,552
25194,RM-1212,10/5/2014,552,0,0,0,0,0,552
25195,RM-1212,10/6/2014,552,0,0,0,0,0,552
25196,RM-1212,10/7/2014,552,0,0,0,0,0,552
28609,RM-1221,10/4/2014,0,0,552,0,0,0,552
28610,RM-1221,10/5/2014,0,0,552,0,0,0,552
28611,RM-1221,10/6/2014,0,0,552,0,0,0,552
28612,RM-1221,10/7/2014,0,0,552,0,0,0,552
29294,RM-1223,10/4/2014,552,0,0,0,0,0,552
29295,RM-1223,10/5/2014,552,0,0,0,0,0,552
29296,RM-1223,10/6/2014,552,0,0,0,0,0,552
29297,RM-1223,10/7/2014,552,0,0,0,0,0,552
30667,RM-1229,10/4/2014,0,0,552,0,0,0,552
30668,RM-1229,10/5/2014,0,0,552,0,0,0,552
30669,RM-1229,10/6/2014,0,0,552,0,0,0,552
30670,RM-1229,10/7/2014,0,0,552,0,0,0,552
32694,RM-1236,10/4/2014,552,0,0,0,0,0,552
32695,RM-1236,10/5/2014,552,0,0,0,0,0,552
32696,RM-1236,10/6/2014,552,0,0,0,0,0,552
32697,RM-1236,10/7/2014,552,0,0,0,0,0,552
33533,RM-4xxx,10/5/2014,0,0,0,0,552,0,552
33534,RM-4xxx,10/6/2014,0,0,0,0,552,0,552
33536,RM-4xxx,10/8/2014,0,0,0,0,552,0,552
36558,RM-B200B,10/4/2014,0,0,552,0,0,0,552
36559,RM-B200B,10/5/2014,0,0,552,0,0,0,552
36560,RM-B200B,10/6/2014,0,0,552,0,0,0,552
36561,RM-B200B,10/7/2014,0,0,552,0,0,0,552
36938,RM-B200C,12/5/2013,183,0,186,0,0,183,552
37240,RM-B200C,10/5/2014,552,0,0,0,0,0,552
37241,RM-B200C,10/6/2014,552,0,0,0,0,0,552
37243,RM-B200C,10/8/2014,552,0,0,0,0,0,552
38314,RM-B215,12/5/2013,183,0,186,0,0,183,552
39988,RM-B222,10/4/2014,552,0,0,0,0,0,552
39989,RM-B222,10/5/2014,552,0,0,0,0,0,552
39990,RM-B222,10/6/2014,552,0,0,0,0,0,552
39992,RM-B222,10/8/2014,552,0,0,0,0,0,552
42050,RM-B230,10/5/2014,552,0,0,0,0,0,552
42051,RM-B230,10/6/2014,552,0,0,0,0,0,552
42053,RM-B230,10/8/2014,552,0,0,0,0,0,552
43301,RM-B240,10/5/2014,0,0,552,0,0,0,552
43302,RM-B240,10/6/2014,0,0,552,0,0,0,552
43304,RM-B240,10/8/2014,0,0,552,0,0,0,552
43910,RM-B240A,10/4/2014,0,0,552,0,0,0,552
43911,RM-B240A,10/5/2014,0,0,552,0,0,0,552
43912,RM-B240A,10/6/2014,0,0,552,0,0,0,552
43914,RM-B240A,10/8/2014,0,0,552,0,0,0,552
44596,RM-B250,10/5/2014,0,0,552,0,0,0,552
44597,RM-B250,10/6/2014,0,0,552,0,0,0,552
44599,RM-B250,10/8/2014,0,0,552,0,0,0,552
45279,RM-B250A,10/4/2014,552,0,0,0,0,0,552
45280,RM-B250A,10/5/2014,552,0,0,0,0,0,552
45281,RM-B250A,10/6/2014,552,0,0,0,0,0,552
45283,RM-B250A,10/8/2014,552,0,0,0,0,0,552
453,RM-1100A,10/9/2014,549,0,0,0,0,0,549
1823,RM-1102,10/9/2014,549,0,0,0,0,0,549
6575,RM-1113,10/9/2014,0,0,549,0,0,0,549
9979,RM-1123,10/9/2014,549,0,0,0,0,0,549
12581,RM-1130,10/9/2014,0,0,549,0,0,0,549
13269,RM-1132,10/9/2014,0,0,549,0,0,0,549
14476,RM-1134,10/9/2014,549,0,0,0,0,0,549
15746,RM-1144,10/9/2014,0,0,549,0,0,0,549
16404,RM-1145,10/9/2014,0,0,549,0,0,0,549
17773,RM-1151,10/9/2014,549,0,0,0,0,0,549
19146,RM-1155,10/9/2014,549,0,0,0,0,0,549
19822,RM-1156,10/9/2014,0,0,549,0,0,0,549
24513,RM-1208B,10/9/2014,549,0,0,0,0,0,549
25198,RM-1212,10/9/2014,549,0,0,0,0,0,549
28614,RM-1221,10/9/2014,0,0,549,0,0,0,549
29299,RM-1223,10/9/2014,549,0,0,0,0,0,549
30672,RM-1229,10/9/2014,0,0,549,0,0,0,549
32699,RM-1236,10/9/2014,549,0,0,0,0,0,549
33532,RM-4xxx,10/4/2014,0,0,0,0,549,0,549
33537,RM-4xxx,10/9/2014,0,0,0,0,549,0,549
36563,RM-B200B,10/9/2014,0,0,549,0,0,0,549
37239,RM-B200C,10/4/2014,549,0,0,0,0,0,549
37244,RM-B200C,10/9/2014,549,0,0,0,0,0,549
39993,RM-B222,10/9/2014,549,0,0,0,0,0,549
42049,RM-B230,10/4/2014,549,0,0,0,0,0,549
42054,RM-B230,10/9/2014,549,0,0,0,0,0,549
43300,RM-B240,10/4/2014,0,0,549,0,0,0,549
43305,RM-B240,10/9/2014,0,0,549,0,0,0,549
43915,RM-B240A,10/9/2014,0,0,549,0,0,0,549
44595,RM-B250,10/4/2014,0,0,549,0,0,0,549
44600,RM-B250,10/9/2014,0,0,549,0,0,0,549
45284,RM-B250A,10/9/2014,549,0,0,0,0,0,549
454,RM-1100A,10/10/2014,546,0,0,0,0,0,546
455,RM-1100A,10/11/2014,546,0,0,0,0,0,546
1824,RM-1102,10/10/2014,546,0,0,0,0,0,546
1825,RM-1102,10/11/2014,546,0,0,0,0,0,546
6576,RM-1113,10/10/2014,0,0,546,0,0,0,546
6577,RM-1113,10/11/2014,0,0,546,0,0,0,546
7033,RM-1115,3/20/2014,273,0,0,0,0,273,546
9980,RM-1123,10/10/2014,546,0,0,0,0,0,546
9981,RM-1123,10/11/2014,546,0,0,0,0,0,546
12582,RM-1130,10/10/2014,0,0,546,0,0,0,546
12583,RM-1130,10/11/2014,0,0,546,0,0,0,546
13270,RM-1132,10/10/2014,0,0,546,0,0,0,546
13271,RM-1132,10/11/2014,0,0,546,0,0,0,546
14477,RM-1134,10/10/2014,546,0,0,0,0,0,546
14478,RM-1134,10/11/2014,546,0,0,0,0,0,546
15747,RM-1144,10/10/2014,0,0,546,0,0,0,546
15748,RM-1144,10/11/2014,0,0,546,0,0,0,546
16405,RM-1145,10/10/2014,0,0,546,0,0,0,546
16406,RM-1145,10/11/2014,0,0,546,0,0,0,546
17774,RM-1151,10/10/2014,546,0,0,0,0,0,546
17775,RM-1151,10/11/2014,546,0,0,0,0,0,546
18945,RM-1155,3/20/2014,273,0,0,0,0,273,546
19147,RM-1155,10/10/2014,546,0,0,0,0,0,546
19148,RM-1155,10/11/2014,546,0,0,0,0,0,546
19621,RM-1156,3/20/2014,273,0,0,0,0,273,546
19823,RM-1156,10/10/2014,0,0,546,0,0,0,546
19824,RM-1156,10/11/2014,0,0,546,0,0,0,546
22939,RM-1207,3/20/2014,273,0,0,0,0,273,546
24461,RM-1208B,8/16/2014,273,0,273,0,0,0,546
24514,RM-1208B,10/10/2014,546,0,0,0,0,0,546
24515,RM-1208B,10/11/2014,546,0,0,0,0,0,546
24997,RM-1212,3/20/2014,273,0,273,0,0,0,546
25199,RM-1212,10/10/2014,546,0,0,0,0,0,546
25200,RM-1212,10/11/2014,546,0,0,0,0,0,546
28615,RM-1221,10/10/2014,0,0,546,0,0,0,546
28616,RM-1221,10/11/2014,0,0,546,0,0,0,546
29300,RM-1223,10/10/2014,546,0,0,0,0,0,546
29301,RM-1223,10/11/2014,546,0,0,0,0,0,546
30673,RM-1229,10/10/2014,0,0,546,0,0,0,546
30674,RM-1229,10/11/2014,0,0,546,0,0,0,546
32647,RM-1236,8/16/2014,273,0,273,0,0,0,546
32700,RM-1236,10/10/2014,546,0,0,0,0,0,546
32701,RM-1236,10/11/2014,546,0,0,0,0,0,546
33538,RM-4xxx,10/10/2014,0,0,0,0,546,0,546
33539,RM-4xxx,10/11/2014,0,0,0,0,546,0,546
35769,RM-B109,6/22/2014,273,0,273,0,0,0,546
35824,RM-B109,8/16/2014,273,0,273,0,0,0,546
36564,RM-B200B,10/10/2014,0,0,546,0,0,0,546
36565,RM-B200B,10/11/2014,0,0,546,0,0,0,546
37043,RM-B200C,3/20/2014,273,0,273,0,0,0,546
37245,RM-B200C,10/10/2014,546,0,0,0,0,0,546
37246,RM-B200C,10/11/2014,546,0,0,0,0,0,546
39994,RM-B222,10/10/2014,546,0,0,0,0,0,546
39995,RM-B222,10/11/2014,546,0,0,0,0,0,546
42055,RM-B230,10/10/2014,546,0,0,0,0,0,546
42056,RM-B230,10/11/2014,546,0,0,0,0,0,546
43306,RM-B240,10/10/2014,0,0,546,0,0,0,546
43307,RM-B240,10/11/2014,0,0,546,0,0,0,546
43916,RM-B240A,10/10/2014,0,0,546,0,0,0,546
43917,RM-B240A,10/11/2014,0,0,546,0,0,0,546
44601,RM-B250,10/10/2014,0,0,546,0,0,0,546
44602,RM-B250,10/11/2014,0,0,546,0,0,0,546
45285,RM-B250A,10/10/2014,546,0,0,0,0,0,546
45286,RM-B250A,10/11/2014,546,0,0,0,0,0,546
368,RM-1100A,7/14/2014,543,0,0,0,0,0,543
373,RM-1100A,7/19/2014,543,0,0,0,0,0,543
1738,RM-1102,7/14/2014,543,0,0,0,0,0,543
1744,RM-1102,7/20/2014,543,0,0,0,0,0,543
5805,RM-1110,7/14/2014,0,0,543,0,0,0,543
5810,RM-1110,7/19/2014,0,0,543,0,0,0,543
6490,RM-1113,7/14/2014,0,0,543,0,0,0,543
6495,RM-1113,7/19/2014,0,0,543,0,0,0,543
9894,RM-1123,7/14/2014,543,0,0,0,0,0,543
9899,RM-1123,7/19/2014,543,0,0,0,0,0,543
13184,RM-1132,7/14/2014,0,0,543,0,0,0,543
13189,RM-1132,7/19/2014,0,0,543,0,0,0,543
14391,RM-1134,7/14/2014,543,0,0,0,0,0,543
14396,RM-1134,7/19/2014,543,0,0,0,0,0,543
15661,RM-1144,7/14/2014,0,0,543,0,0,0,543
15666,RM-1144,7/19/2014,0,0,543,0,0,0,543
16319,RM-1145,7/14/2014,0,0,543,0,0,0,543
16324,RM-1145,7/19/2014,0,0,543,0,0,0,543
17688,RM-1151,7/14/2014,543,0,0,0,0,0,543
17693,RM-1151,7/19/2014,543,0,0,0,0,0,543
19061,RM-1155,7/14/2014,543,0,0,0,0,0,543
19066,RM-1155,7/19/2014,543,0,0,0,0,0,543
23055,RM-1207,7/14/2014,543,0,0,0,0,0,543
23060,RM-1207,7/19/2014,543,0,0,0,0,0,543
23740,RM-1208,7/14/2014,543,0,0,0,0,0,543
23746,RM-1208,7/20/2014,543,0,0,0,0,0,543
25113,RM-1212,7/14/2014,543,0,0,0,0,0,543
25119,RM-1212,7/20/2014,543,0,0,0,0,0,543
26468,RM-1213A,7/14/2014,0,0,543,0,0,0,543
26473,RM-1213A,7/19/2014,0,0,543,0,0,0,543
27153,RM-1217,7/14/2014,543,0,0,0,0,0,543
27158,RM-1217,7/19/2014,543,0,0,0,0,0,543
28529,RM-1221,7/14/2014,0,0,543,0,0,0,543
28535,RM-1221,7/20/2014,0,0,543,0,0,0,543
29214,RM-1223,7/14/2014,543,0,0,0,0,0,543
29220,RM-1223,7/20/2014,543,0,0,0,0,0,543
30587,RM-1229,7/14/2014,0,0,543,0,0,0,543
30592,RM-1229,7/19/2014,0,0,543,0,0,0,543
32614,RM-1236,7/14/2014,0,0,543,0,0,0,543
32619,RM-1236,7/19/2014,0,0,543,0,0,0,543
36478,RM-B200B,7/14/2014,0,0,543,0,0,0,543
36483,RM-B200B,7/19/2014,0,0,543,0,0,0,543
37159,RM-B200C,7/14/2014,543,0,0,0,0,0,543
37164,RM-B200C,7/19/2014,543,0,0,0,0,0,543
39220,RM-B220,7/14/2014,543,0,0,0,0,0,543
39225,RM-B220,7/19/2014,543,0,0,0,0,0,543
39908,RM-B222,7/14/2014,543,0,0,0,0,0,543
39913,RM-B222,7/19/2014,543,0,0,0,0,0,543
41969,RM-B230,7/14/2014,543,0,0,0,0,0,543
41974,RM-B230,7/19/2014,543,0,0,0,0,0,543
43220,RM-B240,7/14/2014,0,0,543,0,0,0,543
43225,RM-B240,7/19/2014,0,0,543,0,0,0,543
44515,RM-B250,7/14/2014,0,0,543,0,0,0,543
44520,RM-B250,7/19/2014,0,0,543,0,0,0,543
45199,RM-B250A,7/14/2014,543,0,0,0,0,0,543
45204,RM-B250A,7/19/2014,543,0,0,0,0,0,543
45884,RM-B260,7/14/2014,543,0,0,0,0,0,543
45889,RM-B260,7/19/2014,543,0,0,0,0,0,543
366,RM-1100A,7/12/2014,540,0,0,0,0,0,540
372,RM-1100A,7/18/2014,540,0,0,0,0,0,540
374,RM-1100A,7/20/2014,540,0,0,0,0,0,540
378,RM-1100A,7/24/2014,540,0,0,0,0,0,540
1736,RM-1102,7/12/2014,540,0,0,0,0,0,540
1742,RM-1102,7/18/2014,540,0,0,0,0,0,540
1743,RM-1102,7/19/2014,540,0,0,0,0,0,540
1748,RM-1102,7/24/2014,540,0,0,0,0,0,540
5803,RM-1110,7/12/2014,0,0,540,0,0,0,540
5809,RM-1110,7/18/2014,0,0,540,0,0,0,540
5811,RM-1110,7/20/2014,0,0,540,0,0,0,540
5812,RM-1110,7/21/2014,0,0,540,0,0,0,540
5815,RM-1110,7/24/2014,0,0,540,0,0,0,540
6488,RM-1113,7/12/2014,0,0,540,0,0,0,540
6494,RM-1113,7/18/2014,0,0,540,0,0,0,540
6496,RM-1113,7/20/2014,0,0,540,0,0,0,540
6500,RM-1113,7/24/2014,0,0,540,0,0,0,540
9892,RM-1123,7/12/2014,540,0,0,0,0,0,540
9898,RM-1123,7/18/2014,540,0,0,0,0,0,540
9900,RM-1123,7/20/2014,540,0,0,0,0,0,540
9901,RM-1123,7/21/2014,540,0,0,0,0,0,540
9904,RM-1123,7/24/2014,540,0,0,0,0,0,540
13182,RM-1132,7/12/2014,0,0,540,0,0,0,540
13188,RM-1132,7/18/2014,0,0,540,0,0,0,540
13190,RM-1132,7/20/2014,0,0,540,0,0,0,540
13191,RM-1132,7/21/2014,0,0,540,0,0,0,540
13194,RM-1132,7/24/2014,0,0,540,0,0,0,540
14389,RM-1134,7/12/2014,540,0,0,0,0,0,540
14395,RM-1134,7/18/2014,540,0,0,0,0,0,540
14397,RM-1134,7/20/2014,540,0,0,0,0,0,540
14398,RM-1134,7/21/2014,540,0,0,0,0,0,540
14401,RM-1134,7/24/2014,540,0,0,0,0,0,540
15659,RM-1144,7/12/2014,0,0,540,0,0,0,540
15665,RM-1144,7/18/2014,0,0,540,0,0,0,540
15667,RM-1144,7/20/2014,0,0,540,0,0,0,540
15668,RM-1144,7/21/2014,0,0,540,0,0,0,540
15671,RM-1144,7/24/2014,0,0,540,0,0,0,540
16317,RM-1145,7/12/2014,0,0,540,0,0,0,540
16323,RM-1145,7/18/2014,0,0,540,0,0,0,540
16325,RM-1145,7/20/2014,0,0,540,0,0,0,540
16326,RM-1145,7/21/2014,0,0,540,0,0,0,540
16329,RM-1145,7/24/2014,0,0,540,0,0,0,540
17686,RM-1151,7/12/2014,540,0,0,0,0,0,540
17692,RM-1151,7/18/2014,540,0,0,0,0,0,540
17694,RM-1151,7/20/2014,540,0,0,0,0,0,540
17695,RM-1151,7/21/2014,540,0,0,0,0,0,540
17698,RM-1151,7/24/2014,540,0,0,0,0,0,540
19059,RM-1155,7/12/2014,540,0,0,0,0,0,540
19065,RM-1155,7/18/2014,540,0,0,0,0,0,540
19067,RM-1155,7/20/2014,540,0,0,0,0,0,540
19068,RM-1155,7/21/2014,540,0,0,0,0,0,540
19071,RM-1155,7/24/2014,540,0,0,0,0,0,540
23053,RM-1207,7/12/2014,540,0,0,0,0,0,540
23059,RM-1207,7/18/2014,540,0,0,0,0,0,540
23061,RM-1207,7/20/2014,540,0,0,0,0,0,540
23065,RM-1207,7/24/2014,540,0,0,0,0,0,540
23738,RM-1208,7/12/2014,540,0,0,0,0,0,540
23744,RM-1208,7/18/2014,540,0,0,0,0,0,540
23745,RM-1208,7/19/2014,540,0,0,0,0,0,540
23750,RM-1208,7/24/2014,540,0,0,0,0,0,540
25111,RM-1212,7/12/2014,540,0,0,0,0,0,540
25117,RM-1212,7/18/2014,540,0,0,0,0,0,540
25118,RM-1212,7/19/2014,540,0,0,0,0,0,540
25123,RM-1212,7/24/2014,540,0,0,0,0,0,540
26466,RM-1213A,7/12/2014,0,0,540,0,0,0,540
26472,RM-1213A,7/18/2014,0,0,540,0,0,0,540
26474,RM-1213A,7/20/2014,0,0,540,0,0,0,540
26478,RM-1213A,7/24/2014,0,0,540,0,0,0,540
27151,RM-1217,7/12/2014,540,0,0,0,0,0,540
27157,RM-1217,7/18/2014,540,0,0,0,0,0,540
27159,RM-1217,7/20/2014,540,0,0,0,0,0,540
27163,RM-1217,7/24/2014,540,0,0,0,0,0,540
28527,RM-1221,7/12/2014,0,0,540,0,0,0,540
28533,RM-1221,7/18/2014,0,0,540,0,0,0,540
28534,RM-1221,7/19/2014,0,0,540,0,0,0,540
28539,RM-1221,7/24/2014,0,0,540,0,0,0,540
29212,RM-1223,7/12/2014,540,0,0,0,0,0,540
29218,RM-1223,7/18/2014,540,0,0,0,0,0,540
29219,RM-1223,7/19/2014,540,0,0,0,0,0,540
29224,RM-1223,7/24/2014,540,0,0,0,0,0,540
30585,RM-1229,7/12/2014,0,0,540,0,0,0,540
30591,RM-1229,7/18/2014,0,0,540,0,0,0,540
30593,RM-1229,7/20/2014,0,0,540,0,0,0,540
30597,RM-1229,7/24/2014,0,0,540,0,0,0,540
32612,RM-1236,7/12/2014,0,0,540,0,0,0,540
32618,RM-1236,7/18/2014,0,0,540,0,0,0,540
32620,RM-1236,7/20/2014,0,0,540,0,0,0,540
32624,RM-1236,7/24/2014,0,0,540,0,0,0,540
36476,RM-B200B,7/12/2014,0,0,540,0,0,0,540
36482,RM-B200B,7/18/2014,0,0,540,0,0,0,540
36484,RM-B200B,7/20/2014,0,0,540,0,0,0,540
36485,RM-B200B,7/21/2014,0,0,540,0,0,0,540
36488,RM-B200B,7/24/2014,0,0,540,0,0,0,540
37157,RM-B200C,7/12/2014,540,0,0,0,0,0,540
37163,RM-B200C,7/18/2014,540,0,0,0,0,0,540
37165,RM-B200C,7/20/2014,540,0,0,0,0,0,540
37166,RM-B200C,7/21/2014,540,0,0,0,0,0,540
37169,RM-B200C,7/24/2014,540,0,0,0,0,0,540
39218,RM-B220,7/12/2014,540,0,0,0,0,0,540
39224,RM-B220,7/18/2014,540,0,0,0,0,0,540
39226,RM-B220,7/20/2014,540,0,0,0,0,0,540
39227,RM-B220,7/21/2014,540,0,0,0,0,0,540
39230,RM-B220,7/24/2014,540,0,0,0,0,0,540
39906,RM-B222,7/12/2014,540,0,0,0,0,0,540
39912,RM-B222,7/18/2014,540,0,0,0,0,0,540
39914,RM-B222,7/20/2014,540,0,0,0,0,0,540
39915,RM-B222,7/21/2014,540,0,0,0,0,0,540
39918,RM-B222,7/24/2014,540,0,0,0,0,0,540
41973,RM-B230,7/18/2014,540,0,0,0,0,0,540
41975,RM-B230,7/20/2014,540,0,0,0,0,0,540
41976,RM-B230,7/21/2014,540,0,0,0,0,0,540
41979,RM-B230,7/24/2014,540,0,0,0,0,0,540
43224,RM-B240,7/18/2014,0,0,540,0,0,0,540
43226,RM-B240,7/20/2014,0,0,540,0,0,0,540
43227,RM-B240,7/21/2014,0,0,540,0,0,0,540
43230,RM-B240,7/24/2014,0,0,540,0,0,0,540
44519,RM-B250,7/18/2014,0,0,540,0,0,0,540
44521,RM-B250,7/20/2014,0,0,540,0,0,0,540
44522,RM-B250,7/21/2014,0,0,540,0,0,0,540
44525,RM-B250,7/24/2014,0,0,540,0,0,0,540
45197,RM-B250A,7/12/2014,540,0,0,0,0,0,540
45203,RM-B250A,7/18/2014,540,0,0,0,0,0,540
45205,RM-B250A,7/20/2014,540,0,0,0,0,0,540
45206,RM-B250A,7/21/2014,540,0,0,0,0,0,540
45209,RM-B250A,7/24/2014,540,0,0,0,0,0,540
45888,RM-B260,7/18/2014,540,0,0,0,0,0,540
45890,RM-B260,7/20/2014,540,0,0,0,0,0,540
45891,RM-B260,7/21/2014,540,0,0,0,0,0,540
45894,RM-B260,7/24/2014,540,0,0,0,0,0,540
370,RM-1100A,7/16/2014,537,0,0,0,0,0,537
371,RM-1100A,7/17/2014,537,0,0,0,0,0,537
375,RM-1100A,7/21/2014,537,0,0,0,0,0,537
376,RM-1100A,7/22/2014,537,0,0,0,0,0,537
1740,RM-1102,7/16/2014,537,0,0,0,0,0,537
1741,RM-1102,7/17/2014,537,0,0,0,0,0,537
1745,RM-1102,7/21/2014,537,0,0,0,0,0,537
1746,RM-1102,7/22/2014,537,0,0,0,0,0,537
5807,RM-1110,7/16/2014,0,0,537,0,0,0,537
5808,RM-1110,7/17/2014,0,0,537,0,0,0,537
6492,RM-1113,7/16/2014,0,0,537,0,0,0,537
6493,RM-1113,7/17/2014,0,0,537,0,0,0,537
6497,RM-1113,7/21/2014,0,0,537,0,0,0,537
6498,RM-1113,7/22/2014,0,0,537,0,0,0,537
9896,RM-1123,7/16/2014,537,0,0,0,0,0,537
9897,RM-1123,7/17/2014,537,0,0,0,0,0,537
13186,RM-1132,7/16/2014,0,0,537,0,0,0,537
13187,RM-1132,7/17/2014,0,0,537,0,0,0,537
14393,RM-1134,7/16/2014,537,0,0,0,0,0,537
14394,RM-1134,7/17/2014,537,0,0,0,0,0,537
15663,RM-1144,7/16/2014,0,0,537,0,0,0,537
15664,RM-1144,7/17/2014,0,0,537,0,0,0,537
16321,RM-1145,7/16/2014,0,0,537,0,0,0,537
16322,RM-1145,7/17/2014,0,0,537,0,0,0,537
17690,RM-1151,7/16/2014,537,0,0,0,0,0,537
17691,RM-1151,7/17/2014,537,0,0,0,0,0,537
19063,RM-1155,7/16/2014,537,0,0,0,0,0,537
19064,RM-1155,7/17/2014,537,0,0,0,0,0,537
23057,RM-1207,7/16/2014,537,0,0,0,0,0,537
23058,RM-1207,7/17/2014,537,0,0,0,0,0,537
23062,RM-1207,7/21/2014,537,0,0,0,0,0,537
23063,RM-1207,7/22/2014,537,0,0,0,0,0,537
23742,RM-1208,7/16/2014,537,0,0,0,0,0,537
23743,RM-1208,7/17/2014,537,0,0,0,0,0,537
23747,RM-1208,7/21/2014,537,0,0,0,0,0,537
23748,RM-1208,7/22/2014,537,0,0,0,0,0,537
25115,RM-1212,7/16/2014,537,0,0,0,0,0,537
25116,RM-1212,7/17/2014,537,0,0,0,0,0,537
25120,RM-1212,7/21/2014,537,0,0,0,0,0,537
25121,RM-1212,7/22/2014,537,0,0,0,0,0,537
26470,RM-1213A,7/16/2014,0,0,537,0,0,0,537
26471,RM-1213A,7/17/2014,0,0,537,0,0,0,537
26475,RM-1213A,7/21/2014,0,0,537,0,0,0,537
26476,RM-1213A,7/22/2014,0,0,537,0,0,0,537
27155,RM-1217,7/16/2014,537,0,0,0,0,0,537
27156,RM-1217,7/17/2014,537,0,0,0,0,0,537
27160,RM-1217,7/21/2014,537,0,0,0,0,0,537
27161,RM-1217,7/22/2014,537,0,0,0,0,0,537
28531,RM-1221,7/16/2014,0,0,537,0,0,0,537
28532,RM-1221,7/17/2014,0,0,537,0,0,0,537
28536,RM-1221,7/21/2014,0,0,537,0,0,0,537
28537,RM-1221,7/22/2014,0,0,537,0,0,0,537
29216,RM-1223,7/16/2014,537,0,0,0,0,0,537
29217,RM-1223,7/17/2014,537,0,0,0,0,0,537
29221,RM-1223,7/21/2014,537,0,0,0,0,0,537
29222,RM-1223,7/22/2014,537,0,0,0,0,0,537
30589,RM-1229,7/16/2014,0,0,537,0,0,0,537
30590,RM-1229,7/17/2014,0,0,537,0,0,0,537
30594,RM-1229,7/21/2014,0,0,537,0,0,0,537
30595,RM-1229,7/22/2014,0,0,537,0,0,0,537
32616,RM-1236,7/16/2014,0,0,537,0,0,0,537
32617,RM-1236,7/17/2014,0,0,537,0,0,0,537
32621,RM-1236,7/21/2014,0,0,537,0,0,0,537
32622,RM-1236,7/22/2014,0,0,537,0,0,0,537
36480,RM-B200B,7/16/2014,0,0,537,0,0,0,537
36481,RM-B200B,7/17/2014,0,0,537,0,0,0,537
37161,RM-B200C,7/16/2014,537,0,0,0,0,0,537
37162,RM-B200C,7/17/2014,537,0,0,0,0,0,537
39222,RM-B220,7/16/2014,537,0,0,0,0,0,537
39223,RM-B220,7/17/2014,537,0,0,0,0,0,537
39910,RM-B222,7/16/2014,537,0,0,0,0,0,537
39911,RM-B222,7/17/2014,537,0,0,0,0,0,537
41967,RM-B230,7/12/2014,537,0,0,0,0,0,537
41971,RM-B230,7/16/2014,537,0,0,0,0,0,537
41972,RM-B230,7/17/2014,537,0,0,0,0,0,537
43218,RM-B240,7/12/2014,0,0,537,0,0,0,537
43222,RM-B240,7/16/2014,0,0,537,0,0,0,537
43223,RM-B240,7/17/2014,0,0,537,0,0,0,537
44503,RM-B250,7/2/2014,0,162,225,150,0,0,537
44513,RM-B250,7/12/2014,0,0,537,0,0,0,537
44517,RM-B250,7/16/2014,0,0,537,0,0,0,537
44518,RM-B250,7/17/2014,0,0,537,0,0,0,537
45201,RM-B250A,7/16/2014,537,0,0,0,0,0,537
45202,RM-B250A,7/17/2014,537,0,0,0,0,0,537
45882,RM-B260,7/12/2014,537,0,0,0,0,0,537
45886,RM-B260,7/16/2014,537,0,0,0,0,0,537
45887,RM-B260,7/17/2014,537,0,0,0,0,0,537
5813,RM-1110,7/22/2014,0,0,534,0,0,0,534
9902,RM-1123,7/22/2014,534,0,0,0,0,0,534
13192,RM-1132,7/22/2014,0,0,534,0,0,0,534
14399,RM-1134,7/22/2014,534,0,0,0,0,0,534
15669,RM-1144,7/22/2014,0,0,534,0,0,0,534
16327,RM-1145,7/22/2014,0,0,534,0,0,0,534
17696,RM-1151,7/22/2014,534,0,0,0,0,0,534
19069,RM-1155,7/22/2014,534,0,0,0,0,0,534
24937,RM-1212,1/19/2014,267,0,267,0,0,0,534
35770,RM-B109,6/23/2014,267,0,267,0,0,0,534
36486,RM-B200B,7/22/2014,0,0,534,0,0,0,534
36983,RM-B200C,1/19/2014,267,0,267,0,0,0,534
37167,RM-B200C,7/22/2014,534,0,0,0,0,0,534
39228,RM-B220,7/22/2014,534,0,0,0,0,0,534
39916,RM-B222,7/22/2014,534,0,0,0,0,0,534
41977,RM-B230,7/22/2014,534,0,0,0,0,0,534
43228,RM-B240,7/22/2014,0,0,534,0,0,0,534
44523,RM-B250,7/22/2014,0,0,534,0,0,0,534
45207,RM-B250A,7/22/2014,534,0,0,0,0,0,534
45892,RM-B260,7/22/2014,534,0,0,0,0,0,534
6454,RM-1113,6/8/2014,0,0,531,0,0,0,531
15625,RM-1144,6/8/2014,0,0,531,0,0,0,531
16283,RM-1145,6/8/2014,0,0,531,0,0,0,531
22879,RM-1207,1/19/2014,267,0,0,0,0,264,531
26432,RM-1213A,6/8/2014,0,0,531,0,0,0,531
28353,RM-1221,1/19/2014,0,0,267,0,0,264,531
28493,RM-1221,6/8/2014,0,0,531,0,0,0,531
38359,RM-B215,1/19/2014,0,0,267,0,0,264,531
43184,RM-B240,6/8/2014,0,0,531,0,0,0,531
464,RM-1100A,10/20/2014,528,0,0,0,0,0,528
1834,RM-1102,10/20/2014,528,0,0,0,0,0,528
6586,RM-1113,10/20/2014,0,0,528,0,0,0,528
9990,RM-1123,10/20/2014,528,0,0,0,0,0,528
12592,RM-1130,10/20/2014,0,0,528,0,0,0,528
13280,RM-1132,10/20/2014,0,0,528,0,0,0,528
14487,RM-1134,10/20/2014,528,0,0,0,0,0,528
15757,RM-1144,10/20/2014,0,0,528,0,0,0,528
16415,RM-1145,10/20/2014,0,0,528,0,0,0,528
16934,RM-1150,5/6/2014,0,0,0,528,0,0,528
17784,RM-1151,10/20/2014,528,0,0,0,0,0,528
19157,RM-1155,10/20/2014,528,0,0,0,0,0,528
19833,RM-1156,10/20/2014,0,0,528,0,0,0,528
23075,RM-1207,8/3/2014,528,0,0,0,0,0,528
24524,RM-1208B,10/20/2014,528,0,0,0,0,0,528
25209,RM-1212,10/20/2014,528,0,0,0,0,0,528
27937,RM-1218,10/20/2014,528,0,0,0,0,0,528
28625,RM-1221,10/20/2014,0,0,528,0,0,0,528
29310,RM-1223,10/20/2014,528,0,0,0,0,0,528
30683,RM-1229,10/20/2014,0,0,528,0,0,0,528
32710,RM-1236,10/20/2014,528,0,0,0,0,0,528
33548,RM-4xxx,10/20/2014,0,0,0,0,528,0,528
36574,RM-B200B,10/20/2014,0,0,528,0,0,0,528
37255,RM-B200C,10/20/2014,528,0,0,0,0,0,528
40004,RM-B222,10/20/2014,528,0,0,0,0,0,528
43316,RM-B240,10/20/2014,0,0,528,0,0,0,528
43926,RM-B240A,10/20/2014,0,0,528,0,0,0,528
44611,RM-B250,10/20/2014,0,0,528,0,0,0,528
45295,RM-B250A,10/20/2014,528,0,0,0,0,0,528
5769,RM-1110,6/8/2014,0,0,525,0,0,0,525
14355,RM-1134,6/8/2014,525,0,0,0,0,0,525
19025,RM-1155,6/8/2014,525,0,0,0,0,0,525
23019,RM-1207,6/8/2014,525,0,0,0,0,0,525
25077,RM-1212,6/8/2014,525,0,0,0,0,0,525
29178,RM-1223,6/8/2014,525,0,0,0,0,0,525
37123,RM-B200C,6/8/2014,525,0,0,0,0,0,525
39184,RM-B220,6/8/2014,525,0,0,0,0,0,525
41933,RM-B230,6/8/2014,525,0,0,0,0,0,525
45163,RM-B250A,6/8/2014,525,0,0,0,0,0,525
367,RM-1100A,7/13/2014,519,0,0,0,0,0,519
379,RM-1100A,7/25/2014,519,0,0,0,0,0,519
469,RM-1100A,10/25/2014,519,0,0,0,0,0,519
1737,RM-1102,7/13/2014,519,0,0,0,0,0,519
1749,RM-1102,7/25/2014,519,0,0,0,0,0,519
1839,RM-1102,10/25/2014,519,0,0,0,0,0,519
5804,RM-1110,7/13/2014,0,0,519,0,0,0,519
5816,RM-1110,7/25/2014,0,0,519,0,0,0,519
6489,RM-1113,7/13/2014,0,0,519,0,0,0,519
6501,RM-1113,7/25/2014,0,0,519,0,0,0,519
6591,RM-1113,10/25/2014,0,0,519,0,0,0,519
9565,RM-1123,8/7/2013,0,0,519,0,0,0,519
9893,RM-1123,7/13/2014,519,0,0,0,0,0,519
9905,RM-1123,7/25/2014,519,0,0,0,0,0,519
9995,RM-1123,10/25/2014,519,0,0,0,0,0,519
12597,RM-1130,10/25/2014,0,0,519,0,0,0,519
13183,RM-1132,7/13/2014,0,0,519,0,0,0,519
13195,RM-1132,7/25/2014,0,0,519,0,0,0,519
13285,RM-1132,10/25/2014,0,0,519,0,0,0,519
14390,RM-1134,7/13/2014,519,0,0,0,0,0,519
14402,RM-1134,7/25/2014,519,0,0,0,0,0,519
14492,RM-1134,10/25/2014,519,0,0,0,0,0,519
15660,RM-1144,7/13/2014,0,0,519,0,0,0,519
15672,RM-1144,7/25/2014,0,0,519,0,0,0,519
15762,RM-1144,10/25/2014,0,0,519,0,0,0,519
16318,RM-1145,7/13/2014,0,0,519,0,0,0,519
16330,RM-1145,7/25/2014,0,0,519,0,0,0,519
16420,RM-1145,10/25/2014,0,0,519,0,0,0,519
17687,RM-1151,7/13/2014,519,0,0,0,0,0,519
17699,RM-1151,7/25/2014,519,0,0,0,0,0,519
17789,RM-1151,10/25/2014,519,0,0,0,0,0,519
19060,RM-1155,7/13/2014,519,0,0,0,0,0,519
19072,RM-1155,7/25/2014,519,0,0,0,0,0,519
19162,RM-1155,10/25/2014,519,0,0,0,0,0,519
19838,RM-1156,10/25/2014,0,0,519,0,0,0,519
23054,RM-1207,7/13/2014,519,0,0,0,0,0,519
23066,RM-1207,7/25/2014,519,0,0,0,0,0,519
23739,RM-1208,7/13/2014,519,0,0,0,0,0,519
23751,RM-1208,7/25/2014,519,0,0,0,0,0,519
24529,RM-1208B,10/25/2014,519,0,0,0,0,0,519
25112,RM-1212,7/13/2014,519,0,0,0,0,0,519
25124,RM-1212,7/25/2014,519,0,0,0,0,0,519
25214,RM-1212,10/25/2014,519,0,0,0,0,0,519
26467,RM-1213A,7/13/2014,0,0,519,0,0,0,519
26479,RM-1213A,7/25/2014,0,0,519,0,0,0,519
27152,RM-1217,7/13/2014,519,0,0,0,0,0,519
27164,RM-1217,7/25/2014,519,0,0,0,0,0,519
27942,RM-1218,10/25/2014,519,0,0,0,0,0,519
28528,RM-1221,7/13/2014,0,0,519,0,0,0,519
28540,RM-1221,7/25/2014,0,0,519,0,0,0,519
28630,RM-1221,10/25/2014,0,0,519,0,0,0,519
29213,RM-1223,7/13/2014,519,0,0,0,0,0,519
29225,RM-1223,7/25/2014,519,0,0,0,0,0,519
29315,RM-1223,10/25/2014,519,0,0,0,0,0,519
30586,RM-1229,7/13/2014,0,0,519,0,0,0,519
30598,RM-1229,7/25/2014,0,0,519,0,0,0,519
30688,RM-1229,10/25/2014,0,0,519,0,0,0,519
32613,RM-1236,7/13/2014,0,0,519,0,0,0,519
32625,RM-1236,7/25/2014,0,0,519,0,0,0,519
32715,RM-1236,10/25/2014,519,0,0,0,0,0,519
33553,RM-4xxx,10/25/2014,0,0,0,0,519,0,519
36477,RM-B200B,7/13/2014,0,0,519,0,0,0,519
36489,RM-B200B,7/25/2014,0,0,519,0,0,0,519
37158,RM-B200C,7/13/2014,519,0,0,0,0,0,519
37170,RM-B200C,7/25/2014,519,0,0,0,0,0,519
37260,RM-B200C,10/25/2014,519,0,0,0,0,0,519
39219,RM-B220,7/13/2014,519,0,0,0,0,0,519
39231,RM-B220,7/25/2014,519,0,0,0,0,0,519
39907,RM-B222,7/13/2014,519,0,0,0,0,0,519
39919,RM-B222,7/25/2014,519,0,0,0,0,0,519
40009,RM-B222,10/25/2014,519,0,0,0,0,0,519
41968,RM-B230,7/13/2014,519,0,0,0,0,0,519
41980,RM-B230,7/25/2014,519,0,0,0,0,0,519
43219,RM-B240,7/13/2014,0,0,519,0,0,0,519
43231,RM-B240,7/25/2014,0,0,519,0,0,0,519
43321,RM-B240,10/25/2014,0,0,519,0,0,0,519
43931,RM-B240A,10/25/2014,0,0,519,0,0,0,519
44514,RM-B250,7/13/2014,0,0,519,0,0,0,519
44526,RM-B250,7/25/2014,0,0,519,0,0,0,519
44616,RM-B250,10/25/2014,0,0,519,0,0,0,519
45198,RM-B250A,7/13/2014,519,0,0,0,0,0,519
45210,RM-B250A,7/25/2014,519,0,0,0,0,0,519
45300,RM-B250A,10/25/2014,519,0,0,0,0,0,519
45883,RM-B260,7/13/2014,519,0,0,0,0,0,519
45895,RM-B260,7/25/2014,519,0,0,0,0,0,519
468,RM-1100A,10/24/2014,513,0,0,0,0,0,513
470,RM-1100A,10/26/2014,513,0,0,0,0,0,513
471,RM-1100A,10/27/2014,513,0,0,0,0,0,513
476,RM-1100A,11/1/2014,513,0,0,0,0,0,513
1838,RM-1102,10/24/2014,513,0,0,0,0,0,513
1840,RM-1102,10/26/2014,513,0,0,0,0,0,513
1841,RM-1102,10/27/2014,513,0,0,0,0,0,513
1846,RM-1102,11/1/2014,513,0,0,0,0,0,513
6590,RM-1113,10/24/2014,0,0,513,0,0,0,513
6592,RM-1113,10/26/2014,0,0,513,0,0,0,513
6593,RM-1113,10/27/2014,0,0,513,0,0,0,513
6598,RM-1113,11/1/2014,0,0,513,0,0,0,513
9994,RM-1123,10/24/2014,513,0,0,0,0,0,513
9996,RM-1123,10/26/2014,513,0,0,0,0,0,513
9997,RM-1123,10/27/2014,513,0,0,0,0,0,513
10002,RM-1123,11/1/2014,513,0,0,0,0,0,513
12596,RM-1130,10/24/2014,0,0,513,0,0,0,513
12598,RM-1130,10/26/2014,0,0,513,0,0,0,513
12599,RM-1130,10/27/2014,0,0,513,0,0,0,513
12604,RM-1130,11/1/2014,0,0,513,0,0,0,513
12888,RM-1132,9/18/2013,0,0,513,0,0,0,513
13172,RM-1132,7/2/2014,0,0,225,288,0,0,513
13284,RM-1132,10/24/2014,0,0,513,0,0,0,513
13286,RM-1132,10/26/2014,0,0,513,0,0,0,513
13287,RM-1132,10/27/2014,0,0,513,0,0,0,513
13292,RM-1132,11/1/2014,0,0,513,0,0,0,513
14491,RM-1134,10/24/2014,513,0,0,0,0,0,513
14493,RM-1134,10/26/2014,513,0,0,0,0,0,513
14494,RM-1134,10/27/2014,513,0,0,0,0,0,513
14499,RM-1134,11/1/2014,513,0,0,0,0,0,513
15761,RM-1144,10/24/2014,0,0,513,0,0,0,513
15763,RM-1144,10/26/2014,0,0,513,0,0,0,513
15764,RM-1144,10/27/2014,0,0,513,0,0,0,513
15769,RM-1144,11/1/2014,0,0,513,0,0,0,513
16419,RM-1145,10/24/2014,0,0,513,0,0,0,513
16421,RM-1145,10/26/2014,0,0,513,0,0,0,513
16422,RM-1145,10/27/2014,0,0,513,0,0,0,513
16427,RM-1145,11/1/2014,0,0,513,0,0,0,513
17676,RM-1151,7/2/2014,225,0,0,288,0,0,513
17788,RM-1151,10/24/2014,513,0,0,0,0,0,513
17790,RM-1151,10/26/2014,513,0,0,0,0,0,513
17791,RM-1151,10/27/2014,513,0,0,0,0,0,513
17796,RM-1151,11/1/2014,513,0,0,0,0,0,513
19161,RM-1155,10/24/2014,513,0,0,0,0,0,513
19163,RM-1155,10/26/2014,513,0,0,0,0,0,513
19164,RM-1155,10/27/2014,513,0,0,0,0,0,513
19169,RM-1155,11/1/2014,513,0,0,0,0,0,513
19837,RM-1156,10/24/2014,0,0,513,0,0,0,513
19839,RM-1156,10/26/2014,0,0,513,0,0,0,513
19840,RM-1156,10/27/2014,0,0,513,0,0,0,513
19845,RM-1156,11/1/2014,0,0,513,0,0,0,513
24528,RM-1208B,10/24/2014,513,0,0,0,0,0,513
24530,RM-1208B,10/26/2014,513,0,0,0,0,0,513
24531,RM-1208B,10/27/2014,513,0,0,0,0,0,513
24536,RM-1208B,11/1/2014,513,0,0,0,0,0,513
25213,RM-1212,10/24/2014,513,0,0,0,0,0,513
25215,RM-1212,10/26/2014,513,0,0,0,0,0,513
25216,RM-1212,10/27/2014,513,0,0,0,0,0,513
25221,RM-1212,11/1/2014,513,0,0,0,0,0,513
27941,RM-1218,10/24/2014,513,0,0,0,0,0,513
27943,RM-1218,10/26/2014,513,0,0,0,0,0,513
27944,RM-1218,10/27/2014,513,0,0,0,0,0,513
27949,RM-1218,11/1/2014,513,0,0,0,0,0,513
28629,RM-1221,10/24/2014,0,0,513,0,0,0,513
28631,RM-1221,10/26/2014,0,0,513,0,0,0,513
28632,RM-1221,10/27/2014,0,0,513,0,0,0,513
29314,RM-1223,10/24/2014,513,0,0,0,0,0,513
29316,RM-1223,10/26/2014,513,0,0,0,0,0,513
29317,RM-1223,10/27/2014,513,0,0,0,0,0,513
29322,RM-1223,11/1/2014,513,0,0,0,0,0,513
30687,RM-1229,10/24/2014,0,0,513,0,0,0,513
30689,RM-1229,10/26/2014,0,0,513,0,0,0,513
30690,RM-1229,10/27/2014,0,0,513,0,0,0,513
30695,RM-1229,11/1/2014,0,0,513,0,0,0,513
31581,RM-1231,7/24/2013,0,0,0,0,0,513,513
32714,RM-1236,10/24/2014,513,0,0,0,0,0,513
32716,RM-1236,10/26/2014,513,0,0,0,0,0,513
32717,RM-1236,10/27/2014,513,0,0,0,0,0,513
32722,RM-1236,11/1/2014,513,0,0,0,0,0,513
33552,RM-4xxx,10/24/2014,0,0,0,0,513,0,513
33554,RM-4xxx,10/26/2014,0,0,0,0,513,0,513
33555,RM-4xxx,10/27/2014,0,0,0,0,513,0,513
33560,RM-4xxx,11/1/2014,0,0,0,0,513,0,513
36578,RM-B200B,10/24/2014,0,0,513,0,0,0,513
37259,RM-B200C,10/24/2014,513,0,0,0,0,0,513
37261,RM-B200C,10/26/2014,513,0,0,0,0,0,513
37262,RM-B200C,10/27/2014,513,0,0,0,0,0,513
37267,RM-B200C,11/1/2014,513,0,0,0,0,0,513
40008,RM-B222,10/24/2014,513,0,0,0,0,0,513
40010,RM-B222,10/26/2014,513,0,0,0,0,0,513
40011,RM-B222,10/27/2014,513,0,0,0,0,0,513
40016,RM-B222,11/1/2014,513,0,0,0,0,0,513
43320,RM-B240,10/24/2014,0,0,513,0,0,0,513
43322,RM-B240,10/26/2014,0,0,513,0,0,0,513
43323,RM-B240,10/27/2014,0,0,513,0,0,0,513
43328,RM-B240,11/1/2014,0,0,513,0,0,0,513
43930,RM-B240A,10/24/2014,0,0,513,0,0,0,513
43932,RM-B240A,10/26/2014,0,0,513,0,0,0,513
43933,RM-B240A,10/27/2014,0,0,513,0,0,0,513
43938,RM-B240A,11/1/2014,0,0,513,0,0,0,513
44615,RM-B250,10/24/2014,0,0,513,0,0,0,513
44617,RM-B250,10/26/2014,0,0,513,0,0,0,513
44618,RM-B250,10/27/2014,0,0,513,0,0,0,513
45299,RM-B250A,10/24/2014,513,0,0,0,0,0,513
45301,RM-B250A,10/26/2014,513,0,0,0,0,0,513
45302,RM-B250A,10/27/2014,513,0,0,0,0,0,513
45307,RM-B250A,11/1/2014,513,0,0,0,0,0,513
475,RM-1100A,10/31/2014,510,0,0,0,0,0,510
477,RM-1100A,11/2/2014,510,0,0,0,0,0,510
1845,RM-1102,10/31/2014,510,0,0,0,0,0,510
1847,RM-1102,11/2/2014,510,0,0,0,0,0,510
4584,RM-1108,12/14/2014,0,0,510,0,0,0,510
6597,RM-1113,10/31/2014,0,0,510,0,0,0,510
6599,RM-1113,11/2/2014,0,0,510,0,0,0,510
10001,RM-1123,10/31/2014,510,0,0,0,0,0,510
10003,RM-1123,11/2/2014,510,0,0,0,0,0,510
12603,RM-1130,10/31/2014,0,0,510,0,0,0,510
12605,RM-1130,11/2/2014,0,0,510,0,0,0,510
13291,RM-1132,10/31/2014,0,0,510,0,0,0,510
13293,RM-1132,11/2/2014,0,0,510,0,0,0,510
14498,RM-1134,10/31/2014,510,0,0,0,0,0,510
14500,RM-1134,11/2/2014,510,0,0,0,0,0,510
15768,RM-1144,10/31/2014,0,0,510,0,0,0,510
15770,RM-1144,11/2/2014,0,0,510,0,0,0,510
16426,RM-1145,10/31/2014,0,0,510,0,0,0,510
16428,RM-1145,11/2/2014,0,0,510,0,0,0,510
17795,RM-1151,10/31/2014,510,0,0,0,0,0,510
17797,RM-1151,11/2/2014,510,0,0,0,0,0,510
19168,RM-1155,10/31/2014,510,0,0,0,0,0,510
19170,RM-1155,11/2/2014,510,0,0,0,0,0,510
19844,RM-1156,10/31/2014,0,0,510,0,0,0,510
19846,RM-1156,11/2/2014,0,0,510,0,0,0,510
24535,RM-1208B,10/31/2014,510,0,0,0,0,0,510
24537,RM-1208B,11/2/2014,510,0,0,0,0,0,510
25220,RM-1212,10/31/2014,510,0,0,0,0,0,510
25222,RM-1212,11/2/2014,510,0,0,0,0,0,510
27948,RM-1218,10/31/2014,510,0,0,0,0,0,510
27950,RM-1218,11/2/2014,510,0,0,0,0,0,510
29321,RM-1223,10/31/2014,510,0,0,0,0,0,510
29323,RM-1223,11/2/2014,510,0,0,0,0,0,510
30694,RM-1229,10/31/2014,0,0,510,0,0,0,510
30696,RM-1229,11/2/2014,0,0,510,0,0,0,510
32721,RM-1236,10/31/2014,510,0,0,0,0,0,510
32723,RM-1236,11/2/2014,510,0,0,0,0,0,510
33559,RM-4xxx,10/31/2014,0,0,0,0,510,0,510
33561,RM-4xxx,11/2/2014,0,0,0,0,510,0,510
37266,RM-B200C,10/31/2014,510,0,0,0,0,0,510
37268,RM-B200C,11/2/2014,510,0,0,0,0,0,510
40015,RM-B222,10/31/2014,510,0,0,0,0,0,510
40017,RM-B222,11/2/2014,510,0,0,0,0,0,510
43327,RM-B240,10/31/2014,0,0,510,0,0,0,510
43329,RM-B240,11/2/2014,0,0,510,0,0,0,510
43937,RM-B240A,10/31/2014,0,0,510,0,0,0,510
43939,RM-B240A,11/2/2014,0,0,510,0,0,0,510
44622,RM-B250,10/31/2014,0,0,510,0,0,0,510
45306,RM-B250A,10/31/2014,510,0,0,0,0,0,510
45308,RM-B250A,11/2/2014,510,0,0,0,0,0,510
465,RM-1100A,10/21/2014,507,0,0,0,0,0,507
466,RM-1100A,10/22/2014,507,0,0,0,0,0,507
474,RM-1100A,10/30/2014,507,0,0,0,0,0,507
1835,RM-1102,10/21/2014,507,0,0,0,0,0,507
1836,RM-1102,10/22/2014,507,0,0,0,0,0,507
1844,RM-1102,10/30/2014,507,0,0,0,0,0,507
6587,RM-1113,10/21/2014,0,0,507,0,0,0,507
6588,RM-1113,10/22/2014,0,0,507,0,0,0,507
6596,RM-1113,10/30/2014,0,0,507,0,0,0,507
9991,RM-1123,10/21/2014,507,0,0,0,0,0,507
9992,RM-1123,10/22/2014,507,0,0,0,0,0,507
10000,RM-1123,10/30/2014,507,0,0,0,0,0,507
12593,RM-1130,10/21/2014,0,0,507,0,0,0,507
12594,RM-1130,10/22/2014,0,0,507,0,0,0,507
12602,RM-1130,10/30/2014,0,0,507,0,0,0,507
13281,RM-1132,10/21/2014,0,0,507,0,0,0,507
13282,RM-1132,10/22/2014,0,0,507,0,0,0,507
13290,RM-1132,10/30/2014,0,0,507,0,0,0,507
14488,RM-1134,10/21/2014,507,0,0,0,0,0,507
14489,RM-1134,10/22/2014,507,0,0,0,0,0,507
14497,RM-1134,10/30/2014,507,0,0,0,0,0,507
15758,RM-1144,10/21/2014,0,0,507,0,0,0,507
15759,RM-1144,10/22/2014,0,0,507,0,0,0,507
15767,RM-1144,10/30/2014,0,0,507,0,0,0,507
16416,RM-1145,10/21/2014,0,0,507,0,0,0,507
16417,RM-1145,10/22/2014,0,0,507,0,0,0,507
16425,RM-1145,10/30/2014,0,0,507,0,0,0,507
17785,RM-1151,10/21/2014,507,0,0,0,0,0,507
17786,RM-1151,10/22/2014,507,0,0,0,0,0,507
17794,RM-1151,10/30/2014,507,0,0,0,0,0,507
19158,RM-1155,10/21/2014,507,0,0,0,0,0,507
19159,RM-1155,10/22/2014,507,0,0,0,0,0,507
19167,RM-1155,10/30/2014,507,0,0,0,0,0,507
19834,RM-1156,10/21/2014,0,0,507,0,0,0,507
19835,RM-1156,10/22/2014,0,0,507,0,0,0,507
19843,RM-1156,10/30/2014,0,0,507,0,0,0,507
24525,RM-1208B,10/21/2014,507,0,0,0,0,0,507
24526,RM-1208B,10/22/2014,507,0,0,0,0,0,507
24534,RM-1208B,10/30/2014,507,0,0,0,0,0,507
25210,RM-1212,10/21/2014,507,0,0,0,0,0,507
25211,RM-1212,10/22/2014,507,0,0,0,0,0,507
25219,RM-1212,10/30/2014,507,0,0,0,0,0,507
27938,RM-1218,10/21/2014,507,0,0,0,0,0,507
27939,RM-1218,10/22/2014,507,0,0,0,0,0,507
27947,RM-1218,10/30/2014,507,0,0,0,0,0,507
28626,RM-1221,10/21/2014,0,0,507,0,0,0,507
28627,RM-1221,10/22/2014,0,0,507,0,0,0,507
29311,RM-1223,10/21/2014,507,0,0,0,0,0,507
29312,RM-1223,10/22/2014,507,0,0,0,0,0,507
29320,RM-1223,10/30/2014,507,0,0,0,0,0,507
30684,RM-1229,10/21/2014,0,0,507,0,0,0,507
30685,RM-1229,10/22/2014,0,0,507,0,0,0,507
30693,RM-1229,10/30/2014,0,0,507,0,0,0,507
32711,RM-1236,10/21/2014,507,0,0,0,0,0,507
32712,RM-1236,10/22/2014,507,0,0,0,0,0,507
32720,RM-1236,10/30/2014,507,0,0,0,0,0,507
33549,RM-4xxx,10/21/2014,0,0,0,0,507,0,507
33550,RM-4xxx,10/22/2014,0,0,0,0,507,0,507
33558,RM-4xxx,10/30/2014,0,0,0,0,507,0,507
36575,RM-B200B,10/21/2014,0,0,507,0,0,0,507
36576,RM-B200B,10/22/2014,0,0,507,0,0,0,507
37256,RM-B200C,10/21/2014,507,0,0,0,0,0,507
37257,RM-B200C,10/22/2014,507,0,0,0,0,0,507
37265,RM-B200C,10/30/2014,507,0,0,0,0,0,507
40005,RM-B222,10/21/2014,507,0,0,0,0,0,507
40006,RM-B222,10/22/2014,507,0,0,0,0,0,507
40014,RM-B222,10/30/2014,507,0,0,0,0,0,507
43317,RM-B240,10/21/2014,0,0,507,0,0,0,507
43318,RM-B240,10/22/2014,0,0,507,0,0,0,507
43326,RM-B240,10/30/2014,0,0,507,0,0,0,507
43927,RM-B240A,10/21/2014,0,0,507,0,0,0,507
43928,RM-B240A,10/22/2014,0,0,507,0,0,0,507
43936,RM-B240A,10/30/2014,0,0,507,0,0,0,507
44612,RM-B250,10/21/2014,0,0,507,0,0,0,507
44613,RM-B250,10/22/2014,0,0,507,0,0,0,507
44621,RM-B250,10/30/2014,0,0,507,0,0,0,507
45296,RM-B250A,10/21/2014,507,0,0,0,0,0,507
45297,RM-B250A,10/22/2014,507,0,0,0,0,0,507
45305,RM-B250A,10/30/2014,507,0,0,0,0,0,507
472,RM-1100A,10/28/2014,504,0,0,0,0,0,504
1842,RM-1102,10/28/2014,504,0,0,0,0,0,504
6457,RM-1113,6/11/2014,0,0,504,0,0,0,504
6594,RM-1113,10/28/2014,0,0,504,0,0,0,504
9998,RM-1123,10/28/2014,504,0,0,0,0,0,504
12600,RM-1130,10/28/2014,0,0,504,0,0,0,504
13288,RM-1132,10/28/2014,0,0,504,0,0,0,504
13788,RM-1133,4/24/2014,0,504,0,0,0,0,504
14495,RM-1134,10/28/2014,504,0,0,0,0,0,504
15628,RM-1144,6/11/2014,0,0,504,0,0,0,504
15765,RM-1144,10/28/2014,0,0,504,0,0,0,504
16286,RM-1145,6/11/2014,0,0,504,0,0,0,504
16423,RM-1145,10/28/2014,0,0,504,0,0,0,504
17792,RM-1151,10/28/2014,504,0,0,0,0,0,504
19165,RM-1155,10/28/2014,504,0,0,0,0,0,504
19841,RM-1156,10/28/2014,0,0,504,0,0,0,504
24532,RM-1208B,10/28/2014,504,0,0,0,0,0,504
25217,RM-1212,10/28/2014,504,0,0,0,0,0,504
26435,RM-1213A,6/11/2014,0,0,504,0,0,0,504
27945,RM-1218,10/28/2014,504,0,0,0,0,0,504
28496,RM-1221,6/11/2014,0,0,504,0,0,0,504
28633,RM-1221,10/28/2014,0,0,504,0,0,0,504
29318,RM-1223,10/28/2014,504,0,0,0,0,0,504
30691,RM-1229,10/28/2014,0,0,504,0,0,0,504
32718,RM-1236,10/28/2014,504,0,0,0,0,0,504
33556,RM-4xxx,10/28/2014,0,0,0,0,504,0,504
37263,RM-B200C,10/28/2014,504,0,0,0,0,0,504
40012,RM-B222,10/28/2014,504,0,0,0,0,0,504
43187,RM-B240,6/11/2014,0,0,504,0,0,0,504
43324,RM-B240,10/28/2014,0,0,504,0,0,0,504
43934,RM-B240A,10/28/2014,0,0,504,0,0,0,504
44619,RM-B250,10/28/2014,0,0,504,0,0,0,504
45303,RM-B250A,10/28/2014,504,0,0,0,0,0,504
473,RM-1100A,10/29/2014,501,0,0,0,0,0,501
1843,RM-1102,10/29/2014,501,0,0,0,0,0,501
6595,RM-1113,10/29/2014,0,0,501,0,0,0,501
9999,RM-1123,10/29/2014,501,0,0,0,0,0,501
12601,RM-1130,10/29/2014,0,0,501,0,0,0,501
13289,RM-1132,10/29/2014,0,0,501,0,0,0,501
14496,RM-1134,10/29/2014,501,0,0,0,0,0,501
15766,RM-1144,10/29/2014,0,0,501,0,0,0,501
16424,RM-1145,10/29/2014,0,0,501,0,0,0,501
17793,RM-1151,10/29/2014,501,0,0,0,0,0,501
19166,RM-1155,10/29/2014,501,0,0,0,0,0,501
19842,RM-1156,10/29/2014,0,0,501,0,0,0,501
24533,RM-1208B,10/29/2014,501,0,0,0,0,0,501
25218,RM-1212,10/29/2014,501,0,0,0,0,0,501
27946,RM-1218,10/29/2014,501,0,0,0,0,0,501
28634,RM-1221,10/29/2014,0,0,501,0,0,0,501
29319,RM-1223,10/29/2014,501,0,0,0,0,0,501
30692,RM-1229,10/29/2014,0,0,501,0,0,0,501
32719,RM-1236,10/29/2014,501,0,0,0,0,0,501
33557,RM-4xxx,10/29/2014,0,0,0,0,501,0,501
37126,RM-B200C,6/11/2014,501,0,0,0,0,0,501
37264,RM-B200C,10/29/2014,501,0,0,0,0,0,501
39187,RM-B220,6/11/2014,501,0,0,0,0,0,501
40013,RM-B222,10/29/2014,501,0,0,0,0,0,501
41936,RM-B230,6/11/2014,501,0,0,0,0,0,501
43325,RM-B240,10/29/2014,0,0,501,0,0,0,501
43935,RM-B240A,10/29/2014,0,0,501,0,0,0,501
44620,RM-B250,10/29/2014,0,0,501,0,0,0,501
45304,RM-B250A,10/29/2014,501,0,0,0,0,0,501
14358,RM-1134,6/11/2014,498,0,0,0,0,0,498
19028,RM-1155,6/11/2014,498,0,0,0,0,0,498
22880,RM-1207,1/20/2014,249,0,0,0,0,249,498
23022,RM-1207,6/11/2014,498,0,0,0,0,0,498
24938,RM-1212,1/20/2014,249,0,249,0,0,0,498
25080,RM-1212,6/11/2014,498,0,0,0,0,0,498
28354,RM-1221,1/20/2014,0,0,249,0,0,249,498
29181,RM-1223,6/11/2014,498,0,0,0,0,0,498
36984,RM-B200C,1/20/2014,249,0,249,0,0,0,498
38360,RM-B215,1/20/2014,0,0,249,0,0,249,498
45166,RM-B250A,6/11/2014,498,0,0,0,0,0,498
5772,RM-1110,6/11/2014,0,0,495,0,0,0,495
369,RM-1100A,7/15/2014,492,0,0,0,0,0,492
1739,RM-1102,7/15/2014,492,0,0,0,0,0,492
5806,RM-1110,7/15/2014,0,0,492,0,0,0,492
6491,RM-1113,7/15/2014,0,0,492,0,0,0,492
9895,RM-1123,7/15/2014,492,0,0,0,0,0,492
13185,RM-1132,7/15/2014,0,0,492,0,0,0,492
14392,RM-1134,7/15/2014,492,0,0,0,0,0,492
15662,RM-1144,7/15/2014,0,0,492,0,0,0,492
16320,RM-1145,7/15/2014,0,0,492,0,0,0,492
17689,RM-1151,7/15/2014,492,0,0,0,0,0,492
19062,RM-1155,7/15/2014,492,0,0,0,0,0,492
23056,RM-1207,7/15/2014,492,0,0,0,0,0,492
23741,RM-1208,7/15/2014,492,0,0,0,0,0,492
25114,RM-1212,7/15/2014,492,0,0,0,0,0,492
26469,RM-1213A,7/15/2014,0,0,492,0,0,0,492
27154,RM-1217,7/15/2014,492,0,0,0,0,0,492
28530,RM-1221,7/15/2014,0,0,492,0,0,0,492
29215,RM-1223,7/15/2014,492,0,0,0,0,0,492
30588,RM-1229,7/15/2014,0,0,492,0,0,0,492
32615,RM-1236,7/15/2014,0,0,492,0,0,0,492
36479,RM-B200B,7/15/2014,0,0,492,0,0,0,492
37160,RM-B200C,7/15/2014,492,0,0,0,0,0,492
39221,RM-B220,7/15/2014,492,0,0,0,0,0,492
39909,RM-B222,7/15/2014,492,0,0,0,0,0,492
41970,RM-B230,7/15/2014,492,0,0,0,0,0,492
43221,RM-B240,7/15/2014,0,0,492,0,0,0,492
44516,RM-B250,7/15/2014,0,0,492,0,0,0,492
45200,RM-B250A,7/15/2014,492,0,0,0,0,0,492
45885,RM-B260,7/15/2014,492,0,0,0,0,0,492
35773,RM-B109,6/26/2014,231,0,258,0,0,0,489
12178,RM-1130,8/17/2013,0,0,0,0,0,483,483
15342,RM-1144,8/17/2013,0,0,0,0,0,483,483
22883,RM-1207,1/23/2014,240,0,0,0,0,243,483
26149,RM-1213A,8/17/2013,0,0,0,0,0,483,483
28357,RM-1221,1/23/2014,0,0,240,0,0,243,483
31605,RM-1231,8/17/2013,0,0,0,0,0,483,483
34923,RM-B103A,8/17/2013,0,0,0,0,0,483,483
38363,RM-B215,1/23/2014,0,0,240,0,0,243,483
40965,RM-B225,8/17/2013,0,0,0,0,0,483,483
42335,RM-B230A,8/17/2013,0,0,0,0,0,483,483
43586,RM-B240A,8/17/2013,0,0,0,0,0,483,483
441,RM-1100A,9/25/2014,480,0,0,0,0,0,480
1811,RM-1102,9/25/2014,480,0,0,0,0,0,480
3430,RM-1107,8/17/2013,0,0,480,0,0,0,480
5878,RM-1110,9/25/2014,0,0,480,0,0,0,480
6171,RM-1113,8/17/2013,0,0,480,0,0,0,480
6563,RM-1113,9/25/2014,0,0,480,0,0,0,480
8890,RM-1122,8/17/2013,0,0,480,0,0,0,480
9575,RM-1123,8/17/2013,0,0,480,0,0,0,480
9967,RM-1123,9/25/2014,480,0,0,0,0,0,480
12569,RM-1130,9/25/2014,0,0,480,0,0,0,480
13257,RM-1132,9/25/2014,0,0,480,0,0,0,480
13550,RM-1133,8/17/2013,0,0,480,0,0,0,480
14464,RM-1134,9/25/2014,480,0,0,0,0,0,480
15734,RM-1144,9/25/2014,0,0,480,0,0,0,480
16392,RM-1145,9/25/2014,0,0,480,0,0,0,480
17761,RM-1151,9/25/2014,480,0,0,0,0,0,480
18054,RM-1154,8/17/2013,480,0,0,0,0,0,480
19134,RM-1155,9/25/2014,480,0,0,0,0,0,480
19810,RM-1156,9/25/2014,0,0,480,0,0,0,480
24501,RM-1208B,9/25/2014,480,0,0,0,0,0,480
24941,RM-1212,1/23/2014,240,0,240,0,0,0,480
25186,RM-1212,9/25/2014,480,0,0,0,0,0,480
25464,RM-1213,8/17/2013,0,0,480,0,0,0,480
26834,RM-1217,8/17/2013,480,0,0,0,0,0,480
27084,RM-1217,5/6/2014,0,480,0,0,0,0,480
28602,RM-1221,9/25/2014,0,0,480,0,0,0,480
29287,RM-1223,9/25/2014,480,0,0,0,0,0,480
30660,RM-1229,9/25/2014,0,0,480,0,0,0,480
32687,RM-1236,9/25/2014,480,0,0,0,0,0,480
33525,RM-4xxx,9/25/2014,0,0,0,0,480,0,480
33707,RM-B102C,8/17/2013,0,0,480,0,0,0,480
36551,RM-B200B,9/25/2014,0,0,480,0,0,0,480
36987,RM-B200C,1/23/2014,240,0,240,0,0,0,480
37232,RM-B200C,9/25/2014,480,0,0,0,0,0,480
39981,RM-B222,9/25/2014,480,0,0,0,0,0,480
42042,RM-B230,9/25/2014,480,0,0,0,0,0,480
43293,RM-B240,9/25/2014,0,0,480,0,0,0,480
43903,RM-B240A,9/25/2014,0,0,480,0,0,0,480
44196,RM-B250,8/17/2013,480,0,0,0,0,0,480
44588,RM-B250,9/25/2014,0,0,480,0,0,0,480
45272,RM-B250A,9/25/2014,480,0,0,0,0,0,480
46935,RM-B270,8/17/2013,0,0,480,0,0,0,480
20735,RM-1200B,8/17/2013,0,0,0,0,0,477,477
27215,RM-1217,9/14/2014,474,0,0,0,0,0,474
27773,RM-1218,5/7/2014,0,0,0,474,0,0,474
34825,RM-B103,4/10/2015,0,0,474,0,0,0,474
29831,RM-1224,5/7/2014,0,0,0,468,0,0,468
9,RM-1100A,7/7/2013,459,0,0,0,0,0,459
2705,RM-1106,7/7/2013,459,0,0,0,0,0,459
4762,RM-1109,7/7/2013,459,0,0,0,0,0,459
6458,RM-1113,6/12/2014,0,0,459,0,0,0,459
12825,RM-1132,7/7/2013,459,0,0,0,0,0,459
15629,RM-1144,6/12/2014,0,0,459,0,0,0,459
16287,RM-1145,6/12/2014,0,0,459,0,0,0,459
19542,RM-1156,12/31/2013,459,0,0,0,0,0,459
26436,RM-1213A,6/12/2014,0,0,459,0,0,0,459
28497,RM-1221,6/12/2014,0,0,459,0,0,0,459
30228,RM-1229,7/7/2013,459,0,0,0,0,0,459
38176,RM-B215,7/7/2013,459,0,0,0,0,0,459
39549,RM-B222,7/7/2013,459,0,0,0,0,0,459
43188,RM-B240,6/12/2014,0,0,459,0,0,0,459
3390,RM-1107,7/7/2013,0,0,456,0,0,0,456
5447,RM-1110,7/7/2013,0,0,0,0,0,456,456
5773,RM-1110,6/12/2014,0,0,456,0,0,0,456
6131,RM-1113,7/7/2013,0,0,456,0,0,0,456
8850,RM-1122,7/7/2013,0,0,456,0,0,0,456
11590,RM-1126,7/7/2013,0,0,0,0,0,456,456
12138,RM-1130,7/7/2013,0,0,0,0,0,456,456
13510,RM-1133,7/7/2013,0,0,456,0,0,0,456
14359,RM-1134,6/12/2014,456,0,0,0,0,0,456
18014,RM-1154,7/7/2013,0,0,456,0,0,0,456
19029,RM-1155,6/12/2014,456,0,0,0,0,0,456
23023,RM-1207,6/12/2014,456,0,0,0,0,0,456
23381,RM-1208,7/7/2013,0,0,0,0,0,456,456
24424,RM-1208B,7/10/2014,228,0,228,0,0,0,456
25081,RM-1212,6/12/2014,456,0,0,0,0,0,456
25424,RM-1213,7/7/2013,0,0,456,0,0,0,456
26109,RM-1213A,7/7/2013,0,0,0,0,0,456,456
27482,RM-1218,7/7/2013,0,0,456,0,0,0,456
28170,RM-1221,7/7/2013,0,0,0,0,0,456,456
29182,RM-1223,6/12/2014,456,0,0,0,0,0,456
31170,RM-1230,5/6/2014,0,456,0,0,0,0,456
33667,RM-B102C,7/7/2013,0,0,456,0,0,0,456
34883,RM-B103A,7/7/2013,0,0,0,0,0,456,456
35787,RM-B109,7/10/2014,228,0,228,0,0,0,456
37127,RM-B200C,6/12/2014,456,0,0,0,0,0,456
37488,RM-B210,7/7/2013,0,0,456,0,0,0,456
39188,RM-B220,6/12/2014,456,0,0,0,0,0,456
40925,RM-B225,7/7/2013,0,0,0,0,0,456,456
41937,RM-B230,6/12/2014,456,0,0,0,0,0,456
42295,RM-B230A,7/7/2013,0,0,0,0,0,456,456
43546,RM-B240A,7/7/2013,0,0,0,0,0,456,456
44156,RM-B250,7/7/2013,0,0,0,0,0,456,456
45167,RM-B250A,6/12/2014,456,0,0,0,0,0,456
46895,RM-B270,7/7/2013,0,0,456,0,0,0,456
47563,RM-B275,7/7/2013,0,0,456,0,0,0,456
3391,RM-1107,7/8/2013,0,0,453,0,0,0,453
6132,RM-1113,7/8/2013,0,0,453,0,0,0,453
8851,RM-1122,7/8/2013,0,0,453,0,0,0,453
13511,RM-1133,7/8/2013,0,0,453,0,0,0,453
18015,RM-1154,7/8/2013,0,0,453,0,0,0,453
25425,RM-1213,7/8/2013,0,0,453,0,0,0,453
27483,RM-1218,7/8/2013,0,0,453,0,0,0,453
33668,RM-B102C,7/8/2013,0,0,453,0,0,0,453
37489,RM-B210,7/8/2013,0,0,453,0,0,0,453
46896,RM-B270,7/8/2013,0,0,453,0,0,0,453
47564,RM-B275,7/8/2013,0,0,453,0,0,0,453
10,RM-1100A,7/8/2013,450,0,0,0,0,0,450
2706,RM-1106,7/8/2013,450,0,0,0,0,0,450
4763,RM-1109,7/8/2013,450,0,0,0,0,0,450
5448,RM-1110,7/8/2013,0,0,0,0,0,450,450
11591,RM-1126,7/8/2013,0,0,0,0,0,450,450
12139,RM-1130,7/8/2013,0,0,0,0,0,450,450
12826,RM-1132,7/8/2013,450,0,0,0,0,0,450
23382,RM-1208,7/8/2013,0,0,0,0,0,450,450
24420,RM-1208B,7/6/2014,225,0,225,0,0,0,450
24423,RM-1208B,7/9/2014,225,0,225,0,0,0,450
26110,RM-1213A,7/8/2013,0,0,0,0,0,450,450
28171,RM-1221,7/8/2013,0,0,0,0,0,450,450
30229,RM-1229,7/8/2013,450,0,0,0,0,0,450
34884,RM-B103A,7/8/2013,0,0,0,0,0,450,450
35778,RM-B109,7/1/2014,225,0,225,0,0,0,450
35779,RM-B109,7/2/2014,225,0,225,0,0,0,450
35783,RM-B109,7/6/2014,225,0,225,0,0,0,450
35786,RM-B109,7/9/2014,225,0,225,0,0,0,450
38177,RM-B215,7/8/2013,450,0,0,0,0,0,450
39550,RM-B222,7/8/2013,450,0,0,0,0,0,450
40926,RM-B225,7/8/2013,0,0,0,0,0,450,450
42296,RM-B230A,7/8/2013,0,0,0,0,0,450,450
43547,RM-B240A,7/8/2013,0,0,0,0,0,450,450
44157,RM-B250,7/8/2013,0,0,0,0,0,450,450
6,RM-1100A,7/4/2013,444,0,0,0,0,0,444
2702,RM-1106,7/4/2013,444,0,0,0,0,0,444
3387,RM-1107,7/4/2013,0,0,444,0,0,0,444
4759,RM-1109,7/4/2013,444,0,0,0,0,0,444
5444,RM-1110,7/4/2013,0,0,0,0,0,444,444
6128,RM-1113,7/4/2013,0,0,444,0,0,0,444
8847,RM-1122,7/4/2013,0,0,444,0,0,0,444
11587,RM-1126,7/4/2013,0,0,0,0,0,444,444
12135,RM-1130,7/4/2013,0,0,0,0,0,444,444
12822,RM-1132,7/4/2013,444,0,0,0,0,0,444
13507,RM-1133,7/4/2013,0,0,444,0,0,0,444
18011,RM-1154,7/4/2013,0,0,444,0,0,0,444
23378,RM-1208,7/4/2013,0,0,0,0,0,444,444
24419,RM-1208B,7/5/2014,222,0,222,0,0,0,444
25421,RM-1213,7/4/2013,0,0,444,0,0,0,444
26106,RM-1213A,7/4/2013,0,0,0,0,0,444,444
27479,RM-1218,7/4/2013,0,0,444,0,0,0,444
28167,RM-1221,7/4/2013,0,0,0,0,0,444,444
30225,RM-1229,7/4/2013,444,0,0,0,0,0,444
33664,RM-B102C,7/4/2013,0,0,444,0,0,0,444
34880,RM-B103A,7/4/2013,0,0,0,0,0,444,444
35782,RM-B109,7/5/2014,222,0,222,0,0,0,444
37485,RM-B210,7/4/2013,0,0,444,0,0,0,444
38173,RM-B215,7/4/2013,444,0,0,0,0,0,444
39546,RM-B222,7/4/2013,444,0,0,0,0,0,444
40922,RM-B225,7/4/2013,0,0,0,0,0,444,444
42292,RM-B230A,7/4/2013,0,0,0,0,0,444,444
43543,RM-B240A,7/4/2013,0,0,0,0,0,444,444
44153,RM-B250,7/4/2013,0,0,0,0,0,444,444
46892,RM-B270,7/4/2013,0,0,444,0,0,0,444
47560,RM-B275,7/4/2013,0,0,444,0,0,0,444
7,RM-1100A,7/5/2013,441,0,0,0,0,0,441
2703,RM-1106,7/5/2013,441,0,0,0,0,0,441
4760,RM-1109,7/5/2013,441,0,0,0,0,0,441
5445,RM-1110,7/5/2013,0,0,0,0,0,441,441
11588,RM-1126,7/5/2013,0,0,0,0,0,441,441
12136,RM-1130,7/5/2013,0,0,0,0,0,441,441
12823,RM-1132,7/5/2013,441,0,0,0,0,0,441
23379,RM-1208,7/5/2013,0,0,0,0,0,441,441
26107,RM-1213A,7/5/2013,0,0,0,0,0,441,441
28168,RM-1221,7/5/2013,0,0,0,0,0,441,441
30226,RM-1229,7/5/2013,441,0,0,0,0,0,441
34881,RM-B103A,7/5/2013,0,0,0,0,0,441,441
35788,RM-B109,7/11/2014,222,0,219,0,0,0,441
38174,RM-B215,7/5/2013,441,0,0,0,0,0,441
39547,RM-B222,7/5/2013,441,0,0,0,0,0,441
40923,RM-B225,7/5/2013,0,0,0,0,0,441,441
42293,RM-B230A,7/5/2013,0,0,0,0,0,441,441
43544,RM-B240A,7/5/2013,0,0,0,0,0,441,441
44154,RM-B250,7/5/2013,0,0,0,0,0,441,441
3388,RM-1107,7/5/2013,0,0,438,0,0,0,438
6129,RM-1113,7/5/2013,0,0,438,0,0,0,438
8848,RM-1122,7/5/2013,0,0,438,0,0,0,438
13508,RM-1133,7/5/2013,0,0,438,0,0,0,438
18012,RM-1154,7/5/2013,0,0,438,0,0,0,438
22884,RM-1207,1/24/2014,219,0,0,0,0,219,438
24425,RM-1208B,7/11/2014,219,0,219,0,0,0,438
24942,RM-1212,1/24/2014,219,0,219,0,0,0,438
25422,RM-1213,7/5/2013,0,0,438,0,0,0,438
27480,RM-1218,7/5/2013,0,0,438,0,0,0,438
28358,RM-1221,1/24/2014,0,0,219,0,0,219,438
32545,RM-1236,5/6/2014,0,432,6,0,0,0,438
33665,RM-B102C,7/5/2013,0,0,438,0,0,0,438
36988,RM-B200C,1/24/2014,219,0,219,0,0,0,438
37486,RM-B210,7/5/2013,0,0,438,0,0,0,438
38364,RM-B215,1/24/2014,0,0,219,0,0,219,438
43894,RM-B240A,9/16/2014,0,0,438,0,0,0,438
46893,RM-B270,7/5/2013,0,0,438,0,0,0,438
47561,RM-B275,7/5/2013,0,0,438,0,0,0,438
16561,RM-1145,3/15/2015,0,0,435,0,0,0,435
24940,RM-1212,1/22/2014,216,0,219,0,0,0,435
28356,RM-1221,1/22/2014,0,0,219,0,0,216,435
36986,RM-B200C,1/22/2014,216,0,219,0,0,0,435
38362,RM-B215,1/22/2014,0,0,219,0,0,216,435
22882,RM-1207,1/22/2014,216,0,0,0,0,216,432
24421,RM-1208B,7/7/2014,216,0,216,0,0,0,432
27772,RM-1218,5/6/2014,0,0,0,432,0,0,432
29830,RM-1224,5/6/2014,0,0,0,432,0,0,432
30518,RM-1229,5/6/2014,0,0,6,426,0,0,432
31171,RM-1230,5/7/2014,0,432,0,0,0,0,432
35784,RM-B109,7/7/2014,216,0,216,0,0,0,432
43929,RM-B240A,10/23/2014,0,0,429,0,0,0,429
467,RM-1100A,10/23/2014,426,0,0,0,0,0,426
1837,RM-1102,10/23/2014,426,0,0,0,0,0,426
6589,RM-1113,10/23/2014,0,0,426,0,0,0,426
9993,RM-1123,10/23/2014,426,0,0,0,0,0,426
12595,RM-1130,10/23/2014,0,0,426,0,0,0,426
13283,RM-1132,10/23/2014,0,0,426,0,0,0,426
14490,RM-1134,10/23/2014,426,0,0,0,0,0,426
15760,RM-1144,10/23/2014,0,0,426,0,0,0,426
16418,RM-1145,10/23/2014,0,0,426,0,0,0,426
17787,RM-1151,10/23/2014,426,0,0,0,0,0,426
19160,RM-1155,10/23/2014,426,0,0,0,0,0,426
19836,RM-1156,10/23/2014,0,0,426,0,0,0,426
24527,RM-1208B,10/23/2014,426,0,0,0,0,0,426
24943,RM-1212,1/25/2014,213,0,213,0,0,0,426
25212,RM-1212,10/23/2014,426,0,0,0,0,0,426
27940,RM-1218,10/23/2014,426,0,0,0,0,0,426
28628,RM-1221,10/23/2014,0,0,426,0,0,0,426
29313,RM-1223,10/23/2014,426,0,0,0,0,0,426
30686,RM-1229,10/23/2014,0,0,426,0,0,0,426
32713,RM-1236,10/23/2014,426,0,0,0,0,0,426
36577,RM-B200B,10/23/2014,0,0,426,0,0,0,426
36989,RM-B200C,1/25/2014,213,0,213,0,0,0,426
37171,RM-B200C,7/26/2014,426,0,0,0,0,0,426
37258,RM-B200C,10/23/2014,426,0,0,0,0,0,426
39232,RM-B220,7/26/2014,426,0,0,0,0,0,426
40007,RM-B222,10/23/2014,426,0,0,0,0,0,426
41981,RM-B230,7/26/2014,426,0,0,0,0,0,426
43232,RM-B240,7/26/2014,0,0,426,0,0,0,426
43319,RM-B240,10/23/2014,0,0,426,0,0,0,426
44527,RM-B250,7/26/2014,0,0,426,0,0,0,426
44614,RM-B250,10/23/2014,0,0,426,0,0,0,426
45298,RM-B250A,10/23/2014,426,0,0,0,0,0,426
45896,RM-B260,7/26/2014,426,0,0,0,0,0,426
380,RM-1100A,7/26/2014,423,0,0,0,0,0,423
1750,RM-1102,7/26/2014,423,0,0,0,0,0,423
5817,RM-1110,7/26/2014,0,0,423,0,0,0,423
6502,RM-1113,7/26/2014,0,0,423,0,0,0,423
9906,RM-1123,7/26/2014,423,0,0,0,0,0,423
13196,RM-1132,7/26/2014,0,0,423,0,0,0,423
14403,RM-1134,7/26/2014,423,0,0,0,0,0,423
15673,RM-1144,7/26/2014,0,0,423,0,0,0,423
16331,RM-1145,7/26/2014,0,0,423,0,0,0,423
17700,RM-1151,7/26/2014,423,0,0,0,0,0,423
19073,RM-1155,7/26/2014,423,0,0,0,0,0,423
22885,RM-1207,1/25/2014,213,0,0,0,0,210,423
23067,RM-1207,7/26/2014,423,0,0,0,0,0,423
23752,RM-1208,7/26/2014,423,0,0,0,0,0,423
25125,RM-1212,7/26/2014,423,0,0,0,0,0,423
26480,RM-1213A,7/26/2014,0,0,423,0,0,0,423
27165,RM-1217,7/26/2014,423,0,0,0,0,0,423
28359,RM-1221,1/25/2014,0,0,213,0,0,210,423
28541,RM-1221,7/26/2014,0,0,423,0,0,0,423
29226,RM-1223,7/26/2014,423,0,0,0,0,0,423
30599,RM-1229,7/26/2014,0,0,423,0,0,0,423
32626,RM-1236,7/26/2014,0,0,423,0,0,0,423
33551,RM-4xxx,10/23/2014,0,0,0,0,423,0,423
35775,RM-B109,6/28/2014,210,0,213,0,0,0,423
36490,RM-B200B,7/26/2014,0,0,423,0,0,0,423
38365,RM-B215,1/25/2014,0,0,213,0,0,210,423
39920,RM-B222,7/26/2014,423,0,0,0,0,0,423
45211,RM-B250A,7/26/2014,423,0,0,0,0,0,423
15425,RM-1144,11/20/2013,0,0,0,0,0,414,414
377,RM-1100A,7/23/2014,408,0,0,0,0,0,408
1747,RM-1102,7/23/2014,408,0,0,0,0,0,408
5814,RM-1110,7/23/2014,0,0,408,0,0,0,408
6499,RM-1113,7/23/2014,0,0,408,0,0,0,408
9903,RM-1123,7/23/2014,408,0,0,0,0,0,408
13193,RM-1132,7/23/2014,0,0,408,0,0,0,408
14400,RM-1134,7/23/2014,408,0,0,0,0,0,408
15670,RM-1144,7/23/2014,0,0,408,0,0,0,408
16328,RM-1145,7/23/2014,0,0,408,0,0,0,408
17697,RM-1151,7/23/2014,408,0,0,0,0,0,408
19070,RM-1155,7/23/2014,408,0,0,0,0,0,408
23064,RM-1207,7/23/2014,408,0,0,0,0,0,408
23749,RM-1208,7/23/2014,408,0,0,0,0,0,408
25122,RM-1212,7/23/2014,408,0,0,0,0,0,408
26477,RM-1213A,7/23/2014,0,0,408,0,0,0,408
27162,RM-1217,7/23/2014,408,0,0,0,0,0,408
28538,RM-1221,7/23/2014,0,0,408,0,0,0,408
29223,RM-1223,7/23/2014,408,0,0,0,0,0,408
30596,RM-1229,7/23/2014,0,0,408,0,0,0,408
32623,RM-1236,7/23/2014,0,0,408,0,0,0,408
32912,RM-1236,5/10/2015,408,0,0,0,0,0,408
36487,RM-B200B,7/23/2014,0,0,408,0,0,0,408
37168,RM-B200C,7/23/2014,408,0,0,0,0,0,408
39229,RM-B220,7/23/2014,408,0,0,0,0,0,408
39917,RM-B222,7/23/2014,408,0,0,0,0,0,408
41978,RM-B230,7/23/2014,408,0,0,0,0,0,408
43229,RM-B240,7/23/2014,0,0,408,0,0,0,408
44524,RM-B250,7/23/2014,0,0,408,0,0,0,408
45208,RM-B250A,7/23/2014,408,0,0,0,0,0,408
45893,RM-B260,7/23/2014,408,0,0,0,0,0,408
18880,RM-1155,1/14/2014,201,0,204,0,0,0,405
24932,RM-1212,1/14/2014,201,0,204,0,0,0,405
28348,RM-1221,1/14/2014,0,0,204,0,0,201,405
30406,RM-1229,1/14/2014,0,0,204,0,0,201,405
36978,RM-B200C,1/14/2014,201,0,204,0,0,0,405
38354,RM-B215,1/14/2014,0,0,204,0,0,201,405
22874,RM-1207,1/14/2014,201,0,0,0,0,201,402
23559,RM-1208,1/14/2014,201,0,0,0,0,201,402
35061,RM-B103A,1/14/2014,201,0,0,0,0,201,402
39259,RM-B220,8/22/2014,402,0,0,0,0,0,402
20811,RM-1200B,11/10/2013,0,0,0,0,0,399,399
45958,RM-B260,9/28/2014,201,0,198,0,0,0,399
35865,RM-B109,9/28/2014,198,0,198,0,0,0,396
44623,RM-B250,11/1/2014,0,0,396,0,0,0,396
36466,RM-B200B,7/2/2014,0,168,225,0,0,0,393
20869,RM-1200B,1/10/2014,0,198,0,192,0,0,390
29714,RM-1224,1/10/2014,0,198,0,192,0,0,390
356,RM-1100A,7/2/2014,225,162,0,0,0,0,387
1726,RM-1102,7/2/2014,225,162,0,0,0,0,387
7523,RM-1116,8/27/2013,0,0,195,0,0,192,387
18748,RM-1155,8/27/2013,192,0,195,0,0,0,387
20680,RM-1200A,5/1/2015,387,0,0,0,0,0,387
26535,RM-1213A,9/19/2014,0,0,387,0,0,0,387
27141,RM-1217,7/2/2014,225,162,0,0,0,0,387
30274,RM-1229,8/27/2013,192,0,195,0,0,0,387
32301,RM-1236,8/27/2013,192,0,195,0,0,0,387
32602,RM-1236,7/2/2014,0,162,225,0,0,0,387
36846,RM-B200C,8/27/2013,0,0,195,0,0,192,387
40283,RM-B224,8/27/2013,0,0,195,0,0,192,387
47609,RM-B275,8/27/2013,0,0,195,0,0,192,387
2751,RM-1106,8/27/2013,192,0,0,0,0,192,384
5775,RM-1110,6/14/2014,0,0,384,0,0,0,384
6460,RM-1113,6/14/2014,0,0,384,0,0,0,384
8211,RM-1117,8/27/2013,192,0,0,0,0,192,384
14361,RM-1134,6/14/2014,384,0,0,0,0,0,384
15631,RM-1144,6/14/2014,0,0,384,0,0,0,384
16289,RM-1145,6/14/2014,0,0,384,0,0,0,384
19031,RM-1155,6/14/2014,384,0,0,0,0,0,384
23025,RM-1207,6/14/2014,384,0,0,0,0,0,384
23427,RM-1208,8/27/2013,192,0,0,0,0,192,384
25083,RM-1212,6/14/2014,384,0,0,0,0,0,384
26438,RM-1213A,6/14/2014,0,0,384,0,0,0,384
28499,RM-1221,6/14/2014,0,0,384,0,0,0,384
29184,RM-1223,6/14/2014,384,0,0,0,0,0,384
37129,RM-B200C,6/14/2014,384,0,0,0,0,0,384
38222,RM-B215,8/27/2013,192,0,0,0,0,192,384
39190,RM-B220,6/14/2014,384,0,0,0,0,0,384
39595,RM-B222,8/27/2013,192,0,192,0,0,0,384
41939,RM-B230,6/14/2014,384,0,0,0,0,0,384
43190,RM-B240,6/14/2014,0,0,384,0,0,0,384
45169,RM-B250A,6/14/2014,384,0,0,0,0,0,384
6461,RM-1113,6/15/2014,0,0,378,0,0,0,378
15632,RM-1144,6/15/2014,0,0,378,0,0,0,378
16290,RM-1145,6/15/2014,0,0,378,0,0,0,378
26439,RM-1213A,6/15/2014,0,0,378,0,0,0,378
28500,RM-1221,6/15/2014,0,0,378,0,0,0,378
35774,RM-B109,6/27/2014,189,0,189,0,0,0,378
43191,RM-B240,6/15/2014,0,0,378,0,0,0,378
21944,RM-1200C,2/6/2015,375,0,0,0,0,0,375
30575,RM-1229,7/2/2014,0,0,225,150,0,0,375
39896,RM-B222,7/2/2014,225,0,0,150,0,0,375
45872,RM-B260,7/2/2014,225,0,0,150,0,0,375
6269,RM-1113,12/5/2013,183,0,186,0,0,0,369
6459,RM-1113,6/13/2014,0,0,369,0,0,0,369
8303,RM-1117,12/5/2013,183,0,186,0,0,0,369
15630,RM-1144,6/13/2014,0,0,369,0,0,0,369
16288,RM-1145,6/13/2014,0,0,369,0,0,0,369
18840,RM-1155,12/5/2013,183,0,186,0,0,0,369
26437,RM-1213A,6/13/2014,0,0,369,0,0,0,369
28498,RM-1221,6/13/2014,0,0,369,0,0,0,369
30366,RM-1229,12/5/2013,0,0,186,0,0,183,369
43189,RM-B240,6/13/2014,0,0,369,0,0,0,369
44294,RM-B250,12/5/2013,183,0,186,0,0,0,369
7615,RM-1116,12/5/2013,183,0,0,0,0,183,366
23519,RM-1208,12/5/2013,183,0,0,0,0,183,366
35021,RM-B103A,12/5/2013,183,0,0,0,0,183,366
22881,RM-1207,1/21/2014,180,0,0,0,0,180,360
24417,RM-1208B,7/3/2014,180,0,180,0,0,0,360
35780,RM-B109,7/3/2014,180,0,180,0,0,0,360
36753,RM-B200B,4/21/2015,0,0,360,0,0,0,360
24939,RM-1212,1/21/2014,180,0,177,0,0,0,357
28355,RM-1221,1/21/2014,0,0,177,0,0,180,357
36985,RM-B200C,1/21/2014,180,0,177,0,0,0,357
38361,RM-B215,1/21/2014,0,0,177,0,0,180,357
3389,RM-1107,7/6/2013,0,0,354,0,0,0,354
5446,RM-1110,7/6/2013,0,0,0,0,0,354,354
5776,RM-1110,6/15/2014,0,0,354,0,0,0,354
6130,RM-1113,7/6/2013,0,0,354,0,0,0,354
8849,RM-1122,7/6/2013,0,0,354,0,0,0,354
11589,RM-1126,7/6/2013,0,0,0,0,0,354,354
12137,RM-1130,7/6/2013,0,0,0,0,0,354,354
13509,RM-1133,7/6/2013,0,0,354,0,0,0,354
14362,RM-1134,6/15/2014,354,0,0,0,0,0,354
18013,RM-1154,7/6/2013,0,0,354,0,0,0,354
19032,RM-1155,6/15/2014,354,0,0,0,0,0,354
23026,RM-1207,6/15/2014,354,0,0,0,0,0,354
23380,RM-1208,7/6/2013,0,0,0,0,0,354,354
25084,RM-1212,6/15/2014,354,0,0,0,0,0,354
25423,RM-1213,7/6/2013,0,0,354,0,0,0,354
26108,RM-1213A,7/6/2013,0,0,0,0,0,354,354
27481,RM-1218,7/6/2013,0,0,354,0,0,0,354
28169,RM-1221,7/6/2013,0,0,0,0,0,354,354
29185,RM-1223,6/15/2014,354,0,0,0,0,0,354
33666,RM-B102C,7/6/2013,0,0,354,0,0,0,354
34882,RM-B103A,7/6/2013,0,0,0,0,0,354,354
37130,RM-B200C,6/15/2014,354,0,0,0,0,0,354
37487,RM-B210,7/6/2013,0,0,354,0,0,0,354
39191,RM-B220,6/15/2014,354,0,0,0,0,0,354
40924,RM-B225,7/6/2013,0,0,0,0,0,354,354
41940,RM-B230,6/15/2014,354,0,0,0,0,0,354
42294,RM-B230A,7/6/2013,0,0,0,0,0,354,354
43545,RM-B240A,7/6/2013,0,0,0,0,0,354,354
44155,RM-B250,7/6/2013,0,0,0,0,0,354,354
45170,RM-B250A,6/15/2014,354,0,0,0,0,0,354
46894,RM-B270,7/6/2013,0,0,354,0,0,0,354
47562,RM-B275,7/6/2013,0,0,354,0,0,0,354
8,RM-1100A,7/6/2013,351,0,0,0,0,0,351
2704,RM-1106,7/6/2013,351,0,0,0,0,0,351
4761,RM-1109,7/6/2013,351,0,0,0,0,0,351
12824,RM-1132,7/6/2013,351,0,0,0,0,0,351
30227,RM-1229,7/6/2013,351,0,0,0,0,0,351
38175,RM-B215,7/6/2013,351,0,0,0,0,0,351
39548,RM-B222,7/6/2013,351,0,0,0,0,0,351
2827,RM-1106,11/19/2013,0,0,0,0,0,348,348
4884,RM-1109,11/19/2013,0,0,0,0,0,348,348
9657,RM-1123,11/19/2013,0,0,348,0,0,0,348
10342,RM-1124,11/19/2013,0,0,0,0,0,348,348
12260,RM-1130,11/19/2013,0,0,0,0,0,348,348
13632,RM-1133,11/19/2013,0,0,348,0,0,0,348
15424,RM-1144,11/19/2013,0,0,0,0,0,348,348
16109,RM-1145,11/19/2013,0,0,0,0,0,348,348
16291,RM-1145,6/16/2014,0,0,348,0,0,0,348
22818,RM-1207,11/19/2013,0,0,0,0,0,348,348
24876,RM-1212,11/19/2013,0,0,348,0,0,0,348
25546,RM-1213,11/19/2013,0,0,0,0,0,348,348
26916,RM-1217,11/19/2013,348,0,0,0,0,0,348
28292,RM-1221,11/19/2013,0,0,348,0,0,0,348
31687,RM-1231,11/19/2013,0,0,0,0,0,348,348
32377,RM-1236,11/19/2013,0,0,348,0,0,0,348
35005,RM-B103A,11/19/2013,0,0,0,0,0,348,348
36241,RM-B200B,11/19/2013,0,0,0,0,0,348,348
39671,RM-B222,11/19/2013,348,0,0,0,0,0,348
40359,RM-B224,11/19/2013,0,0,0,0,0,348,348
41047,RM-B225,11/19/2013,0,0,0,0,0,348,348
42417,RM-B230A,11/19/2013,0,0,0,0,0,348,348
43192,RM-B240,6/16/2014,0,0,348,0,0,0,348
6462,RM-1113,6/16/2014,0,0,345,0,0,0,345
6463,RM-1113,6/17/2014,0,0,345,0,0,0,345
12947,RM-1132,11/19/2013,0,0,345,0,0,0,345
15633,RM-1144,6/16/2014,0,0,345,0,0,0,345
15634,RM-1144,6/17/2014,0,0,345,0,0,0,345
16292,RM-1145,6/17/2014,0,0,345,0,0,0,345
19271,RM-1155,2/11/2015,345,0,0,0,0,0,345
26440,RM-1213A,6/16/2014,0,0,345,0,0,0,345
26441,RM-1213A,6/17/2014,0,0,345,0,0,0,345
28501,RM-1221,6/16/2014,0,0,345,0,0,0,345
28502,RM-1221,6/17/2014,0,0,345,0,0,0,345
43072,RM-B240,2/16/2014,0,0,345,0,0,0,345
43193,RM-B240,6/17/2014,0,0,345,0,0,0,345
2374,RM-1104,5/26/2014,0,342,0,0,0,0,342
41128,RM-B225,2/8/2014,0,0,0,0,0,342,342
18026,RM-1154,7/20/2013,0,0,336,0,0,0,336
18696,RM-1155,7/1/2013,36,0,300,0,0,0,336
6464,RM-1113,6/18/2014,0,0,333,0,0,0,333
15635,RM-1144,6/18/2014,0,0,333,0,0,0,333
16293,RM-1145,6/18/2014,0,0,333,0,0,0,333
26442,RM-1213A,6/18/2014,0,0,333,0,0,0,333
28503,RM-1221,6/18/2014,0,0,333,0,0,0,333
32249,RM-1236,7/1/2013,36,0,297,0,0,0,333
43194,RM-B240,6/18/2014,0,0,333,0,0,0,333
5779,RM-1110,6/18/2014,0,0,330,0,0,0,330
14365,RM-1134,6/18/2014,330,0,0,0,0,0,330
19035,RM-1155,6/18/2014,330,0,0,0,0,0,330
23029,RM-1207,6/18/2014,330,0,0,0,0,0,330
25087,RM-1212,6/18/2014,330,0,0,0,0,0,330
29188,RM-1223,6/18/2014,330,0,0,0,0,0,330
37133,RM-B200C,6/18/2014,330,0,0,0,0,0,330
37522,RM-B210,8/11/2013,0,0,330,0,0,0,330
39194,RM-B220,6/18/2014,330,0,0,0,0,0,330
41943,RM-B230,6/18/2014,330,0,0,0,0,0,330
45173,RM-B250A,6/18/2014,330,0,0,0,0,0,330
5774,RM-1110,6/13/2014,0,0,327,0,0,0,327
5777,RM-1110,6/16/2014,0,0,327,0,0,0,327
14363,RM-1134,6/16/2014,327,0,0,0,0,0,327
19033,RM-1155,6/16/2014,327,0,0,0,0,0,327
23027,RM-1207,6/16/2014,327,0,0,0,0,0,327
25085,RM-1212,6/16/2014,327,0,0,0,0,0,327
29186,RM-1223,6/16/2014,327,0,0,0,0,0,327
37131,RM-B200C,6/16/2014,327,0,0,0,0,0,327
39192,RM-B220,6/16/2014,327,0,0,0,0,0,327
41941,RM-B230,6/16/2014,327,0,0,0,0,0,327
45171,RM-B250A,6/16/2014,327,0,0,0,0,0,327
9882,RM-1123,7/2/2014,0,324,0,0,0,0,324
14360,RM-1134,6/13/2014,324,0,0,0,0,0,324
19030,RM-1155,6/13/2014,324,0,0,0,0,0,324
23024,RM-1207,6/13/2014,324,0,0,0,0,0,324
25082,RM-1212,6/13/2014,324,0,0,0,0,0,324
29183,RM-1223,6/13/2014,324,0,0,0,0,0,324
37128,RM-B200C,6/13/2014,324,0,0,0,0,0,324
39189,RM-B220,6/13/2014,324,0,0,0,0,0,324
41938,RM-B230,6/13/2014,324,0,0,0,0,0,324
45168,RM-B250A,6/13/2014,324,0,0,0,0,0,324
5778,RM-1110,6/17/2014,0,0,321,0,0,0,321
14364,RM-1134,6/17/2014,321,0,0,0,0,0,321
19034,RM-1155,6/17/2014,321,0,0,0,0,0,321
23028,RM-1207,6/17/2014,321,0,0,0,0,0,321
25086,RM-1212,6/17/2014,321,0,0,0,0,0,321
29187,RM-1223,6/17/2014,321,0,0,0,0,0,321
37132,RM-B200C,6/17/2014,321,0,0,0,0,0,321
39193,RM-B220,6/17/2014,321,0,0,0,0,0,321
41942,RM-B230,6/17/2014,321,0,0,0,0,0,321
45172,RM-B250A,6/17/2014,321,0,0,0,0,0,321
36794,RM-B200C,7/1/2013,0,0,306,0,0,6,312
5780,RM-1110,6/19/2014,0,0,309,0,0,0,309
6465,RM-1113,6/19/2014,0,0,309,0,0,0,309
14366,RM-1134,6/19/2014,309,0,0,0,0,0,309
15636,RM-1144,6/19/2014,0,0,309,0,0,0,309
16294,RM-1145,6/19/2014,0,0,309,0,0,0,309
19036,RM-1155,6/19/2014,309,0,0,0,0,0,309
23030,RM-1207,6/19/2014,309,0,0,0,0,0,309
25088,RM-1212,6/19/2014,309,0,0,0,0,0,309
26443,RM-1213A,6/19/2014,0,0,309,0,0,0,309
28504,RM-1221,6/19/2014,0,0,309,0,0,0,309
29189,RM-1223,6/19/2014,309,0,0,0,0,0,309
37134,RM-B200C,6/19/2014,309,0,0,0,0,0,309
39195,RM-B220,6/19/2014,309,0,0,0,0,0,309
40231,RM-B224,7/1/2013,0,0,303,0,0,6,309
41944,RM-B230,6/19/2014,309,0,0,0,0,0,309
43195,RM-B240,6/19/2014,0,0,309,0,0,0,309
45174,RM-B250A,6/19/2014,309,0,0,0,0,0,309
24422,RM-1208B,7/8/2014,153,0,153,0,0,0,306
33661,RM-B102C,7/1/2013,0,0,306,0,0,0,306
35785,RM-B109,7/8/2014,153,0,153,0,0,0,306
37482,RM-B210,7/1/2013,0,0,306,0,0,0,306
46889,RM-B270,7/1/2013,0,0,306,0,0,0,306
47557,RM-B275,7/1/2013,0,0,306,0,0,0,306
5781,RM-1110,6/20/2014,0,0,303,0,0,0,303
7471,RM-1116,7/1/2013,0,0,300,0,0,3,303
14367,RM-1134,6/20/2014,303,0,0,0,0,0,303
19037,RM-1155,6/20/2014,303,0,0,0,0,0,303
23031,RM-1207,6/20/2014,303,0,0,0,0,0,303
24949,RM-1212,1/31/2014,150,0,153,0,0,0,303
25089,RM-1212,6/20/2014,303,0,0,0,0,0,303
28365,RM-1221,1/31/2014,0,0,153,0,0,150,303
29190,RM-1223,6/20/2014,303,0,0,0,0,0,303
36995,RM-B200C,1/31/2014,150,0,153,0,0,0,303
37135,RM-B200C,6/20/2014,303,0,0,0,0,0,303
39196,RM-B220,6/20/2014,303,0,0,0,0,0,303
41945,RM-B230,6/20/2014,303,0,0,0,0,0,303
45175,RM-B250A,6/20/2014,303,0,0,0,0,0,303
6466,RM-1113,6/20/2014,0,0,300,0,0,0,300
8844,RM-1122,7/1/2013,0,0,300,0,0,0,300
15637,RM-1144,6/20/2014,0,0,300,0,0,0,300
16295,RM-1145,6/20/2014,0,0,300,0,0,0,300
18008,RM-1154,7/1/2013,0,0,300,0,0,0,300
20379,RM-1200A,7/2/2014,0,0,0,300,0,0,300
22891,RM-1207,1/31/2014,150,0,0,0,0,150,300
26444,RM-1213A,6/20/2014,0,0,300,0,0,0,300
28505,RM-1221,6/20/2014,0,0,300,0,0,0,300
43196,RM-B240,6/20/2014,0,0,300,0,0,0,300
3384,RM-1107,7/1/2013,0,0,297,0,0,0,297
6125,RM-1113,7/1/2013,0,0,297,0,0,0,297
12555,RM-1130,9/11/2014,0,0,297,0,0,0,297
13504,RM-1133,7/1/2013,0,0,297,0,0,0,297
25418,RM-1213,7/1/2013,0,0,297,0,0,0,297
27476,RM-1218,7/1/2013,0,0,297,0,0,0,297
4944,RM-1109,1/18/2014,0,0,0,0,0,288,288
6312,RM-1113,1/17/2014,0,0,288,0,0,0,288
6972,RM-1115,1/18/2014,0,0,0,0,0,288,288
9032,RM-1122,1/18/2014,0,0,0,0,0,288,288
10402,RM-1124,1/18/2014,0,0,0,0,0,288,288
15483,RM-1144,1/17/2014,0,0,288,0,0,0,288
16169,RM-1145,1/18/2014,0,0,0,0,0,288,288
25606,RM-1213,1/18/2014,0,0,0,0,0,288,288
31747,RM-1231,1/18/2014,0,0,0,0,0,288,288
32436,RM-1236,1/17/2014,0,0,288,0,0,0,288
40419,RM-B224,1/18/2014,0,0,0,0,0,288,288
41107,RM-B225,1/18/2014,0,0,0,0,0,288,288
42477,RM-B230A,1/18/2014,0,0,0,0,0,288,288
44337,RM-B250,1/17/2014,0,0,288,0,0,0,288
4943,RM-1109,1/17/2014,0,0,0,0,0,285,285
6313,RM-1113,1/18/2014,0,0,285,0,0,0,285
6971,RM-1115,1/17/2014,0,0,0,0,0,285,285
7658,RM-1116,1/17/2014,285,0,0,0,0,0,285
7659,RM-1116,1/18/2014,285,0,0,0,0,0,285
9031,RM-1122,1/17/2014,0,0,0,0,0,285,285
10401,RM-1124,1/17/2014,0,0,0,0,0,285,285
15484,RM-1144,1/18/2014,0,0,285,0,0,0,285
16168,RM-1145,1/17/2014,0,0,0,0,0,285,285
19559,RM-1156,1/17/2014,285,0,0,0,0,0,285
19560,RM-1156,1/18/2014,285,0,0,0,0,0,285
25605,RM-1213,1/17/2014,0,0,0,0,0,285,285
31746,RM-1231,1/17/2014,0,0,0,0,0,285,285
32437,RM-1236,1/18/2014,0,0,285,0,0,0,285
39042,RM-B220,1/17/2014,285,0,0,0,0,0,285
39043,RM-B220,1/18/2014,285,0,0,0,0,0,285
40418,RM-B224,1/17/2014,0,0,0,0,0,285,285
41106,RM-B225,1/17/2014,0,0,0,0,0,285,285
42476,RM-B230A,1/17/2014,0,0,0,0,0,285,285
43201,RM-B240,6/25/2014,0,0,285,0,0,0,285
44338,RM-B250,1/18/2014,0,0,285,0,0,0,285
6467,RM-1113,6/21/2014,0,0,282,0,0,0,282
6470,RM-1113,6/24/2014,0,0,282,0,0,0,282
6471,RM-1113,6/25/2014,0,0,282,0,0,0,282
15638,RM-1144,6/21/2014,0,0,282,0,0,0,282
15641,RM-1144,6/24/2014,0,0,282,0,0,0,282
15642,RM-1144,6/25/2014,0,0,282,0,0,0,282
16296,RM-1145,6/21/2014,0,0,282,0,0,0,282
16299,RM-1145,6/24/2014,0,0,282,0,0,0,282
16300,RM-1145,6/25/2014,0,0,282,0,0,0,282
26445,RM-1213A,6/21/2014,0,0,282,0,0,0,282
26448,RM-1213A,6/24/2014,0,0,282,0,0,0,282
26449,RM-1213A,6/25/2014,0,0,282,0,0,0,282
28506,RM-1221,6/21/2014,0,0,282,0,0,0,282
28509,RM-1221,6/24/2014,0,0,282,0,0,0,282
28510,RM-1221,6/25/2014,0,0,282,0,0,0,282
37140,RM-B200C,6/25/2014,282,0,0,0,0,0,282
43197,RM-B240,6/21/2014,0,0,282,0,0,0,282
43200,RM-B240,6/24/2014,0,0,282,0,0,0,282
5782,RM-1110,6/21/2014,0,0,279,0,0,0,279
14368,RM-1134,6/21/2014,279,0,0,0,0,0,279
19038,RM-1155,6/21/2014,279,0,0,0,0,0,279
23032,RM-1207,6/21/2014,279,0,0,0,0,0,279
25090,RM-1212,6/21/2014,279,0,0,0,0,0,279
29191,RM-1223,6/21/2014,279,0,0,0,0,0,279
37136,RM-B200C,6/21/2014,279,0,0,0,0,0,279
39197,RM-B220,6/21/2014,279,0,0,0,0,0,279
39201,RM-B220,6/25/2014,279,0,0,0,0,0,279
41946,RM-B230,6/21/2014,279,0,0,0,0,0,279
41950,RM-B230,6/25/2014,279,0,0,0,0,0,279
45176,RM-B250A,6/21/2014,279,0,0,0,0,0,279
22887,RM-1207,1/27/2014,138,0,0,0,0,138,276
24945,RM-1212,1/27/2014,138,0,138,0,0,0,276
28361,RM-1221,1/27/2014,0,0,138,0,0,138,276
36991,RM-B200C,1/27/2014,138,0,138,0,0,0,276
401,RM-1100A,8/16/2014,273,0,0,0,0,0,273
1771,RM-1102,8/16/2014,273,0,0,0,0,0,273
5005,RM-1109,3/20/2014,0,0,0,0,0,273,273
5783,RM-1110,6/22/2014,0,0,273,0,0,0,273
5785,RM-1110,6/24/2014,0,0,273,0,0,0,273
5786,RM-1110,6/25/2014,0,0,273,0,0,0,273
5838,RM-1110,8/16/2014,0,0,273,0,0,0,273
6374,RM-1113,3/20/2014,0,0,273,0,0,0,273
6468,RM-1113,6/22/2014,0,0,273,0,0,0,273
6523,RM-1113,8/16/2014,0,0,273,0,0,0,273
7720,RM-1116,3/20/2014,273,0,0,0,0,0,273
9093,RM-1122,3/20/2014,0,0,0,0,0,273,273
9927,RM-1123,8/16/2014,273,0,0,0,0,0,273
13217,RM-1132,8/16/2014,0,0,273,0,0,0,273
14276,RM-1134,3/20/2014,273,0,0,0,0,0,273
14369,RM-1134,6/22/2014,273,0,0,0,0,0,273
14371,RM-1134,6/24/2014,273,0,0,0,0,0,273
14372,RM-1134,6/25/2014,273,0,0,0,0,0,273
14424,RM-1134,8/16/2014,273,0,0,0,0,0,273
15545,RM-1144,3/20/2014,0,0,273,0,0,0,273
15639,RM-1144,6/22/2014,0,0,273,0,0,0,273
15694,RM-1144,8/16/2014,0,0,273,0,0,0,273
16230,RM-1145,3/20/2014,0,0,0,0,0,273,273
16297,RM-1145,6/22/2014,0,0,273,0,0,0,273
16352,RM-1145,8/16/2014,0,0,273,0,0,0,273
17721,RM-1151,8/16/2014,273,0,0,0,0,0,273
19039,RM-1155,6/22/2014,273,0,0,0,0,0,273
19041,RM-1155,6/24/2014,273,0,0,0,0,0,273
19042,RM-1155,6/25/2014,273,0,0,0,0,0,273
19094,RM-1155,8/16/2014,273,0,0,0,0,0,273
23033,RM-1207,6/22/2014,273,0,0,0,0,0,273
23035,RM-1207,6/24/2014,273,0,0,0,0,0,273
23036,RM-1207,6/25/2014,273,0,0,0,0,0,273
23773,RM-1208,8/16/2014,273,0,0,0,0,0,273
24944,RM-1212,1/26/2014,135,0,138,0,0,0,273
25091,RM-1212,6/22/2014,273,0,0,0,0,0,273
25093,RM-1212,6/24/2014,273,0,0,0,0,0,273
25094,RM-1212,6/25/2014,273,0,0,0,0,0,273
25146,RM-1212,8/16/2014,273,0,0,0,0,0,273
25667,RM-1213,3/20/2014,0,0,0,0,0,273,273
26352,RM-1213A,3/20/2014,0,0,273,0,0,0,273
26446,RM-1213A,6/22/2014,0,0,273,0,0,0,273
26501,RM-1213A,8/16/2014,0,0,273,0,0,0,273
27037,RM-1217,3/20/2014,273,0,0,0,0,0,273
27186,RM-1217,8/16/2014,273,0,0,0,0,0,273
28360,RM-1221,1/26/2014,0,0,138,0,0,135,273
28413,RM-1221,3/20/2014,0,0,0,0,0,273,273
28507,RM-1221,6/22/2014,0,0,273,0,0,0,273
28562,RM-1221,8/16/2014,0,0,273,0,0,0,273
29192,RM-1223,6/22/2014,273,0,0,0,0,0,273
29194,RM-1223,6/24/2014,273,0,0,0,0,0,273
29195,RM-1223,6/25/2014,273,0,0,0,0,0,273
29247,RM-1223,8/16/2014,273,0,0,0,0,0,273
30620,RM-1229,8/16/2014,0,0,273,0,0,0,273
31808,RM-1231,3/20/2014,0,0,0,0,0,273,273
32498,RM-1236,3/20/2014,0,0,273,0,0,0,273
35675,RM-B109,3/20/2014,0,0,273,0,0,0,273
36511,RM-B200B,8/16/2014,0,0,273,0,0,0,273
36990,RM-B200C,1/26/2014,135,0,138,0,0,0,273
37137,RM-B200C,6/22/2014,273,0,0,0,0,0,273
37139,RM-B200C,6/24/2014,273,0,0,0,0,0,273
37192,RM-B200C,8/16/2014,273,0,0,0,0,0,273
38366,RM-B215,1/26/2014,0,0,138,0,0,135,273
38419,RM-B215,3/20/2014,0,0,273,0,0,0,273
39104,RM-B220,3/20/2014,273,0,0,0,0,0,273
39198,RM-B220,6/22/2014,273,0,0,0,0,0,273
39253,RM-B220,8/16/2014,273,0,0,0,0,0,273
39941,RM-B222,8/16/2014,273,0,0,0,0,0,273
40480,RM-B224,3/20/2014,0,0,0,0,0,273,273
41947,RM-B230,6/22/2014,273,0,0,0,0,0,273
42002,RM-B230,8/16/2014,273,0,0,0,0,0,273
42538,RM-B230A,3/20/2014,0,0,0,0,0,273,273
43104,RM-B240,3/20/2014,0,0,273,0,0,0,273
43198,RM-B240,6/22/2014,0,0,273,0,0,0,273
43253,RM-B240,8/16/2014,0,0,273,0,0,0,273
44548,RM-B250,8/16/2014,0,0,273,0,0,0,273
45084,RM-B250A,3/20/2014,273,0,0,0,0,0,273
45177,RM-B250A,6/22/2014,273,0,0,0,0,0,273
45179,RM-B250A,6/24/2014,273,0,0,0,0,0,273
45180,RM-B250A,6/25/2014,273,0,0,0,0,0,273
45232,RM-B250A,8/16/2014,273,0,0,0,0,0,273
45917,RM-B260,8/16/2014,273,0,0,0,0,0,273
47806,RM-B275,3/20/2014,0,0,0,0,0,273,273
2754,RM-1106,8/30/2013,135,0,0,0,0,135,270
7526,RM-1116,8/30/2013,0,0,135,0,0,135,270
8214,RM-1117,8/30/2013,135,0,0,0,0,135,270
9465,RM-1122,3/29/2015,0,0,270,0,0,0,270
18751,RM-1155,8/30/2013,135,0,135,0,0,0,270
22886,RM-1207,1/26/2014,135,0,0,0,0,135,270
23430,RM-1208,8/30/2013,135,0,0,0,0,135,270
30277,RM-1229,8/30/2013,135,0,135,0,0,0,270
32304,RM-1236,8/30/2013,135,0,135,0,0,0,270
36849,RM-B200C,8/30/2013,0,0,135,0,0,135,270
38225,RM-B215,8/30/2013,135,0,0,0,0,135,270
39200,RM-B220,6/24/2014,270,0,0,0,0,0,270
39598,RM-B222,8/30/2013,135,0,135,0,0,0,270
41949,RM-B230,6/24/2014,270,0,0,0,0,0,270
47612,RM-B275,8/30/2013,0,0,135,0,0,135,270
5784,RM-1110,6/23/2014,0,0,267,0,0,0,267
6314,RM-1113,1/19/2014,0,0,267,0,0,0,267
6469,RM-1113,6/23/2014,0,0,267,0,0,0,267
7660,RM-1116,1/19/2014,267,0,0,0,0,0,267
14370,RM-1134,6/23/2014,267,0,0,0,0,0,267
15485,RM-1144,1/19/2014,0,0,267,0,0,0,267
15640,RM-1144,6/23/2014,0,0,267,0,0,0,267
16298,RM-1145,6/23/2014,0,0,267,0,0,0,267
19040,RM-1155,6/23/2014,267,0,0,0,0,0,267
19561,RM-1156,1/19/2014,267,0,0,0,0,0,267
23034,RM-1207,6/23/2014,267,0,0,0,0,0,267
25092,RM-1212,6/23/2014,267,0,0,0,0,0,267
26447,RM-1213A,6/23/2014,0,0,267,0,0,0,267
28508,RM-1221,6/23/2014,0,0,267,0,0,0,267
29193,RM-1223,6/23/2014,267,0,0,0,0,0,267
32438,RM-1236,1/19/2014,0,0,267,0,0,0,267
36665,RM-B200B,1/23/2015,0,0,267,0,0,0,267
37138,RM-B200C,6/23/2014,267,0,0,0,0,0,267
39044,RM-B220,1/19/2014,267,0,0,0,0,0,267
39199,RM-B220,6/23/2014,267,0,0,0,0,0,267
41948,RM-B230,6/23/2014,267,0,0,0,0,0,267
43199,RM-B240,6/23/2014,0,0,267,0,0,0,267
44339,RM-B250,1/19/2014,0,0,267,0,0,0,267
45178,RM-B250A,6/23/2014,267,0,0,0,0,0,267
4945,RM-1109,1/19/2014,0,0,0,0,0,264,264
6973,RM-1115,1/19/2014,0,0,0,0,0,264,264
9033,RM-1122,1/19/2014,0,0,0,0,0,264,264
10403,RM-1124,1/19/2014,0,0,0,0,0,264,264
16170,RM-1145,1/19/2014,0,0,0,0,0,264,264
25607,RM-1213,1/19/2014,0,0,0,0,0,264,264
31748,RM-1231,1/19/2014,0,0,0,0,0,264,264
40420,RM-B224,1/19/2014,0,0,0,0,0,264,264
41108,RM-B225,1/19/2014,0,0,0,0,0,264,264
42478,RM-B230A,1/19/2014,0,0,0,0,0,264,264
7094,RM-1115,5/20/2014,261,0,0,0,0,0,261
6472,RM-1113,6/26/2014,0,0,258,0,0,0,258
15643,RM-1144,6/26/2014,0,0,258,0,0,0,258
16301,RM-1145,6/26/2014,0,0,258,0,0,0,258
26450,RM-1213A,6/26/2014,0,0,258,0,0,0,258
28511,RM-1221,6/26/2014,0,0,258,0,0,0,258
43202,RM-B240,6/26/2014,0,0,258,0,0,0,258
4946,RM-1109,1/20/2014,0,0,0,0,0,249,249
6315,RM-1113,1/20/2014,0,0,249,0,0,0,249
6974,RM-1115,1/20/2014,0,0,0,0,0,249,249
7661,RM-1116,1/20/2014,249,0,0,0,0,0,249
9034,RM-1122,1/20/2014,0,0,0,0,0,249,249
10404,RM-1124,1/20/2014,0,0,0,0,0,249,249
15486,RM-1144,1/20/2014,0,0,249,0,0,0,249
16171,RM-1145,1/20/2014,0,0,0,0,0,249,249
19562,RM-1156,1/20/2014,249,0,0,0,0,0,249
25608,RM-1213,1/20/2014,0,0,0,0,0,249,249
31749,RM-1231,1/20/2014,0,0,0,0,0,249,249
32439,RM-1236,1/20/2014,0,0,249,0,0,0,249
38367,RM-B215,1/27/2014,0,0,138,0,0,111,249
39045,RM-B220,1/20/2014,249,0,0,0,0,0,249
40421,RM-B224,1/20/2014,0,0,0,0,0,249,249
41109,RM-B225,1/20/2014,0,0,0,0,0,249,249
42479,RM-B230A,1/20/2014,0,0,0,0,0,249,249
44340,RM-B250,1/20/2014,0,0,249,0,0,0,249
4949,RM-1109,1/23/2014,0,0,0,0,0,243,243
6977,RM-1115,1/23/2014,0,0,0,0,0,243,243
9037,RM-1122,1/23/2014,0,0,0,0,0,243,243
10407,RM-1124,1/23/2014,0,0,0,0,0,243,243
16174,RM-1145,1/23/2014,0,0,0,0,0,243,243
25611,RM-1213,1/23/2014,0,0,0,0,0,243,243
31752,RM-1231,1/23/2014,0,0,0,0,0,243,243
40424,RM-B224,1/23/2014,0,0,0,0,0,243,243
41112,RM-B225,1/23/2014,0,0,0,0,0,243,243
42482,RM-B230A,1/23/2014,0,0,0,0,0,243,243
6318,RM-1113,1/23/2014,0,0,240,0,0,0,240
7664,RM-1116,1/23/2014,240,0,0,0,0,0,240
15489,RM-1144,1/23/2014,0,0,240,0,0,0,240
19565,RM-1156,1/23/2014,240,0,0,0,0,0,240
26296,RM-1213A,1/23/2014,0,0,240,0,0,0,240
32442,RM-1236,1/23/2014,0,0,240,0,0,0,240
39048,RM-B220,1/23/2014,240,0,0,0,0,0,240
44343,RM-B250,1/23/2014,0,0,240,0,0,0,240
47014,RM-B270,11/13/2013,0,0,240,0,0,0,240
37141,RM-B200C,6/26/2014,234,0,0,0,0,0,234
37156,RM-B200C,7/11/2014,234,0,0,0,0,0,234
39217,RM-B220,7/11/2014,234,0,0,0,0,0,234
17799,RM-1151,11/4/2014,231,0,0,0,0,0,231
19043,RM-1155,6/26/2014,231,0,0,0,0,0,231
39202,RM-B220,6/26/2014,231,0,0,0,0,0,231
41951,RM-B230,6/26/2014,231,0,0,0,0,0,231
41966,RM-B230,7/11/2014,231,0,0,0,0,0,231
45181,RM-B250A,6/26/2014,231,0,0,0,0,0,231
364,RM-1100A,7/10/2014,228,0,0,0,0,0,228
1734,RM-1102,7/10/2014,228,0,0,0,0,0,228
5787,RM-1110,6/26/2014,0,0,228,0,0,0,228
5801,RM-1110,7/10/2014,0,0,228,0,0,0,228
6486,RM-1113,7/10/2014,0,0,228,0,0,0,228
9890,RM-1123,7/10/2014,228,0,0,0,0,0,228
13180,RM-1132,7/10/2014,0,0,228,0,0,0,228
14373,RM-1134,6/26/2014,228,0,0,0,0,0,228
14387,RM-1134,7/10/2014,228,0,0,0,0,0,228
15657,RM-1144,7/10/2014,0,0,228,0,0,0,228
16315,RM-1145,7/10/2014,0,0,228,0,0,0,228
17684,RM-1151,7/10/2014,228,0,0,0,0,0,228
19057,RM-1155,7/10/2014,228,0,0,0,0,0,228
23037,RM-1207,6/26/2014,228,0,0,0,0,0,228
23051,RM-1207,7/10/2014,228,0,0,0,0,0,228
23736,RM-1208,7/10/2014,228,0,0,0,0,0,228
25095,RM-1212,6/26/2014,228,0,0,0,0,0,228
25109,RM-1212,7/10/2014,228,0,0,0,0,0,228
26464,RM-1213A,7/10/2014,0,0,228,0,0,0,228
27149,RM-1217,7/10/2014,228,0,0,0,0,0,228
28525,RM-1221,7/10/2014,0,0,228,0,0,0,228
29196,RM-1223,6/26/2014,228,0,0,0,0,0,228
29210,RM-1223,7/10/2014,228,0,0,0,0,0,228
30061,RM-1224,12/25/2014,228,0,0,0,0,0,228
30583,RM-1229,7/10/2014,0,0,228,0,0,0,228
32610,RM-1236,7/10/2014,0,0,228,0,0,0,228
36474,RM-B200B,7/10/2014,0,0,228,0,0,0,228
37155,RM-B200C,7/10/2014,228,0,0,0,0,0,228
39216,RM-B220,7/10/2014,228,0,0,0,0,0,228
39904,RM-B222,7/10/2014,228,0,0,0,0,0,228
41965,RM-B230,7/10/2014,228,0,0,0,0,0,228
43216,RM-B240,7/10/2014,0,0,228,0,0,0,228
44511,RM-B250,7/10/2014,0,0,228,0,0,0,228
45195,RM-B250A,7/10/2014,228,0,0,0,0,0,228
45880,RM-B260,7/10/2014,228,0,0,0,0,0,228
45881,RM-B260,7/11/2014,228,0,0,0,0,0,228
360,RM-1100A,7/6/2014,225,0,0,0,0,0,225
363,RM-1100A,7/9/2014,225,0,0,0,0,0,225
1730,RM-1102,7/6/2014,225,0,0,0,0,0,225
1733,RM-1102,7/9/2014,225,0,0,0,0,0,225
5792,RM-1110,7/1/2014,0,0,225,0,0,0,225
5793,RM-1110,7/2/2014,0,0,225,0,0,0,225
5797,RM-1110,7/6/2014,0,0,225,0,0,0,225
5800,RM-1110,7/9/2014,0,0,225,0,0,0,225
6478,RM-1113,7/2/2014,0,0,225,0,0,0,225
6482,RM-1113,7/6/2014,0,0,225,0,0,0,225
6485,RM-1113,7/9/2014,0,0,225,0,0,0,225
9886,RM-1123,7/6/2014,225,0,0,0,0,0,225
9889,RM-1123,7/9/2014,225,0,0,0,0,0,225
13176,RM-1132,7/6/2014,0,0,225,0,0,0,225
13179,RM-1132,7/9/2014,0,0,225,0,0,0,225
14379,RM-1134,7/2/2014,225,0,0,0,0,0,225
14383,RM-1134,7/6/2014,225,0,0,0,0,0,225
14386,RM-1134,7/9/2014,225,0,0,0,0,0,225
15649,RM-1144,7/2/2014,0,0,225,0,0,0,225
15653,RM-1144,7/6/2014,0,0,225,0,0,0,225
15656,RM-1144,7/9/2014,0,0,225,0,0,0,225
16306,RM-1145,7/1/2014,0,0,225,0,0,0,225
16307,RM-1145,7/2/2014,0,0,225,0,0,0,225
16311,RM-1145,7/6/2014,0,0,225,0,0,0,225
16314,RM-1145,7/9/2014,0,0,225,0,0,0,225
17680,RM-1151,7/6/2014,225,0,0,0,0,0,225
17683,RM-1151,7/9/2014,225,0,0,0,0,0,225
19048,RM-1155,7/1/2014,225,0,0,0,0,0,225
19049,RM-1155,7/2/2014,225,0,0,0,0,0,225
19053,RM-1155,7/6/2014,225,0,0,0,0,0,225
19056,RM-1155,7/9/2014,225,0,0,0,0,0,225
23043,RM-1207,7/2/2014,225,0,0,0,0,0,225
23047,RM-1207,7/6/2014,225,0,0,0,0,0,225
23050,RM-1207,7/9/2014,225,0,0,0,0,0,225
23732,RM-1208,7/6/2014,225,0,0,0,0,0,225
23735,RM-1208,7/9/2014,225,0,0,0,0,0,225
25101,RM-1212,7/2/2014,225,0,0,0,0,0,225
25105,RM-1212,7/6/2014,225,0,0,0,0,0,225
25108,RM-1212,7/9/2014,225,0,0,0,0,0,225
26456,RM-1213A,7/2/2014,0,0,225,0,0,0,225
26460,RM-1213A,7/6/2014,0,0,225,0,0,0,225
26463,RM-1213A,7/9/2014,0,0,225,0,0,0,225
27145,RM-1217,7/6/2014,225,0,0,0,0,0,225
27148,RM-1217,7/9/2014,225,0,0,0,0,0,225
28517,RM-1221,7/2/2014,0,0,225,0,0,0,225
28521,RM-1221,7/6/2014,0,0,225,0,0,0,225
28524,RM-1221,7/9/2014,0,0,225,0,0,0,225
29202,RM-1223,7/2/2014,225,0,0,0,0,0,225
29206,RM-1223,7/6/2014,225,0,0,0,0,0,225
29209,RM-1223,7/9/2014,225,0,0,0,0,0,225
30579,RM-1229,7/6/2014,0,0,225,0,0,0,225
30582,RM-1229,7/9/2014,0,0,225,0,0,0,225
32606,RM-1236,7/6/2014,0,0,225,0,0,0,225
32609,RM-1236,7/9/2014,0,0,225,0,0,0,225
36470,RM-B200B,7/6/2014,0,0,225,0,0,0,225
36473,RM-B200B,7/9/2014,0,0,225,0,0,0,225
37146,RM-B200C,7/1/2014,225,0,0,0,0,0,225
37147,RM-B200C,7/2/2014,225,0,0,0,0,0,225
37151,RM-B200C,7/6/2014,225,0,0,0,0,0,225
37154,RM-B200C,7/9/2014,225,0,0,0,0,0,225
39207,RM-B220,7/1/2014,225,0,0,0,0,0,225
39208,RM-B220,7/2/2014,225,0,0,0,0,0,225
39212,RM-B220,7/6/2014,225,0,0,0,0,0,225
39215,RM-B220,7/9/2014,225,0,0,0,0,0,225
39900,RM-B222,7/6/2014,225,0,0,0,0,0,225
39903,RM-B222,7/9/2014,225,0,0,0,0,0,225
41956,RM-B230,7/1/2014,225,0,0,0,0,0,225
41957,RM-B230,7/2/2014,225,0,0,0,0,0,225
41961,RM-B230,7/6/2014,225,0,0,0,0,0,225
41964,RM-B230,7/9/2014,225,0,0,0,0,0,225
43207,RM-B240,7/1/2014,0,0,225,0,0,0,225
43208,RM-B240,7/2/2014,0,0,225,0,0,0,225
43212,RM-B240,7/6/2014,0,0,225,0,0,0,225
43215,RM-B240,7/9/2014,0,0,225,0,0,0,225
43217,RM-B240,7/11/2014,0,0,225,0,0,0,225
44507,RM-B250,7/6/2014,0,0,225,0,0,0,225
44510,RM-B250,7/9/2014,0,0,225,0,0,0,225
44512,RM-B250,7/11/2014,0,0,225,0,0,0,225
45186,RM-B250A,7/1/2014,225,0,0,0,0,0,225
45187,RM-B250A,7/2/2014,225,0,0,0,0,0,225
45191,RM-B250A,7/6/2014,225,0,0,0,0,0,225
45194,RM-B250A,7/9/2014,225,0,0,0,0,0,225
45876,RM-B260,7/6/2014,225,0,0,0,0,0,225
45879,RM-B260,7/9/2014,225,0,0,0,0,0,225
359,RM-1100A,7/5/2014,222,0,0,0,0,0,222
1729,RM-1102,7/5/2014,222,0,0,0,0,0,222
5796,RM-1110,7/5/2014,0,0,222,0,0,0,222
6477,RM-1113,7/1/2014,0,0,222,0,0,0,222
6481,RM-1113,7/5/2014,0,0,222,0,0,0,222
9885,RM-1123,7/5/2014,222,0,0,0,0,0,222
13175,RM-1132,7/5/2014,0,0,222,0,0,0,222
14378,RM-1134,7/1/2014,222,0,0,0,0,0,222
14382,RM-1134,7/5/2014,222,0,0,0,0,0,222
15648,RM-1144,7/1/2014,0,0,222,0,0,0,222
15652,RM-1144,7/5/2014,0,0,222,0,0,0,222
16310,RM-1145,7/5/2014,0,0,222,0,0,0,222
17679,RM-1151,7/5/2014,222,0,0,0,0,0,222
19052,RM-1155,7/5/2014,222,0,0,0,0,0,222
23042,RM-1207,7/1/2014,222,0,0,0,0,0,222
23046,RM-1207,7/5/2014,222,0,0,0,0,0,222
23731,RM-1208,7/5/2014,222,0,0,0,0,0,222
25100,RM-1212,7/1/2014,222,0,0,0,0,0,222
25104,RM-1212,7/5/2014,222,0,0,0,0,0,222
26455,RM-1213A,7/1/2014,0,0,222,0,0,0,222
26459,RM-1213A,7/5/2014,0,0,222,0,0,0,222
27144,RM-1217,7/5/2014,222,0,0,0,0,0,222
28516,RM-1221,7/1/2014,0,0,222,0,0,0,222
28520,RM-1221,7/5/2014,0,0,222,0,0,0,222
29201,RM-1223,7/1/2014,222,0,0,0,0,0,222
29205,RM-1223,7/5/2014,222,0,0,0,0,0,222
30578,RM-1229,7/5/2014,0,0,222,0,0,0,222
32605,RM-1236,7/5/2014,0,0,222,0,0,0,222
36469,RM-B200B,7/5/2014,0,0,222,0,0,0,222
37150,RM-B200C,7/5/2014,222,0,0,0,0,0,222
39211,RM-B220,7/5/2014,222,0,0,0,0,0,222
39899,RM-B222,7/5/2014,222,0,0,0,0,0,222
41960,RM-B230,7/5/2014,222,0,0,0,0,0,222
43211,RM-B240,7/5/2014,0,0,222,0,0,0,222
44506,RM-B250,7/5/2014,0,0,222,0,0,0,222
45190,RM-B250A,7/5/2014,222,0,0,0,0,0,222
45196,RM-B250A,7/11/2014,222,0,0,0,0,0,222
45875,RM-B260,7/5/2014,222,0,0,0,0,0,222
365,RM-1100A,7/11/2014,219,0,0,0,0,0,219
1735,RM-1102,7/11/2014,219,0,0,0,0,0,219
4950,RM-1109,1/24/2014,0,0,0,0,0,219,219
5802,RM-1110,7/11/2014,0,0,219,0,0,0,219
6317,RM-1113,1/22/2014,0,0,219,0,0,0,219
6319,RM-1113,1/24/2014,0,0,219,0,0,0,219
6487,RM-1113,7/11/2014,0,0,219,0,0,0,219
6978,RM-1115,1/24/2014,0,0,0,0,0,219,219
7665,RM-1116,1/24/2014,219,0,0,0,0,0,219
9038,RM-1122,1/24/2014,0,0,0,0,0,219,219
9891,RM-1123,7/11/2014,219,0,0,0,0,0,219
10408,RM-1124,1/24/2014,0,0,0,0,0,219,219
13181,RM-1132,7/11/2014,0,0,219,0,0,0,219
14388,RM-1134,7/11/2014,219,0,0,0,0,0,219
15488,RM-1144,1/22/2014,0,0,219,0,0,0,219
15490,RM-1144,1/24/2014,0,0,219,0,0,0,219
15658,RM-1144,7/11/2014,0,0,219,0,0,0,219
16175,RM-1145,1/24/2014,0,0,0,0,0,219,219
16316,RM-1145,7/11/2014,0,0,219,0,0,0,219
17685,RM-1151,7/11/2014,219,0,0,0,0,0,219
19058,RM-1155,7/11/2014,219,0,0,0,0,0,219
19566,RM-1156,1/24/2014,219,0,0,0,0,0,219
23052,RM-1207,7/11/2014,219,0,0,0,0,0,219
23737,RM-1208,7/11/2014,219,0,0,0,0,0,219
25110,RM-1212,7/11/2014,219,0,0,0,0,0,219
25612,RM-1213,1/24/2014,0,0,0,0,0,219,219
26295,RM-1213A,1/22/2014,0,0,219,0,0,0,219
26297,RM-1213A,1/24/2014,0,0,219,0,0,0,219
26465,RM-1213A,7/11/2014,0,0,219,0,0,0,219
27150,RM-1217,7/11/2014,219,0,0,0,0,0,219
28526,RM-1221,7/11/2014,0,0,219,0,0,0,219
29211,RM-1223,7/11/2014,219,0,0,0,0,0,219
30584,RM-1229,7/11/2014,0,0,219,0,0,0,219
31753,RM-1231,1/24/2014,0,0,0,0,0,219,219
32441,RM-1236,1/22/2014,0,0,219,0,0,0,219
32443,RM-1236,1/24/2014,0,0,219,0,0,0,219
32611,RM-1236,7/11/2014,0,0,219,0,0,0,219
36475,RM-B200B,7/11/2014,0,0,219,0,0,0,219
39049,RM-B220,1/24/2014,219,0,0,0,0,0,219
39905,RM-B222,7/11/2014,219,0,0,0,0,0,219
40425,RM-B224,1/24/2014,0,0,0,0,0,219,219
41113,RM-B225,1/24/2014,0,0,0,0,0,219,219
42483,RM-B230A,1/24/2014,0,0,0,0,0,219,219
44342,RM-B250,1/22/2014,0,0,219,0,0,0,219
44344,RM-B250,1/24/2014,0,0,219,0,0,0,219
361,RM-1100A,7/7/2014,216,0,0,0,0,0,216
1731,RM-1102,7/7/2014,216,0,0,0,0,0,216
4948,RM-1109,1/22/2014,0,0,0,0,0,216,216
5798,RM-1110,7/7/2014,0,0,216,0,0,0,216
6483,RM-1113,7/7/2014,0,0,216,0,0,0,216
6976,RM-1115,1/22/2014,0,0,0,0,0,216,216
7663,RM-1116,1/22/2014,216,0,0,0,0,0,216
9036,RM-1122,1/22/2014,0,0,0,0,0,216,216
9887,RM-1123,7/7/2014,216,0,0,0,0,0,216
10406,RM-1124,1/22/2014,0,0,0,0,0,216,216
13177,RM-1132,7/7/2014,0,0,216,0,0,0,216
14384,RM-1134,7/7/2014,216,0,0,0,0,0,216
15654,RM-1144,7/7/2014,0,0,216,0,0,0,216
16173,RM-1145,1/22/2014,0,0,0,0,0,216,216
16312,RM-1145,7/7/2014,0,0,216,0,0,0,216
17681,RM-1151,7/7/2014,216,0,0,0,0,0,216
19054,RM-1155,7/7/2014,216,0,0,0,0,0,216
19564,RM-1156,1/22/2014,216,0,0,0,0,0,216
20867,RM-1200B,1/8/2014,0,72,0,144,0,0,216
23048,RM-1207,7/7/2014,216,0,0,0,0,0,216
23733,RM-1208,7/7/2014,216,0,0,0,0,0,216
25106,RM-1212,7/7/2014,216,0,0,0,0,0,216
25610,RM-1213,1/22/2014,0,0,0,0,0,216,216
26461,RM-1213A,7/7/2014,0,0,216,0,0,0,216
27146,RM-1217,7/7/2014,216,0,0,0,0,0,216
28522,RM-1221,7/7/2014,0,0,216,0,0,0,216
29207,RM-1223,7/7/2014,216,0,0,0,0,0,216
29712,RM-1224,1/8/2014,0,72,0,144,0,0,216
30580,RM-1229,7/7/2014,0,0,216,0,0,0,216
31751,RM-1231,1/22/2014,0,0,0,0,0,216,216
32607,RM-1236,7/7/2014,0,0,216,0,0,0,216
36471,RM-B200B,7/7/2014,0,0,216,0,0,0,216
37152,RM-B200C,7/7/2014,216,0,0,0,0,0,216
38781,RM-B215,3/19/2015,216,0,0,0,0,0,216
39047,RM-B220,1/22/2014,216,0,0,0,0,0,216
39213,RM-B220,7/7/2014,216,0,0,0,0,0,216
39901,RM-B222,7/7/2014,216,0,0,0,0,0,216
40423,RM-B224,1/22/2014,0,0,0,0,0,216,216
41111,RM-B225,1/22/2014,0,0,0,0,0,216,216
41962,RM-B230,7/7/2014,216,0,0,0,0,0,216
42481,RM-B230A,1/22/2014,0,0,0,0,0,216,216
43213,RM-B240,7/7/2014,0,0,216,0,0,0,216
44508,RM-B250,7/7/2014,0,0,216,0,0,0,216
45192,RM-B250A,7/7/2014,216,0,0,0,0,0,216
45877,RM-B260,7/7/2014,216,0,0,0,0,0,216
6320,RM-1113,1/25/2014,0,0,213,0,0,0,213
6474,RM-1113,6/28/2014,0,0,213,0,0,0,213
7666,RM-1116,1/25/2014,213,0,0,0,0,0,213
15491,RM-1144,1/25/2014,0,0,213,0,0,0,213
15645,RM-1144,6/28/2014,0,0,213,0,0,0,213
16303,RM-1145,6/28/2014,0,0,213,0,0,0,213
19567,RM-1156,1/25/2014,213,0,0,0,0,0,213
26298,RM-1213A,1/25/2014,0,0,213,0,0,0,213
26452,RM-1213A,6/28/2014,0,0,213,0,0,0,213
28513,RM-1221,6/28/2014,0,0,213,0,0,0,213
32444,RM-1236,1/25/2014,0,0,213,0,0,0,213
39050,RM-B220,1/25/2014,213,0,0,0,0,0,213
43204,RM-B240,6/28/2014,0,0,213,0,0,0,213
44345,RM-B250,1/25/2014,0,0,213,0,0,0,213
4951,RM-1109,1/25/2014,0,0,0,0,0,210,210
5789,RM-1110,6/28/2014,0,0,210,0,0,0,210
6979,RM-1115,1/25/2014,0,0,0,0,0,210,210
9039,RM-1122,1/25/2014,0,0,0,0,0,210,210
10409,RM-1124,1/25/2014,0,0,0,0,0,210,210
14375,RM-1134,6/28/2014,210,0,0,0,0,0,210
16176,RM-1145,1/25/2014,0,0,0,0,0,210,210
19045,RM-1155,6/28/2014,210,0,0,0,0,0,210
23039,RM-1207,6/28/2014,210,0,0,0,0,0,210
25097,RM-1212,6/28/2014,210,0,0,0,0,0,210
25613,RM-1213,1/25/2014,0,0,0,0,0,210,210
29198,RM-1223,6/28/2014,210,0,0,0,0,0,210
31754,RM-1231,1/25/2014,0,0,0,0,0,210,210
37143,RM-B200C,6/28/2014,210,0,0,0,0,0,210
39204,RM-B220,6/28/2014,210,0,0,0,0,0,210
40426,RM-B224,1/25/2014,0,0,0,0,0,210,210
41114,RM-B225,1/25/2014,0,0,0,0,0,210,210
41953,RM-B230,6/28/2014,210,0,0,0,0,0,210
42484,RM-B230A,1/25/2014,0,0,0,0,0,210,210
45183,RM-B250A,6/28/2014,210,0,0,0,0,0,210
6309,RM-1113,1/14/2014,0,0,204,0,0,0,204
8343,RM-1117,1/14/2014,0,0,204,0,0,0,204
9713,RM-1123,1/14/2014,0,0,204,0,0,0,204
13688,RM-1133,1/14/2014,0,0,204,0,0,0,204
15480,RM-1144,1/14/2014,0,0,204,0,0,0,204
24247,RM-1208B,1/14/2014,0,0,204,0,0,0,204
24418,RM-1208B,7/4/2014,102,0,102,0,0,0,204
32433,RM-1236,1/14/2014,0,0,204,0,0,0,204
35781,RM-B109,7/4/2014,102,0,102,0,0,0,204
41788,RM-B230,1/14/2014,0,0,204,0,0,0,204
44334,RM-B250,1/14/2014,0,0,204,0,0,0,204
2883,RM-1106,1/14/2014,0,0,0,0,0,201,201
4940,RM-1109,1/14/2014,0,0,0,0,0,201,201
6968,RM-1115,1/14/2014,0,0,0,0,0,201,201
7655,RM-1116,1/14/2014,201,0,0,0,0,0,201
9028,RM-1122,1/14/2014,0,0,0,0,0,201,201
10398,RM-1124,1/14/2014,0,0,0,0,0,201,201
13003,RM-1132,1/14/2014,0,0,201,0,0,0,201
16165,RM-1145,1/14/2014,0,0,0,0,0,201,201
19556,RM-1156,1/14/2014,201,0,0,0,0,0,201
25602,RM-1213,1/14/2014,0,0,0,0,0,201,201
26972,RM-1217,1/14/2014,201,0,0,0,0,0,201
30282,RM-1229,9/9/2013,66,0,69,0,0,66,201
31743,RM-1231,1/14/2014,0,0,0,0,0,201,201
36297,RM-B200B,1/14/2014,0,0,0,0,0,201,201
39039,RM-B220,1/14/2014,201,0,0,0,0,0,201
39727,RM-B222,1/14/2014,201,0,0,0,0,0,201
40415,RM-B224,1/14/2014,0,0,0,0,0,201,201
41103,RM-B225,1/14/2014,0,0,0,0,0,201,201
42473,RM-B230A,1/14/2014,0,0,0,0,0,201,201
43904,RM-B240A,9/28/2014,0,0,201,0,0,0,201
47741,RM-B275,1/14/2014,0,0,0,0,0,201,201
442,RM-1100A,9/28/2014,198,0,0,0,0,0,198
1812,RM-1102,9/28/2014,198,0,0,0,0,0,198
2238,RM-1104,1/10/2014,0,198,0,0,0,0,198
5879,RM-1110,9/28/2014,0,0,198,0,0,0,198
6564,RM-1113,9/28/2014,0,0,198,0,0,0,198
9968,RM-1123,9/28/2014,198,0,0,0,0,0,198
12570,RM-1130,9/28/2014,0,0,198,0,0,0,198
13258,RM-1132,9/28/2014,0,0,198,0,0,0,198
14465,RM-1134,9/28/2014,198,0,0,0,0,0,198
15735,RM-1144,9/28/2014,0,0,198,0,0,0,198
16393,RM-1145,9/28/2014,0,0,198,0,0,0,198
17762,RM-1151,9/28/2014,198,0,0,0,0,0,198
19135,RM-1155,9/28/2014,198,0,0,0,0,0,198
19811,RM-1156,9/28/2014,0,0,198,0,0,0,198
21554,RM-1200C,1/10/2014,0,198,0,0,0,0,198
24502,RM-1208B,9/28/2014,198,0,0,0,0,0,198
25187,RM-1212,9/28/2014,198,0,0,0,0,0,198
26293,RM-1213A,1/20/2014,0,0,198,0,0,0,198
28603,RM-1221,9/28/2014,0,0,198,0,0,0,198
29288,RM-1223,9/28/2014,198,0,0,0,0,0,198
30661,RM-1229,9/28/2014,0,0,198,0,0,0,198
31054,RM-1230,1/10/2014,0,198,0,0,0,0,198
32688,RM-1236,9/28/2014,198,0,0,0,0,0,198
35606,RM-B109,1/10/2014,0,198,0,0,0,0,198
36552,RM-B200B,9/28/2014,0,0,198,0,0,0,198
37233,RM-B200C,9/28/2014,198,0,0,0,0,0,198
39982,RM-B222,9/28/2014,198,0,0,0,0,0,198
42043,RM-B230,9/28/2014,198,0,0,0,0,0,198
43294,RM-B240,9/28/2014,0,0,198,0,0,0,198
43720,RM-B240A,1/10/2014,0,198,0,0,0,0,198
44589,RM-B250,9/28/2014,0,0,198,0,0,0,198
45273,RM-B250A,9/28/2014,198,0,0,0,0,0,198
3436,RM-1107,8/27/2013,0,0,195,0,0,0,195
6177,RM-1113,8/27/2013,0,0,195,0,0,0,195
8896,RM-1122,8/27/2013,0,0,195,0,0,0,195
9581,RM-1123,8/27/2013,0,0,195,0,0,0,195
13556,RM-1133,8/27/2013,0,0,195,0,0,0,195
25470,RM-1213,8/27/2013,0,0,195,0,0,0,195
33526,RM-4xxx,9/28/2014,0,0,0,0,195,0,195
33713,RM-B102C,8/27/2013,0,0,195,0,0,0,195
46941,RM-B270,8/27/2013,0,0,195,0,0,0,195
12184,RM-1130,8/27/2013,0,0,0,0,0,192,192
15348,RM-1144,8/27/2013,0,0,0,0,0,192,192
18060,RM-1154,8/27/2013,192,0,0,0,0,0,192
20741,RM-1200B,8/27/2013,0,0,0,0,0,192,192
26840,RM-1217,8/27/2013,192,0,0,0,0,0,192
31611,RM-1231,8/27/2013,0,0,0,0,0,192,192
34378,RM-B103,1/10/2014,0,0,0,192,0,0,192
34929,RM-B103A,8/27/2013,0,0,0,0,0,192,192
40971,RM-B225,8/27/2013,0,0,0,0,0,192,192
42341,RM-B230A,8/27/2013,0,0,0,0,0,192,192
43592,RM-B240A,8/27/2013,0,0,0,0,0,192,192
44202,RM-B250,8/27/2013,192,0,0,0,0,0,192
45699,RM-B260,1/10/2014,0,0,0,192,0,0,192
5788,RM-1110,6/27/2014,0,0,189,0,0,0,189
6473,RM-1113,6/27/2014,0,0,189,0,0,0,189
10311,RM-1124,10/16/2013,0,0,0,0,0,189,189
14374,RM-1134,6/27/2014,189,0,0,0,0,0,189
15644,RM-1144,6/27/2014,0,0,189,0,0,0,189
16302,RM-1145,6/27/2014,0,0,189,0,0,0,189
19044,RM-1155,6/27/2014,189,0,0,0,0,0,189
23038,RM-1207,6/27/2014,189,0,0,0,0,0,189
25096,RM-1212,6/27/2014,189,0,0,0,0,0,189
26451,RM-1213A,6/27/2014,0,0,189,0,0,0,189
28512,RM-1221,6/27/2014,0,0,189,0,0,0,189
29197,RM-1223,6/27/2014,189,0,0,0,0,0,189
37142,RM-B200C,6/27/2014,189,0,0,0,0,0,189
39203,RM-B220,6/27/2014,189,0,0,0,0,0,189
41952,RM-B230,6/27/2014,189,0,0,0,0,0,189
43203,RM-B240,6/27/2014,0,0,189,0,0,0,189
45182,RM-B250A,6/27/2014,189,0,0,0,0,0,189
9673,RM-1123,12/5/2013,0,0,186,0,0,0,186
13648,RM-1133,12/5/2013,0,0,186,0,0,0,186
24207,RM-1208B,12/5/2013,0,0,186,0,0,0,186
24892,RM-1212,12/5/2013,0,0,186,0,0,0,186
28308,RM-1221,12/5/2013,0,0,186,0,0,0,186
32393,RM-1236,12/5/2013,0,0,186,0,0,0,186
2843,RM-1106,12/5/2013,0,0,0,0,0,183,183
4900,RM-1109,12/5/2013,0,0,0,0,0,183,183
7472,RM-1116,7/2/2013,0,0,99,0,0,84,183
8988,RM-1122,12/5/2013,0,0,0,0,0,183,183
10358,RM-1124,12/5/2013,0,0,0,0,0,183,183
12276,RM-1130,12/5/2013,0,0,0,0,0,183,183
12963,RM-1132,12/5/2013,0,0,183,0,0,0,183
16125,RM-1145,12/5/2013,0,0,0,0,0,183,183
22834,RM-1207,12/5/2013,0,0,0,0,0,183,183
25562,RM-1213,12/5/2013,0,0,0,0,0,183,183
26932,RM-1217,12/5/2013,183,0,0,0,0,0,183
28635,RM-1221,10/30/2014,0,0,183,0,0,0,183
31703,RM-1231,12/5/2013,0,0,0,0,0,183,183
36257,RM-B200B,12/5/2013,0,0,0,0,0,183,183
36795,RM-B200C,7/2/2013,0,0,99,0,0,84,183
39687,RM-B222,12/5/2013,183,0,0,0,0,0,183
40232,RM-B224,7/2/2013,0,0,99,0,0,84,183
40375,RM-B224,12/5/2013,0,0,0,0,0,183,183
41063,RM-B225,12/5/2013,0,0,0,0,0,183,183
42433,RM-B230A,12/5/2013,0,0,0,0,0,183,183
44446,RM-B250,5/6/2014,0,72,9,102,0,0,183
47701,RM-B275,12/5/2013,0,0,0,0,0,183,183
357,RM-1100A,7/3/2014,180,0,0,0,0,0,180
1727,RM-1102,7/3/2014,180,0,0,0,0,0,180
4947,RM-1109,1/21/2014,0,0,0,0,0,180,180
5794,RM-1110,7/3/2014,0,0,180,0,0,0,180
6479,RM-1113,7/3/2014,0,0,180,0,0,0,180
6975,RM-1115,1/21/2014,0,0,0,0,0,180,180
7662,RM-1116,1/21/2014,180,0,0,0,0,0,180
9035,RM-1122,1/21/2014,0,0,0,0,0,180,180
10405,RM-1124,1/21/2014,0,0,0,0,0,180,180
13173,RM-1132,7/3/2014,0,0,180,0,0,0,180
14380,RM-1134,7/3/2014,180,0,0,0,0,0,180
15650,RM-1144,7/3/2014,0,0,180,0,0,0,180
16172,RM-1145,1/21/2014,0,0,0,0,0,180,180
16308,RM-1145,7/3/2014,0,0,180,0,0,0,180
17677,RM-1151,7/3/2014,180,0,0,0,0,0,180
19050,RM-1155,7/3/2014,180,0,0,0,0,0,180
19563,RM-1156,1/21/2014,180,0,0,0,0,0,180
23044,RM-1207,7/3/2014,180,0,0,0,0,0,180
23729,RM-1208,7/3/2014,180,0,0,0,0,0,180
25102,RM-1212,7/3/2014,180,0,0,0,0,0,180
25609,RM-1213,1/21/2014,0,0,0,0,0,180,180
26457,RM-1213A,7/3/2014,0,0,180,0,0,0,180
26821,RM-1217,8/4/2013,180,0,0,0,0,0,180
27142,RM-1217,7/3/2014,180,0,0,0,0,0,180
28518,RM-1221,7/3/2014,0,0,180,0,0,0,180
29203,RM-1223,7/3/2014,180,0,0,0,0,0,180
30576,RM-1229,7/3/2014,0,0,180,0,0,0,180
31750,RM-1231,1/21/2014,0,0,0,0,0,180,180
32603,RM-1236,7/3/2014,0,0,180,0,0,0,180
36467,RM-B200B,7/3/2014,0,0,180,0,0,0,180
37148,RM-B200C,7/3/2014,180,0,0,0,0,0,180
39046,RM-B220,1/21/2014,180,0,0,0,0,0,180
39209,RM-B220,7/3/2014,180,0,0,0,0,0,180
39897,RM-B222,7/3/2014,180,0,0,0,0,0,180
40422,RM-B224,1/21/2014,0,0,0,0,0,180,180
41110,RM-B225,1/21/2014,0,0,0,0,0,180,180
41958,RM-B230,7/3/2014,180,0,0,0,0,0,180
42480,RM-B230A,1/21/2014,0,0,0,0,0,180,180
43209,RM-B240,7/3/2014,0,0,180,0,0,0,180
44504,RM-B250,7/3/2014,0,0,180,0,0,0,180
45188,RM-B250A,7/3/2014,180,0,0,0,0,0,180
45873,RM-B260,7/3/2014,180,0,0,0,0,0,180
6316,RM-1113,1/21/2014,0,0,177,0,0,0,177
15487,RM-1144,1/21/2014,0,0,177,0,0,0,177
26294,RM-1213A,1/21/2014,0,0,177,0,0,0,177
32440,RM-1236,1/21/2014,0,0,177,0,0,0,177
44341,RM-B250,1/21/2014,0,0,177,0,0,0,177
4421,RM-1108,7/2/2014,0,162,0,0,0,0,162
8512,RM-1117,7/2/2014,0,162,0,0,0,0,162
13857,RM-1133,7/2/2014,0,162,0,0,0,0,162
21670,RM-1200C,5/6/2014,0,72,0,90,0,0,162
31227,RM-1230,7/2/2014,0,162,0,0,0,0,162
43893,RM-B240A,7/2/2014,0,162,0,0,0,0,162
5697,RM-1110,3/27/2014,0,0,159,0,0,0,159
362,RM-1100A,7/8/2014,153,0,0,0,0,0,153
1732,RM-1102,7/8/2014,153,0,0,0,0,0,153
5799,RM-1110,7/8/2014,0,0,153,0,0,0,153
6326,RM-1113,1/31/2014,0,0,153,0,0,0,153
6484,RM-1113,7/8/2014,0,0,153,0,0,0,153
9888,RM-1123,7/8/2014,153,0,0,0,0,0,153
13178,RM-1132,7/8/2014,0,0,153,0,0,0,153
14385,RM-1134,7/8/2014,153,0,0,0,0,0,153
15497,RM-1144,1/31/2014,0,0,153,0,0,0,153
15655,RM-1144,7/8/2014,0,0,153,0,0,0,153
16313,RM-1145,7/8/2014,0,0,153,0,0,0,153
17682,RM-1151,7/8/2014,153,0,0,0,0,0,153
19055,RM-1155,7/8/2014,153,0,0,0,0,0,153
23049,RM-1207,7/8/2014,153,0,0,0,0,0,153
23734,RM-1208,7/8/2014,153,0,0,0,0,0,153
25107,RM-1212,7/8/2014,153,0,0,0,0,0,153
26304,RM-1213A,1/31/2014,0,0,153,0,0,0,153
26462,RM-1213A,7/8/2014,0,0,153,0,0,0,153
27147,RM-1217,7/8/2014,153,0,0,0,0,0,153
28523,RM-1221,7/8/2014,0,0,153,0,0,0,153
29208,RM-1223,7/8/2014,153,0,0,0,0,0,153
30581,RM-1229,7/8/2014,0,0,153,0,0,0,153
32450,RM-1236,1/31/2014,0,0,153,0,0,0,153
32608,RM-1236,7/8/2014,0,0,153,0,0,0,153
36472,RM-B200B,7/8/2014,0,0,153,0,0,0,153
37153,RM-B200C,7/8/2014,153,0,0,0,0,0,153
38371,RM-B215,1/31/2014,0,0,153,0,0,0,153
39214,RM-B220,7/8/2014,153,0,0,0,0,0,153
39902,RM-B222,7/8/2014,153,0,0,0,0,0,153
41963,RM-B230,7/8/2014,153,0,0,0,0,0,153
43214,RM-B240,7/8/2014,0,0,153,0,0,0,153
44351,RM-B250,1/31/2014,0,0,153,0,0,0,153
44509,RM-B250,7/8/2014,0,0,153,0,0,0,153
45193,RM-B250A,7/8/2014,153,0,0,0,0,0,153
45878,RM-B260,7/8/2014,153,0,0,0,0,0,153
1041,RM-1100D,7/2/2014,0,0,0,150,0,0,150
4957,RM-1109,1/31/2014,0,0,0,0,0,150,150
6985,RM-1115,1/31/2014,0,0,0,0,0,150,150
7672,RM-1116,1/31/2014,150,0,0,0,0,0,150
9045,RM-1122,1/31/2014,0,0,0,0,0,150,150
10415,RM-1124,1/31/2014,0,0,0,0,0,150,150
16182,RM-1145,1/31/2014,0,0,0,0,0,150,150
18697,RM-1155,7/2/2013,51,0,99,0,0,0,150
19573,RM-1156,1/31/2014,150,0,0,0,0,0,150
21727,RM-1200C,7/2/2014,0,0,0,150,0,0,150
25619,RM-1213,1/31/2014,0,0,0,0,0,150,150
27829,RM-1218,7/2/2014,0,0,0,150,0,0,150
29887,RM-1224,7/2/2014,0,0,0,150,0,0,150
31760,RM-1231,1/31/2014,0,0,0,0,0,150,150
34550,RM-B103,7/2/2014,0,0,0,150,0,0,150
35230,RM-B103A,7/2/2014,0,0,0,150,0,0,150
39056,RM-B220,1/31/2014,150,0,0,0,0,0,150
40432,RM-B224,1/31/2014,0,0,0,0,0,150,150
41120,RM-B225,1/31/2014,0,0,0,0,0,150,150
42490,RM-B230A,1/31/2014,0,0,0,0,0,150,150
47242,RM-B270,7/2/2014,0,0,0,150,0,0,150
3052,RM-1106,7/2/2014,0,0,0,144,0,0,144
16991,RM-1150,7/2/2014,0,0,0,144,0,0,144
32250,RM-1236,7/2/2013,45,0,99,0,0,0,144
34376,RM-B103,1/8/2014,0,0,0,144,0,0,144
45697,RM-B260,1/8/2014,0,0,0,144,0,0,144
48051,RM-B275,11/22/2014,144,0,0,0,0,0,144
29135,RM-1223,4/26/2014,141,0,0,0,0,0,141
4953,RM-1109,1/27/2014,0,0,0,0,0,138,138
6321,RM-1113,1/26/2014,0,0,138,0,0,0,138
6322,RM-1113,1/27/2014,0,0,138,0,0,0,138
6960,RM-1115,1/6/2014,0,0,0,0,0,138,138
6981,RM-1115,1/27/2014,0,0,0,0,0,138,138
7668,RM-1116,1/27/2014,138,0,0,0,0,0,138
9041,RM-1122,1/27/2014,0,0,0,0,0,138,138
10411,RM-1124,1/27/2014,0,0,0,0,0,138,138
15492,RM-1144,1/26/2014,0,0,138,0,0,0,138
15493,RM-1144,1/27/2014,0,0,138,0,0,0,138
16178,RM-1145,1/27/2014,0,0,0,0,0,138,138
19569,RM-1156,1/27/2014,138,0,0,0,0,0,138
25615,RM-1213,1/27/2014,0,0,0,0,0,138,138
26299,RM-1213A,1/26/2014,0,0,138,0,0,0,138
26300,RM-1213A,1/27/2014,0,0,138,0,0,0,138
31756,RM-1231,1/27/2014,0,0,0,0,0,138,138
32445,RM-1236,1/26/2014,0,0,138,0,0,0,138
32446,RM-1236,1/27/2014,0,0,138,0,0,0,138
39052,RM-B220,1/27/2014,138,0,0,0,0,0,138
40428,RM-B224,1/27/2014,0,0,0,0,0,138,138
41116,RM-B225,1/27/2014,0,0,0,0,0,138,138
42486,RM-B230A,1/27/2014,0,0,0,0,0,138,138
44346,RM-B250,1/26/2014,0,0,138,0,0,0,138
44347,RM-B250,1/27/2014,0,0,138,0,0,0,138
3439,RM-1107,8/30/2013,0,0,135,0,0,0,135
4952,RM-1109,1/26/2014,0,0,0,0,0,135,135
6180,RM-1113,8/30/2013,0,0,135,0,0,0,135
6980,RM-1115,1/26/2014,0,0,0,0,0,135,135
7531,RM-1116,9/9/2013,0,0,69,0,0,66,135
7667,RM-1116,1/26/2014,135,0,0,0,0,0,135
8899,RM-1122,8/30/2013,0,0,135,0,0,0,135
9040,RM-1122,1/26/2014,0,0,0,0,0,135,135
9584,RM-1123,8/30/2013,0,0,135,0,0,0,135
10410,RM-1124,1/26/2014,0,0,0,0,0,135,135
12187,RM-1130,8/30/2013,0,0,0,0,0,135,135
13559,RM-1133,8/30/2013,0,0,135,0,0,0,135
15351,RM-1144,8/30/2013,0,0,0,0,0,135,135
16177,RM-1145,1/26/2014,0,0,0,0,0,135,135
18063,RM-1154,8/30/2013,135,0,0,0,0,0,135
18756,RM-1155,9/9/2013,66,0,69,0,0,0,135
19568,RM-1156,1/26/2014,135,0,0,0,0,0,135
20744,RM-1200B,8/30/2013,0,0,0,0,0,135,135
25473,RM-1213,8/30/2013,0,0,135,0,0,0,135
25614,RM-1213,1/26/2014,0,0,0,0,0,135,135
26843,RM-1217,8/30/2013,135,0,0,0,0,0,135
31614,RM-1231,8/30/2013,0,0,0,0,0,135,135
31755,RM-1231,1/26/2014,0,0,0,0,0,135,135
32309,RM-1236,9/9/2013,66,0,69,0,0,0,135
33716,RM-B102C,8/30/2013,0,0,135,0,0,0,135
34932,RM-B103A,8/30/2013,0,0,0,0,0,135,135
36168,RM-B200B,8/30/2013,0,0,0,0,0,135,135
36854,RM-B200C,9/9/2013,0,0,69,0,0,66,135
39051,RM-B220,1/26/2014,135,0,0,0,0,0,135
40286,RM-B224,8/30/2013,0,0,0,0,0,135,135
40427,RM-B224,1/26/2014,0,0,0,0,0,135,135
40974,RM-B225,8/30/2013,0,0,0,0,0,135,135
41115,RM-B225,1/26/2014,0,0,0,0,0,135,135
42344,RM-B230A,8/30/2013,0,0,0,0,0,135,135
42485,RM-B230A,1/26/2014,0,0,0,0,0,135,135
43595,RM-B240A,8/30/2013,0,0,0,0,0,135,135
44205,RM-B250,8/30/2013,135,0,0,0,0,0,135
46944,RM-B270,8/30/2013,0,0,135,0,0,0,135
47617,RM-B275,9/9/2013,0,0,69,0,0,66,135
2759,RM-1106,9/9/2013,66,0,0,0,0,66,132
8160,RM-1117,7/2/2013,48,0,0,0,0,84,132
8219,RM-1117,9/9/2013,66,0,0,0,0,66,132
23435,RM-1208,9/9/2013,66,0,0,0,0,66,132
38230,RM-B215,9/9/2013,66,0,0,0,0,66,132
39603,RM-B222,9/9/2013,66,0,66,0,0,0,132
26152,RM-1213A,8/20/2013,0,0,0,0,0,123,123
30887,RM-1229,5/12/2015,0,0,123,0,0,0,123
7473,RM-1116,7/3/2013,0,0,60,0,0,57,117
18698,RM-1155,7/3/2013,57,0,60,0,0,0,117
32251,RM-1236,7/3/2013,57,0,60,0,0,0,117
36796,RM-B200C,7/3/2013,0,0,60,0,0,57,117
40233,RM-B224,7/3/2013,0,0,60,0,0,57,117
8161,RM-1117,7/3/2013,57,0,0,0,0,57,114
36579,RM-B200B,10/25/2014,0,0,108,0,0,0,108
37149,RM-B200C,7/4/2014,105,0,0,0,0,0,105
39210,RM-B220,7/4/2014,105,0,0,0,0,0,105
41959,RM-B230,7/4/2014,105,0,0,0,0,0,105
43210,RM-B240,7/4/2014,0,0,105,0,0,0,105
44505,RM-B250,7/4/2014,0,0,105,0,0,0,105
45874,RM-B260,7/4/2014,105,0,0,0,0,0,105
358,RM-1100A,7/4/2014,102,0,0,0,0,0,102
5795,RM-1110,7/4/2014,0,0,102,0,0,0,102
6480,RM-1113,7/4/2014,0,0,102,0,0,0,102
9884,RM-1123,7/4/2014,102,0,0,0,0,0,102
10136,RM-1123,3/15/2015,102,0,0,0,0,0,102
13174,RM-1132,7/4/2014,0,0,102,0,0,0,102
14381,RM-1134,7/4/2014,102,0,0,0,0,0,102
15651,RM-1144,7/4/2014,0,0,102,0,0,0,102
16309,RM-1145,7/4/2014,0,0,102,0,0,0,102
17678,RM-1151,7/4/2014,102,0,0,0,0,0,102
19051,RM-1155,7/4/2014,102,0,0,0,0,0,102
23045,RM-1207,7/4/2014,102,0,0,0,0,0,102
23730,RM-1208,7/4/2014,102,0,0,0,0,0,102
25103,RM-1212,7/4/2014,102,0,0,0,0,0,102
26458,RM-1213A,7/4/2014,0,0,102,0,0,0,102
27143,RM-1217,7/4/2014,102,0,0,0,0,0,102
28519,RM-1221,7/4/2014,0,0,102,0,0,0,102
29204,RM-1223,7/4/2014,102,0,0,0,0,0,102
30577,RM-1229,7/4/2014,0,0,102,0,0,0,102
32211,RM-1231,4/27/2015,0,0,102,0,0,0,102
32604,RM-1236,7/4/2014,0,0,102,0,0,0,102
36468,RM-B200B,7/4/2014,0,0,102,0,0,0,102
39000,RM-B220,12/6/2013,102,0,0,0,0,0,102
39898,RM-B222,7/4/2014,102,0,0,0,0,0,102
45189,RM-B250A,7/4/2014,102,0,0,0,0,0,102
1728,RM-1102,7/4/2014,99,0,0,0,0,0,99
3385,RM-1107,7/2/2013,0,0,99,0,0,0,99
6126,RM-1113,7/2/2013,0,0,99,0,0,0,99
8845,RM-1122,7/2/2013,0,0,99,0,0,0,99
13505,RM-1133,7/2/2013,0,0,99,0,0,0,99
18009,RM-1154,7/2/2013,0,0,99,0,0,0,99
25419,RM-1213,7/2/2013,0,0,99,0,0,0,99
27477,RM-1218,7/2/2013,0,0,99,0,0,0,99
33488,RM-4xxx,8/19/2014,0,0,0,0,99,0,99
33662,RM-B102C,7/2/2013,0,0,99,0,0,0,99
37483,RM-B210,7/2/2013,0,0,99,0,0,0,99
46890,RM-B270,7/2/2013,0,0,99,0,0,0,99
47558,RM-B275,7/2/2013,0,0,99,0,0,0,99
984,RM-1100D,5/6/2014,0,0,0,96,0,0,96
20322,RM-1200A,5/6/2014,0,0,0,96,0,0,96
24359,RM-1208B,5/6/2014,0,0,6,90,0,0,96
35173,RM-B103A,5/6/2014,0,0,0,96,0,0,96
45815,RM-B260,5/6/2014,0,0,0,96,0,0,96
0,RM-1100A,6/28/2013,93,0,0,0,0,0,93
2696,RM-1106,6/28/2013,93,0,0,0,0,0,93
4753,RM-1109,6/28/2013,93,0,0,0,0,0,93
8156,RM-1117,6/28/2013,93,0,0,0,0,0,93
12816,RM-1132,6/28/2013,93,0,0,0,0,0,93
18693,RM-1155,6/28/2013,93,0,0,0,0,0,93
30219,RM-1229,6/28/2013,93,0,0,0,0,0,93
32246,RM-1236,6/28/2013,93,0,0,0,0,0,93
38167,RM-B215,6/28/2013,93,0,0,0,0,0,93
39540,RM-B222,6/28/2013,93,0,0,0,0,0,93
12297,RM-1130,12/26/2013,0,0,0,0,0,90,90
47185,RM-B270,5/6/2014,0,0,0,90,0,0,90
5442,RM-1110,7/2/2013,0,0,0,0,0,84,84
11585,RM-1126,7/2/2013,0,0,0,0,0,84,84
12133,RM-1130,7/2/2013,0,0,0,0,0,84,84
23376,RM-1208,7/2/2013,0,0,0,0,0,84,84
26104,RM-1213A,7/2/2013,0,0,0,0,0,84,84
34878,RM-B103A,7/2/2013,0,0,0,0,0,84,84
40920,RM-B225,7/2/2013,0,0,0,0,0,84,84
42290,RM-B230A,7/2/2013,0,0,0,0,0,84,84
43541,RM-B240A,7/2/2013,0,0,0,0,0,84,84
44151,RM-B250,7/2/2013,0,0,0,0,0,84,84
28165,RM-1221,7/2/2013,0,0,0,0,0,81,81
36409,RM-B200B,5/6/2014,0,78,0,0,0,0,78
43836,RM-B240A,5/6/2014,0,78,0,0,0,0,78
2236,RM-1104,1/8/2014,0,72,0,0,0,0,72
20985,RM-1200B,5/6/2014,0,72,0,0,0,0,72
21552,RM-1200C,1/8/2014,0,72,0,0,0,0,72
31052,RM-1230,1/8/2014,0,72,0,0,0,0,72
35604,RM-B109,1/8/2014,0,72,0,0,0,0,72
43718,RM-B240A,1/8/2014,0,72,0,0,0,0,72
3444,RM-1107,9/9/2013,0,0,69,0,0,0,69
4770,RM-1109,7/15/2013,69,0,0,0,0,0,69
6185,RM-1113,9/9/2013,0,0,69,0,0,0,69
8904,RM-1122,9/9/2013,0,0,69,0,0,0,69
9589,RM-1123,9/9/2013,0,0,69,0,0,0,69
13564,RM-1133,9/9/2013,0,0,69,0,0,0,69
25478,RM-1213,9/9/2013,0,0,69,0,0,0,69
33721,RM-B102C,9/9/2013,0,0,69,0,0,0,69
46949,RM-B270,9/9/2013,0,0,69,0,0,0,69
7797,RM-1116,6/5/2014,66,0,0,0,0,0,66
12192,RM-1130,9/9/2013,0,0,0,0,0,66,66
15356,RM-1144,9/9/2013,0,0,0,0,0,66,66
18068,RM-1154,9/9/2013,66,0,0,0,0,0,66
20749,RM-1200B,9/9/2013,0,0,0,0,0,66,66
26848,RM-1217,9/9/2013,66,0,0,0,0,0,66
31619,RM-1231,9/9/2013,0,0,0,0,0,66,66
34937,RM-B103A,9/9/2013,0,0,0,0,0,66,66
36173,RM-B200B,9/9/2013,0,0,0,0,0,66,66
38666,RM-B215,11/24/2014,66,0,0,0,0,0,66
40291,RM-B224,9/9/2013,0,0,0,0,0,66,66
40979,RM-B225,9/9/2013,0,0,0,0,0,66,66
42349,RM-B230A,9/9/2013,0,0,0,0,0,66,66
43600,RM-B240A,9/9/2013,0,0,0,0,0,66,66
44210,RM-B250,9/9/2013,66,0,0,0,0,0,66
15829,RM-1144,12/31/2014,0,0,63,0,0,0,63
3386,RM-1107,7/3/2013,0,0,60,0,0,0,60
6127,RM-1113,7/3/2013,0,0,60,0,0,0,60
8846,RM-1122,7/3/2013,0,0,60,0,0,0,60
9883,RM-1123,7/3/2014,60,0,0,0,0,0,60
13506,RM-1133,7/3/2013,0,0,60,0,0,0,60
18010,RM-1154,7/3/2013,0,0,60,0,0,0,60
25420,RM-1213,7/3/2013,0,0,60,0,0,0,60
27478,RM-1218,7/3/2013,0,0,60,0,0,0,60
28258,RM-1221,10/13/2013,0,0,60,0,0,0,60
33663,RM-B102C,7/3/2013,0,0,60,0,0,0,60
37484,RM-B210,7/3/2013,0,0,60,0,0,0,60
46891,RM-B270,7/3/2013,0,0,60,0,0,0,60
47559,RM-B275,7/3/2013,0,0,60,0,0,0,60
5,RM-1100A,7/3/2013,57,0,0,0,0,0,57
2701,RM-1106,7/3/2013,57,0,0,0,0,0,57
4758,RM-1109,7/3/2013,57,0,0,0,0,0,57
5443,RM-1110,7/3/2013,0,0,0,0,0,57,57
11586,RM-1126,7/3/2013,0,0,0,0,0,57,57
12134,RM-1130,7/3/2013,0,0,0,0,0,57,57
12821,RM-1132,7/3/2013,57,0,0,0,0,0,57
16239,RM-1145,4/25/2014,0,0,57,0,0,0,57
23377,RM-1208,7/3/2013,0,0,0,0,0,57,57
26105,RM-1213A,7/3/2013,0,0,0,0,0,57,57
28166,RM-1221,7/3/2013,0,0,0,0,0,57,57
30224,RM-1229,7/3/2013,57,0,0,0,0,0,57
34879,RM-B103A,7/3/2013,0,0,0,0,0,57,57
38172,RM-B215,7/3/2013,57,0,0,0,0,0,57
39545,RM-B222,7/3/2013,57,0,0,0,0,0,57
40921,RM-B225,7/3/2013,0,0,0,0,0,57,57
42291,RM-B230A,7/3/2013,0,0,0,0,0,57,57
43542,RM-B240A,7/3/2013,0,0,0,0,0,57,57
44152,RM-B250,7/3/2013,0,0,0,0,0,57,57
1646,RM-1102,4/13/2014,51,0,0,0,0,0,51
2700,RM-1106,7/2/2013,51,0,0,0,0,0,51
4757,RM-1109,7/2/2013,51,0,0,0,0,0,51
38171,RM-B215,7/2/2013,51,0,0,0,0,0,51
39544,RM-B222,7/2/2013,51,0,0,0,0,0,51
4,RM-1100A,7/2/2013,48,0,0,0,0,0,48
12820,RM-1132,7/2/2013,48,0,0,0,0,0,48
42057,RM-B230,10/12/2014,48,0,0,0,0,0,48
30223,RM-1229,7/2/2013,45,0,0,0,0,0,45
3,RM-1100A,7/1/2013,36,0,0,0,0,0,36
2699,RM-1106,7/1/2013,36,0,0,0,0,0,36
4756,RM-1109,7/1/2013,36,0,0,0,0,0,36
8159,RM-1117,7/1/2013,36,0,0,0,0,0,36
12819,RM-1132,7/1/2013,36,0,0,0,0,0,36
30222,RM-1229,7/1/2013,36,0,0,0,0,0,36
38170,RM-B215,7/1/2013,36,0,0,0,0,0,36
39543,RM-B222,7/1/2013,36,0,0,0,0,0,36
19779,RM-1156,8/25/2014,0,0,21,0,0,0,21
18029,RM-1154,7/23/2013,18,0,0,0,0,0,18
24869,RM-1212,11/9/2013,0,0,15,0,0,0,15
16075,RM-1145,10/13/2013,0,0,0,0,0,12,12
6421,RM-1113,5/6/2014,0,0,9,0,0,0,9
15592,RM-1144,5/6/2014,0,0,9,0,0,0,9
16250,RM-1145,5/6/2014,0,0,9,0,0,0,9
25006,RM-1212,3/29/2014,3,0,6,0,0,0,9
26399,RM-1213A,5/6/2014,0,0,9,0,0,0,9
35722,RM-B109,5/6/2014,0,0,9,0,0,0,9
37052,RM-B200C,3/29/2014,3,0,6,0,0,0,9
37090,RM-B200C,5/6/2014,0,0,9,0,0,0,9
38466,RM-B215,5/6/2014,0,0,9,0,0,0,9
41862,RM-B230,3/29/2014,3,0,6,0,0,0,9
41900,RM-B230,5/6/2014,0,0,9,0,0,0,9
43151,RM-B240,5/6/2014,0,0,9,0,0,0,9
189,RM-1100A,1/16/2014,0,6,0,0,0,0,6
6383,RM-1113,3/29/2014,0,0,6,0,0,0,6
15554,RM-1144,3/29/2014,0,0,6,0,0,0,6
16824,RM-1150,1/16/2014,0,0,0,6,0,0,6
17509,RM-1151,1/16/2014,0,0,0,6,0,0,6
20212,RM-1200A,1/16/2014,0,0,0,6,0,0,6
26361,RM-1213A,3/29/2014,0,0,6,0,0,0,6
27662,RM-1218,1/16/2014,0,0,0,6,0,0,6
27931,RM-1218,10/14/2014,6,0,0,0,0,0,6
32507,RM-1236,3/29/2014,0,0,6,0,0,0,6
34877,RM-B103A,7/1/2013,0,0,0,0,0,6,6
35684,RM-B109,3/29/2014,0,0,6,0,0,0,6
38428,RM-B215,3/29/2014,0,0,6,0,0,0,6
40919,RM-B225,7/1/2013,0,0,0,0,0,6,6
42289,RM-B230A,7/1/2013,0,0,0,0,0,6,6
43113,RM-B240,3/29/2014,0,0,6,0,0,0,6
43540,RM-B240A,7/1/2013,0,0,0,0,0,6,6
44150,RM-B250,7/1/2013,0,0,0,0,0,6,6
45045,RM-B250A,2/9/2014,6,0,0,0,0,0,6
5441,RM-1110,7/1/2013,0,0,0,0,0,3,3
5699,RM-1110,3/29/2014,0,0,3,0,0,0,3
7042,RM-1115,3/29/2014,3,0,0,0,0,0,3
7729,RM-1116,3/29/2014,3,0,0,0,0,0,3
11584,RM-1126,7/1/2013,0,0,0,0,0,3,3
12132,RM-1130,7/1/2013,0,0,0,0,0,3,3
14285,RM-1134,3/29/2014,3,0,0,0,0,0,3
18954,RM-1155,3/29/2014,3,0,0,0,0,0,3
19630,RM-1156,3/29/2014,3,0,0,0,0,0,3
22948,RM-1207,3/29/2014,3,0,0,0,0,0,3
27046,RM-1217,3/29/2014,3,0,0,0,0,0,3
39113,RM-B220,3/29/2014,3,0,0,0,0,0,3
45093,RM-B250A,3/29/2014,3,0,0,0,0,0,3
28,RM-1100A,7/27/2013,0,0,0,0,0,0,0
29,RM-1100A,7/28/2013,0,0,0,0,0,0,0
30,RM-1100A,7/29/2013,0,0,0,0,0,0,0
31,RM-1100A,7/30/2013,0,0,0,0,0,0,0
32,RM-1100A,7/31/2013,0,0,0,0,0,0,0
33,RM-1100A,8/1/2013,0,0,0,0,0,0,0
34,RM-1100A,8/2/2013,0,0,0,0,0,0,0
35,RM-1100A,8/3/2013,0,0,0,0,0,0,0
36,RM-1100A,8/4/2013,0,0,0,0,0,0,0
37,RM-1100A,8/5/2013,0,0,0,0,0,0,0
38,RM-1100A,8/6/2013,0,0,0,0,0,0,0
39,RM-1100A,8/7/2013,0,0,0,0,0,0,0
40,RM-1100A,8/8/2013,0,0,0,0,0,0,0
41,RM-1100A,8/9/2013,0,0,0,0,0,0,0
42,RM-1100A,8/10/2013,0,0,0,0,0,0,0
43,RM-1100A,8/11/2013,0,0,0,0,0,0,0
44,RM-1100A,8/12/2013,0,0,0,0,0,0,0
45,RM-1100A,8/13/2013,0,0,0,0,0,0,0
46,RM-1100A,8/14/2013,0,0,0,0,0,0,0
47,RM-1100A,8/15/2013,0,0,0,0,0,0,0
48,RM-1100A,8/16/2013,0,0,0,0,0,0,0
49,RM-1100A,8/17/2013,0,0,0,0,0,0,0
50,RM-1100A,8/18/2013,0,0,0,0,0,0,0
51,RM-1100A,8/19/2013,0,0,0,0,0,0,0
52,RM-1100A,8/20/2013,0,0,0,0,0,0,0
53,RM-1100A,8/21/2013,0,0,0,0,0,0,0
54,RM-1100A,8/22/2013,0,0,0,0,0,0,0
55,RM-1100A,8/27/2013,0,0,0,0,0,0,0
56,RM-1100A,8/28/2013,0,0,0,0,0,0,0
57,RM-1100A,8/29/2013,0,0,0,0,0,0,0
58,RM-1100A,8/30/2013,0,0,0,0,0,0,0
59,RM-1100A,9/4/2013,0,0,0,0,0,0,0
60,RM-1100A,9/5/2013,0,0,0,0,0,0,0
61,RM-1100A,9/6/2013,0,0,0,0,0,0,0
62,RM-1100A,9/7/2013,0,0,0,0,0,0,0
63,RM-1100A,9/9/2013,0,0,0,0,0,0,0
64,RM-1100A,9/10/2013,0,0,0,0,0,0,0
65,RM-1100A,9/11/2013,0,0,0,0,0,0,0
66,RM-1100A,9/12/2013,0,0,0,0,0,0,0
67,RM-1100A,9/13/2013,0,0,0,0,0,0,0
68,RM-1100A,9/14/2013,0,0,0,0,0,0,0
69,RM-1100A,9/15/2013,0,0,0,0,0,0,0
70,RM-1100A,9/16/2013,0,0,0,0,0,0,0
71,RM-1100A,9/17/2013,0,0,0,0,0,0,0
72,RM-1100A,9/18/2013,0,0,0,0,0,0,0
73,RM-1100A,9/19/2013,0,0,0,0,0,0,0
74,RM-1100A,9/20/2013,0,0,0,0,0,0,0
75,RM-1100A,9/21/2013,0,0,0,0,0,0,0
76,RM-1100A,9/22/2013,0,0,0,0,0,0,0
77,RM-1100A,9/23/2013,0,0,0,0,0,0,0
78,RM-1100A,9/24/2013,0,0,0,0,0,0,0
79,RM-1100A,9/25/2013,0,0,0,0,0,0,0
80,RM-1100A,9/26/2013,0,0,0,0,0,0,0
81,RM-1100A,9/27/2013,0,0,0,0,0,0,0
82,RM-1100A,9/28/2013,0,0,0,0,0,0,0
83,RM-1100A,9/29/2013,0,0,0,0,0,0,0
84,RM-1100A,9/30/2013,0,0,0,0,0,0,0
85,RM-1100A,10/1/2013,0,0,0,0,0,0,0
86,RM-1100A,10/2/2013,0,0,0,0,0,0,0
87,RM-1100A,10/3/2013,0,0,0,0,0,0,0
88,RM-1100A,10/4/2013,0,0,0,0,0,0,0
89,RM-1100A,10/5/2013,0,0,0,0,0,0,0
90,RM-1100A,10/6/2013,0,0,0,0,0,0,0
91,RM-1100A,10/7/2013,0,0,0,0,0,0,0
92,RM-1100A,10/8/2013,0,0,0,0,0,0,0
93,RM-1100A,10/9/2013,0,0,0,0,0,0,0
94,RM-1100A,10/10/2013,0,0,0,0,0,0,0
95,RM-1100A,10/11/2013,0,0,0,0,0,0,0
96,RM-1100A,10/12/2013,0,0,0,0,0,0,0
97,RM-1100A,10/13/2013,0,0,0,0,0,0,0
98,RM-1100A,10/14/2013,0,0,0,0,0,0,0
99,RM-1100A,10/15/2013,0,0,0,0,0,0,0
100,RM-1100A,10/16/2013,0,0,0,0,0,0,0
101,RM-1100A,10/17/2013,0,0,0,0,0,0,0
102,RM-1100A,10/18/2013,0,0,0,0,0,0,0
103,RM-1100A,10/19/2013,0,0,0,0,0,0,0
104,RM-1100A,10/20/2013,0,0,0,0,0,0,0
105,RM-1100A,10/21/2013,0,0,0,0,0,0,0
106,RM-1100A,10/22/2013,0,0,0,0,0,0,0
107,RM-1100A,10/23/2013,0,0,0,0,0,0,0
108,RM-1100A,10/24/2013,0,0,0,0,0,0,0
109,RM-1100A,10/25/2013,0,0,0,0,0,0,0
110,RM-1100A,10/26/2013,0,0,0,0,0,0,0
111,RM-1100A,10/27/2013,0,0,0,0,0,0,0
112,RM-1100A,10/28/2013,0,0,0,0,0,0,0
113,RM-1100A,10/29/2013,0,0,0,0,0,0,0
114,RM-1100A,10/30/2013,0,0,0,0,0,0,0
115,RM-1100A,10/31/2013,0,0,0,0,0,0,0
116,RM-1100A,11/1/2013,0,0,0,0,0,0,0
117,RM-1100A,11/2/2013,0,0,0,0,0,0,0
118,RM-1100A,11/3/2013,0,0,0,0,0,0,0
119,RM-1100A,11/4/2013,0,0,0,0,0,0,0
120,RM-1100A,11/5/2013,0,0,0,0,0,0,0
121,RM-1100A,11/6/2013,0,0,0,0,0,0,0
122,RM-1100A,11/7/2013,0,0,0,0,0,0,0
123,RM-1100A,11/8/2013,0,0,0,0,0,0,0
124,RM-1100A,11/9/2013,0,0,0,0,0,0,0
125,RM-1100A,11/10/2013,0,0,0,0,0,0,0
126,RM-1100A,11/11/2013,0,0,0,0,0,0,0
127,RM-1100A,11/12/2013,0,0,0,0,0,0,0
128,RM-1100A,11/13/2013,0,0,0,0,0,0,0
129,RM-1100A,11/14/2013,0,0,0,0,0,0,0
130,RM-1100A,11/15/2013,0,0,0,0,0,0,0
131,RM-1100A,11/19/2013,0,0,0,0,0,0,0
132,RM-1100A,11/20/2013,0,0,0,0,0,0,0
133,RM-1100A,11/21/2013,0,0,0,0,0,0,0
134,RM-1100A,11/22/2013,0,0,0,0,0,0,0
135,RM-1100A,11/23/2013,0,0,0,0,0,0,0
136,RM-1100A,11/24/2013,0,0,0,0,0,0,0
137,RM-1100A,11/25/2013,0,0,0,0,0,0,0
138,RM-1100A,11/26/2013,0,0,0,0,0,0,0
139,RM-1100A,11/27/2013,0,0,0,0,0,0,0
140,RM-1100A,11/28/2013,0,0,0,0,0,0,0
141,RM-1100A,11/29/2013,0,0,0,0,0,0,0
142,RM-1100A,11/30/2013,0,0,0,0,0,0,0
143,RM-1100A,12/1/2013,0,0,0,0,0,0,0
144,RM-1100A,12/2/2013,0,0,0,0,0,0,0
145,RM-1100A,12/3/2013,0,0,0,0,0,0,0
146,RM-1100A,12/4/2013,0,0,0,0,0,0,0
147,RM-1100A,12/5/2013,0,0,0,0,0,0,0
148,RM-1100A,12/6/2013,0,0,0,0,0,0,0
149,RM-1100A,12/7/2013,0,0,0,0,0,0,0
150,RM-1100A,12/8/2013,0,0,0,0,0,0,0
151,RM-1100A,12/9/2013,0,0,0,0,0,0,0
152,RM-1100A,12/10/2013,0,0,0,0,0,0,0
153,RM-1100A,12/11/2013,0,0,0,0,0,0,0
154,RM-1100A,12/12/2013,0,0,0,0,0,0,0
155,RM-1100A,12/13/2013,0,0,0,0,0,0,0
156,RM-1100A,12/14/2013,0,0,0,0,0,0,0
157,RM-1100A,12/15/2013,0,0,0,0,0,0,0
158,RM-1100A,12/16/2013,0,0,0,0,0,0,0
159,RM-1100A,12/17/2013,0,0,0,0,0,0,0
160,RM-1100A,12/18/2013,0,0,0,0,0,0,0
161,RM-1100A,12/19/2013,0,0,0,0,0,0,0
162,RM-1100A,12/20/2013,0,0,0,0,0,0,0
163,RM-1100A,12/21/2013,0,0,0,0,0,0,0
164,RM-1100A,12/22/2013,0,0,0,0,0,0,0
165,RM-1100A,12/23/2013,0,0,0,0,0,0,0
166,RM-1100A,12/24/2013,0,0,0,0,0,0,0
167,RM-1100A,12/25/2013,0,0,0,0,0,0,0
168,RM-1100A,12/26/2013,0,0,0,0,0,0,0
169,RM-1100A,12/27/2013,0,0,0,0,0,0,0
170,RM-1100A,12/28/2013,0,0,0,0,0,0,0
171,RM-1100A,12/29/2013,0,0,0,0,0,0,0
172,RM-1100A,12/30/2013,0,0,0,0,0,0,0
173,RM-1100A,12/31/2013,0,0,0,0,0,0,0
174,RM-1100A,1/1/2014,0,0,0,0,0,0,0
175,RM-1100A,1/2/2014,0,0,0,0,0,0,0
176,RM-1100A,1/3/2014,0,0,0,0,0,0,0
177,RM-1100A,1/4/2014,0,0,0,0,0,0,0
178,RM-1100A,1/5/2014,0,0,0,0,0,0,0
179,RM-1100A,1/6/2014,0,0,0,0,0,0,0
180,RM-1100A,1/7/2014,0,0,0,0,0,0,0
181,RM-1100A,1/8/2014,0,0,0,0,0,0,0
182,RM-1100A,1/9/2014,0,0,0,0,0,0,0
183,RM-1100A,1/10/2014,0,0,0,0,0,0,0
184,RM-1100A,1/11/2014,0,0,0,0,0,0,0
185,RM-1100A,1/12/2014,0,0,0,0,0,0,0
186,RM-1100A,1/13/2014,0,0,0,0,0,0,0
187,RM-1100A,1/14/2014,0,0,0,0,0,0,0
188,RM-1100A,1/15/2014,0,0,0,0,0,0,0
299,RM-1100A,5/6/2014,0,0,0,0,0,0,0
563,RM-1100A,1/27/2015,0,0,0,0,0,0,0
564,RM-1100A,1/28/2015,0,0,0,0,0,0,0
565,RM-1100A,1/29/2015,0,0,0,0,0,0,0
566,RM-1100A,1/30/2015,0,0,0,0,0,0,0
567,RM-1100A,1/31/2015,0,0,0,0,0,0,0
568,RM-1100A,2/1/2015,0,0,0,0,0,0,0
569,RM-1100A,2/2/2015,0,0,0,0,0,0,0
570,RM-1100A,2/3/2015,0,0,0,0,0,0,0
571,RM-1100A,2/4/2015,0,0,0,0,0,0,0
572,RM-1100A,2/5/2015,0,0,0,0,0,0,0
573,RM-1100A,2/6/2015,0,0,0,0,0,0,0
574,RM-1100A,2/7/2015,0,0,0,0,0,0,0
575,RM-1100A,2/8/2015,0,0,0,0,0,0,0
576,RM-1100A,2/9/2015,0,0,0,0,0,0,0
577,RM-1100A,2/10/2015,0,0,0,0,0,0,0
578,RM-1100A,2/11/2015,0,0,0,0,0,0,0
579,RM-1100A,2/12/2015,0,0,0,0,0,0,0
580,RM-1100A,2/13/2015,0,0,0,0,0,0,0
581,RM-1100A,2/14/2015,0,0,0,0,0,0,0
582,RM-1100A,2/15/2015,0,0,0,0,0,0,0
583,RM-1100A,2/16/2015,0,0,0,0,0,0,0
584,RM-1100A,2/17/2015,0,0,0,0,0,0,0
585,RM-1100A,2/18/2015,0,0,0,0,0,0,0
586,RM-1100A,2/19/2015,0,0,0,0,0,0,0
587,RM-1100A,2/20/2015,0,0,0,0,0,0,0
588,RM-1100A,2/21/2015,0,0,0,0,0,0,0
589,RM-1100A,2/22/2015,0,0,0,0,0,0,0
590,RM-1100A,2/23/2015,0,0,0,0,0,0,0
591,RM-1100A,2/24/2015,0,0,0,0,0,0,0
592,RM-1100A,2/25/2015,0,0,0,0,0,0,0
593,RM-1100A,2/26/2015,0,0,0,0,0,0,0
594,RM-1100A,2/27/2015,0,0,0,0,0,0,0
595,RM-1100A,2/28/2015,0,0,0,0,0,0,0
596,RM-1100A,3/1/2015,0,0,0,0,0,0,0
597,RM-1100A,3/2/2015,0,0,0,0,0,0,0
598,RM-1100A,3/3/2015,0,0,0,0,0,0,0
599,RM-1100A,3/4/2015,0,0,0,0,0,0,0
600,RM-1100A,3/5/2015,0,0,0,0,0,0,0
601,RM-1100A,3/6/2015,0,0,0,0,0,0,0
602,RM-1100A,3/7/2015,0,0,0,0,0,0,0
603,RM-1100A,3/8/2015,0,0,0,0,0,0,0
604,RM-1100A,3/9/2015,0,0,0,0,0,0,0
605,RM-1100A,3/10/2015,0,0,0,0,0,0,0
606,RM-1100A,3/11/2015,0,0,0,0,0,0,0
607,RM-1100A,3/12/2015,0,0,0,0,0,0,0
608,RM-1100A,3/13/2015,0,0,0,0,0,0,0
609,RM-1100A,3/14/2015,0,0,0,0,0,0,0
610,RM-1100A,3/15/2015,0,0,0,0,0,0,0
611,RM-1100A,3/16/2015,0,0,0,0,0,0,0
612,RM-1100A,3/17/2015,0,0,0,0,0,0,0
613,RM-1100A,3/18/2015,0,0,0,0,0,0,0
614,RM-1100A,3/19/2015,0,0,0,0,0,0,0
615,RM-1100A,3/20/2015,0,0,0,0,0,0,0
616,RM-1100A,3/21/2015,0,0,0,0,0,0,0
617,RM-1100A,3/22/2015,0,0,0,0,0,0,0
618,RM-1100A,3/23/2015,0,0,0,0,0,0,0
619,RM-1100A,3/24/2015,0,0,0,0,0,0,0
620,RM-1100A,3/25/2015,0,0,0,0,0,0,0
621,RM-1100A,3/26/2015,0,0,0,0,0,0,0
622,RM-1100A,3/27/2015,0,0,0,0,0,0,0
623,RM-1100A,3/28/2015,0,0,0,0,0,0,0
624,RM-1100A,3/29/2015,0,0,0,0,0,0,0
625,RM-1100A,3/30/2015,0,0,0,0,0,0,0
626,RM-1100A,3/31/2015,0,0,0,0,0,0,0
627,RM-1100A,4/1/2015,0,0,0,0,0,0,0
628,RM-1100A,4/2/2015,0,0,0,0,0,0,0
629,RM-1100A,4/3/2015,0,0,0,0,0,0,0
630,RM-1100A,4/4/2015,0,0,0,0,0,0,0
631,RM-1100A,4/5/2015,0,0,0,0,0,0,0
632,RM-1100A,4/6/2015,0,0,0,0,0,0,0
633,RM-1100A,4/7/2015,0,0,0,0,0,0,0
634,RM-1100A,4/8/2015,0,0,0,0,0,0,0
635,RM-1100A,4/9/2015,0,0,0,0,0,0,0
636,RM-1100A,4/10/2015,0,0,0,0,0,0,0
637,RM-1100A,4/11/2015,0,0,0,0,0,0,0
638,RM-1100A,4/12/2015,0,0,0,0,0,0,0
639,RM-1100A,4/13/2015,0,0,0,0,0,0,0
640,RM-1100A,4/14/2015,0,0,0,0,0,0,0
641,RM-1100A,4/15/2015,0,0,0,0,0,0,0
642,RM-1100A,4/16/2015,0,0,0,0,0,0,0
643,RM-1100A,4/17/2015,0,0,0,0,0,0,0
644,RM-1100A,4/18/2015,0,0,0,0,0,0,0
645,RM-1100A,4/19/2015,0,0,0,0,0,0,0
646,RM-1100A,4/20/2015,0,0,0,0,0,0,0
647,RM-1100A,4/21/2015,0,0,0,0,0,0,0
648,RM-1100A,4/22/2015,0,0,0,0,0,0,0
649,RM-1100A,4/23/2015,0,0,0,0,0,0,0
650,RM-1100A,4/24/2015,0,0,0,0,0,0,0
651,RM-1100A,4/25/2015,0,0,0,0,0,0,0
652,RM-1100A,4/26/2015,0,0,0,0,0,0,0
653,RM-1100A,4/27/2015,0,0,0,0,0,0,0
654,RM-1100A,4/28/2015,0,0,0,0,0,0,0
655,RM-1100A,4/29/2015,0,0,0,0,0,0,0
656,RM-1100A,4/30/2015,0,0,0,0,0,0,0
657,RM-1100A,5/1/2015,0,0,0,0,0,0,0
658,RM-1100A,5/2/2015,0,0,0,0,0,0,0
659,RM-1100A,5/3/2015,0,0,0,0,0,0,0
660,RM-1100A,5/4/2015,0,0,0,0,0,0,0
661,RM-1100A,5/5/2015,0,0,0,0,0,0,0
662,RM-1100A,5/6/2015,0,0,0,0,0,0,0
663,RM-1100A,5/7/2015,0,0,0,0,0,0,0
664,RM-1100A,5/8/2015,0,0,0,0,0,0,0
665,RM-1100A,5/9/2015,0,0,0,0,0,0,0
666,RM-1100A,5/10/2015,0,0,0,0,0,0,0
667,RM-1100A,5/11/2015,0,0,0,0,0,0,0
668,RM-1100A,5/12/2015,0,0,0,0,0,0,0
669,RM-1100A,5/13/2015,0,0,0,0,0,0,0
670,RM-1100A,5/14/2015,0,0,0,0,0,0,0
671,RM-1100A,5/15/2015,0,0,0,0,0,0,0
672,RM-1100A,5/16/2015,0,0,0,0,0,0,0
673,RM-1100A,5/17/2015,0,0,0,0,0,0,0
674,RM-1100A,5/18/2015,0,0,0,0,0,0,0
675,RM-1100A,5/19/2015,0,0,0,0,0,0,0
676,RM-1100A,5/20/2015,0,0,0,0,0,0,0
677,RM-1100A,5/21/2015,0,0,0,0,0,0,0
678,RM-1100A,5/22/2015,0,0,0,0,0,0,0
679,RM-1100A,5/23/2015,0,0,0,0,0,0,0
680,RM-1100A,5/24/2015,0,0,0,0,0,0,0
681,RM-1100A,5/25/2015,0,0,0,0,0,0,0
682,RM-1100A,5/26/2015,0,0,0,0,0,0,0
683,RM-1100A,5/27/2015,0,0,0,0,0,0,0
684,RM-1100A,5/28/2015,0,0,0,0,0,0,0
685,RM-1100A,5/29/2015,0,0,0,0,0,0,0
686,RM-1100A,5/30/2015,0,0,0,0,0,0,0
687,RM-1100A,5/31/2015,0,0,0,0,0,0,0
688,RM-1100D,7/1/2013,0,0,0,0,0,0,0
689,RM-1100D,7/2/2013,0,0,0,0,0,0,0
690,RM-1100D,7/3/2013,0,0,0,0,0,0,0
691,RM-1100D,7/4/2013,0,0,0,0,0,0,0
692,RM-1100D,7/5/2013,0,0,0,0,0,0,0
693,RM-1100D,7/6/2013,0,0,0,0,0,0,0
694,RM-1100D,7/7/2013,0,0,0,0,0,0,0
695,RM-1100D,7/8/2013,0,0,0,0,0,0,0
696,RM-1100D,7/9/2013,0,0,0,0,0,0,0
697,RM-1100D,7/10/2013,0,0,0,0,0,0,0
698,RM-1100D,7/11/2013,0,0,0,0,0,0,0
699,RM-1100D,7/12/2013,0,0,0,0,0,0,0
700,RM-1100D,7/13/2013,0,0,0,0,0,0,0
701,RM-1100D,7/14/2013,0,0,0,0,0,0,0
702,RM-1100D,7/15/2013,0,0,0,0,0,0,0
703,RM-1100D,7/17/2013,0,0,0,0,0,0,0
704,RM-1100D,7/18/2013,0,0,0,0,0,0,0
705,RM-1100D,7/19/2013,0,0,0,0,0,0,0
706,RM-1100D,7/20/2013,0,0,0,0,0,0,0
707,RM-1100D,7/21/2013,0,0,0,0,0,0,0
708,RM-1100D,7/22/2013,0,0,0,0,0,0,0
709,RM-1100D,7/23/2013,0,0,0,0,0,0,0
710,RM-1100D,7/24/2013,0,0,0,0,0,0,0
711,RM-1100D,7/25/2013,0,0,0,0,0,0,0
712,RM-1100D,7/26/2013,0,0,0,0,0,0,0
713,RM-1100D,7/27/2013,0,0,0,0,0,0,0
714,RM-1100D,7/28/2013,0,0,0,0,0,0,0
715,RM-1100D,7/29/2013,0,0,0,0,0,0,0
716,RM-1100D,7/30/2013,0,0,0,0,0,0,0
717,RM-1100D,7/31/2013,0,0,0,0,0,0,0
718,RM-1100D,8/1/2013,0,0,0,0,0,0,0
719,RM-1100D,8/2/2013,0,0,0,0,0,0,0
720,RM-1100D,8/3/2013,0,0,0,0,0,0,0
721,RM-1100D,8/4/2013,0,0,0,0,0,0,0
722,RM-1100D,8/5/2013,0,0,0,0,0,0,0
723,RM-1100D,8/6/2013,0,0,0,0,0,0,0
724,RM-1100D,8/7/2013,0,0,0,0,0,0,0
725,RM-1100D,8/8/2013,0,0,0,0,0,0,0
726,RM-1100D,8/9/2013,0,0,0,0,0,0,0
727,RM-1100D,8/10/2013,0,0,0,0,0,0,0
728,RM-1100D,8/11/2013,0,0,0,0,0,0,0
729,RM-1100D,8/12/2013,0,0,0,0,0,0,0
730,RM-1100D,8/13/2013,0,0,0,0,0,0,0
731,RM-1100D,8/14/2013,0,0,0,0,0,0,0
732,RM-1100D,8/15/2013,0,0,0,0,0,0,0
733,RM-1100D,8/16/2013,0,0,0,0,0,0,0
734,RM-1100D,8/17/2013,0,0,0,0,0,0,0
735,RM-1100D,8/18/2013,0,0,0,0,0,0,0
736,RM-1100D,8/19/2013,0,0,0,0,0,0,0
737,RM-1100D,8/20/2013,0,0,0,0,0,0,0
738,RM-1100D,8/21/2013,0,0,0,0,0,0,0
739,RM-1100D,8/22/2013,0,0,0,0,0,0,0
740,RM-1100D,8/27/2013,0,0,0,0,0,0,0
741,RM-1100D,8/28/2013,0,0,0,0,0,0,0
742,RM-1100D,8/29/2013,0,0,0,0,0,0,0
743,RM-1100D,8/30/2013,0,0,0,0,0,0,0
744,RM-1100D,9/4/2013,0,0,0,0,0,0,0
745,RM-1100D,9/5/2013,0,0,0,0,0,0,0
746,RM-1100D,9/6/2013,0,0,0,0,0,0,0
747,RM-1100D,9/7/2013,0,0,0,0,0,0,0
748,RM-1100D,9/9/2013,0,0,0,0,0,0,0
749,RM-1100D,9/10/2013,0,0,0,0,0,0,0
750,RM-1100D,9/11/2013,0,0,0,0,0,0,0
751,RM-1100D,9/12/2013,0,0,0,0,0,0,0
752,RM-1100D,9/13/2013,0,0,0,0,0,0,0
753,RM-1100D,9/14/2013,0,0,0,0,0,0,0
754,RM-1100D,9/15/2013,0,0,0,0,0,0,0
755,RM-1100D,9/16/2013,0,0,0,0,0,0,0
756,RM-1100D,9/17/2013,0,0,0,0,0,0,0
757,RM-1100D,9/18/2013,0,0,0,0,0,0,0
758,RM-1100D,9/19/2013,0,0,0,0,0,0,0
759,RM-1100D,9/20/2013,0,0,0,0,0,0,0
760,RM-1100D,9/21/2013,0,0,0,0,0,0,0
761,RM-1100D,9/22/2013,0,0,0,0,0,0,0
762,RM-1100D,9/23/2013,0,0,0,0,0,0,0
763,RM-1100D,9/24/2013,0,0,0,0,0,0,0
764,RM-1100D,9/25/2013,0,0,0,0,0,0,0
765,RM-1100D,9/26/2013,0,0,0,0,0,0,0
766,RM-1100D,9/27/2013,0,0,0,0,0,0,0
767,RM-1100D,9/28/2013,0,0,0,0,0,0,0
768,RM-1100D,9/29/2013,0,0,0,0,0,0,0
769,RM-1100D,9/30/2013,0,0,0,0,0,0,0
770,RM-1100D,10/1/2013,0,0,0,0,0,0,0
771,RM-1100D,10/2/2013,0,0,0,0,0,0,0
772,RM-1100D,10/3/2013,0,0,0,0,0,0,0
773,RM-1100D,10/4/2013,0,0,0,0,0,0,0
774,RM-1100D,10/5/2013,0,0,0,0,0,0,0
775,RM-1100D,10/6/2013,0,0,0,0,0,0,0
776,RM-1100D,10/7/2013,0,0,0,0,0,0,0
777,RM-1100D,10/8/2013,0,0,0,0,0,0,0
778,RM-1100D,10/9/2013,0,0,0,0,0,0,0
779,RM-1100D,10/10/2013,0,0,0,0,0,0,0
780,RM-1100D,10/11/2013,0,0,0,0,0,0,0
781,RM-1100D,10/12/2013,0,0,0,0,0,0,0
782,RM-1100D,10/13/2013,0,0,0,0,0,0,0
783,RM-1100D,10/14/2013,0,0,0,0,0,0,0
784,RM-1100D,10/15/2013,0,0,0,0,0,0,0
785,RM-1100D,10/16/2013,0,0,0,0,0,0,0
786,RM-1100D,10/17/2013,0,0,0,0,0,0,0
787,RM-1100D,10/18/2013,0,0,0,0,0,0,0
788,RM-1100D,10/19/2013,0,0,0,0,0,0,0
789,RM-1100D,10/20/2013,0,0,0,0,0,0,0
790,RM-1100D,10/21/2013,0,0,0,0,0,0,0
791,RM-1100D,10/22/2013,0,0,0,0,0,0,0
792,RM-1100D,10/23/2013,0,0,0,0,0,0,0
793,RM-1100D,10/24/2013,0,0,0,0,0,0,0
794,RM-1100D,10/25/2013,0,0,0,0,0,0,0
795,RM-1100D,10/26/2013,0,0,0,0,0,0,0
796,RM-1100D,10/27/2013,0,0,0,0,0,0,0
797,RM-1100D,10/28/2013,0,0,0,0,0,0,0
798,RM-1100D,10/29/2013,0,0,0,0,0,0,0
799,RM-1100D,10/30/2013,0,0,0,0,0,0,0
800,RM-1100D,10/31/2013,0,0,0,0,0,0,0
801,RM-1100D,11/1/2013,0,0,0,0,0,0,0
802,RM-1100D,11/2/2013,0,0,0,0,0,0,0
803,RM-1100D,11/3/2013,0,0,0,0,0,0,0
804,RM-1100D,11/4/2013,0,0,0,0,0,0,0
805,RM-1100D,11/5/2013,0,0,0,0,0,0,0
806,RM-1100D,11/6/2013,0,0,0,0,0,0,0
807,RM-1100D,11/7/2013,0,0,0,0,0,0,0
808,RM-1100D,11/8/2013,0,0,0,0,0,0,0
809,RM-1100D,11/9/2013,0,0,0,0,0,0,0
810,RM-1100D,11/10/2013,0,0,0,0,0,0,0
811,RM-1100D,11/11/2013,0,0,0,0,0,0,0
812,RM-1100D,11/12/2013,0,0,0,0,0,0,0
813,RM-1100D,11/13/2013,0,0,0,0,0,0,0
814,RM-1100D,11/14/2013,0,0,0,0,0,0,0
815,RM-1100D,11/15/2013,0,0,0,0,0,0,0
816,RM-1100D,11/19/2013,0,0,0,0,0,0,0
817,RM-1100D,11/20/2013,0,0,0,0,0,0,0
818,RM-1100D,11/21/2013,0,0,0,0,0,0,0
819,RM-1100D,11/22/2013,0,0,0,0,0,0,0
820,RM-1100D,11/23/2013,0,0,0,0,0,0,0
821,RM-1100D,11/24/2013,0,0,0,0,0,0,0
822,RM-1100D,11/25/2013,0,0,0,0,0,0,0
823,RM-1100D,11/26/2013,0,0,0,0,0,0,0
824,RM-1100D,11/27/2013,0,0,0,0,0,0,0
825,RM-1100D,11/28/2013,0,0,0,0,0,0,0
826,RM-1100D,11/29/2013,0,0,0,0,0,0,0
827,RM-1100D,11/30/2013,0,0,0,0,0,0,0
828,RM-1100D,12/1/2013,0,0,0,0,0,0,0
829,RM-1100D,12/2/2013,0,0,0,0,0,0,0
830,RM-1100D,12/3/2013,0,0,0,0,0,0,0
831,RM-1100D,12/4/2013,0,0,0,0,0,0,0
832,RM-1100D,12/5/2013,0,0,0,0,0,0,0
833,RM-1100D,12/6/2013,0,0,0,0,0,0,0
834,RM-1100D,12/7/2013,0,0,0,0,0,0,0
835,RM-1100D,12/8/2013,0,0,0,0,0,0,0
836,RM-1100D,12/9/2013,0,0,0,0,0,0,0
837,RM-1100D,12/10/2013,0,0,0,0,0,0,0
838,RM-1100D,12/11/2013,0,0,0,0,0,0,0
839,RM-1100D,12/12/2013,0,0,0,0,0,0,0
840,RM-1100D,12/13/2013,0,0,0,0,0,0,0
841,RM-1100D,12/14/2013,0,0,0,0,0,0,0
842,RM-1100D,12/15/2013,0,0,0,0,0,0,0
843,RM-1100D,12/16/2013,0,0,0,0,0,0,0
844,RM-1100D,12/17/2013,0,0,0,0,0,0,0
845,RM-1100D,12/18/2013,0,0,0,0,0,0,0
846,RM-1100D,12/19/2013,0,0,0,0,0,0,0
847,RM-1100D,12/20/2013,0,0,0,0,0,0,0
848,RM-1100D,12/21/2013,0,0,0,0,0,0,0
849,RM-1100D,12/22/2013,0,0,0,0,0,0,0
850,RM-1100D,12/23/2013,0,0,0,0,0,0,0
851,RM-1100D,12/24/2013,0,0,0,0,0,0,0
852,RM-1100D,12/25/2013,0,0,0,0,0,0,0
853,RM-1100D,12/26/2013,0,0,0,0,0,0,0
854,RM-1100D,12/27/2013,0,0,0,0,0,0,0
855,RM-1100D,12/28/2013,0,0,0,0,0,0,0
856,RM-1100D,12/29/2013,0,0,0,0,0,0,0
857,RM-1100D,12/30/2013,0,0,0,0,0,0,0
858,RM-1100D,12/31/2013,0,0,0,0,0,0,0
859,RM-1100D,1/1/2014,0,0,0,0,0,0,0
860,RM-1100D,1/2/2014,0,0,0,0,0,0,0
861,RM-1100D,1/3/2014,0,0,0,0,0,0,0
862,RM-1100D,1/4/2014,0,0,0,0,0,0,0
863,RM-1100D,1/5/2014,0,0,0,0,0,0,0
864,RM-1100D,1/6/2014,0,0,0,0,0,0,0
865,RM-1100D,1/7/2014,0,0,0,0,0,0,0
866,RM-1100D,1/8/2014,0,0,0,0,0,0,0
867,RM-1100D,1/9/2014,0,0,0,0,0,0,0
868,RM-1100D,1/10/2014,0,0,0,0,0,0,0
869,RM-1100D,1/11/2014,0,0,0,0,0,0,0
870,RM-1100D,1/12/2014,0,0,0,0,0,0,0
871,RM-1100D,1/13/2014,0,0,0,0,0,0,0
872,RM-1100D,1/14/2014,0,0,0,0,0,0,0
873,RM-1100D,1/15/2014,0,0,0,0,0,0,0
874,RM-1100D,1/16/2014,0,0,0,0,0,0,0
875,RM-1100D,1/17/2014,0,0,0,0,0,0,0
876,RM-1100D,1/18/2014,0,0,0,0,0,0,0
877,RM-1100D,1/19/2014,0,0,0,0,0,0,0
878,RM-1100D,1/20/2014,0,0,0,0,0,0,0
879,RM-1100D,1/21/2014,0,0,0,0,0,0,0
880,RM-1100D,1/22/2014,0,0,0,0,0,0,0
881,RM-1100D,1/23/2014,0,0,0,0,0,0,0
882,RM-1100D,1/24/2014,0,0,0,0,0,0,0
883,RM-1100D,1/25/2014,0,0,0,0,0,0,0
884,RM-1100D,1/26/2014,0,0,0,0,0,0,0
885,RM-1100D,1/27/2014,0,0,0,0,0,0,0
886,RM-1100D,1/28/2014,0,0,0,0,0,0,0
887,RM-1100D,1/29/2014,0,0,0,0,0,0,0
888,RM-1100D,1/30/2014,0,0,0,0,0,0,0
889,RM-1100D,1/31/2014,0,0,0,0,0,0,0
890,RM-1100D,2/1/2014,0,0,0,0,0,0,0
891,RM-1100D,2/2/2014,0,0,0,0,0,0,0
892,RM-1100D,2/3/2014,0,0,0,0,0,0,0
893,RM-1100D,2/4/2014,0,0,0,0,0,0,0
894,RM-1100D,2/5/2014,0,0,0,0,0,0,0
895,RM-1100D,2/6/2014,0,0,0,0,0,0,0
896,RM-1100D,2/7/2014,0,0,0,0,0,0,0
897,RM-1100D,2/8/2014,0,0,0,0,0,0,0
898,RM-1100D,2/9/2014,0,0,0,0,0,0,0
899,RM-1100D,2/10/2014,0,0,0,0,0,0,0
900,RM-1100D,2/11/2014,0,0,0,0,0,0,0
901,RM-1100D,2/12/2014,0,0,0,0,0,0,0
902,RM-1100D,2/13/2014,0,0,0,0,0,0,0
903,RM-1100D,2/14/2014,0,0,0,0,0,0,0
904,RM-1100D,2/15/2014,0,0,0,0,0,0,0
905,RM-1100D,2/16/2014,0,0,0,0,0,0,0
906,RM-1100D,2/17/2014,0,0,0,0,0,0,0
907,RM-1100D,2/18/2014,0,0,0,0,0,0,0
908,RM-1100D,2/19/2014,0,0,0,0,0,0,0
909,RM-1100D,2/20/2014,0,0,0,0,0,0,0
910,RM-1100D,2/21/2014,0,0,0,0,0,0,0
911,RM-1100D,2/22/2014,0,0,0,0,0,0,0
912,RM-1100D,2/23/2014,0,0,0,0,0,0,0
913,RM-1100D,2/24/2014,0,0,0,0,0,0,0
914,RM-1100D,2/25/2014,0,0,0,0,0,0,0
915,RM-1100D,2/26/2014,0,0,0,0,0,0,0
916,RM-1100D,2/27/2014,0,0,0,0,0,0,0
917,RM-1100D,2/28/2014,0,0,0,0,0,0,0
918,RM-1100D,3/1/2014,0,0,0,0,0,0,0
919,RM-1100D,3/2/2014,0,0,0,0,0,0,0
920,RM-1100D,3/3/2014,0,0,0,0,0,0,0
921,RM-1100D,3/4/2014,0,0,0,0,0,0,0
922,RM-1100D,3/5/2014,0,0,0,0,0,0,0
923,RM-1100D,3/6/2014,0,0,0,0,0,0,0
924,RM-1100D,3/7/2014,0,0,0,0,0,0,0
925,RM-1100D,3/8/2014,0,0,0,0,0,0,0
926,RM-1100D,3/9/2014,0,0,0,0,0,0,0
927,RM-1100D,3/10/2014,0,0,0,0,0,0,0
928,RM-1100D,3/11/2014,0,0,0,0,0,0,0
929,RM-1100D,3/12/2014,0,0,0,0,0,0,0
930,RM-1100D,3/13/2014,0,0,0,0,0,0,0
931,RM-1100D,3/14/2014,0,0,0,0,0,0,0
932,RM-1100D,3/15/2014,0,0,0,0,0,0,0
933,RM-1100D,3/16/2014,0,0,0,0,0,0,0
934,RM-1100D,3/17/2014,0,0,0,0,0,0,0
935,RM-1100D,3/18/2014,0,0,0,0,0,0,0
936,RM-1100D,3/19/2014,0,0,0,0,0,0,0
937,RM-1100D,3/20/2014,0,0,0,0,0,0,0
938,RM-1100D,3/21/2014,0,0,0,0,0,0,0
939,RM-1100D,3/22/2014,0,0,0,0,0,0,0
940,RM-1100D,3/23/2014,0,0,0,0,0,0,0
941,RM-1100D,3/24/2014,0,0,0,0,0,0,0
1042,RM-1100D,7/3/2014,0,0,0,0,0,0,0
1043,RM-1100D,7/4/2014,0,0,0,0,0,0,0
1044,RM-1100D,7/5/2014,0,0,0,0,0,0,0
1045,RM-1100D,7/6/2014,0,0,0,0,0,0,0
1046,RM-1100D,7/7/2014,0,0,0,0,0,0,0
1047,RM-1100D,7/8/2014,0,0,0,0,0,0,0
1048,RM-1100D,7/9/2014,0,0,0,0,0,0,0
1049,RM-1100D,7/10/2014,0,0,0,0,0,0,0
1050,RM-1100D,7/11/2014,0,0,0,0,0,0,0
1051,RM-1100D,7/12/2014,0,0,0,0,0,0,0
1052,RM-1100D,7/13/2014,0,0,0,0,0,0,0
1053,RM-1100D,7/14/2014,0,0,0,0,0,0,0
1054,RM-1100D,7/15/2014,0,0,0,0,0,0,0
1055,RM-1100D,7/16/2014,0,0,0,0,0,0,0
1056,RM-1100D,7/17/2014,0,0,0,0,0,0,0
1057,RM-1100D,7/18/2014,0,0,0,0,0,0,0
1058,RM-1100D,7/19/2014,0,0,0,0,0,0,0
1059,RM-1100D,7/20/2014,0,0,0,0,0,0,0
1060,RM-1100D,7/21/2014,0,0,0,0,0,0,0
1061,RM-1100D,7/22/2014,0,0,0,0,0,0,0
1062,RM-1100D,7/23/2014,0,0,0,0,0,0,0
1063,RM-1100D,7/24/2014,0,0,0,0,0,0,0
1064,RM-1100D,7/25/2014,0,0,0,0,0,0,0
1065,RM-1100D,7/26/2014,0,0,0,0,0,0,0
1066,RM-1100D,7/27/2014,0,0,0,0,0,0,0
1067,RM-1100D,7/28/2014,0,0,0,0,0,0,0
1068,RM-1100D,7/29/2014,0,0,0,0,0,0,0
1069,RM-1100D,7/30/2014,0,0,0,0,0,0,0
1070,RM-1100D,7/31/2014,0,0,0,0,0,0,0
1071,RM-1100D,8/1/2014,0,0,0,0,0,0,0
1072,RM-1100D,8/2/2014,0,0,0,0,0,0,0
1073,RM-1100D,8/3/2014,0,0,0,0,0,0,0
1074,RM-1100D,8/4/2014,0,0,0,0,0,0,0
1075,RM-1100D,8/5/2014,0,0,0,0,0,0,0
1076,RM-1100D,8/6/2014,0,0,0,0,0,0,0
1077,RM-1100D,8/7/2014,0,0,0,0,0,0,0
1078,RM-1100D,8/8/2014,0,0,0,0,0,0,0
1079,RM-1100D,8/9/2014,0,0,0,0,0,0,0
1080,RM-1100D,8/10/2014,0,0,0,0,0,0,0
1081,RM-1100D,8/11/2014,0,0,0,0,0,0,0
1082,RM-1100D,8/12/2014,0,0,0,0,0,0,0
1083,RM-1100D,8/13/2014,0,0,0,0,0,0,0
1084,RM-1100D,8/14/2014,0,0,0,0,0,0,0
1085,RM-1100D,8/15/2014,0,0,0,0,0,0,0
1086,RM-1100D,8/16/2014,0,0,0,0,0,0,0
1087,RM-1100D,8/17/2014,0,0,0,0,0,0,0
1088,RM-1100D,8/18/2014,0,0,0,0,0,0,0
1089,RM-1100D,8/19/2014,0,0,0,0,0,0,0
1090,RM-1100D,8/20/2014,0,0,0,0,0,0,0
1091,RM-1100D,8/21/2014,0,0,0,0,0,0,0
1092,RM-1100D,8/22/2014,0,0,0,0,0,0,0
1093,RM-1100D,8/23/2014,0,0,0,0,0,0,0
1094,RM-1100D,8/24/2014,0,0,0,0,0,0,0
1095,RM-1100D,8/25/2014,0,0,0,0,0,0,0
1096,RM-1100D,8/26/2014,0,0,0,0,0,0,0
1097,RM-1100D,8/27/2014,0,0,0,0,0,0,0
1098,RM-1100D,8/28/2014,0,0,0,0,0,0,0
1099,RM-1100D,8/29/2014,0,0,0,0,0,0,0
1100,RM-1100D,8/30/2014,0,0,0,0,0,0,0
1101,RM-1100D,8/31/2014,0,0,0,0,0,0,0
1102,RM-1100D,9/1/2014,0,0,0,0,0,0,0
1103,RM-1100D,9/2/2014,0,0,0,0,0,0,0
1104,RM-1100D,9/3/2014,0,0,0,0,0,0,0
1105,RM-1100D,9/4/2014,0,0,0,0,0,0,0
1106,RM-1100D,9/5/2014,0,0,0,0,0,0,0
1107,RM-1100D,9/6/2014,0,0,0,0,0,0,0
1108,RM-1100D,9/7/2014,0,0,0,0,0,0,0
1109,RM-1100D,9/8/2014,0,0,0,0,0,0,0
1110,RM-1100D,9/9/2014,0,0,0,0,0,0,0
1111,RM-1100D,9/10/2014,0,0,0,0,0,0,0
1112,RM-1100D,9/11/2014,0,0,0,0,0,0,0
1113,RM-1100D,9/12/2014,0,0,0,0,0,0,0
1114,RM-1100D,9/13/2014,0,0,0,0,0,0,0
1115,RM-1100D,9/14/2014,0,0,0,0,0,0,0
1116,RM-1100D,9/15/2014,0,0,0,0,0,0,0
1117,RM-1100D,9/16/2014,0,0,0,0,0,0,0
1118,RM-1100D,9/17/2014,0,0,0,0,0,0,0
1119,RM-1100D,9/18/2014,0,0,0,0,0,0,0
1120,RM-1100D,9/19/2014,0,0,0,0,0,0,0
1121,RM-1100D,9/20/2014,0,0,0,0,0,0,0
1122,RM-1100D,9/21/2014,0,0,0,0,0,0,0
1123,RM-1100D,9/22/2014,0,0,0,0,0,0,0
1124,RM-1100D,9/23/2014,0,0,0,0,0,0,0
1125,RM-1100D,9/24/2014,0,0,0,0,0,0,0
1126,RM-1100D,9/25/2014,0,0,0,0,0,0,0
1127,RM-1100D,9/28/2014,0,0,0,0,0,0,0
1128,RM-1100D,9/29/2014,0,0,0,0,0,0,0
1129,RM-1100D,9/30/2014,0,0,0,0,0,0,0
1130,RM-1100D,10/1/2014,0,0,0,0,0,0,0
1131,RM-1100D,10/2/2014,0,0,0,0,0,0,0
1132,RM-1100D,10/3/2014,0,0,0,0,0,0,0
1133,RM-1100D,10/4/2014,0,0,0,0,0,0,0
1134,RM-1100D,10/5/2014,0,0,0,0,0,0,0
1135,RM-1100D,10/6/2014,0,0,0,0,0,0,0
1136,RM-1100D,10/7/2014,0,0,0,0,0,0,0
1137,RM-1100D,10/8/2014,0,0,0,0,0,0,0
1138,RM-1100D,10/9/2014,0,0,0,0,0,0,0
1139,RM-1100D,10/10/2014,0,0,0,0,0,0,0
1140,RM-1100D,10/11/2014,0,0,0,0,0,0,0
1141,RM-1100D,10/12/2014,0,0,0,0,0,0,0
1142,RM-1100D,10/13/2014,0,0,0,0,0,0,0
1143,RM-1100D,10/14/2014,0,0,0,0,0,0,0
1144,RM-1100D,10/15/2014,0,0,0,0,0,0,0
1145,RM-1100D,10/16/2014,0,0,0,0,0,0,0
1146,RM-1100D,10/17/2014,0,0,0,0,0,0,0
1147,RM-1100D,10/18/2014,0,0,0,0,0,0,0
1148,RM-1100D,10/19/2014,0,0,0,0,0,0,0
1149,RM-1100D,10/20/2014,0,0,0,0,0,0,0
1150,RM-1100D,10/21/2014,0,0,0,0,0,0,0
1151,RM-1100D,10/22/2014,0,0,0,0,0,0,0
1152,RM-1100D,10/23/2014,0,0,0,0,0,0,0
1153,RM-1100D,10/24/2014,0,0,0,0,0,0,0
1154,RM-1100D,10/25/2014,0,0,0,0,0,0,0
1155,RM-1100D,10/26/2014,0,0,0,0,0,0,0
1156,RM-1100D,10/27/2014,0,0,0,0,0,0,0
1157,RM-1100D,10/28/2014,0,0,0,0,0,0,0
1158,RM-1100D,10/29/2014,0,0,0,0,0,0,0
1159,RM-1100D,10/30/2014,0,0,0,0,0,0,0
1160,RM-1100D,10/31/2014,0,0,0,0,0,0,0
1161,RM-1100D,11/1/2014,0,0,0,0,0,0,0
1162,RM-1100D,11/2/2014,0,0,0,0,0,0,0
1163,RM-1100D,11/3/2014,0,0,0,0,0,0,0
1164,RM-1100D,11/4/2014,0,0,0,0,0,0,0
1165,RM-1100D,11/5/2014,0,0,0,0,0,0,0
1166,RM-1100D,11/6/2014,0,0,0,0,0,0,0
1167,RM-1100D,11/7/2014,0,0,0,0,0,0,0
1168,RM-1100D,11/8/2014,0,0,0,0,0,0,0
1169,RM-1100D,11/9/2014,0,0,0,0,0,0,0
1170,RM-1100D,11/10/2014,0,0,0,0,0,0,0
1171,RM-1100D,11/11/2014,0,0,0,0,0,0,0
1172,RM-1100D,11/12/2014,0,0,0,0,0,0,0
1173,RM-1100D,11/13/2014,0,0,0,0,0,0,0
1174,RM-1100D,11/14/2014,0,0,0,0,0,0,0
1175,RM-1100D,11/15/2014,0,0,0,0,0,0,0
1176,RM-1100D,11/16/2014,0,0,0,0,0,0,0
1177,RM-1100D,11/17/2014,0,0,0,0,0,0,0
1178,RM-1100D,11/18/2014,0,0,0,0,0,0,0
1179,RM-1100D,11/19/2014,0,0,0,0,0,0,0
1180,RM-1100D,11/20/2014,0,0,0,0,0,0,0
1181,RM-1100D,11/21/2014,0,0,0,0,0,0,0
1182,RM-1100D,11/22/2014,0,0,0,0,0,0,0
1183,RM-1100D,11/23/2014,0,0,0,0,0,0,0
1184,RM-1100D,11/24/2014,0,0,0,0,0,0,0
1185,RM-1100D,11/25/2014,0,0,0,0,0,0,0
1186,RM-1100D,11/26/2014,0,0,0,0,0,0,0
1187,RM-1100D,11/27/2014,0,0,0,0,0,0,0
1188,RM-1100D,11/28/2014,0,0,0,0,0,0,0
1189,RM-1100D,11/29/2014,0,0,0,0,0,0,0
1190,RM-1100D,11/30/2014,0,0,0,0,0,0,0
1191,RM-1100D,12/1/2014,0,0,0,0,0,0,0
1192,RM-1100D,12/2/2014,0,0,0,0,0,0,0
1193,RM-1100D,12/3/2014,0,0,0,0,0,0,0
1194,RM-1100D,12/4/2014,0,0,0,0,0,0,0
1195,RM-1100D,12/5/2014,0,0,0,0,0,0,0
1196,RM-1100D,12/6/2014,0,0,0,0,0,0,0
1197,RM-1100D,12/7/2014,0,0,0,0,0,0,0
1198,RM-1100D,12/8/2014,0,0,0,0,0,0,0
1199,RM-1100D,12/9/2014,0,0,0,0,0,0,0
1200,RM-1100D,12/10/2014,0,0,0,0,0,0,0
1201,RM-1100D,12/11/2014,0,0,0,0,0,0,0
1202,RM-1100D,12/12/2014,0,0,0,0,0,0,0
1203,RM-1100D,12/13/2014,0,0,0,0,0,0,0
1204,RM-1100D,12/14/2014,0,0,0,0,0,0,0
1205,RM-1100D,12/15/2014,0,0,0,0,0,0,0
1206,RM-1100D,12/16/2014,0,0,0,0,0,0,0
1207,RM-1100D,12/17/2014,0,0,0,0,0,0,0
1208,RM-1100D,12/18/2014,0,0,0,0,0,0,0
1209,RM-1100D,12/19/2014,0,0,0,0,0,0,0
1210,RM-1100D,12/20/2014,0,0,0,0,0,0,0
1211,RM-1100D,12/21/2014,0,0,0,0,0,0,0
1212,RM-1100D,12/22/2014,0,0,0,0,0,0,0
1213,RM-1100D,12/23/2014,0,0,0,0,0,0,0
1214,RM-1100D,12/24/2014,0,0,0,0,0,0,0
1215,RM-1100D,12/25/2014,0,0,0,0,0,0,0
1216,RM-1100D,12/26/2014,0,0,0,0,0,0,0
1217,RM-1100D,12/27/2014,0,0,0,0,0,0,0
1218,RM-1100D,12/28/2014,0,0,0,0,0,0,0
1219,RM-1100D,12/29/2014,0,0,0,0,0,0,0
1220,RM-1100D,12/30/2014,0,0,0,0,0,0,0
1221,RM-1100D,12/31/2014,0,0,0,0,0,0,0
1222,RM-1100D,1/1/2015,0,0,0,0,0,0,0
1223,RM-1100D,1/2/2015,0,0,0,0,0,0,0
1224,RM-1100D,1/3/2015,0,0,0,0,0,0,0
1225,RM-1100D,1/4/2015,0,0,0,0,0,0,0
1226,RM-1100D,1/5/2015,0,0,0,0,0,0,0
1227,RM-1100D,1/6/2015,0,0,0,0,0,0,0
1228,RM-1100D,1/7/2015,0,0,0,0,0,0,0
1229,RM-1100D,1/8/2015,0,0,0,0,0,0,0
1230,RM-1100D,1/9/2015,0,0,0,0,0,0,0
1231,RM-1100D,1/10/2015,0,0,0,0,0,0,0
1232,RM-1100D,1/11/2015,0,0,0,0,0,0,0
1233,RM-1100D,1/12/2015,0,0,0,0,0,0,0
1234,RM-1100D,1/13/2015,0,0,0,0,0,0,0
1235,RM-1100D,1/14/2015,0,0,0,0,0,0,0
1236,RM-1100D,1/15/2015,0,0,0,0,0,0,0
1237,RM-1100D,1/16/2015,0,0,0,0,0,0,0
1238,RM-1100D,1/17/2015,0,0,0,0,0,0,0
1239,RM-1100D,1/18/2015,0,0,0,0,0,0,0
1240,RM-1100D,1/19/2015,0,0,0,0,0,0,0
1241,RM-1100D,1/20/2015,0,0,0,0,0,0,0
1242,RM-1100D,1/21/2015,0,0,0,0,0,0,0
1243,RM-1100D,1/22/2015,0,0,0,0,0,0,0
1244,RM-1100D,1/23/2015,0,0,0,0,0,0,0
1245,RM-1100D,1/24/2015,0,0,0,0,0,0,0
1246,RM-1100D,1/25/2015,0,0,0,0,0,0,0
1247,RM-1100D,1/26/2015,0,0,0,0,0,0,0
1248,RM-1100D,1/27/2015,0,0,0,0,0,0,0
1249,RM-1100D,1/28/2015,0,0,0,0,0,0,0
1250,RM-1100D,1/29/2015,0,0,0,0,0,0,0
1251,RM-1100D,1/30/2015,0,0,0,0,0,0,0
1252,RM-1100D,1/31/2015,0,0,0,0,0,0,0
1253,RM-1100D,2/1/2015,0,0,0,0,0,0,0
1254,RM-1100D,2/2/2015,0,0,0,0,0,0,0
1255,RM-1100D,2/3/2015,0,0,0,0,0,0,0
1256,RM-1100D,2/4/2015,0,0,0,0,0,0,0
1257,RM-1100D,2/5/2015,0,0,0,0,0,0,0
1258,RM-1100D,2/6/2015,0,0,0,0,0,0,0
1259,RM-1100D,2/7/2015,0,0,0,0,0,0,0
1260,RM-1100D,2/8/2015,0,0,0,0,0,0,0
1261,RM-1100D,2/9/2015,0,0,0,0,0,0,0
1262,RM-1100D,2/10/2015,0,0,0,0,0,0,0
1263,RM-1100D,2/11/2015,0,0,0,0,0,0,0
1264,RM-1100D,2/12/2015,0,0,0,0,0,0,0
1265,RM-1100D,2/13/2015,0,0,0,0,0,0,0
1266,RM-1100D,2/14/2015,0,0,0,0,0,0,0
1267,RM-1100D,2/15/2015,0,0,0,0,0,0,0
1268,RM-1100D,2/16/2015,0,0,0,0,0,0,0
1269,RM-1100D,2/17/2015,0,0,0,0,0,0,0
1270,RM-1100D,2/18/2015,0,0,0,0,0,0,0
1271,RM-1100D,2/19/2015,0,0,0,0,0,0,0
1272,RM-1100D,2/20/2015,0,0,0,0,0,0,0
1273,RM-1100D,2/21/2015,0,0,0,0,0,0,0
1274,RM-1100D,2/22/2015,0,0,0,0,0,0,0
1275,RM-1100D,2/23/2015,0,0,0,0,0,0,0
1276,RM-1100D,2/24/2015,0,0,0,0,0,0,0
1277,RM-1100D,2/25/2015,0,0,0,0,0,0,0
1278,RM-1100D,2/26/2015,0,0,0,0,0,0,0
1279,RM-1100D,2/27/2015,0,0,0,0,0,0,0
1280,RM-1100D,2/28/2015,0,0,0,0,0,0,0
1281,RM-1100D,3/1/2015,0,0,0,0,0,0,0
1282,RM-1100D,3/2/2015,0,0,0,0,0,0,0
1283,RM-1100D,3/3/2015,0,0,0,0,0,0,0
1284,RM-1100D,3/4/2015,0,0,0,0,0,0,0
1285,RM-1100D,3/5/2015,0,0,0,0,0,0,0
1286,RM-1100D,3/6/2015,0,0,0,0,0,0,0
1287,RM-1100D,3/7/2015,0,0,0,0,0,0,0
1288,RM-1100D,3/8/2015,0,0,0,0,0,0,0
1289,RM-1100D,3/9/2015,0,0,0,0,0,0,0
1290,RM-1100D,3/10/2015,0,0,0,0,0,0,0
1291,RM-1100D,3/11/2015,0,0,0,0,0,0,0
1292,RM-1100D,3/12/2015,0,0,0,0,0,0,0
1293,RM-1100D,3/13/2015,0,0,0,0,0,0,0
1294,RM-1100D,3/14/2015,0,0,0,0,0,0,0
1295,RM-1100D,3/15/2015,0,0,0,0,0,0,0
1296,RM-1100D,3/16/2015,0,0,0,0,0,0,0
1297,RM-1100D,3/17/2015,0,0,0,0,0,0,0
1298,RM-1100D,3/18/2015,0,0,0,0,0,0,0
1299,RM-1100D,3/19/2015,0,0,0,0,0,0,0
1300,RM-1100D,3/20/2015,0,0,0,0,0,0,0
1301,RM-1100D,3/21/2015,0,0,0,0,0,0,0
1302,RM-1100D,3/22/2015,0,0,0,0,0,0,0
1303,RM-1100D,3/23/2015,0,0,0,0,0,0,0
1304,RM-1100D,3/24/2015,0,0,0,0,0,0,0
1305,RM-1100D,3/25/2015,0,0,0,0,0,0,0
1306,RM-1100D,3/26/2015,0,0,0,0,0,0,0
1307,RM-1100D,3/27/2015,0,0,0,0,0,0,0
1308,RM-1100D,3/28/2015,0,0,0,0,0,0,0
1309,RM-1100D,3/29/2015,0,0,0,0,0,0,0
1310,RM-1100D,3/30/2015,0,0,0,0,0,0,0
1311,RM-1100D,3/31/2015,0,0,0,0,0,0,0
1312,RM-1100D,4/1/2015,0,0,0,0,0,0,0
1313,RM-1100D,4/2/2015,0,0,0,0,0,0,0
1314,RM-1100D,4/3/2015,0,0,0,0,0,0,0
1315,RM-1100D,4/4/2015,0,0,0,0,0,0,0
1316,RM-1100D,4/5/2015,0,0,0,0,0,0,0
1317,RM-1100D,4/6/2015,0,0,0,0,0,0,0
1318,RM-1100D,4/7/2015,0,0,0,0,0,0,0
1319,RM-1100D,4/8/2015,0,0,0,0,0,0,0
1320,RM-1100D,4/9/2015,0,0,0,0,0,0,0
1321,RM-1100D,4/10/2015,0,0,0,0,0,0,0
1322,RM-1100D,4/11/2015,0,0,0,0,0,0,0
1323,RM-1100D,4/12/2015,0,0,0,0,0,0,0
1324,RM-1100D,4/13/2015,0,0,0,0,0,0,0
1325,RM-1100D,4/14/2015,0,0,0,0,0,0,0
1326,RM-1100D,4/15/2015,0,0,0,0,0,0,0
1327,RM-1100D,4/16/2015,0,0,0,0,0,0,0
1328,RM-1100D,4/17/2015,0,0,0,0,0,0,0
1329,RM-1100D,4/18/2015,0,0,0,0,0,0,0
1330,RM-1100D,4/19/2015,0,0,0,0,0,0,0
1331,RM-1100D,4/20/2015,0,0,0,0,0,0,0
1332,RM-1100D,4/21/2015,0,0,0,0,0,0,0
1333,RM-1100D,4/22/2015,0,0,0,0,0,0,0
1334,RM-1100D,4/23/2015,0,0,0,0,0,0,0
1335,RM-1100D,4/24/2015,0,0,0,0,0,0,0
1336,RM-1100D,4/25/2015,0,0,0,0,0,0,0
1337,RM-1100D,4/26/2015,0,0,0,0,0,0,0
1338,RM-1100D,4/27/2015,0,0,0,0,0,0,0
1339,RM-1100D,4/28/2015,0,0,0,0,0,0,0
1340,RM-1100D,4/29/2015,0,0,0,0,0,0,0
1341,RM-1100D,4/30/2015,0,0,0,0,0,0,0
1342,RM-1100D,5/1/2015,0,0,0,0,0,0,0
1343,RM-1100D,5/2/2015,0,0,0,0,0,0,0
1344,RM-1100D,5/3/2015,0,0,0,0,0,0,0
1345,RM-1100D,5/4/2015,0,0,0,0,0,0,0
1346,RM-1100D,5/5/2015,0,0,0,0,0,0,0
1347,RM-1100D,5/6/2015,0,0,0,0,0,0,0
1348,RM-1100D,5/7/2015,0,0,0,0,0,0,0
1349,RM-1100D,5/8/2015,0,0,0,0,0,0,0
1350,RM-1100D,5/9/2015,0,0,0,0,0,0,0
1351,RM-1100D,5/10/2015,0,0,0,0,0,0,0
1352,RM-1100D,5/11/2015,0,0,0,0,0,0,0
1353,RM-1100D,5/12/2015,0,0,0,0,0,0,0
1354,RM-1100D,5/13/2015,0,0,0,0,0,0,0
1355,RM-1100D,5/14/2015,0,0,0,0,0,0,0
1356,RM-1100D,5/15/2015,0,0,0,0,0,0,0
1357,RM-1100D,5/16/2015,0,0,0,0,0,0,0
1358,RM-1100D,5/17/2015,0,0,0,0,0,0,0
1359,RM-1100D,5/18/2015,0,0,0,0,0,0,0
1360,RM-1100D,5/19/2015,0,0,0,0,0,0,0
1361,RM-1100D,5/20/2015,0,0,0,0,0,0,0
1362,RM-1100D,5/21/2015,0,0,0,0,0,0,0
1363,RM-1100D,5/22/2015,0,0,0,0,0,0,0
1364,RM-1100D,5/23/2015,0,0,0,0,0,0,0
1365,RM-1100D,5/24/2015,0,0,0,0,0,0,0
1366,RM-1100D,5/25/2015,0,0,0,0,0,0,0
1367,RM-1100D,5/26/2015,0,0,0,0,0,0,0
1368,RM-1100D,5/27/2015,0,0,0,0,0,0,0
1369,RM-1100D,5/28/2015,0,0,0,0,0,0,0
1370,RM-1100D,5/29/2015,0,0,0,0,0,0,0
1371,RM-1100D,5/30/2015,0,0,0,0,0,0,0
1372,RM-1100D,5/31/2015,0,0,0,0,0,0,0
1373,RM-1102,7/1/2013,0,0,0,0,0,0,0
1374,RM-1102,7/2/2013,0,0,0,0,0,0,0
1375,RM-1102,7/3/2013,0,0,0,0,0,0,0
1376,RM-1102,7/4/2013,0,0,0,0,0,0,0
1377,RM-1102,7/5/2013,0,0,0,0,0,0,0
1378,RM-1102,7/6/2013,0,0,0,0,0,0,0
1379,RM-1102,7/7/2013,0,0,0,0,0,0,0
1380,RM-1102,7/8/2013,0,0,0,0,0,0,0
1381,RM-1102,7/9/2013,0,0,0,0,0,0,0
1382,RM-1102,7/10/2013,0,0,0,0,0,0,0
1383,RM-1102,7/11/2013,0,0,0,0,0,0,0
1384,RM-1102,7/12/2013,0,0,0,0,0,0,0
1385,RM-1102,7/13/2013,0,0,0,0,0,0,0
1386,RM-1102,7/14/2013,0,0,0,0,0,0,0
1387,RM-1102,7/15/2013,0,0,0,0,0,0,0
1388,RM-1102,7/17/2013,0,0,0,0,0,0,0
1389,RM-1102,7/18/2013,0,0,0,0,0,0,0
1390,RM-1102,7/19/2013,0,0,0,0,0,0,0
1391,RM-1102,7/20/2013,0,0,0,0,0,0,0
1392,RM-1102,7/21/2013,0,0,0,0,0,0,0
1393,RM-1102,7/22/2013,0,0,0,0,0,0,0
1394,RM-1102,7/23/2013,0,0,0,0,0,0,0
1395,RM-1102,7/24/2013,0,0,0,0,0,0,0
1396,RM-1102,7/25/2013,0,0,0,0,0,0,0
1397,RM-1102,7/26/2013,0,0,0,0,0,0,0
1398,RM-1102,7/27/2013,0,0,0,0,0,0,0
1399,RM-1102,7/28/2013,0,0,0,0,0,0,0
1400,RM-1102,7/29/2013,0,0,0,0,0,0,0
1401,RM-1102,7/30/2013,0,0,0,0,0,0,0
1402,RM-1102,7/31/2013,0,0,0,0,0,0,0
1403,RM-1102,8/1/2013,0,0,0,0,0,0,0
1404,RM-1102,8/2/2013,0,0,0,0,0,0,0
1405,RM-1102,8/3/2013,0,0,0,0,0,0,0
1406,RM-1102,8/4/2013,0,0,0,0,0,0,0
1407,RM-1102,8/5/2013,0,0,0,0,0,0,0
1408,RM-1102,8/6/2013,0,0,0,0,0,0,0
1409,RM-1102,8/7/2013,0,0,0,0,0,0,0
1410,RM-1102,8/8/2013,0,0,0,0,0,0,0
1411,RM-1102,8/9/2013,0,0,0,0,0,0,0
1412,RM-1102,8/10/2013,0,0,0,0,0,0,0
1413,RM-1102,8/11/2013,0,0,0,0,0,0,0
1414,RM-1102,8/12/2013,0,0,0,0,0,0,0
1415,RM-1102,8/13/2013,0,0,0,0,0,0,0
1416,RM-1102,8/14/2013,0,0,0,0,0,0,0
1417,RM-1102,8/15/2013,0,0,0,0,0,0,0
1418,RM-1102,8/16/2013,0,0,0,0,0,0,0
1419,RM-1102,8/17/2013,0,0,0,0,0,0,0
1420,RM-1102,8/18/2013,0,0,0,0,0,0,0
1421,RM-1102,8/19/2013,0,0,0,0,0,0,0
1422,RM-1102,8/20/2013,0,0,0,0,0,0,0
1423,RM-1102,8/21/2013,0,0,0,0,0,0,0
1424,RM-1102,8/22/2013,0,0,0,0,0,0,0
1425,RM-1102,8/27/2013,0,0,0,0,0,0,0
1426,RM-1102,8/28/2013,0,0,0,0,0,0,0
1427,RM-1102,8/29/2013,0,0,0,0,0,0,0
1428,RM-1102,8/30/2013,0,0,0,0,0,0,0
1429,RM-1102,9/4/2013,0,0,0,0,0,0,0
1430,RM-1102,9/5/2013,0,0,0,0,0,0,0
1431,RM-1102,9/6/2013,0,0,0,0,0,0,0
1432,RM-1102,9/7/2013,0,0,0,0,0,0,0
1433,RM-1102,9/9/2013,0,0,0,0,0,0,0
1434,RM-1102,9/10/2013,0,0,0,0,0,0,0
1435,RM-1102,9/11/2013,0,0,0,0,0,0,0
1436,RM-1102,9/12/2013,0,0,0,0,0,0,0
1437,RM-1102,9/13/2013,0,0,0,0,0,0,0
1438,RM-1102,9/14/2013,0,0,0,0,0,0,0
1439,RM-1102,9/15/2013,0,0,0,0,0,0,0
1440,RM-1102,9/16/2013,0,0,0,0,0,0,0
1441,RM-1102,9/17/2013,0,0,0,0,0,0,0
1442,RM-1102,9/18/2013,0,0,0,0,0,0,0
1443,RM-1102,9/19/2013,0,0,0,0,0,0,0
1444,RM-1102,9/20/2013,0,0,0,0,0,0,0
1445,RM-1102,9/21/2013,0,0,0,0,0,0,0
1446,RM-1102,9/22/2013,0,0,0,0,0,0,0
1447,RM-1102,9/23/2013,0,0,0,0,0,0,0
1448,RM-1102,9/24/2013,0,0,0,0,0,0,0
1449,RM-1102,9/25/2013,0,0,0,0,0,0,0
1450,RM-1102,9/26/2013,0,0,0,0,0,0,0
1451,RM-1102,9/27/2013,0,0,0,0,0,0,0
1452,RM-1102,9/28/2013,0,0,0,0,0,0,0
1453,RM-1102,9/29/2013,0,0,0,0,0,0,0
1454,RM-1102,9/30/2013,0,0,0,0,0,0,0
1455,RM-1102,10/1/2013,0,0,0,0,0,0,0
1456,RM-1102,10/2/2013,0,0,0,0,0,0,0
1457,RM-1102,10/3/2013,0,0,0,0,0,0,0
1458,RM-1102,10/4/2013,0,0,0,0,0,0,0
1459,RM-1102,10/5/2013,0,0,0,0,0,0,0
1460,RM-1102,10/6/2013,0,0,0,0,0,0,0
1461,RM-1102,10/7/2013,0,0,0,0,0,0,0
1462,RM-1102,10/8/2013,0,0,0,0,0,0,0
1463,RM-1102,10/9/2013,0,0,0,0,0,0,0
1464,RM-1102,10/10/2013,0,0,0,0,0,0,0
1465,RM-1102,10/11/2013,0,0,0,0,0,0,0
1466,RM-1102,10/12/2013,0,0,0,0,0,0,0
1467,RM-1102,10/13/2013,0,0,0,0,0,0,0
1468,RM-1102,10/14/2013,0,0,0,0,0,0,0
1469,RM-1102,10/15/2013,0,0,0,0,0,0,0
1470,RM-1102,10/16/2013,0,0,0,0,0,0,0
1471,RM-1102,10/17/2013,0,0,0,0,0,0,0
1472,RM-1102,10/18/2013,0,0,0,0,0,0,0
1473,RM-1102,10/19/2013,0,0,0,0,0,0,0
1474,RM-1102,10/20/2013,0,0,0,0,0,0,0
1475,RM-1102,10/21/2013,0,0,0,0,0,0,0
1476,RM-1102,10/22/2013,0,0,0,0,0,0,0
1477,RM-1102,10/23/2013,0,0,0,0,0,0,0
1478,RM-1102,10/24/2013,0,0,0,0,0,0,0
1479,RM-1102,10/25/2013,0,0,0,0,0,0,0
1480,RM-1102,10/26/2013,0,0,0,0,0,0,0
1481,RM-1102,10/27/2013,0,0,0,0,0,0,0
1482,RM-1102,10/28/2013,0,0,0,0,0,0,0
1483,RM-1102,10/29/2013,0,0,0,0,0,0,0
1484,RM-1102,10/30/2013,0,0,0,0,0,0,0
1485,RM-1102,10/31/2013,0,0,0,0,0,0,0
1486,RM-1102,11/1/2013,0,0,0,0,0,0,0
1487,RM-1102,11/2/2013,0,0,0,0,0,0,0
1488,RM-1102,11/3/2013,0,0,0,0,0,0,0
1489,RM-1102,11/4/2013,0,0,0,0,0,0,0
1490,RM-1102,11/5/2013,0,0,0,0,0,0,0
1491,RM-1102,11/6/2013,0,0,0,0,0,0,0
1492,RM-1102,11/7/2013,0,0,0,0,0,0,0
1493,RM-1102,11/8/2013,0,0,0,0,0,0,0
1494,RM-1102,11/9/2013,0,0,0,0,0,0,0
1495,RM-1102,11/10/2013,0,0,0,0,0,0,0
1496,RM-1102,11/11/2013,0,0,0,0,0,0,0
1497,RM-1102,11/12/2013,0,0,0,0,0,0,0
1498,RM-1102,11/13/2013,0,0,0,0,0,0,0
1499,RM-1102,11/14/2013,0,0,0,0,0,0,0
1500,RM-1102,11/15/2013,0,0,0,0,0,0,0
1501,RM-1102,11/19/2013,0,0,0,0,0,0,0
1502,RM-1102,11/20/2013,0,0,0,0,0,0,0
1503,RM-1102,11/21/2013,0,0,0,0,0,0,0
1504,RM-1102,11/22/2013,0,0,0,0,0,0,0
1505,RM-1102,11/23/2013,0,0,0,0,0,0,0
1506,RM-1102,11/24/2013,0,0,0,0,0,0,0
1507,RM-1102,11/25/2013,0,0,0,0,0,0,0
1508,RM-1102,11/26/2013,0,0,0,0,0,0,0
1509,RM-1102,11/27/2013,0,0,0,0,0,0,0
1510,RM-1102,11/28/2013,0,0,0,0,0,0,0
1511,RM-1102,11/29/2013,0,0,0,0,0,0,0
1512,RM-1102,11/30/2013,0,0,0,0,0,0,0
1513,RM-1102,12/1/2013,0,0,0,0,0,0,0
1514,RM-1102,12/2/2013,0,0,0,0,0,0,0
1515,RM-1102,12/3/2013,0,0,0,0,0,0,0
1516,RM-1102,12/4/2013,0,0,0,0,0,0,0
1517,RM-1102,12/5/2013,0,0,0,0,0,0,0
1518,RM-1102,12/6/2013,0,0,0,0,0,0,0
1519,RM-1102,12/7/2013,0,0,0,0,0,0,0
1520,RM-1102,12/8/2013,0,0,0,0,0,0,0
1521,RM-1102,12/9/2013,0,0,0,0,0,0,0
1522,RM-1102,12/10/2013,0,0,0,0,0,0,0
1523,RM-1102,12/11/2013,0,0,0,0,0,0,0
1524,RM-1102,12/12/2013,0,0,0,0,0,0,0
1525,RM-1102,12/13/2013,0,0,0,0,0,0,0
1526,RM-1102,12/14/2013,0,0,0,0,0,0,0
1527,RM-1102,12/15/2013,0,0,0,0,0,0,0
1528,RM-1102,12/16/2013,0,0,0,0,0,0,0
1529,RM-1102,12/17/2013,0,0,0,0,0,0,0
1530,RM-1102,12/18/2013,0,0,0,0,0,0,0
1531,RM-1102,12/19/2013,0,0,0,0,0,0,0
1532,RM-1102,12/20/2013,0,0,0,0,0,0,0
1533,RM-1102,12/21/2013,0,0,0,0,0,0,0
1534,RM-1102,12/22/2013,0,0,0,0,0,0,0
1535,RM-1102,12/23/2013,0,0,0,0,0,0,0
1536,RM-1102,12/24/2013,0,0,0,0,0,0,0
1537,RM-1102,12/25/2013,0,0,0,0,0,0,0
1538,RM-1102,12/26/2013,0,0,0,0,0,0,0
1539,RM-1102,12/27/2013,0,0,0,0,0,0,0
1540,RM-1102,12/28/2013,0,0,0,0,0,0,0
1541,RM-1102,12/29/2013,0,0,0,0,0,0,0
1542,RM-1102,12/30/2013,0,0,0,0,0,0,0
1543,RM-1102,12/31/2013,0,0,0,0,0,0,0
1544,RM-1102,1/1/2014,0,0,0,0,0,0,0
1545,RM-1102,1/2/2014,0,0,0,0,0,0,0
1546,RM-1102,1/3/2014,0,0,0,0,0,0,0
1547,RM-1102,1/4/2014,0,0,0,0,0,0,0
1548,RM-1102,1/5/2014,0,0,0,0,0,0,0
1549,RM-1102,1/6/2014,0,0,0,0,0,0,0
1550,RM-1102,1/7/2014,0,0,0,0,0,0,0
1551,RM-1102,1/8/2014,0,0,0,0,0,0,0
1552,RM-1102,1/9/2014,0,0,0,0,0,0,0
1553,RM-1102,1/10/2014,0,0,0,0,0,0,0
1554,RM-1102,1/11/2014,0,0,0,0,0,0,0
1555,RM-1102,1/12/2014,0,0,0,0,0,0,0
1556,RM-1102,1/13/2014,0,0,0,0,0,0,0
1557,RM-1102,1/14/2014,0,0,0,0,0,0,0
1558,RM-1102,1/15/2014,0,0,0,0,0,0,0
1559,RM-1102,1/16/2014,0,0,0,0,0,0,0
1560,RM-1102,1/17/2014,0,0,0,0,0,0,0
1561,RM-1102,1/18/2014,0,0,0,0,0,0,0
1562,RM-1102,1/19/2014,0,0,0,0,0,0,0
1563,RM-1102,1/20/2014,0,0,0,0,0,0,0
1564,RM-1102,1/21/2014,0,0,0,0,0,0,0
1565,RM-1102,1/22/2014,0,0,0,0,0,0,0
1566,RM-1102,1/23/2014,0,0,0,0,0,0,0
1567,RM-1102,1/24/2014,0,0,0,0,0,0,0
1568,RM-1102,1/25/2014,0,0,0,0,0,0,0
1569,RM-1102,1/26/2014,0,0,0,0,0,0,0
1570,RM-1102,1/27/2014,0,0,0,0,0,0,0
1571,RM-1102,1/28/2014,0,0,0,0,0,0,0
1572,RM-1102,1/29/2014,0,0,0,0,0,0,0
1573,RM-1102,1/30/2014,0,0,0,0,0,0,0
1574,RM-1102,1/31/2014,0,0,0,0,0,0,0
1575,RM-1102,2/1/2014,0,0,0,0,0,0,0
1576,RM-1102,2/2/2014,0,0,0,0,0,0,0
1577,RM-1102,2/3/2014,0,0,0,0,0,0,0
1578,RM-1102,2/4/2014,0,0,0,0,0,0,0
1579,RM-1102,2/5/2014,0,0,0,0,0,0,0
1580,RM-1102,2/6/2014,0,0,0,0,0,0,0
1581,RM-1102,2/7/2014,0,0,0,0,0,0,0
1582,RM-1102,2/8/2014,0,0,0,0,0,0,0
1583,RM-1102,2/9/2014,0,0,0,0,0,0,0
1584,RM-1102,2/10/2014,0,0,0,0,0,0,0
1585,RM-1102,2/11/2014,0,0,0,0,0,0,0
1586,RM-1102,2/12/2014,0,0,0,0,0,0,0
1587,RM-1102,2/13/2014,0,0,0,0,0,0,0
1588,RM-1102,2/14/2014,0,0,0,0,0,0,0
1589,RM-1102,2/15/2014,0,0,0,0,0,0,0
1590,RM-1102,2/16/2014,0,0,0,0,0,0,0
1591,RM-1102,2/17/2014,0,0,0,0,0,0,0
1592,RM-1102,2/18/2014,0,0,0,0,0,0,0
1593,RM-1102,2/19/2014,0,0,0,0,0,0,0
1594,RM-1102,2/20/2014,0,0,0,0,0,0,0
1595,RM-1102,2/21/2014,0,0,0,0,0,0,0
1596,RM-1102,2/22/2014,0,0,0,0,0,0,0
1597,RM-1102,2/23/2014,0,0,0,0,0,0,0
1598,RM-1102,2/24/2014,0,0,0,0,0,0,0
1599,RM-1102,2/25/2014,0,0,0,0,0,0,0
1600,RM-1102,2/26/2014,0,0,0,0,0,0,0
1601,RM-1102,2/27/2014,0,0,0,0,0,0,0
1602,RM-1102,2/28/2014,0,0,0,0,0,0,0
1603,RM-1102,3/1/2014,0,0,0,0,0,0,0
1604,RM-1102,3/2/2014,0,0,0,0,0,0,0
1605,RM-1102,3/3/2014,0,0,0,0,0,0,0
1606,RM-1102,3/4/2014,0,0,0,0,0,0,0
1607,RM-1102,3/5/2014,0,0,0,0,0,0,0
1608,RM-1102,3/6/2014,0,0,0,0,0,0,0
1609,RM-1102,3/7/2014,0,0,0,0,0,0,0
1610,RM-1102,3/8/2014,0,0,0,0,0,0,0
1611,RM-1102,3/9/2014,0,0,0,0,0,0,0
1612,RM-1102,3/10/2014,0,0,0,0,0,0,0
1613,RM-1102,3/11/2014,0,0,0,0,0,0,0
1614,RM-1102,3/12/2014,0,0,0,0,0,0,0
1615,RM-1102,3/13/2014,0,0,0,0,0,0,0
1616,RM-1102,3/14/2014,0,0,0,0,0,0,0
1617,RM-1102,3/15/2014,0,0,0,0,0,0,0
1618,RM-1102,3/16/2014,0,0,0,0,0,0,0
1619,RM-1102,3/17/2014,0,0,0,0,0,0,0
1620,RM-1102,3/18/2014,0,0,0,0,0,0,0
1621,RM-1102,3/19/2014,0,0,0,0,0,0,0
1622,RM-1102,3/20/2014,0,0,0,0,0,0,0
1623,RM-1102,3/21/2014,0,0,0,0,0,0,0
1624,RM-1102,3/22/2014,0,0,0,0,0,0,0
1625,RM-1102,3/23/2014,0,0,0,0,0,0,0
1626,RM-1102,3/24/2014,0,0,0,0,0,0,0
1627,RM-1102,3/25/2014,0,0,0,0,0,0,0
1628,RM-1102,3/26/2014,0,0,0,0,0,0,0
1629,RM-1102,3/27/2014,0,0,0,0,0,0,0
1630,RM-1102,3/28/2014,0,0,0,0,0,0,0
1631,RM-1102,3/29/2014,0,0,0,0,0,0,0
1632,RM-1102,3/30/2014,0,0,0,0,0,0,0
1633,RM-1102,3/31/2014,0,0,0,0,0,0,0
1634,RM-1102,4/1/2014,0,0,0,0,0,0,0
1635,RM-1102,4/2/2014,0,0,0,0,0,0,0
1636,RM-1102,4/3/2014,0,0,0,0,0,0,0
1637,RM-1102,4/4/2014,0,0,0,0,0,0,0
1638,RM-1102,4/5/2014,0,0,0,0,0,0,0
1639,RM-1102,4/6/2014,0,0,0,0,0,0,0
1640,RM-1102,4/7/2014,0,0,0,0,0,0,0
1641,RM-1102,4/8/2014,0,0,0,0,0,0,0
1642,RM-1102,4/9/2014,0,0,0,0,0,0,0
1643,RM-1102,4/10/2014,0,0,0,0,0,0,0
1644,RM-1102,4/11/2014,0,0,0,0,0,0,0
1645,RM-1102,4/12/2014,0,0,0,0,0,0,0
1669,RM-1102,5/6/2014,0,0,0,0,0,0,0
2058,RM-1104,7/1/2013,0,0,0,0,0,0,0
2059,RM-1104,7/2/2013,0,0,0,0,0,0,0
2060,RM-1104,7/3/2013,0,0,0,0,0,0,0
2061,RM-1104,7/4/2013,0,0,0,0,0,0,0
2062,RM-1104,7/5/2013,0,0,0,0,0,0,0
2063,RM-1104,7/6/2013,0,0,0,0,0,0,0
2064,RM-1104,7/7/2013,0,0,0,0,0,0,0
2065,RM-1104,7/8/2013,0,0,0,0,0,0,0
2066,RM-1104,7/9/2013,0,0,0,0,0,0,0
2067,RM-1104,7/10/2013,0,0,0,0,0,0,0
2068,RM-1104,7/11/2013,0,0,0,0,0,0,0
2069,RM-1104,7/12/2013,0,0,0,0,0,0,0
2070,RM-1104,7/13/2013,0,0,0,0,0,0,0
2071,RM-1104,7/14/2013,0,0,0,0,0,0,0
2072,RM-1104,7/15/2013,0,0,0,0,0,0,0
2073,RM-1104,7/17/2013,0,0,0,0,0,0,0
2074,RM-1104,7/18/2013,0,0,0,0,0,0,0
2075,RM-1104,7/19/2013,0,0,0,0,0,0,0
2076,RM-1104,7/20/2013,0,0,0,0,0,0,0
2077,RM-1104,7/21/2013,0,0,0,0,0,0,0
2078,RM-1104,7/22/2013,0,0,0,0,0,0,0
2079,RM-1104,7/23/2013,0,0,0,0,0,0,0
2080,RM-1104,7/24/2013,0,0,0,0,0,0,0
2081,RM-1104,7/25/2013,0,0,0,0,0,0,0
2082,RM-1104,7/26/2013,0,0,0,0,0,0,0
2083,RM-1104,7/27/2013,0,0,0,0,0,0,0
2084,RM-1104,7/28/2013,0,0,0,0,0,0,0
2085,RM-1104,7/29/2013,0,0,0,0,0,0,0
2086,RM-1104,7/30/2013,0,0,0,0,0,0,0
2087,RM-1104,7/31/2013,0,0,0,0,0,0,0
2088,RM-1104,8/1/2013,0,0,0,0,0,0,0
2089,RM-1104,8/2/2013,0,0,0,0,0,0,0
2090,RM-1104,8/3/2013,0,0,0,0,0,0,0
2091,RM-1104,8/4/2013,0,0,0,0,0,0,0
2092,RM-1104,8/5/2013,0,0,0,0,0,0,0
2093,RM-1104,8/6/2013,0,0,0,0,0,0,0
2094,RM-1104,8/7/2013,0,0,0,0,0,0,0
2095,RM-1104,8/8/2013,0,0,0,0,0,0,0
2096,RM-1104,8/9/2013,0,0,0,0,0,0,0
2097,RM-1104,8/10/2013,0,0,0,0,0,0,0
2098,RM-1104,8/11/2013,0,0,0,0,0,0,0
2099,RM-1104,8/12/2013,0,0,0,0,0,0,0
2100,RM-1104,8/13/2013,0,0,0,0,0,0,0
2101,RM-1104,8/14/2013,0,0,0,0,0,0,0
2102,RM-1104,8/15/2013,0,0,0,0,0,0,0
2103,RM-1104,8/16/2013,0,0,0,0,0,0,0
2104,RM-1104,8/17/2013,0,0,0,0,0,0,0
2105,RM-1104,8/18/2013,0,0,0,0,0,0,0
2106,RM-1104,8/19/2013,0,0,0,0,0,0,0
2107,RM-1104,8/20/2013,0,0,0,0,0,0,0
2108,RM-1104,8/21/2013,0,0,0,0,0,0,0
2109,RM-1104,8/22/2013,0,0,0,0,0,0,0
2110,RM-1104,8/27/2013,0,0,0,0,0,0,0
2111,RM-1104,8/28/2013,0,0,0,0,0,0,0
2112,RM-1104,8/29/2013,0,0,0,0,0,0,0
2113,RM-1104,8/30/2013,0,0,0,0,0,0,0
2114,RM-1104,9/4/2013,0,0,0,0,0,0,0
2115,RM-1104,9/5/2013,0,0,0,0,0,0,0
2116,RM-1104,9/6/2013,0,0,0,0,0,0,0
2117,RM-1104,9/7/2013,0,0,0,0,0,0,0
2118,RM-1104,9/9/2013,0,0,0,0,0,0,0
2119,RM-1104,9/10/2013,0,0,0,0,0,0,0
2120,RM-1104,9/11/2013,0,0,0,0,0,0,0
2121,RM-1104,9/12/2013,0,0,0,0,0,0,0
2122,RM-1104,9/13/2013,0,0,0,0,0,0,0
2123,RM-1104,9/14/2013,0,0,0,0,0,0,0
2124,RM-1104,9/15/2013,0,0,0,0,0,0,0
2125,RM-1104,9/16/2013,0,0,0,0,0,0,0
2126,RM-1104,9/17/2013,0,0,0,0,0,0,0
2127,RM-1104,9/18/2013,0,0,0,0,0,0,0
2128,RM-1104,9/19/2013,0,0,0,0,0,0,0
2129,RM-1104,9/20/2013,0,0,0,0,0,0,0
2130,RM-1104,9/21/2013,0,0,0,0,0,0,0
2131,RM-1104,9/22/2013,0,0,0,0,0,0,0
2132,RM-1104,9/23/2013,0,0,0,0,0,0,0
2133,RM-1104,9/24/2013,0,0,0,0,0,0,0
2134,RM-1104,9/25/2013,0,0,0,0,0,0,0
2135,RM-1104,9/26/2013,0,0,0,0,0,0,0
2136,RM-1104,9/27/2013,0,0,0,0,0,0,0
2137,RM-1104,9/28/2013,0,0,0,0,0,0,0
2138,RM-1104,9/29/2013,0,0,0,0,0,0,0
2139,RM-1104,9/30/2013,0,0,0,0,0,0,0
2140,RM-1104,10/1/2013,0,0,0,0,0,0,0
2141,RM-1104,10/2/2013,0,0,0,0,0,0,0
2142,RM-1104,10/3/2013,0,0,0,0,0,0,0
2143,RM-1104,10/4/2013,0,0,0,0,0,0,0
2144,RM-1104,10/5/2013,0,0,0,0,0,0,0
2145,RM-1104,10/6/2013,0,0,0,0,0,0,0
2146,RM-1104,10/7/2013,0,0,0,0,0,0,0
2147,RM-1104,10/8/2013,0,0,0,0,0,0,0
2148,RM-1104,10/9/2013,0,0,0,0,0,0,0
2149,RM-1104,10/10/2013,0,0,0,0,0,0,0
2150,RM-1104,10/11/2013,0,0,0,0,0,0,0
2151,RM-1104,10/12/2013,0,0,0,0,0,0,0
2152,RM-1104,10/13/2013,0,0,0,0,0,0,0
2153,RM-1104,10/14/2013,0,0,0,0,0,0,0
2154,RM-1104,10/15/2013,0,0,0,0,0,0,0
2155,RM-1104,10/16/2013,0,0,0,0,0,0,0
2156,RM-1104,10/17/2013,0,0,0,0,0,0,0
2157,RM-1104,10/18/2013,0,0,0,0,0,0,0
2158,RM-1104,10/19/2013,0,0,0,0,0,0,0
2159,RM-1104,10/20/2013,0,0,0,0,0,0,0
2160,RM-1104,10/21/2013,0,0,0,0,0,0,0
2161,RM-1104,10/22/2013,0,0,0,0,0,0,0
2162,RM-1104,10/23/2013,0,0,0,0,0,0,0
2163,RM-1104,10/24/2013,0,0,0,0,0,0,0
2164,RM-1104,10/25/2013,0,0,0,0,0,0,0
2165,RM-1104,10/26/2013,0,0,0,0,0,0,0
2166,RM-1104,10/27/2013,0,0,0,0,0,0,0
2167,RM-1104,10/28/2013,0,0,0,0,0,0,0
2168,RM-1104,10/29/2013,0,0,0,0,0,0,0
2169,RM-1104,10/30/2013,0,0,0,0,0,0,0
2170,RM-1104,10/31/2013,0,0,0,0,0,0,0
2171,RM-1104,11/1/2013,0,0,0,0,0,0,0
2172,RM-1104,11/2/2013,0,0,0,0,0,0,0
2173,RM-1104,11/3/2013,0,0,0,0,0,0,0
2174,RM-1104,11/4/2013,0,0,0,0,0,0,0
2175,RM-1104,11/5/2013,0,0,0,0,0,0,0
2176,RM-1104,11/6/2013,0,0,0,0,0,0,0
2177,RM-1104,11/7/2013,0,0,0,0,0,0,0
2178,RM-1104,11/8/2013,0,0,0,0,0,0,0
2179,RM-1104,11/9/2013,0,0,0,0,0,0,0
2180,RM-1104,11/10/2013,0,0,0,0,0,0,0
2181,RM-1104,11/11/2013,0,0,0,0,0,0,0
2182,RM-1104,11/12/2013,0,0,0,0,0,0,0
2183,RM-1104,11/13/2013,0,0,0,0,0,0,0
2184,RM-1104,11/14/2013,0,0,0,0,0,0,0
2185,RM-1104,11/15/2013,0,0,0,0,0,0,0
2186,RM-1104,11/19/2013,0,0,0,0,0,0,0
2187,RM-1104,11/20/2013,0,0,0,0,0,0,0
2188,RM-1104,11/21/2013,0,0,0,0,0,0,0
2189,RM-1104,11/22/2013,0,0,0,0,0,0,0
2190,RM-1104,11/23/2013,0,0,0,0,0,0,0
2191,RM-1104,11/24/2013,0,0,0,0,0,0,0
2192,RM-1104,11/25/2013,0,0,0,0,0,0,0
2193,RM-1104,11/26/2013,0,0,0,0,0,0,0
2194,RM-1104,11/27/2013,0,0,0,0,0,0,0
2195,RM-1104,11/28/2013,0,0,0,0,0,0,0
2196,RM-1104,11/29/2013,0,0,0,0,0,0,0
2197,RM-1104,11/30/2013,0,0,0,0,0,0,0
2198,RM-1104,12/1/2013,0,0,0,0,0,0,0
2199,RM-1104,12/2/2013,0,0,0,0,0,0,0
2200,RM-1104,12/3/2013,0,0,0,0,0,0,0
2201,RM-1104,12/4/2013,0,0,0,0,0,0,0
2202,RM-1104,12/5/2013,0,0,0,0,0,0,0
2203,RM-1104,12/6/2013,0,0,0,0,0,0,0
2204,RM-1104,12/7/2013,0,0,0,0,0,0,0
2205,RM-1104,12/8/2013,0,0,0,0,0,0,0
2206,RM-1104,12/9/2013,0,0,0,0,0,0,0
2207,RM-1104,12/10/2013,0,0,0,0,0,0,0
2208,RM-1104,12/11/2013,0,0,0,0,0,0,0
2209,RM-1104,12/12/2013,0,0,0,0,0,0,0
2210,RM-1104,12/13/2013,0,0,0,0,0,0,0
2211,RM-1104,12/14/2013,0,0,0,0,0,0,0
2212,RM-1104,12/15/2013,0,0,0,0,0,0,0
2213,RM-1104,12/16/2013,0,0,0,0,0,0,0
2214,RM-1104,12/17/2013,0,0,0,0,0,0,0
2215,RM-1104,12/18/2013,0,0,0,0,0,0,0
2216,RM-1104,12/19/2013,0,0,0,0,0,0,0
2217,RM-1104,12/20/2013,0,0,0,0,0,0,0
2218,RM-1104,12/21/2013,0,0,0,0,0,0,0
2219,RM-1104,12/22/2013,0,0,0,0,0,0,0
2220,RM-1104,12/23/2013,0,0,0,0,0,0,0
2221,RM-1104,12/24/2013,0,0,0,0,0,0,0
2222,RM-1104,12/25/2013,0,0,0,0,0,0,0
2223,RM-1104,12/26/2013,0,0,0,0,0,0,0
2224,RM-1104,12/27/2013,0,0,0,0,0,0,0
2225,RM-1104,12/28/2013,0,0,0,0,0,0,0
2226,RM-1104,12/29/2013,0,0,0,0,0,0,0
2227,RM-1104,12/30/2013,0,0,0,0,0,0,0
2228,RM-1104,12/31/2013,0,0,0,0,0,0,0
2229,RM-1104,1/1/2014,0,0,0,0,0,0,0
2230,RM-1104,1/2/2014,0,0,0,0,0,0,0
2231,RM-1104,1/3/2014,0,0,0,0,0,0,0
2232,RM-1104,1/4/2014,0,0,0,0,0,0,0
2233,RM-1104,1/5/2014,0,0,0,0,0,0,0
2234,RM-1104,1/6/2014,0,0,0,0,0,0,0
2235,RM-1104,1/7/2014,0,0,0,0,0,0,0
2237,RM-1104,1/9/2014,0,0,0,0,0,0,0
2241,RM-1104,1/13/2014,0,0,0,0,0,0,0
2242,RM-1104,1/14/2014,0,0,0,0,0,0,0
2375,RM-1104,5/27/2014,0,0,0,0,0,0,0
2376,RM-1104,5/28/2014,0,0,0,0,0,0,0
2377,RM-1104,5/29/2014,0,0,0,0,0,0,0
2378,RM-1104,5/30/2014,0,0,0,0,0,0,0
2379,RM-1104,5/31/2014,0,0,0,0,0,0,0
2380,RM-1104,6/1/2014,0,0,0,0,0,0,0
2381,RM-1104,6/2/2014,0,0,0,0,0,0,0
2382,RM-1104,6/3/2014,0,0,0,0,0,0,0
2383,RM-1104,6/4/2014,0,0,0,0,0,0,0
2384,RM-1104,6/5/2014,0,0,0,0,0,0,0
2385,RM-1104,6/6/2014,0,0,0,0,0,0,0
2386,RM-1104,6/7/2014,0,0,0,0,0,0,0
2387,RM-1104,6/8/2014,0,0,0,0,0,0,0
2388,RM-1104,6/9/2014,0,0,0,0,0,0,0
2389,RM-1104,6/10/2014,0,0,0,0,0,0,0
2390,RM-1104,6/11/2014,0,0,0,0,0,0,0
2391,RM-1104,6/12/2014,0,0,0,0,0,0,0
2392,RM-1104,6/13/2014,0,0,0,0,0,0,0
2393,RM-1104,6/14/2014,0,0,0,0,0,0,0
2394,RM-1104,6/15/2014,0,0,0,0,0,0,0
2395,RM-1104,6/16/2014,0,0,0,0,0,0,0
2396,RM-1104,6/17/2014,0,0,0,0,0,0,0
2397,RM-1104,6/18/2014,0,0,0,0,0,0,0
2398,RM-1104,6/19/2014,0,0,0,0,0,0,0
2399,RM-1104,6/20/2014,0,0,0,0,0,0,0
2400,RM-1104,6/21/2014,0,0,0,0,0,0,0
2401,RM-1104,6/22/2014,0,0,0,0,0,0,0
2402,RM-1104,6/23/2014,0,0,0,0,0,0,0
2403,RM-1104,6/24/2014,0,0,0,0,0,0,0
2404,RM-1104,6/25/2014,0,0,0,0,0,0,0
2405,RM-1104,6/26/2014,0,0,0,0,0,0,0
2406,RM-1104,6/27/2014,0,0,0,0,0,0,0
2407,RM-1104,6/28/2014,0,0,0,0,0,0,0
2408,RM-1104,6/29/2014,0,0,0,0,0,0,0
2409,RM-1104,6/30/2014,0,0,0,0,0,0,0
2410,RM-1104,7/1/2014,0,0,0,0,0,0,0
2411,RM-1104,7/2/2014,0,0,0,0,0,0,0
2412,RM-1104,7/3/2014,0,0,0,0,0,0,0
2413,RM-1104,7/4/2014,0,0,0,0,0,0,0
2414,RM-1104,7/5/2014,0,0,0,0,0,0,0
2415,RM-1104,7/6/2014,0,0,0,0,0,0,0
2416,RM-1104,7/7/2014,0,0,0,0,0,0,0
2417,RM-1104,7/8/2014,0,0,0,0,0,0,0
2418,RM-1104,7/9/2014,0,0,0,0,0,0,0
2419,RM-1104,7/10/2014,0,0,0,0,0,0,0
2420,RM-1104,7/11/2014,0,0,0,0,0,0,0
2421,RM-1104,7/12/2014,0,0,0,0,0,0,0
2422,RM-1104,7/13/2014,0,0,0,0,0,0,0
2423,RM-1104,7/14/2014,0,0,0,0,0,0,0
2424,RM-1104,7/15/2014,0,0,0,0,0,0,0
2425,RM-1104,7/16/2014,0,0,0,0,0,0,0
2426,RM-1104,7/17/2014,0,0,0,0,0,0,0
2427,RM-1104,7/18/2014,0,0,0,0,0,0,0
2428,RM-1104,7/19/2014,0,0,0,0,0,0,0
2429,RM-1104,7/20/2014,0,0,0,0,0,0,0
2430,RM-1104,7/21/2014,0,0,0,0,0,0,0
2431,RM-1104,7/22/2014,0,0,0,0,0,0,0
2432,RM-1104,7/23/2014,0,0,0,0,0,0,0
2433,RM-1104,7/24/2014,0,0,0,0,0,0,0
2434,RM-1104,7/25/2014,0,0,0,0,0,0,0
2435,RM-1104,7/26/2014,0,0,0,0,0,0,0
2436,RM-1104,7/27/2014,0,0,0,0,0,0,0
2437,RM-1104,7/28/2014,0,0,0,0,0,0,0
2438,RM-1104,7/29/2014,0,0,0,0,0,0,0
2439,RM-1104,7/30/2014,0,0,0,0,0,0,0
2440,RM-1104,7/31/2014,0,0,0,0,0,0,0
2441,RM-1104,8/1/2014,0,0,0,0,0,0,0
2442,RM-1104,8/2/2014,0,0,0,0,0,0,0
2443,RM-1104,8/3/2014,0,0,0,0,0,0,0
2444,RM-1104,8/4/2014,0,0,0,0,0,0,0
2445,RM-1104,8/5/2014,0,0,0,0,0,0,0
2446,RM-1104,8/6/2014,0,0,0,0,0,0,0
2447,RM-1104,8/7/2014,0,0,0,0,0,0,0
2448,RM-1104,8/8/2014,0,0,0,0,0,0,0
2449,RM-1104,8/9/2014,0,0,0,0,0,0,0
2450,RM-1104,8/10/2014,0,0,0,0,0,0,0
2451,RM-1104,8/11/2014,0,0,0,0,0,0,0
2452,RM-1104,8/12/2014,0,0,0,0,0,0,0
2453,RM-1104,8/13/2014,0,0,0,0,0,0,0
2454,RM-1104,8/14/2014,0,0,0,0,0,0,0
2455,RM-1104,8/15/2014,0,0,0,0,0,0,0
2456,RM-1104,8/16/2014,0,0,0,0,0,0,0
2457,RM-1104,8/17/2014,0,0,0,0,0,0,0
2458,RM-1104,8/18/2014,0,0,0,0,0,0,0
2459,RM-1104,8/19/2014,0,0,0,0,0,0,0
2460,RM-1104,8/20/2014,0,0,0,0,0,0,0
2461,RM-1104,8/21/2014,0,0,0,0,0,0,0
2462,RM-1104,8/22/2014,0,0,0,0,0,0,0
2463,RM-1104,8/23/2014,0,0,0,0,0,0,0
2464,RM-1104,8/24/2014,0,0,0,0,0,0,0
2465,RM-1104,8/25/2014,0,0,0,0,0,0,0
2466,RM-1104,8/26/2014,0,0,0,0,0,0,0
2467,RM-1104,8/27/2014,0,0,0,0,0,0,0
2468,RM-1104,8/28/2014,0,0,0,0,0,0,0
2469,RM-1104,8/29/2014,0,0,0,0,0,0,0
2470,RM-1104,8/30/2014,0,0,0,0,0,0,0
2471,RM-1104,8/31/2014,0,0,0,0,0,0,0
2472,RM-1104,9/1/2014,0,0,0,0,0,0,0
2473,RM-1104,9/2/2014,0,0,0,0,0,0,0
2474,RM-1104,9/3/2014,0,0,0,0,0,0,0
2475,RM-1104,9/4/2014,0,0,0,0,0,0,0
2476,RM-1104,9/5/2014,0,0,0,0,0,0,0
2477,RM-1104,9/6/2014,0,0,0,0,0,0,0
2478,RM-1104,9/7/2014,0,0,0,0,0,0,0
2479,RM-1104,9/8/2014,0,0,0,0,0,0,0
2480,RM-1104,9/9/2014,0,0,0,0,0,0,0
2481,RM-1104,9/10/2014,0,0,0,0,0,0,0
2482,RM-1104,9/11/2014,0,0,0,0,0,0,0
2483,RM-1104,9/12/2014,0,0,0,0,0,0,0
2484,RM-1104,9/13/2014,0,0,0,0,0,0,0
2485,RM-1104,9/14/2014,0,0,0,0,0,0,0
2486,RM-1104,9/15/2014,0,0,0,0,0,0,0
2487,RM-1104,9/16/2014,0,0,0,0,0,0,0
2488,RM-1104,9/17/2014,0,0,0,0,0,0,0
2489,RM-1104,9/18/2014,0,0,0,0,0,0,0
2490,RM-1104,9/19/2014,0,0,0,0,0,0,0
2491,RM-1104,9/20/2014,0,0,0,0,0,0,0
2492,RM-1104,9/21/2014,0,0,0,0,0,0,0
2493,RM-1104,9/22/2014,0,0,0,0,0,0,0
2494,RM-1104,9/23/2014,0,0,0,0,0,0,0
2495,RM-1104,9/24/2014,0,0,0,0,0,0,0
2496,RM-1104,9/25/2014,0,0,0,0,0,0,0
2497,RM-1104,9/28/2014,0,0,0,0,0,0,0
2498,RM-1104,9/29/2014,0,0,0,0,0,0,0
2499,RM-1104,9/30/2014,0,0,0,0,0,0,0
2500,RM-1104,10/1/2014,0,0,0,0,0,0,0
2501,RM-1104,10/2/2014,0,0,0,0,0,0,0
2502,RM-1104,10/3/2014,0,0,0,0,0,0,0
2503,RM-1104,10/4/2014,0,0,0,0,0,0,0
2504,RM-1104,10/5/2014,0,0,0,0,0,0,0
2505,RM-1104,10/6/2014,0,0,0,0,0,0,0
2506,RM-1104,10/7/2014,0,0,0,0,0,0,0
2507,RM-1104,10/8/2014,0,0,0,0,0,0,0
2508,RM-1104,10/9/2014,0,0,0,0,0,0,0
2509,RM-1104,10/10/2014,0,0,0,0,0,0,0
2510,RM-1104,10/11/2014,0,0,0,0,0,0,0
2511,RM-1104,10/12/2014,0,0,0,0,0,0,0
2512,RM-1104,10/13/2014,0,0,0,0,0,0,0
2513,RM-1104,10/14/2014,0,0,0,0,0,0,0
2514,RM-1104,10/15/2014,0,0,0,0,0,0,0
2515,RM-1104,10/16/2014,0,0,0,0,0,0,0
2516,RM-1104,10/17/2014,0,0,0,0,0,0,0
2517,RM-1104,10/18/2014,0,0,0,0,0,0,0
2518,RM-1104,10/19/2014,0,0,0,0,0,0,0
2519,RM-1104,10/20/2014,0,0,0,0,0,0,0
2520,RM-1104,10/21/2014,0,0,0,0,0,0,0
2521,RM-1104,10/22/2014,0,0,0,0,0,0,0
2522,RM-1104,10/23/2014,0,0,0,0,0,0,0
2523,RM-1104,10/24/2014,0,0,0,0,0,0,0
2524,RM-1104,10/25/2014,0,0,0,0,0,0,0
2525,RM-1104,10/26/2014,0,0,0,0,0,0,0
2526,RM-1104,10/27/2014,0,0,0,0,0,0,0
2527,RM-1104,10/28/2014,0,0,0,0,0,0,0
2528,RM-1104,10/29/2014,0,0,0,0,0,0,0
2529,RM-1104,10/30/2014,0,0,0,0,0,0,0
2530,RM-1104,10/31/2014,0,0,0,0,0,0,0
2531,RM-1104,11/1/2014,0,0,0,0,0,0,0
2532,RM-1104,11/2/2014,0,0,0,0,0,0,0
2533,RM-1104,11/3/2014,0,0,0,0,0,0,0
2534,RM-1104,11/4/2014,0,0,0,0,0,0,0
2535,RM-1104,11/5/2014,0,0,0,0,0,0,0
2536,RM-1104,11/6/2014,0,0,0,0,0,0,0
2537,RM-1104,11/7/2014,0,0,0,0,0,0,0
2538,RM-1104,11/8/2014,0,0,0,0,0,0,0
2539,RM-1104,11/9/2014,0,0,0,0,0,0,0
2540,RM-1104,11/10/2014,0,0,0,0,0,0,0
2541,RM-1104,11/11/2014,0,0,0,0,0,0,0
2542,RM-1104,11/12/2014,0,0,0,0,0,0,0
2543,RM-1104,11/13/2014,0,0,0,0,0,0,0
2544,RM-1104,11/14/2014,0,0,0,0,0,0,0
2545,RM-1104,11/15/2014,0,0,0,0,0,0,0
2546,RM-1104,11/16/2014,0,0,0,0,0,0,0
2547,RM-1104,11/17/2014,0,0,0,0,0,0,0
2548,RM-1104,11/18/2014,0,0,0,0,0,0,0
2549,RM-1104,11/19/2014,0,0,0,0,0,0,0
2550,RM-1104,11/20/2014,0,0,0,0,0,0,0
2551,RM-1104,11/21/2014,0,0,0,0,0,0,0
2552,RM-1104,11/22/2014,0,0,0,0,0,0,0
2553,RM-1104,11/23/2014,0,0,0,0,0,0,0
2554,RM-1104,11/24/2014,0,0,0,0,0,0,0
2555,RM-1104,11/25/2014,0,0,0,0,0,0,0
2556,RM-1104,11/26/2014,0,0,0,0,0,0,0
2557,RM-1104,11/27/2014,0,0,0,0,0,0,0
2558,RM-1104,11/28/2014,0,0,0,0,0,0,0
2559,RM-1104,11/29/2014,0,0,0,0,0,0,0
2560,RM-1104,11/30/2014,0,0,0,0,0,0,0
2561,RM-1104,12/1/2014,0,0,0,0,0,0,0
2562,RM-1104,12/2/2014,0,0,0,0,0,0,0
2563,RM-1104,12/3/2014,0,0,0,0,0,0,0
2564,RM-1104,12/4/2014,0,0,0,0,0,0,0
2565,RM-1104,12/5/2014,0,0,0,0,0,0,0
2566,RM-1104,12/6/2014,0,0,0,0,0,0,0
2567,RM-1104,12/7/2014,0,0,0,0,0,0,0
2568,RM-1104,12/8/2014,0,0,0,0,0,0,0
2569,RM-1104,12/9/2014,0,0,0,0,0,0,0
2570,RM-1104,12/10/2014,0,0,0,0,0,0,0
2571,RM-1104,12/11/2014,0,0,0,0,0,0,0
2572,RM-1104,12/12/2014,0,0,0,0,0,0,0
2573,RM-1104,12/13/2014,0,0,0,0,0,0,0
2574,RM-1104,12/14/2014,0,0,0,0,0,0,0
2575,RM-1104,12/15/2014,0,0,0,0,0,0,0
2576,RM-1104,12/16/2014,0,0,0,0,0,0,0
2577,RM-1104,12/17/2014,0,0,0,0,0,0,0
2578,RM-1104,12/18/2014,0,0,0,0,0,0,0
2579,RM-1104,12/19/2014,0,0,0,0,0,0,0
2580,RM-1104,12/20/2014,0,0,0,0,0,0,0
2581,RM-1104,12/21/2014,0,0,0,0,0,0,0
2582,RM-1104,12/22/2014,0,0,0,0,0,0,0
2583,RM-1104,12/23/2014,0,0,0,0,0,0,0
2584,RM-1104,12/24/2014,0,0,0,0,0,0,0
2585,RM-1104,12/25/2014,0,0,0,0,0,0,0
2586,RM-1104,12/26/2014,0,0,0,0,0,0,0
2587,RM-1104,12/27/2014,0,0,0,0,0,0,0
2588,RM-1104,12/28/2014,0,0,0,0,0,0,0
2589,RM-1104,12/29/2014,0,0,0,0,0,0,0
2590,RM-1104,12/30/2014,0,0,0,0,0,0,0
2591,RM-1104,12/31/2014,0,0,0,0,0,0,0
2592,RM-1104,1/1/2015,0,0,0,0,0,0,0
2593,RM-1104,1/2/2015,0,0,0,0,0,0,0
2594,RM-1104,2/19/2015,0,0,0,0,0,0,0
2595,RM-1104,2/20/2015,0,0,0,0,0,0,0
2596,RM-1104,2/21/2015,0,0,0,0,0,0,0
2597,RM-1104,2/22/2015,0,0,0,0,0,0,0
2598,RM-1104,2/23/2015,0,0,0,0,0,0,0
2599,RM-1104,2/24/2015,0,0,0,0,0,0,0
2600,RM-1104,2/25/2015,0,0,0,0,0,0,0
2601,RM-1104,2/26/2015,0,0,0,0,0,0,0
2602,RM-1104,2/27/2015,0,0,0,0,0,0,0
2603,RM-1104,2/28/2015,0,0,0,0,0,0,0
2604,RM-1104,3/1/2015,0,0,0,0,0,0,0
2605,RM-1104,3/2/2015,0,0,0,0,0,0,0
2606,RM-1104,3/3/2015,0,0,0,0,0,0,0
2607,RM-1104,3/4/2015,0,0,0,0,0,0,0
2608,RM-1104,3/5/2015,0,0,0,0,0,0,0
2609,RM-1104,3/6/2015,0,0,0,0,0,0,0
2610,RM-1104,3/7/2015,0,0,0,0,0,0,0
2611,RM-1104,3/8/2015,0,0,0,0,0,0,0
2612,RM-1104,3/9/2015,0,0,0,0,0,0,0
2613,RM-1104,3/10/2015,0,0,0,0,0,0,0
2614,RM-1104,3/11/2015,0,0,0,0,0,0,0
2615,RM-1104,3/12/2015,0,0,0,0,0,0,0
2616,RM-1104,3/13/2015,0,0,0,0,0,0,0
2617,RM-1104,3/14/2015,0,0,0,0,0,0,0
2618,RM-1104,3/15/2015,0,0,0,0,0,0,0
2619,RM-1104,3/16/2015,0,0,0,0,0,0,0
2620,RM-1104,3/17/2015,0,0,0,0,0,0,0
2621,RM-1104,3/18/2015,0,0,0,0,0,0,0
2622,RM-1104,3/19/2015,0,0,0,0,0,0,0
2623,RM-1104,3/20/2015,0,0,0,0,0,0,0
2624,RM-1104,3/21/2015,0,0,0,0,0,0,0
2625,RM-1104,3/22/2015,0,0,0,0,0,0,0
2626,RM-1104,3/23/2015,0,0,0,0,0,0,0
2627,RM-1104,3/24/2015,0,0,0,0,0,0,0
2628,RM-1104,3/25/2015,0,0,0,0,0,0,0
2629,RM-1104,3/26/2015,0,0,0,0,0,0,0
2630,RM-1104,3/27/2015,0,0,0,0,0,0,0
2631,RM-1104,3/28/2015,0,0,0,0,0,0,0
2632,RM-1104,3/29/2015,0,0,0,0,0,0,0
2633,RM-1104,3/30/2015,0,0,0,0,0,0,0
2634,RM-1104,3/31/2015,0,0,0,0,0,0,0
2635,RM-1104,4/1/2015,0,0,0,0,0,0,0
2636,RM-1104,4/2/2015,0,0,0,0,0,0,0
2637,RM-1104,4/3/2015,0,0,0,0,0,0,0
2638,RM-1104,4/4/2015,0,0,0,0,0,0,0
2639,RM-1104,4/5/2015,0,0,0,0,0,0,0
2640,RM-1104,4/6/2015,0,0,0,0,0,0,0
2641,RM-1104,4/7/2015,0,0,0,0,0,0,0
2642,RM-1104,4/8/2015,0,0,0,0,0,0,0
2643,RM-1104,4/9/2015,0,0,0,0,0,0,0
2644,RM-1104,4/10/2015,0,0,0,0,0,0,0
2645,RM-1104,4/11/2015,0,0,0,0,0,0,0
2646,RM-1104,4/12/2015,0,0,0,0,0,0,0
2647,RM-1104,4/13/2015,0,0,0,0,0,0,0
2648,RM-1104,4/14/2015,0,0,0,0,0,0,0
2649,RM-1104,4/15/2015,0,0,0,0,0,0,0
2650,RM-1104,4/16/2015,0,0,0,0,0,0,0
2651,RM-1104,4/17/2015,0,0,0,0,0,0,0
2652,RM-1104,4/18/2015,0,0,0,0,0,0,0
2653,RM-1104,4/19/2015,0,0,0,0,0,0,0
2654,RM-1104,4/20/2015,0,0,0,0,0,0,0
2655,RM-1104,4/21/2015,0,0,0,0,0,0,0
2656,RM-1104,4/22/2015,0,0,0,0,0,0,0
2657,RM-1104,4/23/2015,0,0,0,0,0,0,0
2658,RM-1104,4/24/2015,0,0,0,0,0,0,0
2659,RM-1104,4/25/2015,0,0,0,0,0,0,0
2660,RM-1104,4/26/2015,0,0,0,0,0,0,0
2661,RM-1104,4/27/2015,0,0,0,0,0,0,0
2662,RM-1104,4/28/2015,0,0,0,0,0,0,0
2663,RM-1104,4/29/2015,0,0,0,0,0,0,0
2664,RM-1104,4/30/2015,0,0,0,0,0,0,0
2665,RM-1104,5/1/2015,0,0,0,0,0,0,0
2666,RM-1104,5/2/2015,0,0,0,0,0,0,0
2667,RM-1104,5/3/2015,0,0,0,0,0,0,0
2668,RM-1104,5/4/2015,0,0,0,0,0,0,0
2669,RM-1104,5/5/2015,0,0,0,0,0,0,0
2670,RM-1104,5/6/2015,0,0,0,0,0,0,0
2671,RM-1104,5/7/2015,0,0,0,0,0,0,0
2672,RM-1104,5/8/2015,0,0,0,0,0,0,0
2673,RM-1104,5/9/2015,0,0,0,0,0,0,0
2674,RM-1104,5/10/2015,0,0,0,0,0,0,0
2675,RM-1104,5/11/2015,0,0,0,0,0,0,0
2676,RM-1104,5/12/2015,0,0,0,0,0,0,0
2677,RM-1104,5/13/2015,0,0,0,0,0,0,0
2678,RM-1104,5/14/2015,0,0,0,0,0,0,0
2679,RM-1104,5/15/2015,0,0,0,0,0,0,0
2680,RM-1104,5/16/2015,0,0,0,0,0,0,0
2681,RM-1104,5/17/2015,0,0,0,0,0,0,0
2682,RM-1104,5/18/2015,0,0,0,0,0,0,0
2683,RM-1104,5/19/2015,0,0,0,0,0,0,0
2684,RM-1104,5/20/2015,0,0,0,0,0,0,0
2685,RM-1104,5/21/2015,0,0,0,0,0,0,0
2686,RM-1104,5/22/2015,0,0,0,0,0,0,0
2687,RM-1104,5/23/2015,0,0,0,0,0,0,0
2688,RM-1104,5/24/2015,0,0,0,0,0,0,0
2689,RM-1104,5/25/2015,0,0,0,0,0,0,0
2690,RM-1104,5/26/2015,0,0,0,0,0,0,0
2691,RM-1104,5/27/2015,0,0,0,0,0,0,0
2692,RM-1104,5/28/2015,0,0,0,0,0,0,0
2693,RM-1104,5/29/2015,0,0,0,0,0,0,0
2694,RM-1104,5/30/2015,0,0,0,0,0,0,0
2695,RM-1104,5/31/2015,0,0,0,0,0,0,0
3053,RM-1106,7/3/2014,0,0,0,0,0,0,0
3054,RM-1106,7/4/2014,0,0,0,0,0,0,0
3055,RM-1106,7/5/2014,0,0,0,0,0,0,0
3056,RM-1106,7/6/2014,0,0,0,0,0,0,0
3057,RM-1106,7/7/2014,0,0,0,0,0,0,0
3058,RM-1106,7/8/2014,0,0,0,0,0,0,0
3059,RM-1106,7/9/2014,0,0,0,0,0,0,0
3060,RM-1106,7/10/2014,0,0,0,0,0,0,0
3061,RM-1106,7/11/2014,0,0,0,0,0,0,0
3062,RM-1106,7/12/2014,0,0,0,0,0,0,0
3063,RM-1106,7/13/2014,0,0,0,0,0,0,0
3064,RM-1106,7/14/2014,0,0,0,0,0,0,0
3065,RM-1106,7/15/2014,0,0,0,0,0,0,0
3066,RM-1106,7/16/2014,0,0,0,0,0,0,0
3067,RM-1106,7/17/2014,0,0,0,0,0,0,0
3068,RM-1106,7/18/2014,0,0,0,0,0,0,0
3069,RM-1106,7/19/2014,0,0,0,0,0,0,0
3070,RM-1106,7/20/2014,0,0,0,0,0,0,0
3071,RM-1106,7/21/2014,0,0,0,0,0,0,0
3072,RM-1106,7/22/2014,0,0,0,0,0,0,0
3073,RM-1106,7/23/2014,0,0,0,0,0,0,0
3074,RM-1106,7/24/2014,0,0,0,0,0,0,0
3075,RM-1106,7/25/2014,0,0,0,0,0,0,0
3076,RM-1106,7/26/2014,0,0,0,0,0,0,0
3077,RM-1106,7/27/2014,0,0,0,0,0,0,0
3078,RM-1106,7/28/2014,0,0,0,0,0,0,0
3079,RM-1106,7/29/2014,0,0,0,0,0,0,0
3080,RM-1106,7/30/2014,0,0,0,0,0,0,0
3081,RM-1106,7/31/2014,0,0,0,0,0,0,0
3082,RM-1106,8/1/2014,0,0,0,0,0,0,0
3083,RM-1106,8/2/2014,0,0,0,0,0,0,0
3084,RM-1106,8/3/2014,0,0,0,0,0,0,0
3085,RM-1106,8/4/2014,0,0,0,0,0,0,0
3086,RM-1106,8/5/2014,0,0,0,0,0,0,0
3087,RM-1106,8/6/2014,0,0,0,0,0,0,0
3088,RM-1106,8/7/2014,0,0,0,0,0,0,0
3089,RM-1106,8/8/2014,0,0,0,0,0,0,0
3090,RM-1106,8/9/2014,0,0,0,0,0,0,0
3091,RM-1106,8/10/2014,0,0,0,0,0,0,0
3092,RM-1106,8/11/2014,0,0,0,0,0,0,0
3093,RM-1106,8/12/2014,0,0,0,0,0,0,0
3094,RM-1106,8/13/2014,0,0,0,0,0,0,0
3095,RM-1106,8/14/2014,0,0,0,0,0,0,0
3096,RM-1106,8/15/2014,0,0,0,0,0,0,0
3097,RM-1106,8/16/2014,0,0,0,0,0,0,0
3098,RM-1106,8/17/2014,0,0,0,0,0,0,0
3099,RM-1106,8/18/2014,0,0,0,0,0,0,0
3100,RM-1106,8/19/2014,0,0,0,0,0,0,0
3101,RM-1106,8/20/2014,0,0,0,0,0,0,0
3102,RM-1106,8/21/2014,0,0,0,0,0,0,0
3103,RM-1106,8/22/2014,0,0,0,0,0,0,0
3104,RM-1106,8/23/2014,0,0,0,0,0,0,0
3105,RM-1106,8/24/2014,0,0,0,0,0,0,0
3106,RM-1106,8/25/2014,0,0,0,0,0,0,0
3107,RM-1106,8/26/2014,0,0,0,0,0,0,0
3108,RM-1106,8/27/2014,0,0,0,0,0,0,0
3109,RM-1106,8/28/2014,0,0,0,0,0,0,0
3110,RM-1106,8/29/2014,0,0,0,0,0,0,0
3111,RM-1106,8/30/2014,0,0,0,0,0,0,0
3112,RM-1106,8/31/2014,0,0,0,0,0,0,0
3113,RM-1106,9/1/2014,0,0,0,0,0,0,0
3114,RM-1106,9/2/2014,0,0,0,0,0,0,0
3115,RM-1106,9/3/2014,0,0,0,0,0,0,0
3116,RM-1106,9/4/2014,0,0,0,0,0,0,0
3117,RM-1106,9/5/2014,0,0,0,0,0,0,0
3118,RM-1106,9/6/2014,0,0,0,0,0,0,0
3119,RM-1106,9/7/2014,0,0,0,0,0,0,0
3120,RM-1106,9/8/2014,0,0,0,0,0,0,0
3121,RM-1106,9/9/2014,0,0,0,0,0,0,0
3122,RM-1106,9/10/2014,0,0,0,0,0,0,0
3123,RM-1106,9/11/2014,0,0,0,0,0,0,0
3124,RM-1106,9/12/2014,0,0,0,0,0,0,0
3125,RM-1106,9/13/2014,0,0,0,0,0,0,0
3126,RM-1106,9/14/2014,0,0,0,0,0,0,0
3127,RM-1106,9/15/2014,0,0,0,0,0,0,0
3128,RM-1106,9/16/2014,0,0,0,0,0,0,0
3129,RM-1106,9/17/2014,0,0,0,0,0,0,0
3130,RM-1106,9/18/2014,0,0,0,0,0,0,0
3131,RM-1106,9/19/2014,0,0,0,0,0,0,0
3132,RM-1106,9/20/2014,0,0,0,0,0,0,0
3133,RM-1106,9/21/2014,0,0,0,0,0,0,0
3134,RM-1106,9/22/2014,0,0,0,0,0,0,0
3135,RM-1106,9/23/2014,0,0,0,0,0,0,0
3136,RM-1106,9/24/2014,0,0,0,0,0,0,0
3137,RM-1106,9/25/2014,0,0,0,0,0,0,0
3138,RM-1106,9/28/2014,0,0,0,0,0,0,0
3139,RM-1106,9/29/2014,0,0,0,0,0,0,0
3140,RM-1106,9/30/2014,0,0,0,0,0,0,0
3141,RM-1106,10/1/2014,0,0,0,0,0,0,0
3142,RM-1106,10/2/2014,0,0,0,0,0,0,0
3143,RM-1106,10/3/2014,0,0,0,0,0,0,0
3144,RM-1106,10/4/2014,0,0,0,0,0,0,0
3145,RM-1106,10/5/2014,0,0,0,0,0,0,0
3146,RM-1106,10/6/2014,0,0,0,0,0,0,0
3147,RM-1106,10/7/2014,0,0,0,0,0,0,0
3148,RM-1106,10/8/2014,0,0,0,0,0,0,0
3149,RM-1106,10/9/2014,0,0,0,0,0,0,0
3150,RM-1106,10/10/2014,0,0,0,0,0,0,0
3151,RM-1106,10/11/2014,0,0,0,0,0,0,0
3152,RM-1106,10/12/2014,0,0,0,0,0,0,0
3153,RM-1106,10/13/2014,0,0,0,0,0,0,0
3154,RM-1106,10/14/2014,0,0,0,0,0,0,0
3155,RM-1106,10/15/2014,0,0,0,0,0,0,0
3156,RM-1106,10/16/2014,0,0,0,0,0,0,0
3157,RM-1106,10/17/2014,0,0,0,0,0,0,0
3158,RM-1106,10/18/2014,0,0,0,0,0,0,0
3159,RM-1106,10/19/2014,0,0,0,0,0,0,0
3160,RM-1106,10/20/2014,0,0,0,0,0,0,0
3161,RM-1106,10/21/2014,0,0,0,0,0,0,0
3162,RM-1106,10/22/2014,0,0,0,0,0,0,0
3163,RM-1106,10/23/2014,0,0,0,0,0,0,0
3164,RM-1106,10/24/2014,0,0,0,0,0,0,0
3165,RM-1106,10/25/2014,0,0,0,0,0,0,0
3166,RM-1106,10/26/2014,0,0,0,0,0,0,0
3167,RM-1106,10/27/2014,0,0,0,0,0,0,0
3168,RM-1106,10/28/2014,0,0,0,0,0,0,0
3169,RM-1106,10/29/2014,0,0,0,0,0,0,0
3170,RM-1106,10/30/2014,0,0,0,0,0,0,0
3171,RM-1106,10/31/2014,0,0,0,0,0,0,0
3172,RM-1106,11/1/2014,0,0,0,0,0,0,0
3173,RM-1106,11/2/2014,0,0,0,0,0,0,0
3174,RM-1106,11/3/2014,0,0,0,0,0,0,0
3175,RM-1106,11/4/2014,0,0,0,0,0,0,0
3176,RM-1106,11/5/2014,0,0,0,0,0,0,0
3177,RM-1106,11/6/2014,0,0,0,0,0,0,0
3178,RM-1106,11/7/2014,0,0,0,0,0,0,0
3179,RM-1106,11/8/2014,0,0,0,0,0,0,0
3180,RM-1106,11/9/2014,0,0,0,0,0,0,0
3181,RM-1106,11/10/2014,0,0,0,0,0,0,0
3182,RM-1106,11/11/2014,0,0,0,0,0,0,0
3183,RM-1106,11/12/2014,0,0,0,0,0,0,0
3184,RM-1106,11/13/2014,0,0,0,0,0,0,0
3185,RM-1106,11/14/2014,0,0,0,0,0,0,0
3186,RM-1106,11/15/2014,0,0,0,0,0,0,0
3187,RM-1106,11/16/2014,0,0,0,0,0,0,0
3188,RM-1106,11/17/2014,0,0,0,0,0,0,0
3189,RM-1106,11/18/2014,0,0,0,0,0,0,0
3190,RM-1106,11/19/2014,0,0,0,0,0,0,0
3191,RM-1106,11/20/2014,0,0,0,0,0,0,0
3192,RM-1106,11/21/2014,0,0,0,0,0,0,0
3193,RM-1106,11/22/2014,0,0,0,0,0,0,0
3194,RM-1106,11/23/2014,0,0,0,0,0,0,0
3195,RM-1106,11/24/2014,0,0,0,0,0,0,0
3196,RM-1106,11/25/2014,0,0,0,0,0,0,0
3197,RM-1106,11/26/2014,0,0,0,0,0,0,0
3198,RM-1106,11/27/2014,0,0,0,0,0,0,0
3199,RM-1106,11/28/2014,0,0,0,0,0,0,0
3200,RM-1106,11/29/2014,0,0,0,0,0,0,0
3201,RM-1106,11/30/2014,0,0,0,0,0,0,0
3202,RM-1106,12/1/2014,0,0,0,0,0,0,0
3203,RM-1106,12/2/2014,0,0,0,0,0,0,0
3204,RM-1106,12/3/2014,0,0,0,0,0,0,0
3205,RM-1106,12/4/2014,0,0,0,0,0,0,0
3206,RM-1106,12/5/2014,0,0,0,0,0,0,0
3207,RM-1106,12/6/2014,0,0,0,0,0,0,0
3208,RM-1106,12/7/2014,0,0,0,0,0,0,0
3209,RM-1106,12/8/2014,0,0,0,0,0,0,0
3210,RM-1106,12/9/2014,0,0,0,0,0,0,0
3211,RM-1106,12/10/2014,0,0,0,0,0,0,0
3212,RM-1106,12/11/2014,0,0,0,0,0,0,0
3213,RM-1106,12/12/2014,0,0,0,0,0,0,0
3214,RM-1106,12/13/2014,0,0,0,0,0,0,0
3215,RM-1106,12/14/2014,0,0,0,0,0,0,0
3216,RM-1106,12/15/2014,0,0,0,0,0,0,0
3217,RM-1106,12/16/2014,0,0,0,0,0,0,0
3218,RM-1106,12/17/2014,0,0,0,0,0,0,0
3219,RM-1106,12/18/2014,0,0,0,0,0,0,0
3220,RM-1106,12/19/2014,0,0,0,0,0,0,0
3221,RM-1106,12/20/2014,0,0,0,0,0,0,0
3222,RM-1106,12/21/2014,0,0,0,0,0,0,0
3223,RM-1106,12/22/2014,0,0,0,0,0,0,0
3224,RM-1106,12/23/2014,0,0,0,0,0,0,0
3225,RM-1106,12/24/2014,0,0,0,0,0,0,0
3226,RM-1106,12/25/2014,0,0,0,0,0,0,0
3227,RM-1106,12/26/2014,0,0,0,0,0,0,0
3228,RM-1106,12/27/2014,0,0,0,0,0,0,0
3229,RM-1106,12/28/2014,0,0,0,0,0,0,0
3230,RM-1106,12/29/2014,0,0,0,0,0,0,0
3231,RM-1106,12/30/2014,0,0,0,0,0,0,0
3232,RM-1106,12/31/2014,0,0,0,0,0,0,0
3233,RM-1106,1/1/2015,0,0,0,0,0,0,0
3234,RM-1106,1/2/2015,0,0,0,0,0,0,0
3235,RM-1106,1/3/2015,0,0,0,0,0,0,0
3236,RM-1106,1/4/2015,0,0,0,0,0,0,0
3237,RM-1106,1/5/2015,0,0,0,0,0,0,0
3238,RM-1106,1/6/2015,0,0,0,0,0,0,0
3239,RM-1106,1/7/2015,0,0,0,0,0,0,0
3240,RM-1106,1/8/2015,0,0,0,0,0,0,0
3241,RM-1106,1/9/2015,0,0,0,0,0,0,0
3242,RM-1106,1/10/2015,0,0,0,0,0,0,0
3243,RM-1106,1/11/2015,0,0,0,0,0,0,0
3244,RM-1106,1/12/2015,0,0,0,0,0,0,0
3245,RM-1106,1/13/2015,0,0,0,0,0,0,0
3246,RM-1106,1/14/2015,0,0,0,0,0,0,0
3247,RM-1106,1/15/2015,0,0,0,0,0,0,0
3248,RM-1106,1/16/2015,0,0,0,0,0,0,0
3249,RM-1106,1/17/2015,0,0,0,0,0,0,0
3250,RM-1106,1/18/2015,0,0,0,0,0,0,0
3251,RM-1106,1/19/2015,0,0,0,0,0,0,0
3252,RM-1106,1/20/2015,0,0,0,0,0,0,0
3253,RM-1106,1/21/2015,0,0,0,0,0,0,0
3254,RM-1106,1/22/2015,0,0,0,0,0,0,0
3255,RM-1106,1/23/2015,0,0,0,0,0,0,0
3256,RM-1106,1/24/2015,0,0,0,0,0,0,0
3257,RM-1106,1/25/2015,0,0,0,0,0,0,0
3258,RM-1106,1/26/2015,0,0,0,0,0,0,0
3259,RM-1106,1/27/2015,0,0,0,0,0,0,0
3260,RM-1106,1/28/2015,0,0,0,0,0,0,0
3261,RM-1106,1/29/2015,0,0,0,0,0,0,0
3262,RM-1106,1/30/2015,0,0,0,0,0,0,0
3263,RM-1106,1/31/2015,0,0,0,0,0,0,0
3264,RM-1106,2/1/2015,0,0,0,0,0,0,0
3265,RM-1106,2/2/2015,0,0,0,0,0,0,0
3266,RM-1106,2/3/2015,0,0,0,0,0,0,0
3267,RM-1106,2/4/2015,0,0,0,0,0,0,0
3268,RM-1106,2/5/2015,0,0,0,0,0,0,0
3269,RM-1106,2/6/2015,0,0,0,0,0,0,0
3270,RM-1106,2/7/2015,0,0,0,0,0,0,0
3271,RM-1106,2/8/2015,0,0,0,0,0,0,0
3272,RM-1106,2/9/2015,0,0,0,0,0,0,0
3273,RM-1106,2/10/2015,0,0,0,0,0,0,0
3274,RM-1106,2/11/2015,0,0,0,0,0,0,0
3275,RM-1106,2/12/2015,0,0,0,0,0,0,0
3276,RM-1106,2/13/2015,0,0,0,0,0,0,0
3277,RM-1106,2/14/2015,0,0,0,0,0,0,0
3278,RM-1106,2/15/2015,0,0,0,0,0,0,0
3279,RM-1106,2/16/2015,0,0,0,0,0,0,0
3280,RM-1106,2/17/2015,0,0,0,0,0,0,0
3281,RM-1106,2/18/2015,0,0,0,0,0,0,0
3282,RM-1106,2/19/2015,0,0,0,0,0,0,0
3283,RM-1106,2/20/2015,0,0,0,0,0,0,0
3284,RM-1106,2/21/2015,0,0,0,0,0,0,0
3285,RM-1106,2/22/2015,0,0,0,0,0,0,0
3286,RM-1106,2/23/2015,0,0,0,0,0,0,0
3287,RM-1106,2/24/2015,0,0,0,0,0,0,0
3288,RM-1106,2/25/2015,0,0,0,0,0,0,0
3289,RM-1106,2/26/2015,0,0,0,0,0,0,0
3290,RM-1106,2/27/2015,0,0,0,0,0,0,0
3291,RM-1106,2/28/2015,0,0,0,0,0,0,0
3292,RM-1106,3/1/2015,0,0,0,0,0,0,0
3293,RM-1106,3/2/2015,0,0,0,0,0,0,0
3294,RM-1106,3/3/2015,0,0,0,0,0,0,0
3295,RM-1106,3/4/2015,0,0,0,0,0,0,0
3296,RM-1106,3/5/2015,0,0,0,0,0,0,0
3297,RM-1106,3/6/2015,0,0,0,0,0,0,0
3298,RM-1106,3/7/2015,0,0,0,0,0,0,0
3299,RM-1106,3/8/2015,0,0,0,0,0,0,0
3300,RM-1106,3/9/2015,0,0,0,0,0,0,0
3301,RM-1106,3/10/2015,0,0,0,0,0,0,0
3302,RM-1106,3/11/2015,0,0,0,0,0,0,0
3303,RM-1106,3/12/2015,0,0,0,0,0,0,0
3304,RM-1106,3/13/2015,0,0,0,0,0,0,0
3305,RM-1106,3/14/2015,0,0,0,0,0,0,0
3306,RM-1106,3/15/2015,0,0,0,0,0,0,0
3307,RM-1106,3/16/2015,0,0,0,0,0,0,0
3308,RM-1106,3/17/2015,0,0,0,0,0,0,0
3309,RM-1106,3/18/2015,0,0,0,0,0,0,0
3310,RM-1106,3/19/2015,0,0,0,0,0,0,0
3311,RM-1106,3/20/2015,0,0,0,0,0,0,0
3312,RM-1106,3/21/2015,0,0,0,0,0,0,0
3313,RM-1106,3/22/2015,0,0,0,0,0,0,0
3314,RM-1106,3/23/2015,0,0,0,0,0,0,0
3315,RM-1106,3/24/2015,0,0,0,0,0,0,0
3316,RM-1106,3/25/2015,0,0,0,0,0,0,0
3317,RM-1106,3/26/2015,0,0,0,0,0,0,0
3318,RM-1106,3/27/2015,0,0,0,0,0,0,0
3319,RM-1106,3/28/2015,0,0,0,0,0,0,0
3320,RM-1106,3/29/2015,0,0,0,0,0,0,0
3321,RM-1106,3/30/2015,0,0,0,0,0,0,0
3322,RM-1106,3/31/2015,0,0,0,0,0,0,0
3323,RM-1106,4/1/2015,0,0,0,0,0,0,0
3324,RM-1106,4/2/2015,0,0,0,0,0,0,0
3325,RM-1106,4/3/2015,0,0,0,0,0,0,0
3326,RM-1106,4/4/2015,0,0,0,0,0,0,0
3327,RM-1106,4/5/2015,0,0,0,0,0,0,0
3328,RM-1106,4/6/2015,0,0,0,0,0,0,0
3329,RM-1106,4/7/2015,0,0,0,0,0,0,0
3330,RM-1106,4/8/2015,0,0,0,0,0,0,0
3331,RM-1106,4/9/2015,0,0,0,0,0,0,0
3332,RM-1106,4/10/2015,0,0,0,0,0,0,0
3333,RM-1106,4/11/2015,0,0,0,0,0,0,0
3334,RM-1106,4/12/2015,0,0,0,0,0,0,0
3335,RM-1106,4/13/2015,0,0,0,0,0,0,0
3336,RM-1106,4/14/2015,0,0,0,0,0,0,0
3337,RM-1106,4/15/2015,0,0,0,0,0,0,0
3338,RM-1106,4/16/2015,0,0,0,0,0,0,0
3339,RM-1106,4/17/2015,0,0,0,0,0,0,0
3340,RM-1106,4/18/2015,0,0,0,0,0,0,0
3341,RM-1106,4/19/2015,0,0,0,0,0,0,0
3342,RM-1106,4/20/2015,0,0,0,0,0,0,0
3343,RM-1106,4/21/2015,0,0,0,0,0,0,0
3344,RM-1106,4/22/2015,0,0,0,0,0,0,0
3345,RM-1106,4/23/2015,0,0,0,0,0,0,0
3346,RM-1106,4/24/2015,0,0,0,0,0,0,0
3347,RM-1106,4/25/2015,0,0,0,0,0,0,0
3348,RM-1106,4/26/2015,0,0,0,0,0,0,0
3349,RM-1106,4/27/2015,0,0,0,0,0,0,0
3350,RM-1106,4/28/2015,0,0,0,0,0,0,0
3351,RM-1106,4/29/2015,0,0,0,0,0,0,0
3352,RM-1106,4/30/2015,0,0,0,0,0,0,0
3353,RM-1106,5/1/2015,0,0,0,0,0,0,0
3354,RM-1106,5/2/2015,0,0,0,0,0,0,0
3355,RM-1106,5/3/2015,0,0,0,0,0,0,0
3356,RM-1106,5/4/2015,0,0,0,0,0,0,0
3357,RM-1106,5/5/2015,0,0,0,0,0,0,0
3358,RM-1106,5/6/2015,0,0,0,0,0,0,0
3359,RM-1106,5/7/2015,0,0,0,0,0,0,0
3360,RM-1106,5/8/2015,0,0,0,0,0,0,0
3361,RM-1106,5/9/2015,0,0,0,0,0,0,0
3362,RM-1106,5/10/2015,0,0,0,0,0,0,0
3363,RM-1106,5/11/2015,0,0,0,0,0,0,0
3364,RM-1106,5/12/2015,0,0,0,0,0,0,0
3365,RM-1106,5/13/2015,0,0,0,0,0,0,0
3366,RM-1106,5/14/2015,0,0,0,0,0,0,0
3367,RM-1106,5/15/2015,0,0,0,0,0,0,0
3368,RM-1106,5/16/2015,0,0,0,0,0,0,0
3369,RM-1106,5/17/2015,0,0,0,0,0,0,0
3370,RM-1106,5/18/2015,0,0,0,0,0,0,0
3371,RM-1106,5/19/2015,0,0,0,0,0,0,0
3372,RM-1106,5/20/2015,0,0,0,0,0,0,0
3373,RM-1106,5/21/2015,0,0,0,0,0,0,0
3374,RM-1106,5/22/2015,0,0,0,0,0,0,0
3375,RM-1106,5/23/2015,0,0,0,0,0,0,0
3376,RM-1106,5/24/2015,0,0,0,0,0,0,0
3377,RM-1106,5/25/2015,0,0,0,0,0,0,0
3378,RM-1106,5/26/2015,0,0,0,0,0,0,0
3379,RM-1106,5/27/2015,0,0,0,0,0,0,0
3380,RM-1106,5/28/2015,0,0,0,0,0,0,0
3381,RM-1106,5/29/2015,0,0,0,0,0,0,0
3382,RM-1106,5/30/2015,0,0,0,0,0,0,0
3383,RM-1106,5/31/2015,0,0,0,0,0,0,0
3454,RM-1107,9/19/2013,0,0,0,0,0,0,0
3455,RM-1107,9/20/2013,0,0,0,0,0,0,0
3456,RM-1107,9/21/2013,0,0,0,0,0,0,0
3457,RM-1107,9/22/2013,0,0,0,0,0,0,0
3458,RM-1107,9/23/2013,0,0,0,0,0,0,0
3459,RM-1107,9/24/2013,0,0,0,0,0,0,0
3460,RM-1107,9/25/2013,0,0,0,0,0,0,0
3461,RM-1107,9/26/2013,0,0,0,0,0,0,0
3462,RM-1107,9/27/2013,0,0,0,0,0,0,0
3463,RM-1107,9/28/2013,0,0,0,0,0,0,0
3464,RM-1107,9/29/2013,0,0,0,0,0,0,0
3465,RM-1107,9/30/2013,0,0,0,0,0,0,0
3466,RM-1107,10/1/2013,0,0,0,0,0,0,0
3467,RM-1107,10/2/2013,0,0,0,0,0,0,0
3468,RM-1107,10/3/2013,0,0,0,0,0,0,0
3469,RM-1107,10/4/2013,0,0,0,0,0,0,0
3470,RM-1107,10/5/2013,0,0,0,0,0,0,0
3471,RM-1107,10/6/2013,0,0,0,0,0,0,0
3472,RM-1107,10/7/2013,0,0,0,0,0,0,0
3473,RM-1107,10/8/2013,0,0,0,0,0,0,0
3474,RM-1107,10/9/2013,0,0,0,0,0,0,0
3475,RM-1107,10/10/2013,0,0,0,0,0,0,0
3476,RM-1107,10/11/2013,0,0,0,0,0,0,0
3477,RM-1107,10/12/2013,0,0,0,0,0,0,0
3478,RM-1107,10/13/2013,0,0,0,0,0,0,0
3479,RM-1107,10/14/2013,0,0,0,0,0,0,0
3480,RM-1107,10/15/2013,0,0,0,0,0,0,0
3481,RM-1107,10/16/2013,0,0,0,0,0,0,0
3482,RM-1107,10/17/2013,0,0,0,0,0,0,0
3483,RM-1107,10/18/2013,0,0,0,0,0,0,0
3484,RM-1107,10/19/2013,0,0,0,0,0,0,0
3485,RM-1107,10/20/2013,0,0,0,0,0,0,0
3486,RM-1107,10/21/2013,0,0,0,0,0,0,0
3487,RM-1107,10/22/2013,0,0,0,0,0,0,0
3488,RM-1107,10/23/2013,0,0,0,0,0,0,0
3489,RM-1107,10/24/2013,0,0,0,0,0,0,0
3490,RM-1107,10/25/2013,0,0,0,0,0,0,0
3491,RM-1107,10/26/2013,0,0,0,0,0,0,0
3492,RM-1107,10/27/2013,0,0,0,0,0,0,0
3493,RM-1107,10/28/2013,0,0,0,0,0,0,0
3494,RM-1107,10/29/2013,0,0,0,0,0,0,0
3495,RM-1107,10/30/2013,0,0,0,0,0,0,0
3496,RM-1107,11/1/2013,0,0,0,0,0,0,0
3497,RM-1107,11/2/2013,0,0,0,0,0,0,0
3498,RM-1107,11/3/2013,0,0,0,0,0,0,0
3499,RM-1107,11/4/2013,0,0,0,0,0,0,0
3500,RM-1107,11/5/2013,0,0,0,0,0,0,0
3501,RM-1107,11/6/2013,0,0,0,0,0,0,0
3502,RM-1107,11/7/2013,0,0,0,0,0,0,0
3503,RM-1107,11/8/2013,0,0,0,0,0,0,0
3504,RM-1107,11/9/2013,0,0,0,0,0,0,0
3505,RM-1107,11/10/2013,0,0,0,0,0,0,0
3506,RM-1107,11/11/2013,0,0,0,0,0,0,0
3507,RM-1107,11/12/2013,0,0,0,0,0,0,0
3508,RM-1107,11/13/2013,0,0,0,0,0,0,0
3509,RM-1107,11/14/2013,0,0,0,0,0,0,0
3510,RM-1107,11/15/2013,0,0,0,0,0,0,0
3511,RM-1107,11/19/2013,0,0,0,0,0,0,0
3512,RM-1107,11/20/2013,0,0,0,0,0,0,0
3513,RM-1107,11/21/2013,0,0,0,0,0,0,0
3514,RM-1107,11/22/2013,0,0,0,0,0,0,0
3515,RM-1107,11/23/2013,0,0,0,0,0,0,0
3516,RM-1107,11/24/2013,0,0,0,0,0,0,0
3517,RM-1107,11/25/2013,0,0,0,0,0,0,0
3518,RM-1107,11/26/2013,0,0,0,0,0,0,0
3519,RM-1107,11/27/2013,0,0,0,0,0,0,0
3520,RM-1107,11/28/2013,0,0,0,0,0,0,0
3521,RM-1107,11/29/2013,0,0,0,0,0,0,0
3522,RM-1107,11/30/2013,0,0,0,0,0,0,0
3523,RM-1107,12/1/2013,0,0,0,0,0,0,0
3524,RM-1107,12/2/2013,0,0,0,0,0,0,0
3525,RM-1107,12/3/2013,0,0,0,0,0,0,0
3526,RM-1107,12/4/2013,0,0,0,0,0,0,0
3527,RM-1107,12/5/2013,0,0,0,0,0,0,0
3528,RM-1107,12/6/2013,0,0,0,0,0,0,0
3529,RM-1107,12/7/2013,0,0,0,0,0,0,0
3530,RM-1107,12/8/2013,0,0,0,0,0,0,0
3531,RM-1107,12/9/2013,0,0,0,0,0,0,0
3532,RM-1107,12/10/2013,0,0,0,0,0,0,0
3533,RM-1107,12/11/2013,0,0,0,0,0,0,0
3534,RM-1107,12/12/2013,0,0,0,0,0,0,0
3535,RM-1107,12/13/2013,0,0,0,0,0,0,0
3536,RM-1107,12/14/2013,0,0,0,0,0,0,0
3537,RM-1107,12/15/2013,0,0,0,0,0,0,0
3538,RM-1107,12/16/2013,0,0,0,0,0,0,0
3539,RM-1107,12/17/2013,0,0,0,0,0,0,0
3540,RM-1107,12/18/2013,0,0,0,0,0,0,0
3541,RM-1107,12/19/2013,0,0,0,0,0,0,0
3542,RM-1107,12/20/2013,0,0,0,0,0,0,0
3543,RM-1107,12/21/2013,0,0,0,0,0,0,0
3544,RM-1107,12/22/2013,0,0,0,0,0,0,0
3545,RM-1107,12/23/2013,0,0,0,0,0,0,0
3546,RM-1107,12/24/2013,0,0,0,0,0,0,0
3547,RM-1107,12/25/2013,0,0,0,0,0,0,0
3548,RM-1107,12/26/2013,0,0,0,0,0,0,0
3549,RM-1107,12/27/2013,0,0,0,0,0,0,0
3550,RM-1107,12/28/2013,0,0,0,0,0,0,0
3551,RM-1107,12/29/2013,0,0,0,0,0,0,0
3552,RM-1107,12/30/2013,0,0,0,0,0,0,0
3553,RM-1107,12/31/2013,0,0,0,0,0,0,0
3554,RM-1107,1/1/2014,0,0,0,0,0,0,0
3555,RM-1107,1/2/2014,0,0,0,0,0,0,0
3556,RM-1107,1/3/2014,0,0,0,0,0,0,0
3557,RM-1107,1/4/2014,0,0,0,0,0,0,0
3558,RM-1107,1/5/2014,0,0,0,0,0,0,0
3559,RM-1107,1/6/2014,0,0,0,0,0,0,0
3560,RM-1107,1/7/2014,0,0,0,0,0,0,0
3561,RM-1107,1/8/2014,0,0,0,0,0,0,0
3562,RM-1107,1/9/2014,0,0,0,0,0,0,0
3563,RM-1107,1/10/2014,0,0,0,0,0,0,0
3564,RM-1107,1/11/2014,0,0,0,0,0,0,0
3565,RM-1107,1/12/2014,0,0,0,0,0,0,0
3566,RM-1107,1/13/2014,0,0,0,0,0,0,0
3567,RM-1107,1/14/2014,0,0,0,0,0,0,0
3568,RM-1107,1/15/2014,0,0,0,0,0,0,0
3569,RM-1107,1/16/2014,0,0,0,0,0,0,0
3570,RM-1107,1/17/2014,0,0,0,0,0,0,0
3571,RM-1107,1/18/2014,0,0,0,0,0,0,0
3572,RM-1107,1/19/2014,0,0,0,0,0,0,0
3573,RM-1107,1/20/2014,0,0,0,0,0,0,0
3574,RM-1107,1/21/2014,0,0,0,0,0,0,0
3575,RM-1107,1/22/2014,0,0,0,0,0,0,0
3576,RM-1107,1/23/2014,0,0,0,0,0,0,0
3577,RM-1107,1/24/2014,0,0,0,0,0,0,0
3578,RM-1107,1/25/2014,0,0,0,0,0,0,0
3579,RM-1107,1/26/2014,0,0,0,0,0,0,0
3580,RM-1107,1/27/2014,0,0,0,0,0,0,0
3581,RM-1107,1/28/2014,0,0,0,0,0,0,0
3582,RM-1107,1/29/2014,0,0,0,0,0,0,0
3583,RM-1107,1/30/2014,0,0,0,0,0,0,0
3584,RM-1107,1/31/2014,0,0,0,0,0,0,0
3585,RM-1107,2/1/2014,0,0,0,0,0,0,0
3586,RM-1107,2/2/2014,0,0,0,0,0,0,0
3587,RM-1107,2/3/2014,0,0,0,0,0,0,0
3588,RM-1107,2/4/2014,0,0,0,0,0,0,0
3589,RM-1107,2/5/2014,0,0,0,0,0,0,0
3590,RM-1107,2/6/2014,0,0,0,0,0,0,0
3591,RM-1107,2/7/2014,0,0,0,0,0,0,0
3592,RM-1107,2/8/2014,0,0,0,0,0,0,0
3593,RM-1107,2/9/2014,0,0,0,0,0,0,0
3594,RM-1107,2/10/2014,0,0,0,0,0,0,0
3595,RM-1107,2/11/2014,0,0,0,0,0,0,0
3596,RM-1107,2/12/2014,0,0,0,0,0,0,0
3597,RM-1107,2/13/2014,0,0,0,0,0,0,0
3598,RM-1107,2/14/2014,0,0,0,0,0,0,0
3599,RM-1107,2/15/2014,0,0,0,0,0,0,0
3600,RM-1107,2/16/2014,0,0,0,0,0,0,0
3601,RM-1107,2/17/2014,0,0,0,0,0,0,0
3602,RM-1107,2/18/2014,0,0,0,0,0,0,0
3603,RM-1107,2/19/2014,0,0,0,0,0,0,0
3604,RM-1107,2/20/2014,0,0,0,0,0,0,0
3605,RM-1107,2/21/2014,0,0,0,0,0,0,0
3606,RM-1107,2/22/2014,0,0,0,0,0,0,0
3607,RM-1107,2/23/2014,0,0,0,0,0,0,0
3608,RM-1107,2/24/2014,0,0,0,0,0,0,0
3609,RM-1107,2/25/2014,0,0,0,0,0,0,0
3610,RM-1107,2/26/2014,0,0,0,0,0,0,0
3611,RM-1107,2/27/2014,0,0,0,0,0,0,0
3612,RM-1107,2/28/2014,0,0,0,0,0,0,0
3613,RM-1107,3/1/2014,0,0,0,0,0,0,0
3614,RM-1107,3/2/2014,0,0,0,0,0,0,0
3615,RM-1107,3/3/2014,0,0,0,0,0,0,0
3616,RM-1107,3/4/2014,0,0,0,0,0,0,0
3617,RM-1107,3/5/2014,0,0,0,0,0,0,0
3618,RM-1107,3/6/2014,0,0,0,0,0,0,0
3619,RM-1107,3/7/2014,0,0,0,0,0,0,0
3620,RM-1107,3/8/2014,0,0,0,0,0,0,0
3621,RM-1107,3/9/2014,0,0,0,0,0,0,0
3622,RM-1107,3/10/2014,0,0,0,0,0,0,0
3623,RM-1107,3/11/2014,0,0,0,0,0,0,0
3624,RM-1107,3/12/2014,0,0,0,0,0,0,0
3625,RM-1107,3/13/2014,0,0,0,0,0,0,0
3626,RM-1107,3/14/2014,0,0,0,0,0,0,0
3627,RM-1107,3/15/2014,0,0,0,0,0,0,0
3628,RM-1107,3/16/2014,0,0,0,0,0,0,0
3629,RM-1107,3/17/2014,0,0,0,0,0,0,0
3630,RM-1107,3/18/2014,0,0,0,0,0,0,0
3631,RM-1107,3/19/2014,0,0,0,0,0,0,0
3632,RM-1107,3/20/2014,0,0,0,0,0,0,0
3633,RM-1107,3/21/2014,0,0,0,0,0,0,0
3634,RM-1107,3/22/2014,0,0,0,0,0,0,0
3635,RM-1107,3/23/2014,0,0,0,0,0,0,0
3636,RM-1107,3/24/2014,0,0,0,0,0,0,0
3637,RM-1107,3/25/2014,0,0,0,0,0,0,0
3638,RM-1107,3/26/2014,0,0,0,0,0,0,0
3639,RM-1107,3/27/2014,0,0,0,0,0,0,0
3640,RM-1107,3/28/2014,0,0,0,0,0,0,0
3641,RM-1107,3/29/2014,0,0,0,0,0,0,0
3642,RM-1107,3/30/2014,0,0,0,0,0,0,0
3643,RM-1107,3/31/2014,0,0,0,0,0,0,0
3644,RM-1107,4/1/2014,0,0,0,0,0,0,0
3645,RM-1107,4/2/2014,0,0,0,0,0,0,0
3646,RM-1107,4/3/2014,0,0,0,0,0,0,0
3647,RM-1107,4/4/2014,0,0,0,0,0,0,0
3648,RM-1107,4/5/2014,0,0,0,0,0,0,0
3649,RM-1107,4/6/2014,0,0,0,0,0,0,0
3650,RM-1107,4/7/2014,0,0,0,0,0,0,0
3651,RM-1107,4/8/2014,0,0,0,0,0,0,0
3652,RM-1107,4/9/2014,0,0,0,0,0,0,0
3653,RM-1107,4/10/2014,0,0,0,0,0,0,0
3654,RM-1107,4/11/2014,0,0,0,0,0,0,0
3655,RM-1107,4/12/2014,0,0,0,0,0,0,0
3656,RM-1107,4/13/2014,0,0,0,0,0,0,0
3657,RM-1107,4/14/2014,0,0,0,0,0,0,0
3658,RM-1107,4/15/2014,0,0,0,0,0,0,0
3659,RM-1107,4/16/2014,0,0,0,0,0,0,0
3660,RM-1107,4/17/2014,0,0,0,0,0,0,0
3661,RM-1107,4/18/2014,0,0,0,0,0,0,0
3662,RM-1107,4/19/2014,0,0,0,0,0,0,0
3663,RM-1107,4/20/2014,0,0,0,0,0,0,0
3664,RM-1107,4/21/2014,0,0,0,0,0,0,0
3665,RM-1107,4/22/2014,0,0,0,0,0,0,0
3666,RM-1107,4/23/2014,0,0,0,0,0,0,0
3667,RM-1107,4/24/2014,0,0,0,0,0,0,0
3668,RM-1107,4/25/2014,0,0,0,0,0,0,0
3669,RM-1107,4/26/2014,0,0,0,0,0,0,0
3670,RM-1107,4/27/2014,0,0,0,0,0,0,0
3671,RM-1107,4/28/2014,0,0,0,0,0,0,0
3672,RM-1107,4/29/2014,0,0,0,0,0,0,0
3673,RM-1107,4/30/2014,0,0,0,0,0,0,0
3674,RM-1107,5/1/2014,0,0,0,0,0,0,0
3675,RM-1107,5/2/2014,0,0,0,0,0,0,0
3676,RM-1107,5/3/2014,0,0,0,0,0,0,0
3677,RM-1107,5/4/2014,0,0,0,0,0,0,0
3678,RM-1107,5/5/2014,0,0,0,0,0,0,0
3679,RM-1107,5/6/2014,0,0,0,0,0,0,0
3680,RM-1107,5/7/2014,0,0,0,0,0,0,0
3681,RM-1107,5/8/2014,0,0,0,0,0,0,0
3682,RM-1107,5/9/2014,0,0,0,0,0,0,0
3683,RM-1107,5/10/2014,0,0,0,0,0,0,0
3684,RM-1107,5/11/2014,0,0,0,0,0,0,0
3685,RM-1107,5/12/2014,0,0,0,0,0,0,0
3686,RM-1107,5/13/2014,0,0,0,0,0,0,0
3687,RM-1107,5/14/2014,0,0,0,0,0,0,0
3688,RM-1107,5/15/2014,0,0,0,0,0,0,0
3689,RM-1107,5/16/2014,0,0,0,0,0,0,0
3690,RM-1107,5/17/2014,0,0,0,0,0,0,0
3691,RM-1107,5/18/2014,0,0,0,0,0,0,0
3692,RM-1107,5/19/2014,0,0,0,0,0,0,0
3693,RM-1107,5/20/2014,0,0,0,0,0,0,0
3694,RM-1107,5/21/2014,0,0,0,0,0,0,0
3695,RM-1107,5/22/2014,0,0,0,0,0,0,0
3696,RM-1107,5/23/2014,0,0,0,0,0,0,0
3697,RM-1107,5/24/2014,0,0,0,0,0,0,0
3698,RM-1107,5/25/2014,0,0,0,0,0,0,0
3699,RM-1107,5/26/2014,0,0,0,0,0,0,0
3700,RM-1107,5/27/2014,0,0,0,0,0,0,0
3701,RM-1107,5/28/2014,0,0,0,0,0,0,0
3702,RM-1107,5/29/2014,0,0,0,0,0,0,0
3703,RM-1107,5/30/2014,0,0,0,0,0,0,0
3704,RM-1107,5/31/2014,0,0,0,0,0,0,0
3705,RM-1107,6/1/2014,0,0,0,0,0,0,0
3706,RM-1107,6/2/2014,0,0,0,0,0,0,0
3707,RM-1107,6/3/2014,0,0,0,0,0,0,0
3708,RM-1107,6/4/2014,0,0,0,0,0,0,0
3709,RM-1107,6/5/2014,0,0,0,0,0,0,0
3710,RM-1107,6/6/2014,0,0,0,0,0,0,0
3711,RM-1107,6/7/2014,0,0,0,0,0,0,0
3712,RM-1107,6/8/2014,0,0,0,0,0,0,0
3713,RM-1107,6/9/2014,0,0,0,0,0,0,0
3714,RM-1107,6/10/2014,0,0,0,0,0,0,0
3715,RM-1107,6/11/2014,0,0,0,0,0,0,0
3716,RM-1107,6/12/2014,0,0,0,0,0,0,0
3717,RM-1107,6/13/2014,0,0,0,0,0,0,0
3718,RM-1107,6/14/2014,0,0,0,0,0,0,0
3719,RM-1107,6/15/2014,0,0,0,0,0,0,0
3720,RM-1107,6/16/2014,0,0,0,0,0,0,0
3721,RM-1107,6/17/2014,0,0,0,0,0,0,0
3722,RM-1107,6/18/2014,0,0,0,0,0,0,0
3723,RM-1107,6/19/2014,0,0,0,0,0,0,0
3724,RM-1107,6/20/2014,0,0,0,0,0,0,0
3725,RM-1107,6/21/2014,0,0,0,0,0,0,0
3726,RM-1107,6/22/2014,0,0,0,0,0,0,0
3727,RM-1107,6/23/2014,0,0,0,0,0,0,0
3728,RM-1107,6/24/2014,0,0,0,0,0,0,0
3729,RM-1107,6/25/2014,0,0,0,0,0,0,0
3730,RM-1107,6/26/2014,0,0,0,0,0,0,0
3731,RM-1107,6/27/2014,0,0,0,0,0,0,0
3732,RM-1107,6/28/2014,0,0,0,0,0,0,0
3733,RM-1107,6/29/2014,0,0,0,0,0,0,0
3734,RM-1107,6/30/2014,0,0,0,0,0,0,0
3735,RM-1107,7/1/2014,0,0,0,0,0,0,0
3736,RM-1107,7/2/2014,0,0,0,0,0,0,0
3737,RM-1107,7/3/2014,0,0,0,0,0,0,0
3738,RM-1107,7/4/2014,0,0,0,0,0,0,0
3739,RM-1107,7/5/2014,0,0,0,0,0,0,0
3740,RM-1107,7/6/2014,0,0,0,0,0,0,0
3741,RM-1107,7/7/2014,0,0,0,0,0,0,0
3742,RM-1107,7/8/2014,0,0,0,0,0,0,0
3743,RM-1107,7/9/2014,0,0,0,0,0,0,0
3744,RM-1107,7/10/2014,0,0,0,0,0,0,0
3745,RM-1107,7/11/2014,0,0,0,0,0,0,0
3746,RM-1107,7/12/2014,0,0,0,0,0,0,0
3747,RM-1107,7/13/2014,0,0,0,0,0,0,0
3748,RM-1107,7/14/2014,0,0,0,0,0,0,0
3749,RM-1107,7/15/2014,0,0,0,0,0,0,0
3750,RM-1107,7/16/2014,0,0,0,0,0,0,0
3751,RM-1107,7/17/2014,0,0,0,0,0,0,0
3752,RM-1107,7/18/2014,0,0,0,0,0,0,0
3753,RM-1107,7/19/2014,0,0,0,0,0,0,0
3754,RM-1107,7/20/2014,0,0,0,0,0,0,0
3755,RM-1107,7/21/2014,0,0,0,0,0,0,0
3756,RM-1107,7/22/2014,0,0,0,0,0,0,0
3757,RM-1107,7/23/2014,0,0,0,0,0,0,0
3758,RM-1107,7/24/2014,0,0,0,0,0,0,0
3759,RM-1107,7/25/2014,0,0,0,0,0,0,0
3760,RM-1107,7/26/2014,0,0,0,0,0,0,0
3761,RM-1107,7/27/2014,0,0,0,0,0,0,0
3762,RM-1107,7/28/2014,0,0,0,0,0,0,0
3763,RM-1107,7/29/2014,0,0,0,0,0,0,0
3764,RM-1107,7/30/2014,0,0,0,0,0,0,0
3765,RM-1107,7/31/2014,0,0,0,0,0,0,0
3766,RM-1107,8/1/2014,0,0,0,0,0,0,0
3767,RM-1107,8/2/2014,0,0,0,0,0,0,0
3768,RM-1107,8/3/2014,0,0,0,0,0,0,0
3769,RM-1107,8/4/2014,0,0,0,0,0,0,0
3770,RM-1107,8/5/2014,0,0,0,0,0,0,0
3771,RM-1107,8/6/2014,0,0,0,0,0,0,0
3772,RM-1107,8/7/2014,0,0,0,0,0,0,0
3773,RM-1107,8/8/2014,0,0,0,0,0,0,0
3774,RM-1107,8/9/2014,0,0,0,0,0,0,0
3775,RM-1107,8/10/2014,0,0,0,0,0,0,0
3776,RM-1107,8/11/2014,0,0,0,0,0,0,0
3777,RM-1107,8/12/2014,0,0,0,0,0,0,0
3778,RM-1107,8/13/2014,0,0,0,0,0,0,0
3779,RM-1107,8/14/2014,0,0,0,0,0,0,0
3780,RM-1107,8/15/2014,0,0,0,0,0,0,0
3781,RM-1107,8/16/2014,0,0,0,0,0,0,0
3782,RM-1107,8/17/2014,0,0,0,0,0,0,0
3783,RM-1107,8/18/2014,0,0,0,0,0,0,0
3784,RM-1107,8/19/2014,0,0,0,0,0,0,0
3785,RM-1107,8/20/2014,0,0,0,0,0,0,0
3786,RM-1107,8/21/2014,0,0,0,0,0,0,0
3787,RM-1107,8/22/2014,0,0,0,0,0,0,0
3788,RM-1107,8/23/2014,0,0,0,0,0,0,0
3789,RM-1107,8/24/2014,0,0,0,0,0,0,0
3790,RM-1107,8/25/2014,0,0,0,0,0,0,0
3791,RM-1107,8/26/2014,0,0,0,0,0,0,0
3792,RM-1107,8/27/2014,0,0,0,0,0,0,0
3793,RM-1107,8/28/2014,0,0,0,0,0,0,0
3794,RM-1107,8/29/2014,0,0,0,0,0,0,0
3795,RM-1107,8/30/2014,0,0,0,0,0,0,0
3796,RM-1107,8/31/2014,0,0,0,0,0,0,0
3797,RM-1107,9/1/2014,0,0,0,0,0,0,0
3798,RM-1107,9/2/2014,0,0,0,0,0,0,0
3799,RM-1107,9/3/2014,0,0,0,0,0,0,0
3800,RM-1107,9/4/2014,0,0,0,0,0,0,0
3801,RM-1107,9/5/2014,0,0,0,0,0,0,0
3802,RM-1107,9/6/2014,0,0,0,0,0,0,0
3803,RM-1107,9/7/2014,0,0,0,0,0,0,0
3804,RM-1107,9/8/2014,0,0,0,0,0,0,0
3805,RM-1107,9/9/2014,0,0,0,0,0,0,0
3806,RM-1107,9/10/2014,0,0,0,0,0,0,0
3807,RM-1107,9/11/2014,0,0,0,0,0,0,0
3808,RM-1107,9/12/2014,0,0,0,0,0,0,0
3809,RM-1107,9/13/2014,0,0,0,0,0,0,0
3810,RM-1107,9/14/2014,0,0,0,0,0,0,0
3811,RM-1107,9/15/2014,0,0,0,0,0,0,0
3812,RM-1107,9/16/2014,0,0,0,0,0,0,0
3813,RM-1107,9/17/2014,0,0,0,0,0,0,0
3814,RM-1107,9/18/2014,0,0,0,0,0,0,0
3815,RM-1107,9/19/2014,0,0,0,0,0,0,0
3816,RM-1107,9/20/2014,0,0,0,0,0,0,0
3817,RM-1107,9/21/2014,0,0,0,0,0,0,0
3818,RM-1107,9/22/2014,0,0,0,0,0,0,0
3819,RM-1107,9/23/2014,0,0,0,0,0,0,0
3820,RM-1107,9/24/2014,0,0,0,0,0,0,0
3821,RM-1107,9/25/2014,0,0,0,0,0,0,0
3822,RM-1107,9/28/2014,0,0,0,0,0,0,0
3823,RM-1107,9/29/2014,0,0,0,0,0,0,0
3824,RM-1107,9/30/2014,0,0,0,0,0,0,0
3825,RM-1107,10/1/2014,0,0,0,0,0,0,0
3826,RM-1107,10/2/2014,0,0,0,0,0,0,0
3827,RM-1107,10/3/2014,0,0,0,0,0,0,0
3828,RM-1107,10/4/2014,0,0,0,0,0,0,0
3829,RM-1107,10/5/2014,0,0,0,0,0,0,0
3830,RM-1107,10/6/2014,0,0,0,0,0,0,0
3831,RM-1107,10/7/2014,0,0,0,0,0,0,0
3832,RM-1107,10/8/2014,0,0,0,0,0,0,0
3833,RM-1107,10/9/2014,0,0,0,0,0,0,0
3834,RM-1107,10/10/2014,0,0,0,0,0,0,0
3835,RM-1107,10/11/2014,0,0,0,0,0,0,0
3836,RM-1107,10/12/2014,0,0,0,0,0,0,0
3837,RM-1107,10/13/2014,0,0,0,0,0,0,0
3838,RM-1107,10/14/2014,0,0,0,0,0,0,0
3839,RM-1107,10/15/2014,0,0,0,0,0,0,0
3840,RM-1107,10/16/2014,0,0,0,0,0,0,0
3841,RM-1107,10/17/2014,0,0,0,0,0,0,0
3842,RM-1107,10/18/2014,0,0,0,0,0,0,0
3843,RM-1107,10/19/2014,0,0,0,0,0,0,0
3844,RM-1107,10/20/2014,0,0,0,0,0,0,0
3845,RM-1107,10/21/2014,0,0,0,0,0,0,0
3846,RM-1107,10/22/2014,0,0,0,0,0,0,0
3847,RM-1107,10/23/2014,0,0,0,0,0,0,0
3848,RM-1107,10/24/2014,0,0,0,0,0,0,0
3849,RM-1107,10/25/2014,0,0,0,0,0,0,0
3850,RM-1107,10/26/2014,0,0,0,0,0,0,0
3851,RM-1107,10/27/2014,0,0,0,0,0,0,0
3852,RM-1107,10/28/2014,0,0,0,0,0,0,0
3853,RM-1107,10/29/2014,0,0,0,0,0,0,0
3854,RM-1107,10/30/2014,0,0,0,0,0,0,0
3855,RM-1107,10/31/2014,0,0,0,0,0,0,0
3856,RM-1107,11/1/2014,0,0,0,0,0,0,0
3857,RM-1107,11/2/2014,0,0,0,0,0,0,0
3858,RM-1107,11/3/2014,0,0,0,0,0,0,0
3859,RM-1107,11/4/2014,0,0,0,0,0,0,0
3860,RM-1107,11/5/2014,0,0,0,0,0,0,0
3861,RM-1107,11/6/2014,0,0,0,0,0,0,0
3862,RM-1107,11/7/2014,0,0,0,0,0,0,0
3863,RM-1107,11/8/2014,0,0,0,0,0,0,0
3864,RM-1107,11/9/2014,0,0,0,0,0,0,0
3865,RM-1107,11/10/2014,0,0,0,0,0,0,0
3866,RM-1107,11/11/2014,0,0,0,0,0,0,0
3867,RM-1107,11/12/2014,0,0,0,0,0,0,0
3868,RM-1107,11/13/2014,0,0,0,0,0,0,0
3869,RM-1107,11/14/2014,0,0,0,0,0,0,0
3870,RM-1107,11/15/2014,0,0,0,0,0,0,0
3871,RM-1107,11/16/2014,0,0,0,0,0,0,0
3872,RM-1107,11/17/2014,0,0,0,0,0,0,0
3873,RM-1107,11/18/2014,0,0,0,0,0,0,0
3874,RM-1107,11/19/2014,0,0,0,0,0,0,0
3875,RM-1107,11/20/2014,0,0,0,0,0,0,0
3876,RM-1107,11/21/2014,0,0,0,0,0,0,0
3877,RM-1107,11/22/2014,0,0,0,0,0,0,0
3878,RM-1107,11/23/2014,0,0,0,0,0,0,0
3879,RM-1107,11/24/2014,0,0,0,0,0,0,0
3880,RM-1107,11/25/2014,0,0,0,0,0,0,0
3881,RM-1107,11/26/2014,0,0,0,0,0,0,0
3882,RM-1107,11/27/2014,0,0,0,0,0,0,0
3883,RM-1107,11/28/2014,0,0,0,0,0,0,0
3884,RM-1107,11/29/2014,0,0,0,0,0,0,0
3885,RM-1107,11/30/2014,0,0,0,0,0,0,0
3886,RM-1107,12/1/2014,0,0,0,0,0,0,0
3887,RM-1107,12/2/2014,0,0,0,0,0,0,0
3888,RM-1107,12/3/2014,0,0,0,0,0,0,0
3889,RM-1107,12/4/2014,0,0,0,0,0,0,0
3890,RM-1107,12/5/2014,0,0,0,0,0,0,0
3891,RM-1107,12/6/2014,0,0,0,0,0,0,0
3892,RM-1107,12/7/2014,0,0,0,0,0,0,0
3893,RM-1107,12/8/2014,0,0,0,0,0,0,0
3894,RM-1107,12/9/2014,0,0,0,0,0,0,0
3895,RM-1107,12/10/2014,0,0,0,0,0,0,0
3896,RM-1107,12/11/2014,0,0,0,0,0,0,0
3897,RM-1107,12/12/2014,0,0,0,0,0,0,0
3898,RM-1107,12/13/2014,0,0,0,0,0,0,0
3899,RM-1107,12/14/2014,0,0,0,0,0,0,0
3900,RM-1107,12/15/2014,0,0,0,0,0,0,0
3901,RM-1107,12/16/2014,0,0,0,0,0,0,0
3902,RM-1107,12/17/2014,0,0,0,0,0,0,0
3903,RM-1107,12/18/2014,0,0,0,0,0,0,0
3904,RM-1107,12/19/2014,0,0,0,0,0,0,0
3905,RM-1107,12/20/2014,0,0,0,0,0,0,0
3906,RM-1107,12/21/2014,0,0,0,0,0,0,0
3907,RM-1107,12/22/2014,0,0,0,0,0,0,0
3908,RM-1107,12/23/2014,0,0,0,0,0,0,0
3909,RM-1107,12/24/2014,0,0,0,0,0,0,0
3910,RM-1107,12/25/2014,0,0,0,0,0,0,0
3911,RM-1107,12/26/2014,0,0,0,0,0,0,0
3912,RM-1107,12/27/2014,0,0,0,0,0,0,0
3913,RM-1107,12/28/2014,0,0,0,0,0,0,0
3914,RM-1107,12/29/2014,0,0,0,0,0,0,0
3915,RM-1107,12/30/2014,0,0,0,0,0,0,0
3916,RM-1107,12/31/2014,0,0,0,0,0,0,0
3917,RM-1107,1/1/2015,0,0,0,0,0,0,0
3918,RM-1107,1/2/2015,0,0,0,0,0,0,0
3919,RM-1107,1/3/2015,0,0,0,0,0,0,0
3920,RM-1107,1/4/2015,0,0,0,0,0,0,0
3921,RM-1107,1/5/2015,0,0,0,0,0,0,0
3922,RM-1107,1/6/2015,0,0,0,0,0,0,0
3923,RM-1107,1/7/2015,0,0,0,0,0,0,0
3924,RM-1107,1/8/2015,0,0,0,0,0,0,0
3925,RM-1107,1/9/2015,0,0,0,0,0,0,0
3926,RM-1107,1/10/2015,0,0,0,0,0,0,0
3927,RM-1107,1/11/2015,0,0,0,0,0,0,0
3928,RM-1107,1/12/2015,0,0,0,0,0,0,0
3929,RM-1107,1/13/2015,0,0,0,0,0,0,0
3930,RM-1107,1/14/2015,0,0,0,0,0,0,0
3931,RM-1107,1/15/2015,0,0,0,0,0,0,0
3932,RM-1107,1/16/2015,0,0,0,0,0,0,0
3933,RM-1107,1/17/2015,0,0,0,0,0,0,0
3934,RM-1107,1/18/2015,0,0,0,0,0,0,0
3935,RM-1107,1/19/2015,0,0,0,0,0,0,0
3936,RM-1107,1/20/2015,0,0,0,0,0,0,0
3937,RM-1107,1/21/2015,0,0,0,0,0,0,0
3938,RM-1107,1/22/2015,0,0,0,0,0,0,0
3939,RM-1107,1/23/2015,0,0,0,0,0,0,0
3940,RM-1107,1/24/2015,0,0,0,0,0,0,0
3941,RM-1107,1/25/2015,0,0,0,0,0,0,0
3942,RM-1107,1/26/2015,0,0,0,0,0,0,0
3943,RM-1107,1/27/2015,0,0,0,0,0,0,0
3944,RM-1107,1/28/2015,0,0,0,0,0,0,0
3945,RM-1107,1/29/2015,0,0,0,0,0,0,0
3946,RM-1107,1/30/2015,0,0,0,0,0,0,0
3947,RM-1107,1/31/2015,0,0,0,0,0,0,0
3948,RM-1107,2/1/2015,0,0,0,0,0,0,0
3949,RM-1107,2/2/2015,0,0,0,0,0,0,0
3950,RM-1107,2/3/2015,0,0,0,0,0,0,0
3951,RM-1107,2/4/2015,0,0,0,0,0,0,0
3952,RM-1107,2/5/2015,0,0,0,0,0,0,0
3953,RM-1107,2/6/2015,0,0,0,0,0,0,0
3954,RM-1107,2/7/2015,0,0,0,0,0,0,0
3955,RM-1107,2/8/2015,0,0,0,0,0,0,0
3956,RM-1107,2/9/2015,0,0,0,0,0,0,0
3957,RM-1107,2/10/2015,0,0,0,0,0,0,0
3958,RM-1107,2/11/2015,0,0,0,0,0,0,0
3959,RM-1107,2/12/2015,0,0,0,0,0,0,0
3960,RM-1107,2/13/2015,0,0,0,0,0,0,0
3961,RM-1107,2/14/2015,0,0,0,0,0,0,0
3962,RM-1107,2/15/2015,0,0,0,0,0,0,0
3963,RM-1107,2/16/2015,0,0,0,0,0,0,0
3964,RM-1107,2/17/2015,0,0,0,0,0,0,0
3965,RM-1107,2/18/2015,0,0,0,0,0,0,0
3966,RM-1107,2/19/2015,0,0,0,0,0,0,0
3967,RM-1107,2/20/2015,0,0,0,0,0,0,0
3968,RM-1107,2/21/2015,0,0,0,0,0,0,0
3969,RM-1107,2/22/2015,0,0,0,0,0,0,0
3970,RM-1107,2/23/2015,0,0,0,0,0,0,0
3971,RM-1107,2/24/2015,0,0,0,0,0,0,0
3972,RM-1107,2/25/2015,0,0,0,0,0,0,0
3973,RM-1107,2/26/2015,0,0,0,0,0,0,0
3974,RM-1107,2/27/2015,0,0,0,0,0,0,0
3975,RM-1107,2/28/2015,0,0,0,0,0,0,0
3976,RM-1107,3/1/2015,0,0,0,0,0,0,0
3977,RM-1107,3/2/2015,0,0,0,0,0,0,0
3978,RM-1107,3/3/2015,0,0,0,0,0,0,0
3979,RM-1107,3/4/2015,0,0,0,0,0,0,0
3980,RM-1107,3/5/2015,0,0,0,0,0,0,0
3981,RM-1107,3/6/2015,0,0,0,0,0,0,0
3982,RM-1107,3/7/2015,0,0,0,0,0,0,0
3983,RM-1107,3/8/2015,0,0,0,0,0,0,0
3984,RM-1107,3/9/2015,0,0,0,0,0,0,0
3985,RM-1107,3/10/2015,0,0,0,0,0,0,0
3986,RM-1107,3/11/2015,0,0,0,0,0,0,0
3987,RM-1107,3/12/2015,0,0,0,0,0,0,0
3988,RM-1107,3/13/2015,0,0,0,0,0,0,0
3989,RM-1107,3/14/2015,0,0,0,0,0,0,0
3990,RM-1107,3/15/2015,0,0,0,0,0,0,0
3991,RM-1107,3/16/2015,0,0,0,0,0,0,0
3992,RM-1107,3/17/2015,0,0,0,0,0,0,0
3993,RM-1107,3/18/2015,0,0,0,0,0,0,0
3994,RM-1107,3/19/2015,0,0,0,0,0,0,0
3995,RM-1107,3/20/2015,0,0,0,0,0,0,0
3996,RM-1107,3/21/2015,0,0,0,0,0,0,0
3997,RM-1107,3/22/2015,0,0,0,0,0,0,0
3998,RM-1107,3/23/2015,0,0,0,0,0,0,0
3999,RM-1107,3/24/2015,0,0,0,0,0,0,0
4000,RM-1107,3/25/2015,0,0,0,0,0,0,0
4001,RM-1107,3/26/2015,0,0,0,0,0,0,0
4002,RM-1107,3/27/2015,0,0,0,0,0,0,0
4003,RM-1107,3/28/2015,0,0,0,0,0,0,0
4004,RM-1107,3/29/2015,0,0,0,0,0,0,0
4005,RM-1107,3/30/2015,0,0,0,0,0,0,0
4006,RM-1107,3/31/2015,0,0,0,0,0,0,0
4007,RM-1107,4/1/2015,0,0,0,0,0,0,0
4008,RM-1107,4/2/2015,0,0,0,0,0,0,0
4009,RM-1107,4/3/2015,0,0,0,0,0,0,0
4010,RM-1107,4/4/2015,0,0,0,0,0,0,0
4011,RM-1107,4/5/2015,0,0,0,0,0,0,0
4012,RM-1107,4/6/2015,0,0,0,0,0,0,0
4013,RM-1107,4/7/2015,0,0,0,0,0,0,0
4014,RM-1107,4/8/2015,0,0,0,0,0,0,0
4015,RM-1107,4/9/2015,0,0,0,0,0,0,0
4016,RM-1107,4/10/2015,0,0,0,0,0,0,0
4017,RM-1107,4/11/2015,0,0,0,0,0,0,0
4018,RM-1107,4/12/2015,0,0,0,0,0,0,0
4019,RM-1107,4/13/2015,0,0,0,0,0,0,0
4020,RM-1107,4/14/2015,0,0,0,0,0,0,0
4021,RM-1107,4/15/2015,0,0,0,0,0,0,0
4022,RM-1107,4/16/2015,0,0,0,0,0,0,0
4023,RM-1107,4/17/2015,0,0,0,0,0,0,0
4024,RM-1107,4/18/2015,0,0,0,0,0,0,0
4025,RM-1107,4/19/2015,0,0,0,0,0,0,0
4026,RM-1107,4/20/2015,0,0,0,0,0,0,0
4027,RM-1107,4/21/2015,0,0,0,0,0,0,0
4028,RM-1107,4/22/2015,0,0,0,0,0,0,0
4029,RM-1107,4/23/2015,0,0,0,0,0,0,0
4030,RM-1107,4/24/2015,0,0,0,0,0,0,0
4031,RM-1107,4/25/2015,0,0,0,0,0,0,0
4032,RM-1107,4/26/2015,0,0,0,0,0,0,0
4033,RM-1107,4/27/2015,0,0,0,0,0,0,0
4034,RM-1107,4/28/2015,0,0,0,0,0,0,0
4035,RM-1107,4/29/2015,0,0,0,0,0,0,0
4036,RM-1107,4/30/2015,0,0,0,0,0,0,0
4037,RM-1107,5/1/2015,0,0,0,0,0,0,0
4038,RM-1107,5/2/2015,0,0,0,0,0,0,0
4039,RM-1107,5/3/2015,0,0,0,0,0,0,0
4040,RM-1107,5/4/2015,0,0,0,0,0,0,0
4041,RM-1107,5/5/2015,0,0,0,0,0,0,0
4042,RM-1107,5/6/2015,0,0,0,0,0,0,0
4043,RM-1107,5/7/2015,0,0,0,0,0,0,0
4044,RM-1107,5/8/2015,0,0,0,0,0,0,0
4045,RM-1107,5/9/2015,0,0,0,0,0,0,0
4046,RM-1107,5/10/2015,0,0,0,0,0,0,0
4047,RM-1107,5/11/2015,0,0,0,0,0,0,0
4048,RM-1107,5/12/2015,0,0,0,0,0,0,0
4049,RM-1107,5/13/2015,0,0,0,0,0,0,0
4050,RM-1107,5/14/2015,0,0,0,0,0,0,0
4051,RM-1107,5/15/2015,0,0,0,0,0,0,0
4052,RM-1107,5/16/2015,0,0,0,0,0,0,0
4053,RM-1107,5/17/2015,0,0,0,0,0,0,0
4054,RM-1107,5/18/2015,0,0,0,0,0,0,0
4055,RM-1107,5/19/2015,0,0,0,0,0,0,0
4056,RM-1107,5/20/2015,0,0,0,0,0,0,0
4057,RM-1107,5/21/2015,0,0,0,0,0,0,0
4058,RM-1107,5/22/2015,0,0,0,0,0,0,0
4059,RM-1107,5/23/2015,0,0,0,0,0,0,0
4060,RM-1107,5/24/2015,0,0,0,0,0,0,0
4061,RM-1107,5/25/2015,0,0,0,0,0,0,0
4062,RM-1107,5/26/2015,0,0,0,0,0,0,0
4063,RM-1107,5/27/2015,0,0,0,0,0,0,0
4064,RM-1107,5/28/2015,0,0,0,0,0,0,0
4065,RM-1107,5/29/2015,0,0,0,0,0,0,0
4066,RM-1107,5/30/2015,0,0,0,0,0,0,0
4067,RM-1107,5/31/2015,0,0,0,0,0,0,0
4068,RM-1108,7/1/2013,0,0,0,0,0,0,0
4069,RM-1108,7/2/2013,0,0,0,0,0,0,0
4070,RM-1108,7/3/2013,0,0,0,0,0,0,0
4071,RM-1108,7/4/2013,0,0,0,0,0,0,0
4072,RM-1108,7/5/2013,0,0,0,0,0,0,0
4073,RM-1108,7/6/2013,0,0,0,0,0,0,0
4074,RM-1108,7/7/2013,0,0,0,0,0,0,0
4075,RM-1108,7/8/2013,0,0,0,0,0,0,0
4076,RM-1108,7/9/2013,0,0,0,0,0,0,0
4077,RM-1108,7/10/2013,0,0,0,0,0,0,0
4078,RM-1108,7/11/2013,0,0,0,0,0,0,0
4079,RM-1108,7/12/2013,0,0,0,0,0,0,0
4080,RM-1108,7/13/2013,0,0,0,0,0,0,0
4081,RM-1108,7/14/2013,0,0,0,0,0,0,0
4082,RM-1108,7/15/2013,0,0,0,0,0,0,0
4083,RM-1108,7/17/2013,0,0,0,0,0,0,0
4084,RM-1108,7/18/2013,0,0,0,0,0,0,0
4085,RM-1108,7/19/2013,0,0,0,0,0,0,0
4086,RM-1108,7/20/2013,0,0,0,0,0,0,0
4087,RM-1108,7/21/2013,0,0,0,0,0,0,0
4088,RM-1108,7/22/2013,0,0,0,0,0,0,0
4089,RM-1108,7/23/2013,0,0,0,0,0,0,0
4090,RM-1108,7/24/2013,0,0,0,0,0,0,0
4091,RM-1108,7/25/2013,0,0,0,0,0,0,0
4092,RM-1108,7/26/2013,0,0,0,0,0,0,0
4093,RM-1108,7/27/2013,0,0,0,0,0,0,0
4094,RM-1108,7/28/2013,0,0,0,0,0,0,0
4095,RM-1108,7/29/2013,0,0,0,0,0,0,0
4096,RM-1108,7/30/2013,0,0,0,0,0,0,0
4097,RM-1108,7/31/2013,0,0,0,0,0,0,0
4098,RM-1108,8/1/2013,0,0,0,0,0,0,0
4099,RM-1108,8/2/2013,0,0,0,0,0,0,0
4100,RM-1108,8/3/2013,0,0,0,0,0,0,0
4101,RM-1108,8/4/2013,0,0,0,0,0,0,0
4102,RM-1108,8/5/2013,0,0,0,0,0,0,0
4103,RM-1108,8/6/2013,0,0,0,0,0,0,0
4104,RM-1108,8/7/2013,0,0,0,0,0,0,0
4105,RM-1108,8/8/2013,0,0,0,0,0,0,0
4106,RM-1108,8/9/2013,0,0,0,0,0,0,0
4107,RM-1108,8/10/2013,0,0,0,0,0,0,0
4108,RM-1108,8/11/2013,0,0,0,0,0,0,0
4109,RM-1108,8/12/2013,0,0,0,0,0,0,0
4110,RM-1108,8/13/2013,0,0,0,0,0,0,0
4111,RM-1108,8/14/2013,0,0,0,0,0,0,0
4112,RM-1108,8/15/2013,0,0,0,0,0,0,0
4113,RM-1108,8/16/2013,0,0,0,0,0,0,0
4114,RM-1108,8/17/2013,0,0,0,0,0,0,0
4115,RM-1108,8/18/2013,0,0,0,0,0,0,0
4116,RM-1108,8/19/2013,0,0,0,0,0,0,0
4117,RM-1108,8/20/2013,0,0,0,0,0,0,0
4118,RM-1108,8/21/2013,0,0,0,0,0,0,0
4119,RM-1108,8/22/2013,0,0,0,0,0,0,0
4120,RM-1108,8/27/2013,0,0,0,0,0,0,0
4121,RM-1108,8/28/2013,0,0,0,0,0,0,0
4122,RM-1108,8/29/2013,0,0,0,0,0,0,0
4123,RM-1108,8/30/2013,0,0,0,0,0,0,0
4124,RM-1108,9/4/2013,0,0,0,0,0,0,0
4125,RM-1108,9/5/2013,0,0,0,0,0,0,0
4126,RM-1108,9/6/2013,0,0,0,0,0,0,0
4127,RM-1108,9/7/2013,0,0,0,0,0,0,0
4128,RM-1108,9/9/2013,0,0,0,0,0,0,0
4129,RM-1108,9/10/2013,0,0,0,0,0,0,0
4130,RM-1108,9/11/2013,0,0,0,0,0,0,0
4131,RM-1108,9/12/2013,0,0,0,0,0,0,0
4132,RM-1108,9/13/2013,0,0,0,0,0,0,0
4133,RM-1108,9/14/2013,0,0,0,0,0,0,0
4134,RM-1108,9/15/2013,0,0,0,0,0,0,0
4135,RM-1108,9/16/2013,0,0,0,0,0,0,0
4136,RM-1108,9/17/2013,0,0,0,0,0,0,0
4137,RM-1108,9/18/2013,0,0,0,0,0,0,0
4138,RM-1108,9/19/2013,0,0,0,0,0,0,0
4139,RM-1108,9/20/2013,0,0,0,0,0,0,0
4140,RM-1108,9/21/2013,0,0,0,0,0,0,0
4141,RM-1108,9/22/2013,0,0,0,0,0,0,0
4142,RM-1108,9/23/2013,0,0,0,0,0,0,0
4143,RM-1108,9/24/2013,0,0,0,0,0,0,0
4144,RM-1108,9/25/2013,0,0,0,0,0,0,0
4145,RM-1108,9/26/2013,0,0,0,0,0,0,0
4146,RM-1108,9/27/2013,0,0,0,0,0,0,0
4147,RM-1108,9/28/2013,0,0,0,0,0,0,0
4148,RM-1108,9/29/2013,0,0,0,0,0,0,0
4149,RM-1108,9/30/2013,0,0,0,0,0,0,0
4150,RM-1108,10/1/2013,0,0,0,0,0,0,0
4151,RM-1108,10/2/2013,0,0,0,0,0,0,0
4152,RM-1108,10/3/2013,0,0,0,0,0,0,0
4153,RM-1108,10/4/2013,0,0,0,0,0,0,0
4154,RM-1108,10/5/2013,0,0,0,0,0,0,0
4155,RM-1108,10/6/2013,0,0,0,0,0,0,0
4156,RM-1108,10/7/2013,0,0,0,0,0,0,0
4157,RM-1108,10/8/2013,0,0,0,0,0,0,0
4158,RM-1108,10/9/2013,0,0,0,0,0,0,0
4159,RM-1108,10/10/2013,0,0,0,0,0,0,0
4160,RM-1108,10/11/2013,0,0,0,0,0,0,0
4161,RM-1108,10/12/2013,0,0,0,0,0,0,0
4162,RM-1108,10/13/2013,0,0,0,0,0,0,0
4163,RM-1108,10/14/2013,0,0,0,0,0,0,0
4164,RM-1108,10/15/2013,0,0,0,0,0,0,0
4165,RM-1108,10/16/2013,0,0,0,0,0,0,0
4166,RM-1108,10/17/2013,0,0,0,0,0,0,0
4167,RM-1108,10/18/2013,0,0,0,0,0,0,0
4168,RM-1108,10/19/2013,0,0,0,0,0,0,0
4169,RM-1108,10/20/2013,0,0,0,0,0,0,0
4170,RM-1108,10/21/2013,0,0,0,0,0,0,0
4171,RM-1108,10/22/2013,0,0,0,0,0,0,0
4172,RM-1108,10/23/2013,0,0,0,0,0,0,0
4173,RM-1108,10/24/2013,0,0,0,0,0,0,0
4174,RM-1108,10/25/2013,0,0,0,0,0,0,0
4175,RM-1108,10/26/2013,0,0,0,0,0,0,0
4176,RM-1108,10/27/2013,0,0,0,0,0,0,0
4177,RM-1108,10/28/2013,0,0,0,0,0,0,0
4178,RM-1108,10/29/2013,0,0,0,0,0,0,0
4179,RM-1108,10/30/2013,0,0,0,0,0,0,0
4180,RM-1108,10/31/2013,0,0,0,0,0,0,0
4181,RM-1108,11/1/2013,0,0,0,0,0,0,0
4182,RM-1108,11/2/2013,0,0,0,0,0,0,0
4183,RM-1108,11/3/2013,0,0,0,0,0,0,0
4184,RM-1108,11/4/2013,0,0,0,0,0,0,0
4185,RM-1108,11/5/2013,0,0,0,0,0,0,0
4186,RM-1108,11/6/2013,0,0,0,0,0,0,0
4187,RM-1108,11/7/2013,0,0,0,0,0,0,0
4188,RM-1108,11/8/2013,0,0,0,0,0,0,0
4189,RM-1108,11/9/2013,0,0,0,0,0,0,0
4190,RM-1108,11/10/2013,0,0,0,0,0,0,0
4191,RM-1108,11/11/2013,0,0,0,0,0,0,0
4192,RM-1108,11/12/2013,0,0,0,0,0,0,0
4193,RM-1108,11/13/2013,0,0,0,0,0,0,0
4194,RM-1108,11/14/2013,0,0,0,0,0,0,0
4195,RM-1108,11/15/2013,0,0,0,0,0,0,0
4196,RM-1108,11/19/2013,0,0,0,0,0,0,0
4197,RM-1108,11/20/2013,0,0,0,0,0,0,0
4198,RM-1108,11/21/2013,0,0,0,0,0,0,0
4199,RM-1108,11/22/2013,0,0,0,0,0,0,0
4200,RM-1108,11/23/2013,0,0,0,0,0,0,0
4201,RM-1108,11/24/2013,0,0,0,0,0,0,0
4202,RM-1108,11/25/2013,0,0,0,0,0,0,0
4203,RM-1108,11/26/2013,0,0,0,0,0,0,0
4204,RM-1108,11/27/2013,0,0,0,0,0,0,0
4205,RM-1108,11/28/2013,0,0,0,0,0,0,0
4206,RM-1108,11/29/2013,0,0,0,0,0,0,0
4207,RM-1108,11/30/2013,0,0,0,0,0,0,0
4208,RM-1108,12/1/2013,0,0,0,0,0,0,0
4209,RM-1108,12/2/2013,0,0,0,0,0,0,0
4210,RM-1108,12/3/2013,0,0,0,0,0,0,0
4211,RM-1108,12/4/2013,0,0,0,0,0,0,0
4212,RM-1108,12/5/2013,0,0,0,0,0,0,0
4213,RM-1108,12/6/2013,0,0,0,0,0,0,0
4214,RM-1108,12/7/2013,0,0,0,0,0,0,0
4215,RM-1108,12/8/2013,0,0,0,0,0,0,0
4216,RM-1108,12/9/2013,0,0,0,0,0,0,0
4217,RM-1108,12/10/2013,0,0,0,0,0,0,0
4218,RM-1108,12/11/2013,0,0,0,0,0,0,0
4219,RM-1108,12/12/2013,0,0,0,0,0,0,0
4220,RM-1108,12/13/2013,0,0,0,0,0,0,0
4221,RM-1108,12/14/2013,0,0,0,0,0,0,0
4222,RM-1108,12/15/2013,0,0,0,0,0,0,0
4223,RM-1108,12/16/2013,0,0,0,0,0,0,0
4224,RM-1108,12/17/2013,0,0,0,0,0,0,0
4225,RM-1108,12/18/2013,0,0,0,0,0,0,0
4226,RM-1108,12/19/2013,0,0,0,0,0,0,0
4227,RM-1108,12/20/2013,0,0,0,0,0,0,0
4228,RM-1108,12/21/2013,0,0,0,0,0,0,0
4229,RM-1108,12/22/2013,0,0,0,0,0,0,0
4230,RM-1108,12/23/2013,0,0,0,0,0,0,0
4231,RM-1108,12/24/2013,0,0,0,0,0,0,0
4232,RM-1108,12/25/2013,0,0,0,0,0,0,0
4233,RM-1108,12/26/2013,0,0,0,0,0,0,0
4234,RM-1108,12/27/2013,0,0,0,0,0,0,0
4235,RM-1108,12/28/2013,0,0,0,0,0,0,0
4236,RM-1108,12/29/2013,0,0,0,0,0,0,0
4237,RM-1108,12/30/2013,0,0,0,0,0,0,0
4238,RM-1108,12/31/2013,0,0,0,0,0,0,0
4239,RM-1108,1/1/2014,0,0,0,0,0,0,0
4240,RM-1108,1/2/2014,0,0,0,0,0,0,0
4241,RM-1108,1/3/2014,0,0,0,0,0,0,0
4242,RM-1108,1/4/2014,0,0,0,0,0,0,0
4243,RM-1108,1/5/2014,0,0,0,0,0,0,0
4244,RM-1108,1/6/2014,0,0,0,0,0,0,0
4245,RM-1108,1/7/2014,0,0,0,0,0,0,0
4246,RM-1108,1/8/2014,0,0,0,0,0,0,0
4247,RM-1108,1/9/2014,0,0,0,0,0,0,0
4248,RM-1108,1/10/2014,0,0,0,0,0,0,0
4249,RM-1108,1/11/2014,0,0,0,0,0,0,0
4250,RM-1108,1/12/2014,0,0,0,0,0,0,0
4251,RM-1108,1/13/2014,0,0,0,0,0,0,0
4252,RM-1108,1/14/2014,0,0,0,0,0,0,0
4253,RM-1108,1/15/2014,0,0,0,0,0,0,0
4254,RM-1108,1/16/2014,0,0,0,0,0,0,0
4255,RM-1108,1/17/2014,0,0,0,0,0,0,0
4256,RM-1108,1/18/2014,0,0,0,0,0,0,0
4257,RM-1108,1/19/2014,0,0,0,0,0,0,0
4258,RM-1108,1/20/2014,0,0,0,0,0,0,0
4259,RM-1108,1/21/2014,0,0,0,0,0,0,0
4260,RM-1108,1/22/2014,0,0,0,0,0,0,0
4261,RM-1108,1/23/2014,0,0,0,0,0,0,0
4262,RM-1108,1/24/2014,0,0,0,0,0,0,0
4263,RM-1108,1/25/2014,0,0,0,0,0,0,0
4264,RM-1108,1/26/2014,0,0,0,0,0,0,0
4265,RM-1108,1/27/2014,0,0,0,0,0,0,0
4266,RM-1108,1/28/2014,0,0,0,0,0,0,0
4267,RM-1108,1/29/2014,0,0,0,0,0,0,0
4268,RM-1108,1/30/2014,0,0,0,0,0,0,0
4269,RM-1108,1/31/2014,0,0,0,0,0,0,0
4270,RM-1108,2/1/2014,0,0,0,0,0,0,0
4271,RM-1108,2/2/2014,0,0,0,0,0,0,0
4272,RM-1108,2/3/2014,0,0,0,0,0,0,0
4273,RM-1108,2/4/2014,0,0,0,0,0,0,0
4274,RM-1108,2/5/2014,0,0,0,0,0,0,0
4275,RM-1108,2/6/2014,0,0,0,0,0,0,0
4276,RM-1108,2/7/2014,0,0,0,0,0,0,0
4277,RM-1108,2/8/2014,0,0,0,0,0,0,0
4278,RM-1108,2/9/2014,0,0,0,0,0,0,0
4422,RM-1108,7/3/2014,0,0,0,0,0,0,0
4423,RM-1108,7/4/2014,0,0,0,0,0,0,0
4424,RM-1108,7/5/2014,0,0,0,0,0,0,0
4425,RM-1108,7/6/2014,0,0,0,0,0,0,0
4426,RM-1108,7/7/2014,0,0,0,0,0,0,0
4427,RM-1108,7/8/2014,0,0,0,0,0,0,0
4428,RM-1108,7/9/2014,0,0,0,0,0,0,0
4429,RM-1108,7/10/2014,0,0,0,0,0,0,0
4430,RM-1108,7/11/2014,0,0,0,0,0,0,0
4431,RM-1108,7/12/2014,0,0,0,0,0,0,0
4432,RM-1108,7/13/2014,0,0,0,0,0,0,0
4433,RM-1108,7/14/2014,0,0,0,0,0,0,0
4434,RM-1108,7/15/2014,0,0,0,0,0,0,0
4435,RM-1108,7/16/2014,0,0,0,0,0,0,0
4436,RM-1108,7/17/2014,0,0,0,0,0,0,0
4437,RM-1108,7/18/2014,0,0,0,0,0,0,0
4438,RM-1108,7/19/2014,0,0,0,0,0,0,0
4439,RM-1108,7/20/2014,0,0,0,0,0,0,0
4440,RM-1108,7/21/2014,0,0,0,0,0,0,0
4441,RM-1108,7/22/2014,0,0,0,0,0,0,0
4442,RM-1108,7/23/2014,0,0,0,0,0,0,0
4443,RM-1108,7/24/2014,0,0,0,0,0,0,0
4444,RM-1108,7/25/2014,0,0,0,0,0,0,0
4445,RM-1108,7/26/2014,0,0,0,0,0,0,0
4446,RM-1108,7/27/2014,0,0,0,0,0,0,0
4447,RM-1108,7/28/2014,0,0,0,0,0,0,0
4448,RM-1108,7/29/2014,0,0,0,0,0,0,0
4449,RM-1108,7/30/2014,0,0,0,0,0,0,0
4450,RM-1108,7/31/2014,0,0,0,0,0,0,0
4451,RM-1108,8/1/2014,0,0,0,0,0,0,0
4452,RM-1108,8/2/2014,0,0,0,0,0,0,0
4453,RM-1108,8/3/2014,0,0,0,0,0,0,0
4454,RM-1108,8/4/2014,0,0,0,0,0,0,0
4455,RM-1108,8/5/2014,0,0,0,0,0,0,0
4456,RM-1108,8/6/2014,0,0,0,0,0,0,0
4457,RM-1108,8/7/2014,0,0,0,0,0,0,0
4458,RM-1108,8/8/2014,0,0,0,0,0,0,0
4459,RM-1108,8/9/2014,0,0,0,0,0,0,0
4460,RM-1108,8/10/2014,0,0,0,0,0,0,0
4461,RM-1108,8/11/2014,0,0,0,0,0,0,0
4462,RM-1108,8/12/2014,0,0,0,0,0,0,0
4463,RM-1108,8/13/2014,0,0,0,0,0,0,0
4464,RM-1108,8/14/2014,0,0,0,0,0,0,0
4465,RM-1108,8/15/2014,0,0,0,0,0,0,0
4466,RM-1108,8/16/2014,0,0,0,0,0,0,0
4467,RM-1108,8/17/2014,0,0,0,0,0,0,0
4468,RM-1108,8/18/2014,0,0,0,0,0,0,0
4469,RM-1108,8/19/2014,0,0,0,0,0,0,0
4470,RM-1108,8/20/2014,0,0,0,0,0,0,0
4471,RM-1108,8/21/2014,0,0,0,0,0,0,0
4472,RM-1108,8/22/2014,0,0,0,0,0,0,0
4473,RM-1108,8/23/2014,0,0,0,0,0,0,0
4474,RM-1108,8/24/2014,0,0,0,0,0,0,0
4475,RM-1108,8/25/2014,0,0,0,0,0,0,0
4476,RM-1108,8/26/2014,0,0,0,0,0,0,0
4477,RM-1108,8/27/2014,0,0,0,0,0,0,0
4478,RM-1108,8/28/2014,0,0,0,0,0,0,0
4479,RM-1108,8/29/2014,0,0,0,0,0,0,0
4480,RM-1108,8/30/2014,0,0,0,0,0,0,0
4481,RM-1108,8/31/2014,0,0,0,0,0,0,0
4482,RM-1108,9/1/2014,0,0,0,0,0,0,0
4483,RM-1108,9/2/2014,0,0,0,0,0,0,0
4484,RM-1108,9/3/2014,0,0,0,0,0,0,0
4485,RM-1108,9/4/2014,0,0,0,0,0,0,0
4486,RM-1108,9/5/2014,0,0,0,0,0,0,0
4487,RM-1108,9/6/2014,0,0,0,0,0,0,0
4488,RM-1108,9/7/2014,0,0,0,0,0,0,0
4489,RM-1108,9/8/2014,0,0,0,0,0,0,0
4490,RM-1108,9/9/2014,0,0,0,0,0,0,0
4491,RM-1108,9/10/2014,0,0,0,0,0,0,0
4492,RM-1108,9/11/2014,0,0,0,0,0,0,0
4493,RM-1108,9/12/2014,0,0,0,0,0,0,0
4494,RM-1108,9/13/2014,0,0,0,0,0,0,0
4495,RM-1108,9/14/2014,0,0,0,0,0,0,0
4496,RM-1108,9/15/2014,0,0,0,0,0,0,0
4497,RM-1108,9/16/2014,0,0,0,0,0,0,0
4498,RM-1108,9/17/2014,0,0,0,0,0,0,0
4499,RM-1108,9/18/2014,0,0,0,0,0,0,0
4500,RM-1108,9/19/2014,0,0,0,0,0,0,0
4501,RM-1108,9/20/2014,0,0,0,0,0,0,0
4502,RM-1108,9/21/2014,0,0,0,0,0,0,0
4503,RM-1108,9/22/2014,0,0,0,0,0,0,0
4504,RM-1108,9/23/2014,0,0,0,0,0,0,0
4505,RM-1108,9/24/2014,0,0,0,0,0,0,0
4506,RM-1108,9/25/2014,0,0,0,0,0,0,0
4507,RM-1108,9/28/2014,0,0,0,0,0,0,0
4508,RM-1108,9/29/2014,0,0,0,0,0,0,0
4509,RM-1108,9/30/2014,0,0,0,0,0,0,0
4510,RM-1108,10/1/2014,0,0,0,0,0,0,0
4511,RM-1108,10/2/2014,0,0,0,0,0,0,0
4512,RM-1108,10/3/2014,0,0,0,0,0,0,0
4513,RM-1108,10/4/2014,0,0,0,0,0,0,0
4514,RM-1108,10/5/2014,0,0,0,0,0,0,0
4515,RM-1108,10/6/2014,0,0,0,0,0,0,0
4516,RM-1108,10/7/2014,0,0,0,0,0,0,0
4517,RM-1108,10/8/2014,0,0,0,0,0,0,0
4518,RM-1108,10/9/2014,0,0,0,0,0,0,0
4519,RM-1108,10/10/2014,0,0,0,0,0,0,0
4520,RM-1108,10/11/2014,0,0,0,0,0,0,0
4521,RM-1108,10/12/2014,0,0,0,0,0,0,0
4522,RM-1108,10/13/2014,0,0,0,0,0,0,0
4523,RM-1108,10/14/2014,0,0,0,0,0,0,0
4524,RM-1108,10/15/2014,0,0,0,0,0,0,0
4525,RM-1108,10/16/2014,0,0,0,0,0,0,0
4526,RM-1108,10/17/2014,0,0,0,0,0,0,0
4527,RM-1108,10/18/2014,0,0,0,0,0,0,0
4528,RM-1108,10/19/2014,0,0,0,0,0,0,0
4529,RM-1108,10/20/2014,0,0,0,0,0,0,0
4530,RM-1108,10/21/2014,0,0,0,0,0,0,0
4531,RM-1108,10/22/2014,0,0,0,0,0,0,0
4532,RM-1108,10/23/2014,0,0,0,0,0,0,0
4533,RM-1108,10/24/2014,0,0,0,0,0,0,0
4534,RM-1108,10/25/2014,0,0,0,0,0,0,0
4535,RM-1108,10/26/2014,0,0,0,0,0,0,0
4536,RM-1108,10/27/2014,0,0,0,0,0,0,0
4537,RM-1108,10/28/2014,0,0,0,0,0,0,0
4538,RM-1108,10/29/2014,0,0,0,0,0,0,0
4539,RM-1108,10/30/2014,0,0,0,0,0,0,0
4540,RM-1108,10/31/2014,0,0,0,0,0,0,0
4541,RM-1108,11/1/2014,0,0,0,0,0,0,0
4542,RM-1108,11/2/2014,0,0,0,0,0,0,0
4543,RM-1108,11/3/2014,0,0,0,0,0,0,0
4544,RM-1108,11/4/2014,0,0,0,0,0,0,0
4545,RM-1108,11/5/2014,0,0,0,0,0,0,0
4546,RM-1108,11/6/2014,0,0,0,0,0,0,0
4547,RM-1108,11/7/2014,0,0,0,0,0,0,0
4548,RM-1108,11/8/2014,0,0,0,0,0,0,0
4549,RM-1108,11/9/2014,0,0,0,0,0,0,0
4550,RM-1108,11/10/2014,0,0,0,0,0,0,0
4551,RM-1108,11/11/2014,0,0,0,0,0,0,0
4552,RM-1108,11/12/2014,0,0,0,0,0,0,0
4553,RM-1108,11/13/2014,0,0,0,0,0,0,0
4554,RM-1108,11/14/2014,0,0,0,0,0,0,0
4555,RM-1108,11/15/2014,0,0,0,0,0,0,0
4556,RM-1108,11/16/2014,0,0,0,0,0,0,0
4557,RM-1108,11/17/2014,0,0,0,0,0,0,0
4558,RM-1108,11/18/2014,0,0,0,0,0,0,0
4559,RM-1108,11/19/2014,0,0,0,0,0,0,0
4560,RM-1108,11/20/2014,0,0,0,0,0,0,0
4561,RM-1108,11/21/2014,0,0,0,0,0,0,0
4562,RM-1108,11/22/2014,0,0,0,0,0,0,0
4563,RM-1108,11/23/2014,0,0,0,0,0,0,0
4564,RM-1108,11/24/2014,0,0,0,0,0,0,0
4565,RM-1108,11/25/2014,0,0,0,0,0,0,0
4566,RM-1108,11/26/2014,0,0,0,0,0,0,0
4567,RM-1108,11/27/2014,0,0,0,0,0,0,0
4568,RM-1108,11/28/2014,0,0,0,0,0,0,0
4569,RM-1108,11/29/2014,0,0,0,0,0,0,0
4570,RM-1108,11/30/2014,0,0,0,0,0,0,0
4571,RM-1108,12/1/2014,0,0,0,0,0,0,0
4572,RM-1108,12/2/2014,0,0,0,0,0,0,0
4573,RM-1108,12/3/2014,0,0,0,0,0,0,0
4574,RM-1108,12/4/2014,0,0,0,0,0,0,0
4575,RM-1108,12/5/2014,0,0,0,0,0,0,0
4576,RM-1108,12/6/2014,0,0,0,0,0,0,0
4577,RM-1108,12/7/2014,0,0,0,0,0,0,0
4578,RM-1108,12/8/2014,0,0,0,0,0,0,0
4579,RM-1108,12/9/2014,0,0,0,0,0,0,0
4580,RM-1108,12/10/2014,0,0,0,0,0,0,0
4581,RM-1108,12/11/2014,0,0,0,0,0,0,0
4582,RM-1108,12/12/2014,0,0,0,0,0,0,0
4583,RM-1108,12/13/2014,0,0,0,0,0,0,0
4771,RM-1109,7/17/2013,0,0,0,0,0,0,0
4772,RM-1109,7/18/2013,0,0,0,0,0,0,0
4773,RM-1109,7/19/2013,0,0,0,0,0,0,0
4774,RM-1109,7/20/2013,0,0,0,0,0,0,0
4775,RM-1109,7/21/2013,0,0,0,0,0,0,0
4776,RM-1109,7/22/2013,0,0,0,0,0,0,0
4777,RM-1109,7/23/2013,0,0,0,0,0,0,0
4778,RM-1109,7/24/2013,0,0,0,0,0,0,0
4779,RM-1109,7/25/2013,0,0,0,0,0,0,0
4780,RM-1109,7/26/2013,0,0,0,0,0,0,0
4781,RM-1109,7/27/2013,0,0,0,0,0,0,0
4782,RM-1109,7/28/2013,0,0,0,0,0,0,0
4783,RM-1109,7/29/2013,0,0,0,0,0,0,0
4784,RM-1109,7/30/2013,0,0,0,0,0,0,0
4785,RM-1109,7/31/2013,0,0,0,0,0,0,0
4786,RM-1109,8/1/2013,0,0,0,0,0,0,0
4787,RM-1109,8/2/2013,0,0,0,0,0,0,0
4788,RM-1109,8/3/2013,0,0,0,0,0,0,0
4789,RM-1109,8/4/2013,0,0,0,0,0,0,0
4790,RM-1109,8/5/2013,0,0,0,0,0,0,0
4791,RM-1109,8/6/2013,0,0,0,0,0,0,0
4792,RM-1109,8/7/2013,0,0,0,0,0,0,0
4793,RM-1109,8/8/2013,0,0,0,0,0,0,0
4794,RM-1109,8/9/2013,0,0,0,0,0,0,0
4795,RM-1109,8/10/2013,0,0,0,0,0,0,0
4796,RM-1109,8/11/2013,0,0,0,0,0,0,0
4797,RM-1109,8/12/2013,0,0,0,0,0,0,0
4798,RM-1109,8/13/2013,0,0,0,0,0,0,0
4799,RM-1109,8/14/2013,0,0,0,0,0,0,0
4800,RM-1109,8/15/2013,0,0,0,0,0,0,0
4801,RM-1109,8/16/2013,0,0,0,0,0,0,0
4802,RM-1109,8/17/2013,0,0,0,0,0,0,0
4803,RM-1109,8/18/2013,0,0,0,0,0,0,0
4804,RM-1109,8/19/2013,0,0,0,0,0,0,0
4805,RM-1109,8/20/2013,0,0,0,0,0,0,0
4806,RM-1109,8/21/2013,0,0,0,0,0,0,0
4807,RM-1109,8/22/2013,0,0,0,0,0,0,0
4808,RM-1109,8/27/2013,0,0,0,0,0,0,0
4809,RM-1109,8/28/2013,0,0,0,0,0,0,0
4810,RM-1109,8/29/2013,0,0,0,0,0,0,0
4811,RM-1109,8/30/2013,0,0,0,0,0,0,0
4812,RM-1109,9/4/2013,0,0,0,0,0,0,0
4813,RM-1109,9/5/2013,0,0,0,0,0,0,0
4814,RM-1109,9/6/2013,0,0,0,0,0,0,0
4815,RM-1109,9/7/2013,0,0,0,0,0,0,0
4816,RM-1109,9/9/2013,0,0,0,0,0,0,0
4817,RM-1109,9/10/2013,0,0,0,0,0,0,0
4818,RM-1109,9/11/2013,0,0,0,0,0,0,0
4819,RM-1109,9/12/2013,0,0,0,0,0,0,0
4820,RM-1109,9/13/2013,0,0,0,0,0,0,0
4821,RM-1109,9/14/2013,0,0,0,0,0,0,0
4822,RM-1109,9/15/2013,0,0,0,0,0,0,0
4823,RM-1109,9/16/2013,0,0,0,0,0,0,0
4824,RM-1109,9/17/2013,0,0,0,0,0,0,0
4825,RM-1109,9/18/2013,0,0,0,0,0,0,0
4826,RM-1109,9/19/2013,0,0,0,0,0,0,0
4827,RM-1109,9/20/2013,0,0,0,0,0,0,0
4828,RM-1109,9/21/2013,0,0,0,0,0,0,0
4829,RM-1109,9/22/2013,0,0,0,0,0,0,0
4830,RM-1109,9/23/2013,0,0,0,0,0,0,0
4831,RM-1109,9/24/2013,0,0,0,0,0,0,0
4832,RM-1109,9/25/2013,0,0,0,0,0,0,0
4833,RM-1109,9/26/2013,0,0,0,0,0,0,0
4834,RM-1109,9/27/2013,0,0,0,0,0,0,0
4835,RM-1109,9/28/2013,0,0,0,0,0,0,0
4836,RM-1109,9/29/2013,0,0,0,0,0,0,0
5014,RM-1109,3/29/2014,0,0,0,0,0,0,0
5015,RM-1109,3/30/2014,0,0,0,0,0,0,0
5016,RM-1109,3/31/2014,0,0,0,0,0,0,0
5017,RM-1109,4/1/2014,0,0,0,0,0,0,0
5018,RM-1109,4/2/2014,0,0,0,0,0,0,0
5019,RM-1109,4/3/2014,0,0,0,0,0,0,0
5020,RM-1109,4/4/2014,0,0,0,0,0,0,0
5021,RM-1109,4/5/2014,0,0,0,0,0,0,0
5022,RM-1109,4/6/2014,0,0,0,0,0,0,0
5023,RM-1109,4/7/2014,0,0,0,0,0,0,0
5024,RM-1109,4/8/2014,0,0,0,0,0,0,0
5025,RM-1109,4/9/2014,0,0,0,0,0,0,0
5026,RM-1109,4/10/2014,0,0,0,0,0,0,0
5027,RM-1109,4/11/2014,0,0,0,0,0,0,0
5028,RM-1109,4/12/2014,0,0,0,0,0,0,0
5029,RM-1109,4/13/2014,0,0,0,0,0,0,0
5030,RM-1109,4/14/2014,0,0,0,0,0,0,0
5031,RM-1109,4/15/2014,0,0,0,0,0,0,0
5032,RM-1109,4/16/2014,0,0,0,0,0,0,0
5033,RM-1109,4/17/2014,0,0,0,0,0,0,0
5034,RM-1109,4/18/2014,0,0,0,0,0,0,0
5035,RM-1109,4/19/2014,0,0,0,0,0,0,0
5036,RM-1109,4/20/2014,0,0,0,0,0,0,0
5037,RM-1109,4/21/2014,0,0,0,0,0,0,0
5038,RM-1109,4/22/2014,0,0,0,0,0,0,0
5039,RM-1109,4/23/2014,0,0,0,0,0,0,0
5040,RM-1109,4/24/2014,0,0,0,0,0,0,0
5041,RM-1109,4/25/2014,0,0,0,0,0,0,0
5042,RM-1109,4/26/2014,0,0,0,0,0,0,0
5043,RM-1109,4/27/2014,0,0,0,0,0,0,0
5044,RM-1109,4/28/2014,0,0,0,0,0,0,0
5045,RM-1109,4/29/2014,0,0,0,0,0,0,0
5046,RM-1109,4/30/2014,0,0,0,0,0,0,0
5047,RM-1109,5/1/2014,0,0,0,0,0,0,0
5048,RM-1109,5/2/2014,0,0,0,0,0,0,0
5049,RM-1109,5/3/2014,0,0,0,0,0,0,0
5050,RM-1109,5/4/2014,0,0,0,0,0,0,0
5051,RM-1109,5/5/2014,0,0,0,0,0,0,0
5052,RM-1109,5/6/2014,0,0,0,0,0,0,0
5053,RM-1109,5/7/2014,0,0,0,0,0,0,0
5054,RM-1109,5/8/2014,0,0,0,0,0,0,0
5055,RM-1109,5/9/2014,0,0,0,0,0,0,0
5056,RM-1109,5/10/2014,0,0,0,0,0,0,0
5057,RM-1109,5/11/2014,0,0,0,0,0,0,0
5058,RM-1109,5/12/2014,0,0,0,0,0,0,0
5059,RM-1109,5/13/2014,0,0,0,0,0,0,0
5060,RM-1109,5/14/2014,0,0,0,0,0,0,0
5061,RM-1109,5/15/2014,0,0,0,0,0,0,0
5062,RM-1109,5/16/2014,0,0,0,0,0,0,0
5063,RM-1109,5/17/2014,0,0,0,0,0,0,0
5064,RM-1109,5/18/2014,0,0,0,0,0,0,0
5065,RM-1109,5/19/2014,0,0,0,0,0,0,0
5066,RM-1109,5/20/2014,0,0,0,0,0,0,0
5067,RM-1109,5/21/2014,0,0,0,0,0,0,0
5068,RM-1109,5/22/2014,0,0,0,0,0,0,0
5069,RM-1109,5/23/2014,0,0,0,0,0,0,0
5070,RM-1109,5/24/2014,0,0,0,0,0,0,0
5071,RM-1109,5/25/2014,0,0,0,0,0,0,0
5072,RM-1109,5/26/2014,0,0,0,0,0,0,0
5073,RM-1109,5/27/2014,0,0,0,0,0,0,0
5074,RM-1109,5/28/2014,0,0,0,0,0,0,0
5075,RM-1109,5/29/2014,0,0,0,0,0,0,0
5076,RM-1109,5/30/2014,0,0,0,0,0,0,0
5077,RM-1109,5/31/2014,0,0,0,0,0,0,0
5078,RM-1109,6/1/2014,0,0,0,0,0,0,0
5079,RM-1109,6/2/2014,0,0,0,0,0,0,0
5080,RM-1109,6/3/2014,0,0,0,0,0,0,0
5081,RM-1109,6/4/2014,0,0,0,0,0,0,0
5082,RM-1109,6/5/2014,0,0,0,0,0,0,0
5083,RM-1109,6/6/2014,0,0,0,0,0,0,0
5084,RM-1109,6/7/2014,0,0,0,0,0,0,0
5085,RM-1109,6/8/2014,0,0,0,0,0,0,0
5086,RM-1109,6/9/2014,0,0,0,0,0,0,0
5087,RM-1109,6/10/2014,0,0,0,0,0,0,0
5088,RM-1109,6/11/2014,0,0,0,0,0,0,0
5089,RM-1109,6/12/2014,0,0,0,0,0,0,0
5090,RM-1109,6/13/2014,0,0,0,0,0,0,0
5091,RM-1109,6/14/2014,0,0,0,0,0,0,0
5092,RM-1109,6/15/2014,0,0,0,0,0,0,0
5093,RM-1109,6/16/2014,0,0,0,0,0,0,0
5094,RM-1109,6/17/2014,0,0,0,0,0,0,0
5095,RM-1109,6/18/2014,0,0,0,0,0,0,0
5096,RM-1109,6/19/2014,0,0,0,0,0,0,0
5097,RM-1109,6/20/2014,0,0,0,0,0,0,0
5098,RM-1109,6/21/2014,0,0,0,0,0,0,0
5099,RM-1109,6/22/2014,0,0,0,0,0,0,0
5100,RM-1109,6/23/2014,0,0,0,0,0,0,0
5101,RM-1109,6/24/2014,0,0,0,0,0,0,0
5102,RM-1109,6/25/2014,0,0,0,0,0,0,0
5103,RM-1109,6/26/2014,0,0,0,0,0,0,0
5104,RM-1109,6/27/2014,0,0,0,0,0,0,0
5105,RM-1109,6/28/2014,0,0,0,0,0,0,0
5106,RM-1109,6/29/2014,0,0,0,0,0,0,0
5107,RM-1109,6/30/2014,0,0,0,0,0,0,0
5108,RM-1109,7/1/2014,0,0,0,0,0,0,0
5109,RM-1109,7/2/2014,0,0,0,0,0,0,0
5110,RM-1109,7/3/2014,0,0,0,0,0,0,0
5111,RM-1109,7/4/2014,0,0,0,0,0,0,0
5112,RM-1109,7/5/2014,0,0,0,0,0,0,0
5113,RM-1109,7/6/2014,0,0,0,0,0,0,0
5114,RM-1109,7/7/2014,0,0,0,0,0,0,0
5115,RM-1109,7/8/2014,0,0,0,0,0,0,0
5116,RM-1109,7/9/2014,0,0,0,0,0,0,0
5117,RM-1109,7/10/2014,0,0,0,0,0,0,0
5118,RM-1109,7/11/2014,0,0,0,0,0,0,0
5119,RM-1109,7/12/2014,0,0,0,0,0,0,0
5120,RM-1109,7/13/2014,0,0,0,0,0,0,0
5121,RM-1109,7/14/2014,0,0,0,0,0,0,0
5122,RM-1109,7/15/2014,0,0,0,0,0,0,0
5123,RM-1109,7/16/2014,0,0,0,0,0,0,0
5124,RM-1109,7/17/2014,0,0,0,0,0,0,0
5125,RM-1109,7/18/2014,0,0,0,0,0,0,0
5126,RM-1109,7/19/2014,0,0,0,0,0,0,0
5127,RM-1109,7/20/2014,0,0,0,0,0,0,0
5128,RM-1109,7/21/2014,0,0,0,0,0,0,0
5129,RM-1109,7/22/2014,0,0,0,0,0,0,0
5130,RM-1109,7/23/2014,0,0,0,0,0,0,0
5131,RM-1109,7/24/2014,0,0,0,0,0,0,0
5132,RM-1109,7/25/2014,0,0,0,0,0,0,0
5133,RM-1109,7/26/2014,0,0,0,0,0,0,0
5134,RM-1109,7/27/2014,0,0,0,0,0,0,0
5135,RM-1109,7/28/2014,0,0,0,0,0,0,0
5136,RM-1109,7/29/2014,0,0,0,0,0,0,0
5137,RM-1109,7/30/2014,0,0,0,0,0,0,0
5138,RM-1109,7/31/2014,0,0,0,0,0,0,0
5139,RM-1109,8/1/2014,0,0,0,0,0,0,0
5140,RM-1109,8/2/2014,0,0,0,0,0,0,0
5141,RM-1109,8/3/2014,0,0,0,0,0,0,0
5142,RM-1109,8/4/2014,0,0,0,0,0,0,0
5143,RM-1109,8/5/2014,0,0,0,0,0,0,0
5144,RM-1109,8/6/2014,0,0,0,0,0,0,0
5145,RM-1109,8/7/2014,0,0,0,0,0,0,0
5146,RM-1109,8/8/2014,0,0,0,0,0,0,0
5147,RM-1109,8/9/2014,0,0,0,0,0,0,0
5148,RM-1109,8/10/2014,0,0,0,0,0,0,0
5149,RM-1109,8/11/2014,0,0,0,0,0,0,0
5150,RM-1109,8/12/2014,0,0,0,0,0,0,0
5151,RM-1109,8/13/2014,0,0,0,0,0,0,0
5152,RM-1109,8/14/2014,0,0,0,0,0,0,0
5153,RM-1109,8/15/2014,0,0,0,0,0,0,0
5154,RM-1109,8/16/2014,0,0,0,0,0,0,0
5155,RM-1109,8/17/2014,0,0,0,0,0,0,0
5156,RM-1109,8/18/2014,0,0,0,0,0,0,0
5157,RM-1109,8/19/2014,0,0,0,0,0,0,0
5158,RM-1109,8/20/2014,0,0,0,0,0,0,0
5159,RM-1109,8/21/2014,0,0,0,0,0,0,0
5160,RM-1109,8/22/2014,0,0,0,0,0,0,0
5161,RM-1109,8/23/2014,0,0,0,0,0,0,0
5162,RM-1109,8/24/2014,0,0,0,0,0,0,0
5163,RM-1109,8/25/2014,0,0,0,0,0,0,0
5164,RM-1109,8/26/2014,0,0,0,0,0,0,0
5165,RM-1109,8/27/2014,0,0,0,0,0,0,0
5166,RM-1109,8/28/2014,0,0,0,0,0,0,0
5167,RM-1109,8/29/2014,0,0,0,0,0,0,0
5168,RM-1109,8/30/2014,0,0,0,0,0,0,0
5169,RM-1109,8/31/2014,0,0,0,0,0,0,0
5170,RM-1109,9/1/2014,0,0,0,0,0,0,0
5171,RM-1109,9/2/2014,0,0,0,0,0,0,0
5172,RM-1109,9/3/2014,0,0,0,0,0,0,0
5173,RM-1109,9/4/2014,0,0,0,0,0,0,0
5174,RM-1109,9/5/2014,0,0,0,0,0,0,0
5175,RM-1109,9/6/2014,0,0,0,0,0,0,0
5176,RM-1109,9/7/2014,0,0,0,0,0,0,0
5177,RM-1109,9/8/2014,0,0,0,0,0,0,0
5178,RM-1109,9/9/2014,0,0,0,0,0,0,0
5179,RM-1109,9/10/2014,0,0,0,0,0,0,0
5180,RM-1109,9/11/2014,0,0,0,0,0,0,0
5181,RM-1109,9/12/2014,0,0,0,0,0,0,0
5182,RM-1109,9/13/2014,0,0,0,0,0,0,0
5183,RM-1109,9/14/2014,0,0,0,0,0,0,0
5184,RM-1109,9/15/2014,0,0,0,0,0,0,0
5185,RM-1109,9/16/2014,0,0,0,0,0,0,0
5186,RM-1109,9/17/2014,0,0,0,0,0,0,0
5187,RM-1109,9/18/2014,0,0,0,0,0,0,0
5188,RM-1109,9/19/2014,0,0,0,0,0,0,0
5189,RM-1109,9/20/2014,0,0,0,0,0,0,0
5190,RM-1109,9/21/2014,0,0,0,0,0,0,0
5191,RM-1109,9/22/2014,0,0,0,0,0,0,0
5192,RM-1109,9/23/2014,0,0,0,0,0,0,0
5193,RM-1109,9/24/2014,0,0,0,0,0,0,0
5194,RM-1109,9/25/2014,0,0,0,0,0,0,0
5195,RM-1109,9/28/2014,0,0,0,0,0,0,0
5196,RM-1109,9/29/2014,0,0,0,0,0,0,0
5197,RM-1109,9/30/2014,0,0,0,0,0,0,0
5198,RM-1109,10/1/2014,0,0,0,0,0,0,0
5199,RM-1109,10/2/2014,0,0,0,0,0,0,0
5200,RM-1109,10/3/2014,0,0,0,0,0,0,0
5201,RM-1109,10/4/2014,0,0,0,0,0,0,0
5202,RM-1109,10/5/2014,0,0,0,0,0,0,0
5203,RM-1109,10/6/2014,0,0,0,0,0,0,0
5204,RM-1109,10/7/2014,0,0,0,0,0,0,0
5205,RM-1109,10/8/2014,0,0,0,0,0,0,0
5206,RM-1109,10/9/2014,0,0,0,0,0,0,0
5207,RM-1109,10/10/2014,0,0,0,0,0,0,0
5208,RM-1109,10/11/2014,0,0,0,0,0,0,0
5209,RM-1109,10/12/2014,0,0,0,0,0,0,0
5210,RM-1109,10/13/2014,0,0,0,0,0,0,0
5211,RM-1109,10/14/2014,0,0,0,0,0,0,0
5212,RM-1109,10/15/2014,0,0,0,0,0,0,0
5213,RM-1109,10/16/2014,0,0,0,0,0,0,0
5214,RM-1109,10/17/2014,0,0,0,0,0,0,0
5215,RM-1109,10/18/2014,0,0,0,0,0,0,0
5216,RM-1109,10/19/2014,0,0,0,0,0,0,0
5217,RM-1109,10/20/2014,0,0,0,0,0,0,0
5218,RM-1109,10/21/2014,0,0,0,0,0,0,0
5219,RM-1109,10/22/2014,0,0,0,0,0,0,0
5220,RM-1109,10/23/2014,0,0,0,0,0,0,0
5221,RM-1109,10/24/2014,0,0,0,0,0,0,0
5222,RM-1109,10/25/2014,0,0,0,0,0,0,0
5223,RM-1109,10/26/2014,0,0,0,0,0,0,0
5224,RM-1109,10/27/2014,0,0,0,0,0,0,0
5225,RM-1109,10/28/2014,0,0,0,0,0,0,0
5226,RM-1109,10/29/2014,0,0,0,0,0,0,0
5227,RM-1109,10/30/2014,0,0,0,0,0,0,0
5228,RM-1109,10/31/2014,0,0,0,0,0,0,0
5229,RM-1109,11/1/2014,0,0,0,0,0,0,0
5230,RM-1109,11/2/2014,0,0,0,0,0,0,0
5231,RM-1109,11/3/2014,0,0,0,0,0,0,0
5232,RM-1109,11/4/2014,0,0,0,0,0,0,0
5233,RM-1109,11/5/2014,0,0,0,0,0,0,0
5234,RM-1109,11/6/2014,0,0,0,0,0,0,0
5235,RM-1109,11/7/2014,0,0,0,0,0,0,0
5236,RM-1109,11/8/2014,0,0,0,0,0,0,0
5237,RM-1109,11/9/2014,0,0,0,0,0,0,0
5238,RM-1109,11/10/2014,0,0,0,0,0,0,0
5239,RM-1109,11/11/2014,0,0,0,0,0,0,0
5240,RM-1109,11/12/2014,0,0,0,0,0,0,0
5241,RM-1109,11/13/2014,0,0,0,0,0,0,0
5242,RM-1109,11/14/2014,0,0,0,0,0,0,0
5243,RM-1109,11/15/2014,0,0,0,0,0,0,0
5244,RM-1109,11/16/2014,0,0,0,0,0,0,0
5245,RM-1109,11/17/2014,0,0,0,0,0,0,0
5246,RM-1109,11/18/2014,0,0,0,0,0,0,0
5247,RM-1109,11/19/2014,0,0,0,0,0,0,0
5248,RM-1109,11/20/2014,0,0,0,0,0,0,0
5249,RM-1109,11/21/2014,0,0,0,0,0,0,0
5250,RM-1109,11/22/2014,0,0,0,0,0,0,0
5251,RM-1109,11/23/2014,0,0,0,0,0,0,0
5252,RM-1109,11/24/2014,0,0,0,0,0,0,0
5253,RM-1109,11/25/2014,0,0,0,0,0,0,0
5254,RM-1109,11/26/2014,0,0,0,0,0,0,0
5255,RM-1109,11/27/2014,0,0,0,0,0,0,0
5256,RM-1109,11/28/2014,0,0,0,0,0,0,0
5257,RM-1109,11/29/2014,0,0,0,0,0,0,0
5258,RM-1109,11/30/2014,0,0,0,0,0,0,0
5259,RM-1109,12/1/2014,0,0,0,0,0,0,0
5260,RM-1109,12/2/2014,0,0,0,0,0,0,0
5261,RM-1109,12/3/2014,0,0,0,0,0,0,0
5262,RM-1109,12/4/2014,0,0,0,0,0,0,0
5263,RM-1109,12/5/2014,0,0,0,0,0,0,0
5264,RM-1109,12/6/2014,0,0,0,0,0,0,0
5265,RM-1109,12/7/2014,0,0,0,0,0,0,0
5266,RM-1109,12/8/2014,0,0,0,0,0,0,0
5267,RM-1109,12/9/2014,0,0,0,0,0,0,0
5268,RM-1109,12/10/2014,0,0,0,0,0,0,0
5269,RM-1109,12/11/2014,0,0,0,0,0,0,0
5270,RM-1109,12/12/2014,0,0,0,0,0,0,0
5271,RM-1109,12/13/2014,0,0,0,0,0,0,0
5272,RM-1109,12/14/2014,0,0,0,0,0,0,0
5273,RM-1109,12/15/2014,0,0,0,0,0,0,0
5274,RM-1109,12/16/2014,0,0,0,0,0,0,0
5275,RM-1109,12/17/2014,0,0,0,0,0,0,0
5276,RM-1109,12/18/2014,0,0,0,0,0,0,0
5277,RM-1109,12/19/2014,0,0,0,0,0,0,0
5278,RM-1109,12/20/2014,0,0,0,0,0,0,0
5279,RM-1109,12/21/2014,0,0,0,0,0,0,0
5280,RM-1109,12/22/2014,0,0,0,0,0,0,0
5281,RM-1109,12/23/2014,0,0,0,0,0,0,0
5282,RM-1109,12/24/2014,0,0,0,0,0,0,0
5283,RM-1109,12/25/2014,0,0,0,0,0,0,0
5284,RM-1109,12/26/2014,0,0,0,0,0,0,0
5285,RM-1109,12/27/2014,0,0,0,0,0,0,0
5286,RM-1109,12/28/2014,0,0,0,0,0,0,0
5287,RM-1109,12/29/2014,0,0,0,0,0,0,0
5288,RM-1109,12/30/2014,0,0,0,0,0,0,0
5289,RM-1109,12/31/2014,0,0,0,0,0,0,0
5290,RM-1109,1/1/2015,0,0,0,0,0,0,0
5291,RM-1109,1/2/2015,0,0,0,0,0,0,0
5292,RM-1109,1/3/2015,0,0,0,0,0,0,0
5293,RM-1109,1/4/2015,0,0,0,0,0,0,0
5294,RM-1109,1/5/2015,0,0,0,0,0,0,0
5295,RM-1109,1/6/2015,0,0,0,0,0,0,0
5296,RM-1109,1/7/2015,0,0,0,0,0,0,0
5297,RM-1109,1/8/2015,0,0,0,0,0,0,0
5298,RM-1109,1/9/2015,0,0,0,0,0,0,0
5299,RM-1109,1/10/2015,0,0,0,0,0,0,0
5300,RM-1109,1/11/2015,0,0,0,0,0,0,0
5301,RM-1109,1/12/2015,0,0,0,0,0,0,0
5302,RM-1109,1/13/2015,0,0,0,0,0,0,0
5303,RM-1109,1/14/2015,0,0,0,0,0,0,0
5304,RM-1109,1/15/2015,0,0,0,0,0,0,0
5305,RM-1109,1/16/2015,0,0,0,0,0,0,0
5306,RM-1109,1/17/2015,0,0,0,0,0,0,0
5307,RM-1109,1/18/2015,0,0,0,0,0,0,0
5308,RM-1109,1/19/2015,0,0,0,0,0,0,0
5309,RM-1109,1/20/2015,0,0,0,0,0,0,0
5310,RM-1109,1/21/2015,0,0,0,0,0,0,0
5311,RM-1109,1/22/2015,0,0,0,0,0,0,0
5312,RM-1109,1/23/2015,0,0,0,0,0,0,0
5313,RM-1109,1/24/2015,0,0,0,0,0,0,0
5314,RM-1109,1/25/2015,0,0,0,0,0,0,0
5315,RM-1109,1/26/2015,0,0,0,0,0,0,0
5316,RM-1109,1/27/2015,0,0,0,0,0,0,0
5317,RM-1109,1/28/2015,0,0,0,0,0,0,0
5318,RM-1109,1/29/2015,0,0,0,0,0,0,0
5319,RM-1109,1/30/2015,0,0,0,0,0,0,0
5320,RM-1109,1/31/2015,0,0,0,0,0,0,0
5321,RM-1109,2/1/2015,0,0,0,0,0,0,0
5322,RM-1109,2/2/2015,0,0,0,0,0,0,0
5323,RM-1109,2/3/2015,0,0,0,0,0,0,0
5324,RM-1109,2/4/2015,0,0,0,0,0,0,0
5325,RM-1109,2/5/2015,0,0,0,0,0,0,0
5326,RM-1109,2/6/2015,0,0,0,0,0,0,0
5327,RM-1109,2/7/2015,0,0,0,0,0,0,0
5328,RM-1109,2/8/2015,0,0,0,0,0,0,0
5329,RM-1109,2/9/2015,0,0,0,0,0,0,0
5330,RM-1109,2/10/2015,0,0,0,0,0,0,0
5331,RM-1109,2/11/2015,0,0,0,0,0,0,0
5332,RM-1109,2/12/2015,0,0,0,0,0,0,0
5333,RM-1109,2/13/2015,0,0,0,0,0,0,0
5334,RM-1109,2/14/2015,0,0,0,0,0,0,0
5335,RM-1109,2/15/2015,0,0,0,0,0,0,0
5336,RM-1109,2/16/2015,0,0,0,0,0,0,0
5337,RM-1109,2/17/2015,0,0,0,0,0,0,0
5338,RM-1109,2/18/2015,0,0,0,0,0,0,0
5339,RM-1109,2/19/2015,0,0,0,0,0,0,0
5340,RM-1109,2/20/2015,0,0,0,0,0,0,0
5341,RM-1109,2/21/2015,0,0,0,0,0,0,0
5342,RM-1109,2/22/2015,0,0,0,0,0,0,0
5343,RM-1109,2/23/2015,0,0,0,0,0,0,0
5344,RM-1109,2/24/2015,0,0,0,0,0,0,0
5345,RM-1109,2/25/2015,0,0,0,0,0,0,0
5346,RM-1109,2/26/2015,0,0,0,0,0,0,0
5347,RM-1109,2/27/2015,0,0,0,0,0,0,0
5348,RM-1109,2/28/2015,0,0,0,0,0,0,0
5349,RM-1109,3/1/2015,0,0,0,0,0,0,0
5350,RM-1109,3/2/2015,0,0,0,0,0,0,0
5351,RM-1109,3/3/2015,0,0,0,0,0,0,0
5352,RM-1109,3/4/2015,0,0,0,0,0,0,0
5353,RM-1109,3/5/2015,0,0,0,0,0,0,0
5354,RM-1109,3/6/2015,0,0,0,0,0,0,0
5355,RM-1109,3/7/2015,0,0,0,0,0,0,0
5356,RM-1109,3/8/2015,0,0,0,0,0,0,0
5357,RM-1109,3/9/2015,0,0,0,0,0,0,0
5358,RM-1109,3/10/2015,0,0,0,0,0,0,0
5359,RM-1109,3/11/2015,0,0,0,0,0,0,0
5360,RM-1109,3/12/2015,0,0,0,0,0,0,0
5361,RM-1109,3/13/2015,0,0,0,0,0,0,0
5362,RM-1109,3/14/2015,0,0,0,0,0,0,0
5363,RM-1109,3/15/2015,0,0,0,0,0,0,0
5364,RM-1109,3/16/2015,0,0,0,0,0,0,0
5365,RM-1109,3/17/2015,0,0,0,0,0,0,0
5366,RM-1109,3/18/2015,0,0,0,0,0,0,0
5367,RM-1109,3/19/2015,0,0,0,0,0,0,0
5368,RM-1109,3/20/2015,0,0,0,0,0,0,0
5369,RM-1109,3/21/2015,0,0,0,0,0,0,0
5370,RM-1109,3/22/2015,0,0,0,0,0,0,0
5371,RM-1109,3/23/2015,0,0,0,0,0,0,0
5372,RM-1109,3/24/2015,0,0,0,0,0,0,0
5373,RM-1109,3/25/2015,0,0,0,0,0,0,0
5374,RM-1109,3/26/2015,0,0,0,0,0,0,0
5375,RM-1109,3/27/2015,0,0,0,0,0,0,0
5376,RM-1109,3/28/2015,0,0,0,0,0,0,0
5377,RM-1109,3/29/2015,0,0,0,0,0,0,0
5378,RM-1109,3/30/2015,0,0,0,0,0,0,0
5379,RM-1109,3/31/2015,0,0,0,0,0,0,0
5380,RM-1109,4/1/2015,0,0,0,0,0,0,0
5381,RM-1109,4/2/2015,0,0,0,0,0,0,0
5382,RM-1109,4/3/2015,0,0,0,0,0,0,0
5383,RM-1109,4/4/2015,0,0,0,0,0,0,0
5384,RM-1109,4/5/2015,0,0,0,0,0,0,0
5385,RM-1109,4/6/2015,0,0,0,0,0,0,0
5386,RM-1109,4/7/2015,0,0,0,0,0,0,0
5387,RM-1109,4/8/2015,0,0,0,0,0,0,0
5388,RM-1109,4/9/2015,0,0,0,0,0,0,0
5389,RM-1109,4/10/2015,0,0,0,0,0,0,0
5390,RM-1109,4/11/2015,0,0,0,0,0,0,0
5391,RM-1109,4/12/2015,0,0,0,0,0,0,0
5392,RM-1109,4/13/2015,0,0,0,0,0,0,0
5393,RM-1109,4/14/2015,0,0,0,0,0,0,0
5394,RM-1109,4/15/2015,0,0,0,0,0,0,0
5395,RM-1109,4/16/2015,0,0,0,0,0,0,0
5396,RM-1109,4/17/2015,0,0,0,0,0,0,0
5397,RM-1109,4/18/2015,0,0,0,0,0,0,0
5398,RM-1109,4/19/2015,0,0,0,0,0,0,0
5399,RM-1109,4/20/2015,0,0,0,0,0,0,0
5400,RM-1109,4/21/2015,0,0,0,0,0,0,0
5401,RM-1109,4/22/2015,0,0,0,0,0,0,0
5402,RM-1109,4/23/2015,0,0,0,0,0,0,0
5403,RM-1109,4/24/2015,0,0,0,0,0,0,0
5404,RM-1109,4/25/2015,0,0,0,0,0,0,0
5405,RM-1109,4/26/2015,0,0,0,0,0,0,0
5406,RM-1109,4/27/2015,0,0,0,0,0,0,0
5407,RM-1109,4/28/2015,0,0,0,0,0,0,0
5408,RM-1109,4/29/2015,0,0,0,0,0,0,0
5409,RM-1109,4/30/2015,0,0,0,0,0,0,0
5410,RM-1109,5/1/2015,0,0,0,0,0,0,0
5411,RM-1109,5/2/2015,0,0,0,0,0,0,0
5412,RM-1109,5/3/2015,0,0,0,0,0,0,0
5413,RM-1109,5/4/2015,0,0,0,0,0,0,0
5414,RM-1109,5/5/2015,0,0,0,0,0,0,0
5415,RM-1109,5/6/2015,0,0,0,0,0,0,0
5416,RM-1109,5/7/2015,0,0,0,0,0,0,0
5417,RM-1109,5/8/2015,0,0,0,0,0,0,0
5418,RM-1109,5/9/2015,0,0,0,0,0,0,0
5419,RM-1109,5/10/2015,0,0,0,0,0,0,0
5420,RM-1109,5/11/2015,0,0,0,0,0,0,0
5421,RM-1109,5/12/2015,0,0,0,0,0,0,0
5422,RM-1109,5/13/2015,0,0,0,0,0,0,0
5423,RM-1109,5/14/2015,0,0,0,0,0,0,0
5424,RM-1109,5/15/2015,0,0,0,0,0,0,0
5425,RM-1109,5/16/2015,0,0,0,0,0,0,0
5426,RM-1109,5/17/2015,0,0,0,0,0,0,0
5427,RM-1109,5/18/2015,0,0,0,0,0,0,0
5428,RM-1109,5/19/2015,0,0,0,0,0,0,0
5429,RM-1109,5/20/2015,0,0,0,0,0,0,0
5430,RM-1109,5/21/2015,0,0,0,0,0,0,0
5431,RM-1109,5/22/2015,0,0,0,0,0,0,0
5432,RM-1109,5/23/2015,0,0,0,0,0,0,0
5433,RM-1109,5/24/2015,0,0,0,0,0,0,0
5434,RM-1109,5/25/2015,0,0,0,0,0,0,0
5435,RM-1109,5/26/2015,0,0,0,0,0,0,0
5436,RM-1109,5/27/2015,0,0,0,0,0,0,0
5437,RM-1109,5/28/2015,0,0,0,0,0,0,0
5438,RM-1109,5/29/2015,0,0,0,0,0,0,0
5439,RM-1109,5/30/2015,0,0,0,0,0,0,0
5440,RM-1109,5/31/2015,0,0,0,0,0,0,0
5473,RM-1110,8/3/2013,0,0,0,0,0,0,0
5474,RM-1110,8/4/2013,0,0,0,0,0,0,0
5475,RM-1110,8/5/2013,0,0,0,0,0,0,0
5476,RM-1110,8/6/2013,0,0,0,0,0,0,0
5477,RM-1110,8/7/2013,0,0,0,0,0,0,0
5478,RM-1110,8/8/2013,0,0,0,0,0,0,0
5479,RM-1110,8/9/2013,0,0,0,0,0,0,0
5480,RM-1110,8/10/2013,0,0,0,0,0,0,0
5481,RM-1110,8/11/2013,0,0,0,0,0,0,0
5482,RM-1110,8/12/2013,0,0,0,0,0,0,0
5483,RM-1110,8/13/2013,0,0,0,0,0,0,0
5484,RM-1110,8/14/2013,0,0,0,0,0,0,0
5485,RM-1110,8/15/2013,0,0,0,0,0,0,0
5486,RM-1110,8/16/2013,0,0,0,0,0,0,0
5487,RM-1110,8/17/2013,0,0,0,0,0,0,0
5488,RM-1110,8/18/2013,0,0,0,0,0,0,0
5489,RM-1110,8/19/2013,0,0,0,0,0,0,0
5490,RM-1110,8/20/2013,0,0,0,0,0,0,0
5491,RM-1110,8/21/2013,0,0,0,0,0,0,0
5492,RM-1110,8/22/2013,0,0,0,0,0,0,0
5493,RM-1110,8/27/2013,0,0,0,0,0,0,0
5494,RM-1110,8/28/2013,0,0,0,0,0,0,0
5495,RM-1110,8/29/2013,0,0,0,0,0,0,0
5496,RM-1110,8/30/2013,0,0,0,0,0,0,0
5497,RM-1110,9/4/2013,0,0,0,0,0,0,0
5498,RM-1110,9/5/2013,0,0,0,0,0,0,0
5499,RM-1110,9/6/2013,0,0,0,0,0,0,0
5500,RM-1110,9/7/2013,0,0,0,0,0,0,0
5501,RM-1110,9/9/2013,0,0,0,0,0,0,0
5502,RM-1110,9/10/2013,0,0,0,0,0,0,0
5503,RM-1110,9/11/2013,0,0,0,0,0,0,0
5504,RM-1110,9/12/2013,0,0,0,0,0,0,0
5505,RM-1110,9/13/2013,0,0,0,0,0,0,0
5506,RM-1110,9/14/2013,0,0,0,0,0,0,0
5507,RM-1110,9/15/2013,0,0,0,0,0,0,0
5508,RM-1110,9/16/2013,0,0,0,0,0,0,0
5509,RM-1110,9/17/2013,0,0,0,0,0,0,0
5510,RM-1110,9/18/2013,0,0,0,0,0,0,0
5511,RM-1110,9/19/2013,0,0,0,0,0,0,0
5512,RM-1110,9/20/2013,0,0,0,0,0,0,0
5513,RM-1110,9/21/2013,0,0,0,0,0,0,0
5514,RM-1110,9/22/2013,0,0,0,0,0,0,0
5515,RM-1110,9/23/2013,0,0,0,0,0,0,0
5516,RM-1110,9/24/2013,0,0,0,0,0,0,0
5517,RM-1110,9/25/2013,0,0,0,0,0,0,0
5518,RM-1110,9/26/2013,0,0,0,0,0,0,0
5519,RM-1110,9/27/2013,0,0,0,0,0,0,0
5520,RM-1110,9/28/2013,0,0,0,0,0,0,0
5521,RM-1110,9/29/2013,0,0,0,0,0,0,0
5522,RM-1110,9/30/2013,0,0,0,0,0,0,0
5523,RM-1110,10/1/2013,0,0,0,0,0,0,0
5524,RM-1110,10/2/2013,0,0,0,0,0,0,0
5525,RM-1110,10/3/2013,0,0,0,0,0,0,0
5526,RM-1110,10/4/2013,0,0,0,0,0,0,0
5527,RM-1110,10/5/2013,0,0,0,0,0,0,0
5528,RM-1110,10/6/2013,0,0,0,0,0,0,0
5529,RM-1110,10/7/2013,0,0,0,0,0,0,0
5530,RM-1110,10/8/2013,0,0,0,0,0,0,0
5531,RM-1110,10/9/2013,0,0,0,0,0,0,0
5532,RM-1110,10/10/2013,0,0,0,0,0,0,0
5533,RM-1110,10/11/2013,0,0,0,0,0,0,0
5534,RM-1110,10/12/2013,0,0,0,0,0,0,0
5535,RM-1110,10/13/2013,0,0,0,0,0,0,0
5536,RM-1110,10/14/2013,0,0,0,0,0,0,0
5537,RM-1110,10/15/2013,0,0,0,0,0,0,0
5538,RM-1110,10/16/2013,0,0,0,0,0,0,0
5539,RM-1110,10/17/2013,0,0,0,0,0,0,0
5540,RM-1110,10/18/2013,0,0,0,0,0,0,0
5541,RM-1110,10/19/2013,0,0,0,0,0,0,0
5542,RM-1110,10/20/2013,0,0,0,0,0,0,0
5543,RM-1110,10/21/2013,0,0,0,0,0,0,0
5544,RM-1110,10/22/2013,0,0,0,0,0,0,0
5545,RM-1110,10/23/2013,0,0,0,0,0,0,0
5546,RM-1110,10/24/2013,0,0,0,0,0,0,0
5547,RM-1110,10/25/2013,0,0,0,0,0,0,0
5548,RM-1110,10/26/2013,0,0,0,0,0,0,0
5549,RM-1110,10/27/2013,0,0,0,0,0,0,0
5550,RM-1110,10/28/2013,0,0,0,0,0,0,0
5551,RM-1110,10/29/2013,0,0,0,0,0,0,0
5552,RM-1110,10/30/2013,0,0,0,0,0,0,0
5553,RM-1110,10/31/2013,0,0,0,0,0,0,0
5554,RM-1110,11/1/2013,0,0,0,0,0,0,0
5555,RM-1110,11/2/2013,0,0,0,0,0,0,0
5556,RM-1110,11/3/2013,0,0,0,0,0,0,0
5557,RM-1110,11/4/2013,0,0,0,0,0,0,0
5558,RM-1110,11/5/2013,0,0,0,0,0,0,0
5559,RM-1110,11/6/2013,0,0,0,0,0,0,0
5560,RM-1110,11/7/2013,0,0,0,0,0,0,0
5561,RM-1110,11/8/2013,0,0,0,0,0,0,0
5562,RM-1110,11/9/2013,0,0,0,0,0,0,0
5563,RM-1110,11/10/2013,0,0,0,0,0,0,0
5564,RM-1110,11/11/2013,0,0,0,0,0,0,0
5565,RM-1110,11/12/2013,0,0,0,0,0,0,0
5566,RM-1110,11/13/2013,0,0,0,0,0,0,0
5567,RM-1110,11/14/2013,0,0,0,0,0,0,0
5568,RM-1110,11/15/2013,0,0,0,0,0,0,0
5569,RM-1110,11/19/2013,0,0,0,0,0,0,0
5570,RM-1110,11/20/2013,0,0,0,0,0,0,0
5571,RM-1110,11/21/2013,0,0,0,0,0,0,0
5572,RM-1110,11/22/2013,0,0,0,0,0,0,0
5573,RM-1110,11/23/2013,0,0,0,0,0,0,0
5574,RM-1110,11/24/2013,0,0,0,0,0,0,0
5575,RM-1110,11/25/2013,0,0,0,0,0,0,0
5576,RM-1110,11/26/2013,0,0,0,0,0,0,0
5577,RM-1110,11/27/2013,0,0,0,0,0,0,0
5578,RM-1110,11/28/2013,0,0,0,0,0,0,0
5579,RM-1110,11/29/2013,0,0,0,0,0,0,0
5580,RM-1110,11/30/2013,0,0,0,0,0,0,0
5581,RM-1110,12/1/2013,0,0,0,0,0,0,0
5582,RM-1110,12/2/2013,0,0,0,0,0,0,0
5583,RM-1110,12/3/2013,0,0,0,0,0,0,0
5584,RM-1110,12/4/2013,0,0,0,0,0,0,0
5585,RM-1110,12/5/2013,0,0,0,0,0,0,0
5586,RM-1110,12/6/2013,0,0,0,0,0,0,0
5587,RM-1110,12/7/2013,0,0,0,0,0,0,0
5588,RM-1110,12/8/2013,0,0,0,0,0,0,0
5589,RM-1110,12/9/2013,0,0,0,0,0,0,0
5590,RM-1110,12/10/2013,0,0,0,0,0,0,0
5591,RM-1110,12/11/2013,0,0,0,0,0,0,0
5592,RM-1110,12/12/2013,0,0,0,0,0,0,0
5593,RM-1110,12/13/2013,0,0,0,0,0,0,0
5594,RM-1110,12/14/2013,0,0,0,0,0,0,0
5595,RM-1110,12/15/2013,0,0,0,0,0,0,0
5596,RM-1110,12/16/2013,0,0,0,0,0,0,0
5597,RM-1110,12/17/2013,0,0,0,0,0,0,0
5598,RM-1110,12/18/2013,0,0,0,0,0,0,0
5599,RM-1110,12/19/2013,0,0,0,0,0,0,0
5600,RM-1110,12/20/2013,0,0,0,0,0,0,0
5601,RM-1110,12/21/2013,0,0,0,0,0,0,0
5602,RM-1110,12/22/2013,0,0,0,0,0,0,0
5603,RM-1110,12/23/2013,0,0,0,0,0,0,0
5604,RM-1110,12/24/2013,0,0,0,0,0,0,0
5605,RM-1110,12/25/2013,0,0,0,0,0,0,0
5606,RM-1110,12/26/2013,0,0,0,0,0,0,0
5607,RM-1110,12/27/2013,0,0,0,0,0,0,0
5608,RM-1110,12/28/2013,0,0,0,0,0,0,0
5609,RM-1110,12/29/2013,0,0,0,0,0,0,0
5610,RM-1110,12/30/2013,0,0,0,0,0,0,0
5611,RM-1110,12/31/2013,0,0,0,0,0,0,0
5612,RM-1110,1/1/2014,0,0,0,0,0,0,0
5613,RM-1110,1/2/2014,0,0,0,0,0,0,0
5614,RM-1110,1/3/2014,0,0,0,0,0,0,0
5615,RM-1110,1/4/2014,0,0,0,0,0,0,0
5616,RM-1110,1/5/2014,0,0,0,0,0,0,0
5617,RM-1110,1/6/2014,0,0,0,0,0,0,0
5618,RM-1110,1/7/2014,0,0,0,0,0,0,0
5619,RM-1110,1/8/2014,0,0,0,0,0,0,0
5620,RM-1110,1/9/2014,0,0,0,0,0,0,0
5621,RM-1110,1/10/2014,0,0,0,0,0,0,0
5622,RM-1110,1/11/2014,0,0,0,0,0,0,0
5623,RM-1110,1/12/2014,0,0,0,0,0,0,0
5624,RM-1110,1/13/2014,0,0,0,0,0,0,0
5625,RM-1110,1/14/2014,0,0,0,0,0,0,0
5626,RM-1110,1/15/2014,0,0,0,0,0,0,0
5627,RM-1110,1/16/2014,0,0,0,0,0,0,0
5628,RM-1110,1/17/2014,0,0,0,0,0,0,0
5629,RM-1110,1/18/2014,0,0,0,0,0,0,0
5630,RM-1110,1/19/2014,0,0,0,0,0,0,0
5631,RM-1110,1/20/2014,0,0,0,0,0,0,0
5632,RM-1110,1/21/2014,0,0,0,0,0,0,0
5633,RM-1110,1/22/2014,0,0,0,0,0,0,0
5634,RM-1110,1/23/2014,0,0,0,0,0,0,0
5635,RM-1110,1/24/2014,0,0,0,0,0,0,0
5636,RM-1110,1/25/2014,0,0,0,0,0,0,0
5637,RM-1110,1/26/2014,0,0,0,0,0,0,0
5638,RM-1110,1/27/2014,0,0,0,0,0,0,0
5639,RM-1110,1/28/2014,0,0,0,0,0,0,0
5640,RM-1110,1/29/2014,0,0,0,0,0,0,0
5641,RM-1110,1/30/2014,0,0,0,0,0,0,0
5642,RM-1110,1/31/2014,0,0,0,0,0,0,0
5643,RM-1110,2/1/2014,0,0,0,0,0,0,0
5644,RM-1110,2/2/2014,0,0,0,0,0,0,0
5645,RM-1110,2/3/2014,0,0,0,0,0,0,0
5646,RM-1110,2/4/2014,0,0,0,0,0,0,0
5647,RM-1110,2/5/2014,0,0,0,0,0,0,0
5648,RM-1110,2/6/2014,0,0,0,0,0,0,0
5649,RM-1110,2/7/2014,0,0,0,0,0,0,0
5650,RM-1110,2/8/2014,0,0,0,0,0,0,0
5651,RM-1110,2/9/2014,0,0,0,0,0,0,0
5652,RM-1110,2/10/2014,0,0,0,0,0,0,0
5653,RM-1110,2/11/2014,0,0,0,0,0,0,0
5654,RM-1110,2/12/2014,0,0,0,0,0,0,0
5655,RM-1110,2/13/2014,0,0,0,0,0,0,0
5656,RM-1110,2/14/2014,0,0,0,0,0,0,0
5657,RM-1110,2/15/2014,0,0,0,0,0,0,0
5658,RM-1110,2/16/2014,0,0,0,0,0,0,0
5659,RM-1110,2/17/2014,0,0,0,0,0,0,0
5660,RM-1110,2/18/2014,0,0,0,0,0,0,0
5661,RM-1110,2/19/2014,0,0,0,0,0,0,0
5662,RM-1110,2/20/2014,0,0,0,0,0,0,0
5663,RM-1110,2/21/2014,0,0,0,0,0,0,0
5664,RM-1110,2/22/2014,0,0,0,0,0,0,0
5665,RM-1110,2/23/2014,0,0,0,0,0,0,0
5666,RM-1110,2/24/2014,0,0,0,0,0,0,0
5667,RM-1110,2/25/2014,0,0,0,0,0,0,0
5668,RM-1110,2/26/2014,0,0,0,0,0,0,0
5669,RM-1110,2/27/2014,0,0,0,0,0,0,0
5670,RM-1110,2/28/2014,0,0,0,0,0,0,0
5671,RM-1110,3/1/2014,0,0,0,0,0,0,0
5672,RM-1110,3/2/2014,0,0,0,0,0,0,0
5673,RM-1110,3/3/2014,0,0,0,0,0,0,0
5674,RM-1110,3/4/2014,0,0,0,0,0,0,0
5675,RM-1110,3/5/2014,0,0,0,0,0,0,0
5676,RM-1110,3/6/2014,0,0,0,0,0,0,0
5677,RM-1110,3/7/2014,0,0,0,0,0,0,0
5678,RM-1110,3/8/2014,0,0,0,0,0,0,0
5679,RM-1110,3/9/2014,0,0,0,0,0,0,0
5680,RM-1110,3/10/2014,0,0,0,0,0,0,0
5681,RM-1110,3/11/2014,0,0,0,0,0,0,0
5682,RM-1110,3/12/2014,0,0,0,0,0,0,0
5683,RM-1110,3/13/2014,0,0,0,0,0,0,0
5684,RM-1110,3/14/2014,0,0,0,0,0,0,0
5685,RM-1110,3/15/2014,0,0,0,0,0,0,0
5686,RM-1110,3/16/2014,0,0,0,0,0,0,0
5687,RM-1110,3/17/2014,0,0,0,0,0,0,0
5688,RM-1110,3/18/2014,0,0,0,0,0,0,0
5689,RM-1110,3/19/2014,0,0,0,0,0,0,0
5690,RM-1110,3/20/2014,0,0,0,0,0,0,0
5691,RM-1110,3/21/2014,0,0,0,0,0,0,0
5692,RM-1110,3/22/2014,0,0,0,0,0,0,0
5693,RM-1110,3/23/2014,0,0,0,0,0,0,0
5694,RM-1110,3/24/2014,0,0,0,0,0,0,0
5695,RM-1110,3/25/2014,0,0,0,0,0,0,0
5696,RM-1110,3/26/2014,0,0,0,0,0,0,0
5881,RM-1110,9/30/2014,0,0,0,0,0,0,0
5882,RM-1110,10/1/2014,0,0,0,0,0,0,0
5883,RM-1110,10/2/2014,0,0,0,0,0,0,0
5884,RM-1110,10/3/2014,0,0,0,0,0,0,0
5885,RM-1110,10/4/2014,0,0,0,0,0,0,0
5886,RM-1110,10/5/2014,0,0,0,0,0,0,0
5887,RM-1110,10/6/2014,0,0,0,0,0,0,0
5888,RM-1110,10/7/2014,0,0,0,0,0,0,0
5889,RM-1110,10/8/2014,0,0,0,0,0,0,0
5890,RM-1110,10/9/2014,0,0,0,0,0,0,0
5891,RM-1110,10/10/2014,0,0,0,0,0,0,0
5892,RM-1110,10/11/2014,0,0,0,0,0,0,0
5893,RM-1110,10/12/2014,0,0,0,0,0,0,0
5894,RM-1110,10/13/2014,0,0,0,0,0,0,0
5895,RM-1110,10/14/2014,0,0,0,0,0,0,0
5896,RM-1110,10/15/2014,0,0,0,0,0,0,0
5897,RM-1110,10/16/2014,0,0,0,0,0,0,0
5898,RM-1110,10/17/2014,0,0,0,0,0,0,0
5899,RM-1110,10/18/2014,0,0,0,0,0,0,0
5900,RM-1110,10/19/2014,0,0,0,0,0,0,0
5901,RM-1110,10/20/2014,0,0,0,0,0,0,0
5902,RM-1110,10/21/2014,0,0,0,0,0,0,0
5903,RM-1110,10/22/2014,0,0,0,0,0,0,0
5904,RM-1110,10/23/2014,0,0,0,0,0,0,0
5905,RM-1110,10/24/2014,0,0,0,0,0,0,0
5906,RM-1110,10/25/2014,0,0,0,0,0,0,0
5907,RM-1110,10/26/2014,0,0,0,0,0,0,0
5908,RM-1110,10/27/2014,0,0,0,0,0,0,0
5909,RM-1110,10/28/2014,0,0,0,0,0,0,0
5910,RM-1110,10/29/2014,0,0,0,0,0,0,0
5911,RM-1110,10/30/2014,0,0,0,0,0,0,0
5912,RM-1110,10/31/2014,0,0,0,0,0,0,0
5913,RM-1110,11/1/2014,0,0,0,0,0,0,0
5914,RM-1110,11/2/2014,0,0,0,0,0,0,0
5915,RM-1110,11/3/2014,0,0,0,0,0,0,0
5916,RM-1110,11/4/2014,0,0,0,0,0,0,0
5917,RM-1110,11/5/2014,0,0,0,0,0,0,0
5918,RM-1110,11/6/2014,0,0,0,0,0,0,0
5919,RM-1110,11/7/2014,0,0,0,0,0,0,0
5920,RM-1110,11/8/2014,0,0,0,0,0,0,0
5921,RM-1110,11/9/2014,0,0,0,0,0,0,0
5922,RM-1110,11/10/2014,0,0,0,0,0,0,0
5923,RM-1110,11/11/2014,0,0,0,0,0,0,0
5924,RM-1110,11/12/2014,0,0,0,0,0,0,0
5925,RM-1110,11/13/2014,0,0,0,0,0,0,0
5926,RM-1110,11/14/2014,0,0,0,0,0,0,0
5927,RM-1110,11/15/2014,0,0,0,0,0,0,0
5928,RM-1110,11/16/2014,0,0,0,0,0,0,0
5929,RM-1110,11/17/2014,0,0,0,0,0,0,0
5930,RM-1110,11/18/2014,0,0,0,0,0,0,0
5931,RM-1110,11/19/2014,0,0,0,0,0,0,0
5932,RM-1110,11/20/2014,0,0,0,0,0,0,0
5933,RM-1110,11/21/2014,0,0,0,0,0,0,0
5934,RM-1110,11/22/2014,0,0,0,0,0,0,0
5935,RM-1110,11/23/2014,0,0,0,0,0,0,0
5936,RM-1110,11/24/2014,0,0,0,0,0,0,0
5937,RM-1110,11/25/2014,0,0,0,0,0,0,0
5938,RM-1110,11/26/2014,0,0,0,0,0,0,0
5939,RM-1110,11/27/2014,0,0,0,0,0,0,0
5940,RM-1110,11/28/2014,0,0,0,0,0,0,0
5941,RM-1110,11/29/2014,0,0,0,0,0,0,0
5942,RM-1110,11/30/2014,0,0,0,0,0,0,0
5943,RM-1110,12/1/2014,0,0,0,0,0,0,0
5944,RM-1110,12/2/2014,0,0,0,0,0,0,0
5945,RM-1110,12/3/2014,0,0,0,0,0,0,0
5946,RM-1110,12/4/2014,0,0,0,0,0,0,0
5947,RM-1110,12/5/2014,0,0,0,0,0,0,0
5948,RM-1110,12/6/2014,0,0,0,0,0,0,0
5949,RM-1110,12/7/2014,0,0,0,0,0,0,0
5950,RM-1110,12/8/2014,0,0,0,0,0,0,0
5951,RM-1110,12/9/2014,0,0,0,0,0,0,0
5952,RM-1110,12/10/2014,0,0,0,0,0,0,0
5953,RM-1110,12/11/2014,0,0,0,0,0,0,0
5954,RM-1110,12/12/2014,0,0,0,0,0,0,0
5955,RM-1110,12/13/2014,0,0,0,0,0,0,0
5956,RM-1110,12/14/2014,0,0,0,0,0,0,0
5957,RM-1110,12/15/2014,0,0,0,0,0,0,0
5958,RM-1110,12/16/2014,0,0,0,0,0,0,0
5959,RM-1110,12/17/2014,0,0,0,0,0,0,0
5960,RM-1110,12/18/2014,0,0,0,0,0,0,0
5961,RM-1110,12/19/2014,0,0,0,0,0,0,0
5962,RM-1110,12/20/2014,0,0,0,0,0,0,0
5963,RM-1110,12/21/2014,0,0,0,0,0,0,0
5964,RM-1110,12/22/2014,0,0,0,0,0,0,0
5965,RM-1110,12/23/2014,0,0,0,0,0,0,0
5966,RM-1110,12/24/2014,0,0,0,0,0,0,0
5967,RM-1110,12/25/2014,0,0,0,0,0,0,0
5968,RM-1110,12/26/2014,0,0,0,0,0,0,0
5969,RM-1110,12/27/2014,0,0,0,0,0,0,0
5970,RM-1110,12/28/2014,0,0,0,0,0,0,0
5971,RM-1110,12/29/2014,0,0,0,0,0,0,0
5972,RM-1110,12/30/2014,0,0,0,0,0,0,0
5973,RM-1110,12/31/2014,0,0,0,0,0,0,0
5974,RM-1110,1/1/2015,0,0,0,0,0,0,0
5975,RM-1110,1/2/2015,0,0,0,0,0,0,0
5976,RM-1110,1/3/2015,0,0,0,0,0,0,0
5977,RM-1110,1/4/2015,0,0,0,0,0,0,0
5978,RM-1110,1/5/2015,0,0,0,0,0,0,0
5979,RM-1110,1/6/2015,0,0,0,0,0,0,0
5980,RM-1110,1/7/2015,0,0,0,0,0,0,0
5981,RM-1110,1/8/2015,0,0,0,0,0,0,0
5982,RM-1110,1/9/2015,0,0,0,0,0,0,0
5983,RM-1110,1/10/2015,0,0,0,0,0,0,0
5984,RM-1110,1/11/2015,0,0,0,0,0,0,0
5985,RM-1110,1/12/2015,0,0,0,0,0,0,0
5986,RM-1110,1/13/2015,0,0,0,0,0,0,0
5987,RM-1110,1/14/2015,0,0,0,0,0,0,0
5988,RM-1110,1/15/2015,0,0,0,0,0,0,0
5989,RM-1110,1/16/2015,0,0,0,0,0,0,0
5990,RM-1110,1/17/2015,0,0,0,0,0,0,0
5991,RM-1110,1/18/2015,0,0,0,0,0,0,0
5992,RM-1110,1/19/2015,0,0,0,0,0,0,0
5993,RM-1110,1/20/2015,0,0,0,0,0,0,0
5994,RM-1110,1/21/2015,0,0,0,0,0,0,0
5995,RM-1110,1/22/2015,0,0,0,0,0,0,0
5996,RM-1110,1/23/2015,0,0,0,0,0,0,0
5997,RM-1110,1/24/2015,0,0,0,0,0,0,0
5998,RM-1110,1/25/2015,0,0,0,0,0,0,0
5999,RM-1110,1/26/2015,0,0,0,0,0,0,0
6000,RM-1110,1/27/2015,0,0,0,0,0,0,0
6001,RM-1110,1/28/2015,0,0,0,0,0,0,0
6002,RM-1110,1/29/2015,0,0,0,0,0,0,0
6003,RM-1110,1/30/2015,0,0,0,0,0,0,0
6004,RM-1110,1/31/2015,0,0,0,0,0,0,0
6005,RM-1110,2/1/2015,0,0,0,0,0,0,0
6006,RM-1110,2/2/2015,0,0,0,0,0,0,0
6007,RM-1110,2/3/2015,0,0,0,0,0,0,0
6008,RM-1110,2/4/2015,0,0,0,0,0,0,0
6009,RM-1110,2/5/2015,0,0,0,0,0,0,0
6010,RM-1110,2/6/2015,0,0,0,0,0,0,0
6011,RM-1110,2/7/2015,0,0,0,0,0,0,0
6012,RM-1110,2/8/2015,0,0,0,0,0,0,0
6013,RM-1110,2/9/2015,0,0,0,0,0,0,0
6014,RM-1110,2/10/2015,0,0,0,0,0,0,0
6015,RM-1110,2/11/2015,0,0,0,0,0,0,0
6016,RM-1110,2/12/2015,0,0,0,0,0,0,0
6017,RM-1110,2/13/2015,0,0,0,0,0,0,0
6018,RM-1110,2/14/2015,0,0,0,0,0,0,0
6019,RM-1110,2/15/2015,0,0,0,0,0,0,0
6020,RM-1110,2/16/2015,0,0,0,0,0,0,0
6021,RM-1110,2/17/2015,0,0,0,0,0,0,0
6022,RM-1110,2/18/2015,0,0,0,0,0,0,0
6023,RM-1110,2/19/2015,0,0,0,0,0,0,0
6024,RM-1110,2/20/2015,0,0,0,0,0,0,0
6025,RM-1110,2/21/2015,0,0,0,0,0,0,0
6026,RM-1110,2/22/2015,0,0,0,0,0,0,0
6027,RM-1110,2/23/2015,0,0,0,0,0,0,0
6028,RM-1110,2/24/2015,0,0,0,0,0,0,0
6029,RM-1110,2/25/2015,0,0,0,0,0,0,0
6030,RM-1110,2/26/2015,0,0,0,0,0,0,0
6031,RM-1110,2/27/2015,0,0,0,0,0,0,0
6032,RM-1110,2/28/2015,0,0,0,0,0,0,0
6033,RM-1110,3/1/2015,0,0,0,0,0,0,0
6034,RM-1110,3/2/2015,0,0,0,0,0,0,0
6035,RM-1110,3/3/2015,0,0,0,0,0,0,0
6036,RM-1110,3/4/2015,0,0,0,0,0,0,0
6037,RM-1110,3/5/2015,0,0,0,0,0,0,0
6038,RM-1110,3/6/2015,0,0,0,0,0,0,0
6039,RM-1110,3/7/2015,0,0,0,0,0,0,0
6040,RM-1110,3/8/2015,0,0,0,0,0,0,0
6041,RM-1110,3/9/2015,0,0,0,0,0,0,0
6042,RM-1110,3/10/2015,0,0,0,0,0,0,0
6043,RM-1110,3/11/2015,0,0,0,0,0,0,0
6044,RM-1110,3/12/2015,0,0,0,0,0,0,0
6045,RM-1110,3/13/2015,0,0,0,0,0,0,0
6046,RM-1110,3/14/2015,0,0,0,0,0,0,0
6047,RM-1110,3/15/2015,0,0,0,0,0,0,0
6048,RM-1110,3/16/2015,0,0,0,0,0,0,0
6049,RM-1110,3/17/2015,0,0,0,0,0,0,0
6050,RM-1110,3/18/2015,0,0,0,0,0,0,0
6051,RM-1110,3/19/2015,0,0,0,0,0,0,0
6052,RM-1110,3/20/2015,0,0,0,0,0,0,0
6053,RM-1110,3/21/2015,0,0,0,0,0,0,0
6054,RM-1110,3/22/2015,0,0,0,0,0,0,0
6055,RM-1110,3/23/2015,0,0,0,0,0,0,0
6056,RM-1110,3/24/2015,0,0,0,0,0,0,0
6057,RM-1110,3/25/2015,0,0,0,0,0,0,0
6058,RM-1110,3/26/2015,0,0,0,0,0,0,0
6059,RM-1110,3/27/2015,0,0,0,0,0,0,0
6060,RM-1110,3/28/2015,0,0,0,0,0,0,0
6061,RM-1110,3/29/2015,0,0,0,0,0,0,0
6062,RM-1110,3/30/2015,0,0,0,0,0,0,0
6063,RM-1110,3/31/2015,0,0,0,0,0,0,0
6064,RM-1110,4/1/2015,0,0,0,0,0,0,0
6065,RM-1110,4/2/2015,0,0,0,0,0,0,0
6066,RM-1110,4/3/2015,0,0,0,0,0,0,0
6067,RM-1110,4/4/2015,0,0,0,0,0,0,0
6068,RM-1110,4/5/2015,0,0,0,0,0,0,0
6069,RM-1110,4/6/2015,0,0,0,0,0,0,0
6070,RM-1110,4/7/2015,0,0,0,0,0,0,0
6071,RM-1110,4/8/2015,0,0,0,0,0,0,0
6072,RM-1110,4/9/2015,0,0,0,0,0,0,0
6073,RM-1110,4/10/2015,0,0,0,0,0,0,0
6074,RM-1110,4/11/2015,0,0,0,0,0,0,0
6075,RM-1110,4/12/2015,0,0,0,0,0,0,0
6076,RM-1110,4/13/2015,0,0,0,0,0,0,0
6077,RM-1110,4/14/2015,0,0,0,0,0,0,0
6078,RM-1110,4/15/2015,0,0,0,0,0,0,0
6079,RM-1110,4/16/2015,0,0,0,0,0,0,0
6080,RM-1110,4/17/2015,0,0,0,0,0,0,0
6081,RM-1110,4/18/2015,0,0,0,0,0,0,0
6082,RM-1110,4/19/2015,0,0,0,0,0,0,0
6083,RM-1110,4/20/2015,0,0,0,0,0,0,0
6084,RM-1110,4/21/2015,0,0,0,0,0,0,0
6085,RM-1110,4/22/2015,0,0,0,0,0,0,0
6086,RM-1110,4/23/2015,0,0,0,0,0,0,0
6087,RM-1110,4/24/2015,0,0,0,0,0,0,0
6088,RM-1110,4/25/2015,0,0,0,0,0,0,0
6089,RM-1110,4/26/2015,0,0,0,0,0,0,0
6090,RM-1110,4/27/2015,0,0,0,0,0,0,0
6091,RM-1110,4/28/2015,0,0,0,0,0,0,0
6092,RM-1110,4/29/2015,0,0,0,0,0,0,0
6093,RM-1110,4/30/2015,0,0,0,0,0,0,0
6094,RM-1110,5/1/2015,0,0,0,0,0,0,0
6095,RM-1110,5/2/2015,0,0,0,0,0,0,0
6096,RM-1110,5/3/2015,0,0,0,0,0,0,0
6097,RM-1110,5/4/2015,0,0,0,0,0,0,0
6098,RM-1110,5/5/2015,0,0,0,0,0,0,0
6099,RM-1110,5/6/2015,0,0,0,0,0,0,0
6100,RM-1110,5/7/2015,0,0,0,0,0,0,0
6101,RM-1110,5/8/2015,0,0,0,0,0,0,0
6102,RM-1110,5/9/2015,0,0,0,0,0,0,0
6103,RM-1110,5/10/2015,0,0,0,0,0,0,0
6104,RM-1110,5/11/2015,0,0,0,0,0,0,0
6105,RM-1110,5/12/2015,0,0,0,0,0,0,0
6106,RM-1110,5/13/2015,0,0,0,0,0,0,0
6107,RM-1110,5/14/2015,0,0,0,0,0,0,0
6108,RM-1110,5/15/2015,0,0,0,0,0,0,0
6109,RM-1110,5/16/2015,0,0,0,0,0,0,0
6110,RM-1110,5/17/2015,0,0,0,0,0,0,0
6111,RM-1110,5/18/2015,0,0,0,0,0,0,0
6112,RM-1110,5/19/2015,0,0,0,0,0,0,0
6113,RM-1110,5/20/2015,0,0,0,0,0,0,0
6114,RM-1110,5/21/2015,0,0,0,0,0,0,0
6115,RM-1110,5/22/2015,0,0,0,0,0,0,0
6116,RM-1110,5/23/2015,0,0,0,0,0,0,0
6117,RM-1110,5/24/2015,0,0,0,0,0,0,0
6118,RM-1110,5/25/2015,0,0,0,0,0,0,0
6119,RM-1110,5/26/2015,0,0,0,0,0,0,0
6120,RM-1110,5/27/2015,0,0,0,0,0,0,0
6121,RM-1110,5/28/2015,0,0,0,0,0,0,0
6122,RM-1110,5/29/2015,0,0,0,0,0,0,0
6123,RM-1110,5/30/2015,0,0,0,0,0,0,0
6124,RM-1110,5/31/2015,0,0,0,0,0,0,0
6729,RM-1113,3/12/2015,0,0,0,0,0,0,0
6730,RM-1113,3/13/2015,0,0,0,0,0,0,0
6731,RM-1113,3/14/2015,0,0,0,0,0,0,0
6732,RM-1113,3/15/2015,0,0,0,0,0,0,0
6733,RM-1113,3/16/2015,0,0,0,0,0,0,0
6734,RM-1113,3/17/2015,0,0,0,0,0,0,0
6735,RM-1113,3/18/2015,0,0,0,0,0,0,0
6736,RM-1113,3/19/2015,0,0,0,0,0,0,0
6737,RM-1113,3/20/2015,0,0,0,0,0,0,0
6738,RM-1113,3/21/2015,0,0,0,0,0,0,0
6739,RM-1113,3/22/2015,0,0,0,0,0,0,0
6740,RM-1113,3/23/2015,0,0,0,0,0,0,0
6741,RM-1113,3/24/2015,0,0,0,0,0,0,0
6742,RM-1113,3/25/2015,0,0,0,0,0,0,0
6743,RM-1113,3/26/2015,0,0,0,0,0,0,0
6744,RM-1113,3/27/2015,0,0,0,0,0,0,0
6745,RM-1113,3/28/2015,0,0,0,0,0,0,0
6746,RM-1113,3/29/2015,0,0,0,0,0,0,0
6747,RM-1113,3/30/2015,0,0,0,0,0,0,0
6748,RM-1113,3/31/2015,0,0,0,0,0,0,0
6749,RM-1113,4/1/2015,0,0,0,0,0,0,0
6750,RM-1113,4/2/2015,0,0,0,0,0,0,0
6751,RM-1113,4/3/2015,0,0,0,0,0,0,0
6752,RM-1113,4/4/2015,0,0,0,0,0,0,0
6753,RM-1113,4/5/2015,0,0,0,0,0,0,0
6754,RM-1113,4/6/2015,0,0,0,0,0,0,0
6755,RM-1113,4/7/2015,0,0,0,0,0,0,0
6756,RM-1113,4/8/2015,0,0,0,0,0,0,0
6757,RM-1113,4/9/2015,0,0,0,0,0,0,0
6758,RM-1113,4/10/2015,0,0,0,0,0,0,0
6759,RM-1113,4/11/2015,0,0,0,0,0,0,0
6760,RM-1113,4/12/2015,0,0,0,0,0,0,0
6761,RM-1113,4/13/2015,0,0,0,0,0,0,0
6762,RM-1113,4/14/2015,0,0,0,0,0,0,0
6763,RM-1113,4/15/2015,0,0,0,0,0,0,0
6764,RM-1113,4/16/2015,0,0,0,0,0,0,0
6765,RM-1113,4/17/2015,0,0,0,0,0,0,0
6766,RM-1113,4/18/2015,0,0,0,0,0,0,0
6767,RM-1113,4/19/2015,0,0,0,0,0,0,0
6768,RM-1113,4/20/2015,0,0,0,0,0,0,0
6769,RM-1113,4/21/2015,0,0,0,0,0,0,0
6770,RM-1113,4/22/2015,0,0,0,0,0,0,0
6771,RM-1113,4/23/2015,0,0,0,0,0,0,0
6772,RM-1113,4/24/2015,0,0,0,0,0,0,0
6773,RM-1113,4/25/2015,0,0,0,0,0,0,0
6774,RM-1113,4/26/2015,0,0,0,0,0,0,0
6775,RM-1113,4/27/2015,0,0,0,0,0,0,0
6776,RM-1113,4/28/2015,0,0,0,0,0,0,0
6777,RM-1113,4/29/2015,0,0,0,0,0,0,0
6778,RM-1113,4/30/2015,0,0,0,0,0,0,0
6779,RM-1113,5/1/2015,0,0,0,0,0,0,0
6780,RM-1113,5/2/2015,0,0,0,0,0,0,0
6781,RM-1113,5/3/2015,0,0,0,0,0,0,0
6782,RM-1113,5/4/2015,0,0,0,0,0,0,0
6783,RM-1113,5/5/2015,0,0,0,0,0,0,0
6784,RM-1113,5/6/2015,0,0,0,0,0,0,0
6785,RM-1113,5/7/2015,0,0,0,0,0,0,0
6786,RM-1113,5/8/2015,0,0,0,0,0,0,0
6787,RM-1113,5/9/2015,0,0,0,0,0,0,0
6788,RM-1113,5/10/2015,0,0,0,0,0,0,0
6789,RM-1113,5/11/2015,0,0,0,0,0,0,0
6790,RM-1113,5/12/2015,0,0,0,0,0,0,0
6791,RM-1113,5/13/2015,0,0,0,0,0,0,0
6792,RM-1113,5/14/2015,0,0,0,0,0,0,0
6793,RM-1113,5/15/2015,0,0,0,0,0,0,0
6794,RM-1113,5/16/2015,0,0,0,0,0,0,0
6795,RM-1113,5/17/2015,0,0,0,0,0,0,0
6796,RM-1113,5/18/2015,0,0,0,0,0,0,0
6797,RM-1113,5/19/2015,0,0,0,0,0,0,0
6798,RM-1113,5/20/2015,0,0,0,0,0,0,0
6799,RM-1113,5/21/2015,0,0,0,0,0,0,0
6800,RM-1113,5/22/2015,0,0,0,0,0,0,0
6801,RM-1113,5/23/2015,0,0,0,0,0,0,0
6802,RM-1113,5/24/2015,0,0,0,0,0,0,0
6803,RM-1113,5/25/2015,0,0,0,0,0,0,0
6804,RM-1113,5/26/2015,0,0,0,0,0,0,0
6805,RM-1113,5/27/2015,0,0,0,0,0,0,0
6806,RM-1113,5/28/2015,0,0,0,0,0,0,0
6807,RM-1113,5/29/2015,0,0,0,0,0,0,0
6808,RM-1113,5/30/2015,0,0,0,0,0,0,0
6809,RM-1113,5/31/2015,0,0,0,0,0,0,0
6810,RM-1115,7/28/2013,0,0,0,0,0,0,0
6811,RM-1115,7/29/2013,0,0,0,0,0,0,0
6812,RM-1115,7/30/2013,0,0,0,0,0,0,0
6813,RM-1115,7/31/2013,0,0,0,0,0,0,0
6814,RM-1115,8/1/2013,0,0,0,0,0,0,0
6815,RM-1115,8/2/2013,0,0,0,0,0,0,0
6816,RM-1115,8/3/2013,0,0,0,0,0,0,0
6817,RM-1115,8/4/2013,0,0,0,0,0,0,0
6818,RM-1115,8/5/2013,0,0,0,0,0,0,0
6819,RM-1115,8/6/2013,0,0,0,0,0,0,0
6820,RM-1115,8/7/2013,0,0,0,0,0,0,0
6821,RM-1115,8/8/2013,0,0,0,0,0,0,0
6822,RM-1115,8/9/2013,0,0,0,0,0,0,0
6823,RM-1115,8/10/2013,0,0,0,0,0,0,0
6824,RM-1115,8/11/2013,0,0,0,0,0,0,0
6825,RM-1115,8/12/2013,0,0,0,0,0,0,0
6826,RM-1115,8/13/2013,0,0,0,0,0,0,0
6827,RM-1115,8/14/2013,0,0,0,0,0,0,0
6828,RM-1115,8/15/2013,0,0,0,0,0,0,0
6829,RM-1115,8/16/2013,0,0,0,0,0,0,0
6830,RM-1115,8/17/2013,0,0,0,0,0,0,0
6831,RM-1115,8/18/2013,0,0,0,0,0,0,0
6832,RM-1115,8/19/2013,0,0,0,0,0,0,0
6833,RM-1115,8/20/2013,0,0,0,0,0,0,0
6834,RM-1115,8/21/2013,0,0,0,0,0,0,0
6835,RM-1115,8/22/2013,0,0,0,0,0,0,0
6836,RM-1115,8/27/2013,0,0,0,0,0,0,0
6837,RM-1115,8/28/2013,0,0,0,0,0,0,0
6838,RM-1115,8/29/2013,0,0,0,0,0,0,0
6839,RM-1115,8/30/2013,0,0,0,0,0,0,0
6840,RM-1115,9/4/2013,0,0,0,0,0,0,0
6841,RM-1115,9/5/2013,0,0,0,0,0,0,0
6842,RM-1115,9/6/2013,0,0,0,0,0,0,0
6843,RM-1115,9/7/2013,0,0,0,0,0,0,0
6844,RM-1115,9/9/2013,0,0,0,0,0,0,0
6845,RM-1115,9/10/2013,0,0,0,0,0,0,0
6846,RM-1115,9/11/2013,0,0,0,0,0,0,0
6847,RM-1115,9/12/2013,0,0,0,0,0,0,0
6848,RM-1115,9/13/2013,0,0,0,0,0,0,0
6849,RM-1115,9/14/2013,0,0,0,0,0,0,0
6850,RM-1115,9/15/2013,0,0,0,0,0,0,0
6851,RM-1115,9/16/2013,0,0,0,0,0,0,0
6852,RM-1115,9/17/2013,0,0,0,0,0,0,0
6853,RM-1115,9/18/2013,0,0,0,0,0,0,0
6854,RM-1115,9/19/2013,0,0,0,0,0,0,0
6855,RM-1115,9/20/2013,0,0,0,0,0,0,0
6856,RM-1115,9/21/2013,0,0,0,0,0,0,0
6857,RM-1115,9/22/2013,0,0,0,0,0,0,0
6858,RM-1115,9/23/2013,0,0,0,0,0,0,0
6859,RM-1115,9/24/2013,0,0,0,0,0,0,0
6860,RM-1115,9/25/2013,0,0,0,0,0,0,0
6861,RM-1115,9/26/2013,0,0,0,0,0,0,0
6862,RM-1115,9/27/2013,0,0,0,0,0,0,0
6863,RM-1115,9/28/2013,0,0,0,0,0,0,0
6864,RM-1115,9/29/2013,0,0,0,0,0,0,0
6865,RM-1115,9/30/2013,0,0,0,0,0,0,0
6866,RM-1115,10/1/2013,0,0,0,0,0,0,0
6867,RM-1115,10/2/2013,0,0,0,0,0,0,0
6868,RM-1115,10/3/2013,0,0,0,0,0,0,0
6869,RM-1115,10/4/2013,0,0,0,0,0,0,0
6870,RM-1115,10/5/2013,0,0,0,0,0,0,0
6871,RM-1115,10/6/2013,0,0,0,0,0,0,0
6872,RM-1115,10/7/2013,0,0,0,0,0,0,0
6873,RM-1115,10/8/2013,0,0,0,0,0,0,0
6874,RM-1115,10/9/2013,0,0,0,0,0,0,0
6875,RM-1115,10/10/2013,0,0,0,0,0,0,0
6876,RM-1115,10/11/2013,0,0,0,0,0,0,0
6877,RM-1115,10/12/2013,0,0,0,0,0,0,0
6878,RM-1115,10/13/2013,0,0,0,0,0,0,0
6879,RM-1115,10/14/2013,0,0,0,0,0,0,0
6880,RM-1115,10/15/2013,0,0,0,0,0,0,0
6881,RM-1115,10/16/2013,0,0,0,0,0,0,0
6882,RM-1115,10/17/2013,0,0,0,0,0,0,0
6883,RM-1115,10/18/2013,0,0,0,0,0,0,0
6884,RM-1115,10/19/2013,0,0,0,0,0,0,0
6885,RM-1115,10/20/2013,0,0,0,0,0,0,0
6886,RM-1115,10/21/2013,0,0,0,0,0,0,0
6887,RM-1115,10/22/2013,0,0,0,0,0,0,0
6888,RM-1115,10/23/2013,0,0,0,0,0,0,0
6889,RM-1115,10/24/2013,0,0,0,0,0,0,0
6890,RM-1115,10/25/2013,0,0,0,0,0,0,0
6891,RM-1115,10/26/2013,0,0,0,0,0,0,0
6892,RM-1115,10/27/2013,0,0,0,0,0,0,0
6893,RM-1115,10/28/2013,0,0,0,0,0,0,0
6894,RM-1115,10/29/2013,0,0,0,0,0,0,0
6895,RM-1115,10/30/2013,0,0,0,0,0,0,0
6896,RM-1115,10/31/2013,0,0,0,0,0,0,0
6897,RM-1115,11/1/2013,0,0,0,0,0,0,0
6898,RM-1115,11/2/2013,0,0,0,0,0,0,0
6899,RM-1115,11/3/2013,0,0,0,0,0,0,0
6900,RM-1115,11/4/2013,0,0,0,0,0,0,0
6901,RM-1115,11/5/2013,0,0,0,0,0,0,0
6902,RM-1115,11/6/2013,0,0,0,0,0,0,0
6903,RM-1115,11/7/2013,0,0,0,0,0,0,0
6904,RM-1115,11/8/2013,0,0,0,0,0,0,0
6905,RM-1115,11/9/2013,0,0,0,0,0,0,0
6906,RM-1115,11/10/2013,0,0,0,0,0,0,0
6907,RM-1115,11/11/2013,0,0,0,0,0,0,0
6908,RM-1115,11/12/2013,0,0,0,0,0,0,0
6909,RM-1115,11/13/2013,0,0,0,0,0,0,0
6910,RM-1115,11/14/2013,0,0,0,0,0,0,0
6911,RM-1115,11/15/2013,0,0,0,0,0,0,0
6912,RM-1115,11/19/2013,0,0,0,0,0,0,0
6913,RM-1115,11/20/2013,0,0,0,0,0,0,0
6914,RM-1115,11/21/2013,0,0,0,0,0,0,0
6915,RM-1115,11/22/2013,0,0,0,0,0,0,0
6916,RM-1115,11/23/2013,0,0,0,0,0,0,0
6917,RM-1115,11/24/2013,0,0,0,0,0,0,0
6918,RM-1115,11/25/2013,0,0,0,0,0,0,0
6919,RM-1115,11/26/2013,0,0,0,0,0,0,0
6920,RM-1115,11/27/2013,0,0,0,0,0,0,0
6921,RM-1115,11/28/2013,0,0,0,0,0,0,0
6922,RM-1115,11/29/2013,0,0,0,0,0,0,0
6923,RM-1115,11/30/2013,0,0,0,0,0,0,0
6924,RM-1115,12/1/2013,0,0,0,0,0,0,0
6925,RM-1115,12/2/2013,0,0,0,0,0,0,0
6926,RM-1115,12/3/2013,0,0,0,0,0,0,0
6927,RM-1115,12/4/2013,0,0,0,0,0,0,0
6928,RM-1115,12/5/2013,0,0,0,0,0,0,0
6929,RM-1115,12/6/2013,0,0,0,0,0,0,0
6930,RM-1115,12/7/2013,0,0,0,0,0,0,0
6931,RM-1115,12/8/2013,0,0,0,0,0,0,0
6932,RM-1115,12/9/2013,0,0,0,0,0,0,0
6933,RM-1115,12/10/2013,0,0,0,0,0,0,0
6934,RM-1115,12/11/2013,0,0,0,0,0,0,0
6935,RM-1115,12/12/2013,0,0,0,0,0,0,0
6936,RM-1115,12/13/2013,0,0,0,0,0,0,0
6937,RM-1115,12/14/2013,0,0,0,0,0,0,0
6938,RM-1115,12/15/2013,0,0,0,0,0,0,0
6939,RM-1115,12/16/2013,0,0,0,0,0,0,0
6940,RM-1115,12/17/2013,0,0,0,0,0,0,0
6941,RM-1115,12/18/2013,0,0,0,0,0,0,0
6942,RM-1115,12/19/2013,0,0,0,0,0,0,0
6943,RM-1115,12/20/2013,0,0,0,0,0,0,0
6944,RM-1115,12/21/2013,0,0,0,0,0,0,0
6945,RM-1115,12/22/2013,0,0,0,0,0,0,0
6946,RM-1115,12/23/2013,0,0,0,0,0,0,0
6947,RM-1115,12/24/2013,0,0,0,0,0,0,0
6948,RM-1115,12/25/2013,0,0,0,0,0,0,0
6949,RM-1115,12/26/2013,0,0,0,0,0,0,0
6950,RM-1115,12/27/2013,0,0,0,0,0,0,0
6951,RM-1115,12/28/2013,0,0,0,0,0,0,0
6952,RM-1115,12/29/2013,0,0,0,0,0,0,0
6953,RM-1115,12/30/2013,0,0,0,0,0,0,0
6954,RM-1115,12/31/2013,0,0,0,0,0,0,0
6955,RM-1115,1/1/2014,0,0,0,0,0,0,0
6956,RM-1115,1/2/2014,0,0,0,0,0,0,0
6957,RM-1115,1/3/2014,0,0,0,0,0,0,0
6958,RM-1115,1/4/2014,0,0,0,0,0,0,0
6959,RM-1115,1/5/2014,0,0,0,0,0,0,0
7080,RM-1115,5/6/2014,0,0,0,0,0,0,0
7095,RM-1115,5/21/2014,0,0,0,0,0,0,0
7096,RM-1115,5/22/2014,0,0,0,0,0,0,0
7097,RM-1115,5/23/2014,0,0,0,0,0,0,0
7098,RM-1115,5/24/2014,0,0,0,0,0,0,0
7099,RM-1115,5/25/2014,0,0,0,0,0,0,0
7100,RM-1115,5/26/2014,0,0,0,0,0,0,0
7101,RM-1115,5/27/2014,0,0,0,0,0,0,0
7102,RM-1115,5/28/2014,0,0,0,0,0,0,0
7103,RM-1115,5/29/2014,0,0,0,0,0,0,0
7104,RM-1115,5/30/2014,0,0,0,0,0,0,0
7105,RM-1115,5/31/2014,0,0,0,0,0,0,0
7106,RM-1115,6/1/2014,0,0,0,0,0,0,0
7107,RM-1115,6/2/2014,0,0,0,0,0,0,0
7108,RM-1115,6/3/2014,0,0,0,0,0,0,0
7109,RM-1115,6/4/2014,0,0,0,0,0,0,0
7110,RM-1115,6/5/2014,0,0,0,0,0,0,0
7111,RM-1115,6/6/2014,0,0,0,0,0,0,0
7112,RM-1115,6/7/2014,0,0,0,0,0,0,0
7113,RM-1115,6/8/2014,0,0,0,0,0,0,0
7114,RM-1115,6/9/2014,0,0,0,0,0,0,0
7115,RM-1115,6/10/2014,0,0,0,0,0,0,0
7116,RM-1115,6/11/2014,0,0,0,0,0,0,0
7117,RM-1115,6/12/2014,0,0,0,0,0,0,0
7118,RM-1115,6/13/2014,0,0,0,0,0,0,0
7119,RM-1115,6/14/2014,0,0,0,0,0,0,0
7120,RM-1115,6/15/2014,0,0,0,0,0,0,0
7121,RM-1115,6/16/2014,0,0,0,0,0,0,0
7122,RM-1115,6/17/2014,0,0,0,0,0,0,0
7123,RM-1115,6/18/2014,0,0,0,0,0,0,0
7124,RM-1115,6/19/2014,0,0,0,0,0,0,0
7125,RM-1115,6/20/2014,0,0,0,0,0,0,0
7126,RM-1115,6/21/2014,0,0,0,0,0,0,0
7127,RM-1115,6/22/2014,0,0,0,0,0,0,0
7128,RM-1115,6/23/2014,0,0,0,0,0,0,0
7129,RM-1115,6/24/2014,0,0,0,0,0,0,0
7130,RM-1115,6/25/2014,0,0,0,0,0,0,0
7131,RM-1115,6/26/2014,0,0,0,0,0,0,0
7132,RM-1115,6/27/2014,0,0,0,0,0,0,0
7133,RM-1115,6/28/2014,0,0,0,0,0,0,0
7134,RM-1115,6/29/2014,0,0,0,0,0,0,0
7135,RM-1115,6/30/2014,0,0,0,0,0,0,0
7136,RM-1115,7/1/2014,0,0,0,0,0,0,0
7137,RM-1115,7/2/2014,0,0,0,0,0,0,0
7138,RM-1115,7/3/2014,0,0,0,0,0,0,0
7139,RM-1115,7/4/2014,0,0,0,0,0,0,0
7140,RM-1115,7/5/2014,0,0,0,0,0,0,0
7141,RM-1115,7/6/2014,0,0,0,0,0,0,0
7142,RM-1115,7/7/2014,0,0,0,0,0,0,0
7143,RM-1115,7/8/2014,0,0,0,0,0,0,0
7144,RM-1115,7/9/2014,0,0,0,0,0,0,0
7145,RM-1115,7/10/2014,0,0,0,0,0,0,0
7146,RM-1115,7/11/2014,0,0,0,0,0,0,0
7147,RM-1115,7/12/2014,0,0,0,0,0,0,0
7148,RM-1115,7/13/2014,0,0,0,0,0,0,0
7149,RM-1115,7/14/2014,0,0,0,0,0,0,0
7150,RM-1115,7/15/2014,0,0,0,0,0,0,0
7151,RM-1115,7/16/2014,0,0,0,0,0,0,0
7152,RM-1115,7/17/2014,0,0,0,0,0,0,0
7153,RM-1115,7/18/2014,0,0,0,0,0,0,0
7154,RM-1115,7/19/2014,0,0,0,0,0,0,0
7155,RM-1115,7/20/2014,0,0,0,0,0,0,0
7156,RM-1115,7/21/2014,0,0,0,0,0,0,0
7157,RM-1115,7/22/2014,0,0,0,0,0,0,0
7158,RM-1115,7/23/2014,0,0,0,0,0,0,0
7159,RM-1115,7/24/2014,0,0,0,0,0,0,0
7160,RM-1115,7/25/2014,0,0,0,0,0,0,0
7161,RM-1115,7/26/2014,0,0,0,0,0,0,0
7162,RM-1115,7/27/2014,0,0,0,0,0,0,0
7163,RM-1115,7/28/2014,0,0,0,0,0,0,0
7164,RM-1115,7/29/2014,0,0,0,0,0,0,0
7165,RM-1115,7/30/2014,0,0,0,0,0,0,0
7166,RM-1115,7/31/2014,0,0,0,0,0,0,0
7167,RM-1115,8/1/2014,0,0,0,0,0,0,0
7168,RM-1115,8/2/2014,0,0,0,0,0,0,0
7169,RM-1115,8/3/2014,0,0,0,0,0,0,0
7170,RM-1115,8/4/2014,0,0,0,0,0,0,0
7171,RM-1115,8/5/2014,0,0,0,0,0,0,0
7172,RM-1115,8/6/2014,0,0,0,0,0,0,0
7173,RM-1115,8/7/2014,0,0,0,0,0,0,0
7174,RM-1115,8/8/2014,0,0,0,0,0,0,0
7175,RM-1115,8/9/2014,0,0,0,0,0,0,0
7176,RM-1115,8/10/2014,0,0,0,0,0,0,0
7177,RM-1115,8/11/2014,0,0,0,0,0,0,0
7178,RM-1115,8/12/2014,0,0,0,0,0,0,0
7179,RM-1115,8/13/2014,0,0,0,0,0,0,0
7180,RM-1115,8/14/2014,0,0,0,0,0,0,0
7181,RM-1115,8/15/2014,0,0,0,0,0,0,0
7182,RM-1115,8/16/2014,0,0,0,0,0,0,0
7183,RM-1115,8/17/2014,0,0,0,0,0,0,0
7184,RM-1115,8/18/2014,0,0,0,0,0,0,0
7185,RM-1115,8/19/2014,0,0,0,0,0,0,0
7186,RM-1115,8/20/2014,0,0,0,0,0,0,0
7187,RM-1115,8/21/2014,0,0,0,0,0,0,0
7188,RM-1115,8/22/2014,0,0,0,0,0,0,0
7189,RM-1115,8/23/2014,0,0,0,0,0,0,0
7190,RM-1115,8/24/2014,0,0,0,0,0,0,0
7191,RM-1115,8/25/2014,0,0,0,0,0,0,0
7192,RM-1115,8/26/2014,0,0,0,0,0,0,0
7193,RM-1115,8/27/2014,0,0,0,0,0,0,0
7194,RM-1115,8/28/2014,0,0,0,0,0,0,0
7195,RM-1115,8/29/2014,0,0,0,0,0,0,0
7196,RM-1115,8/30/2014,0,0,0,0,0,0,0
7197,RM-1115,8/31/2014,0,0,0,0,0,0,0
7198,RM-1115,9/1/2014,0,0,0,0,0,0,0
7199,RM-1115,9/2/2014,0,0,0,0,0,0,0
7200,RM-1115,9/3/2014,0,0,0,0,0,0,0
7201,RM-1115,9/4/2014,0,0,0,0,0,0,0
7202,RM-1115,9/5/2014,0,0,0,0,0,0,0
7203,RM-1115,9/6/2014,0,0,0,0,0,0,0
7204,RM-1115,9/7/2014,0,0,0,0,0,0,0
7205,RM-1115,9/8/2014,0,0,0,0,0,0,0
7206,RM-1115,9/9/2014,0,0,0,0,0,0,0
7207,RM-1115,9/10/2014,0,0,0,0,0,0,0
7208,RM-1115,9/11/2014,0,0,0,0,0,0,0
7209,RM-1115,9/12/2014,0,0,0,0,0,0,0
7210,RM-1115,9/13/2014,0,0,0,0,0,0,0
7211,RM-1115,9/14/2014,0,0,0,0,0,0,0
7212,RM-1115,9/15/2014,0,0,0,0,0,0,0
7213,RM-1115,9/16/2014,0,0,0,0,0,0,0
7214,RM-1115,9/17/2014,0,0,0,0,0,0,0
7215,RM-1115,9/18/2014,0,0,0,0,0,0,0
7216,RM-1115,9/19/2014,0,0,0,0,0,0,0
7217,RM-1115,9/20/2014,0,0,0,0,0,0,0
7218,RM-1115,9/21/2014,0,0,0,0,0,0,0
7219,RM-1115,9/22/2014,0,0,0,0,0,0,0
7220,RM-1115,9/23/2014,0,0,0,0,0,0,0
7221,RM-1115,9/24/2014,0,0,0,0,0,0,0
7222,RM-1115,9/25/2014,0,0,0,0,0,0,0
7223,RM-1115,9/28/2014,0,0,0,0,0,0,0
7224,RM-1115,9/29/2014,0,0,0,0,0,0,0
7225,RM-1115,9/30/2014,0,0,0,0,0,0,0
7226,RM-1115,10/1/2014,0,0,0,0,0,0,0
7227,RM-1115,10/2/2014,0,0,0,0,0,0,0
7228,RM-1115,10/3/2014,0,0,0,0,0,0,0
7229,RM-1115,10/4/2014,0,0,0,0,0,0,0
7230,RM-1115,10/5/2014,0,0,0,0,0,0,0
7231,RM-1115,10/6/2014,0,0,0,0,0,0,0
7232,RM-1115,10/7/2014,0,0,0,0,0,0,0
7233,RM-1115,10/8/2014,0,0,0,0,0,0,0
7234,RM-1115,10/9/2014,0,0,0,0,0,0,0
7235,RM-1115,10/10/2014,0,0,0,0,0,0,0
7236,RM-1115,10/11/2014,0,0,0,0,0,0,0
7237,RM-1115,10/12/2014,0,0,0,0,0,0,0
7238,RM-1115,10/13/2014,0,0,0,0,0,0,0
7239,RM-1115,10/14/2014,0,0,0,0,0,0,0
7240,RM-1115,10/15/2014,0,0,0,0,0,0,0
7241,RM-1115,10/16/2014,0,0,0,0,0,0,0
7242,RM-1115,10/17/2014,0,0,0,0,0,0,0
7243,RM-1115,10/18/2014,0,0,0,0,0,0,0
7244,RM-1115,10/19/2014,0,0,0,0,0,0,0
7245,RM-1115,10/20/2014,0,0,0,0,0,0,0
7246,RM-1115,10/21/2014,0,0,0,0,0,0,0
7247,RM-1115,10/22/2014,0,0,0,0,0,0,0
7248,RM-1115,10/23/2014,0,0,0,0,0,0,0
7249,RM-1115,10/24/2014,0,0,0,0,0,0,0
7250,RM-1115,10/25/2014,0,0,0,0,0,0,0
7251,RM-1115,10/26/2014,0,0,0,0,0,0,0
7252,RM-1115,10/27/2014,0,0,0,0,0,0,0
7253,RM-1115,10/28/2014,0,0,0,0,0,0,0
7254,RM-1115,10/29/2014,0,0,0,0,0,0,0
7255,RM-1115,10/30/2014,0,0,0,0,0,0,0
7256,RM-1115,10/31/2014,0,0,0,0,0,0,0
7257,RM-1115,11/1/2014,0,0,0,0,0,0,0
7258,RM-1115,11/2/2014,0,0,0,0,0,0,0
7259,RM-1115,11/3/2014,0,0,0,0,0,0,0
7260,RM-1115,11/4/2014,0,0,0,0,0,0,0
7261,RM-1115,11/5/2014,0,0,0,0,0,0,0
7262,RM-1115,11/6/2014,0,0,0,0,0,0,0
7263,RM-1115,11/7/2014,0,0,0,0,0,0,0
7264,RM-1115,11/8/2014,0,0,0,0,0,0,0
7265,RM-1115,11/9/2014,0,0,0,0,0,0,0
7266,RM-1115,11/10/2014,0,0,0,0,0,0,0
7267,RM-1115,11/11/2014,0,0,0,0,0,0,0
7268,RM-1115,11/12/2014,0,0,0,0,0,0,0
7269,RM-1115,11/13/2014,0,0,0,0,0,0,0
7270,RM-1115,11/14/2014,0,0,0,0,0,0,0
7271,RM-1115,11/15/2014,0,0,0,0,0,0,0
7272,RM-1115,11/16/2014,0,0,0,0,0,0,0
7273,RM-1115,11/17/2014,0,0,0,0,0,0,0
7274,RM-1115,11/18/2014,0,0,0,0,0,0,0
7275,RM-1115,11/19/2014,0,0,0,0,0,0,0
7276,RM-1115,11/20/2014,0,0,0,0,0,0,0
7277,RM-1115,11/21/2014,0,0,0,0,0,0,0
7278,RM-1115,11/22/2014,0,0,0,0,0,0,0
7279,RM-1115,11/23/2014,0,0,0,0,0,0,0
7280,RM-1115,11/24/2014,0,0,0,0,0,0,0
7281,RM-1115,11/25/2014,0,0,0,0,0,0,0
7282,RM-1115,11/26/2014,0,0,0,0,0,0,0
7283,RM-1115,11/27/2014,0,0,0,0,0,0,0
7284,RM-1115,11/28/2014,0,0,0,0,0,0,0
7285,RM-1115,11/29/2014,0,0,0,0,0,0,0
7286,RM-1115,11/30/2014,0,0,0,0,0,0,0
7287,RM-1115,12/1/2014,0,0,0,0,0,0,0
7288,RM-1115,12/2/2014,0,0,0,0,0,0,0
7289,RM-1115,12/3/2014,0,0,0,0,0,0,0
7290,RM-1115,12/4/2014,0,0,0,0,0,0,0
7291,RM-1115,12/5/2014,0,0,0,0,0,0,0
7292,RM-1115,12/6/2014,0,0,0,0,0,0,0
7293,RM-1115,12/7/2014,0,0,0,0,0,0,0
7294,RM-1115,12/8/2014,0,0,0,0,0,0,0
7295,RM-1115,12/9/2014,0,0,0,0,0,0,0
7296,RM-1115,12/10/2014,0,0,0,0,0,0,0
7297,RM-1115,12/11/2014,0,0,0,0,0,0,0
7298,RM-1115,12/12/2014,0,0,0,0,0,0,0
7299,RM-1115,12/13/2014,0,0,0,0,0,0,0
7300,RM-1115,12/14/2014,0,0,0,0,0,0,0
7301,RM-1115,12/15/2014,0,0,0,0,0,0,0
7302,RM-1115,12/16/2014,0,0,0,0,0,0,0
7303,RM-1115,12/17/2014,0,0,0,0,0,0,0
7304,RM-1115,12/18/2014,0,0,0,0,0,0,0
7305,RM-1115,12/19/2014,0,0,0,0,0,0,0
7306,RM-1115,12/20/2014,0,0,0,0,0,0,0
7307,RM-1115,12/21/2014,0,0,0,0,0,0,0
7308,RM-1115,12/22/2014,0,0,0,0,0,0,0
7309,RM-1115,12/23/2014,0,0,0,0,0,0,0
7310,RM-1115,12/24/2014,0,0,0,0,0,0,0
7311,RM-1115,12/25/2014,0,0,0,0,0,0,0
7312,RM-1115,12/26/2014,0,0,0,0,0,0,0
7313,RM-1115,12/27/2014,0,0,0,0,0,0,0
7314,RM-1115,12/28/2014,0,0,0,0,0,0,0
7315,RM-1115,12/29/2014,0,0,0,0,0,0,0
7316,RM-1115,12/30/2014,0,0,0,0,0,0,0
7317,RM-1115,12/31/2014,0,0,0,0,0,0,0
7318,RM-1115,1/1/2015,0,0,0,0,0,0,0
7319,RM-1115,1/2/2015,0,0,0,0,0,0,0
7320,RM-1115,1/3/2015,0,0,0,0,0,0,0
7321,RM-1115,1/4/2015,0,0,0,0,0,0,0
7322,RM-1115,1/5/2015,0,0,0,0,0,0,0
7323,RM-1115,1/6/2015,0,0,0,0,0,0,0
7324,RM-1115,1/7/2015,0,0,0,0,0,0,0
7325,RM-1115,1/8/2015,0,0,0,0,0,0,0
7326,RM-1115,1/9/2015,0,0,0,0,0,0,0
7327,RM-1115,1/10/2015,0,0,0,0,0,0,0
7328,RM-1115,1/11/2015,0,0,0,0,0,0,0
7329,RM-1115,1/12/2015,0,0,0,0,0,0,0
7330,RM-1115,1/13/2015,0,0,0,0,0,0,0
7331,RM-1115,1/14/2015,0,0,0,0,0,0,0
7332,RM-1115,1/15/2015,0,0,0,0,0,0,0
7333,RM-1115,1/16/2015,0,0,0,0,0,0,0
7334,RM-1115,1/17/2015,0,0,0,0,0,0,0
7335,RM-1115,1/18/2015,0,0,0,0,0,0,0
7336,RM-1115,1/19/2015,0,0,0,0,0,0,0
7337,RM-1115,1/20/2015,0,0,0,0,0,0,0
7338,RM-1115,1/21/2015,0,0,0,0,0,0,0
7339,RM-1115,1/22/2015,0,0,0,0,0,0,0
7340,RM-1115,1/23/2015,0,0,0,0,0,0,0
7341,RM-1115,1/24/2015,0,0,0,0,0,0,0
7342,RM-1115,1/25/2015,0,0,0,0,0,0,0
7343,RM-1115,1/26/2015,0,0,0,0,0,0,0
7344,RM-1115,1/27/2015,0,0,0,0,0,0,0
7345,RM-1115,1/28/2015,0,0,0,0,0,0,0
7346,RM-1115,1/29/2015,0,0,0,0,0,0,0
7347,RM-1115,1/30/2015,0,0,0,0,0,0,0
7348,RM-1115,1/31/2015,0,0,0,0,0,0,0
7349,RM-1115,2/1/2015,0,0,0,0,0,0,0
7350,RM-1115,2/2/2015,0,0,0,0,0,0,0
7351,RM-1115,2/3/2015,0,0,0,0,0,0,0
7352,RM-1115,2/4/2015,0,0,0,0,0,0,0
7353,RM-1115,2/5/2015,0,0,0,0,0,0,0
7354,RM-1115,2/6/2015,0,0,0,0,0,0,0
7355,RM-1115,2/7/2015,0,0,0,0,0,0,0
7356,RM-1115,2/8/2015,0,0,0,0,0,0,0
7357,RM-1115,2/9/2015,0,0,0,0,0,0,0
7358,RM-1115,2/10/2015,0,0,0,0,0,0,0
7359,RM-1115,2/11/2015,0,0,0,0,0,0,0
7360,RM-1115,2/12/2015,0,0,0,0,0,0,0
7361,RM-1115,2/13/2015,0,0,0,0,0,0,0
7362,RM-1115,2/14/2015,0,0,0,0,0,0,0
7363,RM-1115,2/15/2015,0,0,0,0,0,0,0
7364,RM-1115,2/16/2015,0,0,0,0,0,0,0
7365,RM-1115,2/17/2015,0,0,0,0,0,0,0
7366,RM-1115,2/18/2015,0,0,0,0,0,0,0
7367,RM-1115,2/19/2015,0,0,0,0,0,0,0
7368,RM-1115,2/20/2015,0,0,0,0,0,0,0
7369,RM-1115,2/21/2015,0,0,0,0,0,0,0
7370,RM-1115,2/22/2015,0,0,0,0,0,0,0
7371,RM-1115,2/23/2015,0,0,0,0,0,0,0
7372,RM-1115,2/24/2015,0,0,0,0,0,0,0
7373,RM-1115,2/25/2015,0,0,0,0,0,0,0
7374,RM-1115,2/26/2015,0,0,0,0,0,0,0
7375,RM-1115,2/27/2015,0,0,0,0,0,0,0
7376,RM-1115,2/28/2015,0,0,0,0,0,0,0
7377,RM-1115,3/1/2015,0,0,0,0,0,0,0
7378,RM-1115,3/2/2015,0,0,0,0,0,0,0
7379,RM-1115,3/3/2015,0,0,0,0,0,0,0
7380,RM-1115,3/4/2015,0,0,0,0,0,0,0
7381,RM-1115,3/5/2015,0,0,0,0,0,0,0
7382,RM-1115,3/6/2015,0,0,0,0,0,0,0
7383,RM-1115,3/7/2015,0,0,0,0,0,0,0
7384,RM-1115,3/8/2015,0,0,0,0,0,0,0
7385,RM-1115,3/9/2015,0,0,0,0,0,0,0
7386,RM-1115,3/10/2015,0,0,0,0,0,0,0
7387,RM-1115,3/11/2015,0,0,0,0,0,0,0
7388,RM-1115,3/12/2015,0,0,0,0,0,0,0
7389,RM-1115,3/13/2015,0,0,0,0,0,0,0
7390,RM-1115,3/14/2015,0,0,0,0,0,0,0
7391,RM-1115,3/15/2015,0,0,0,0,0,0,0
7392,RM-1115,3/16/2015,0,0,0,0,0,0,0
7393,RM-1115,3/17/2015,0,0,0,0,0,0,0
7394,RM-1115,3/18/2015,0,0,0,0,0,0,0
7395,RM-1115,3/19/2015,0,0,0,0,0,0,0
7396,RM-1115,3/20/2015,0,0,0,0,0,0,0
7397,RM-1115,3/21/2015,0,0,0,0,0,0,0
7398,RM-1115,3/22/2015,0,0,0,0,0,0,0
7399,RM-1115,3/23/2015,0,0,0,0,0,0,0
7400,RM-1115,3/24/2015,0,0,0,0,0,0,0
7401,RM-1115,3/25/2015,0,0,0,0,0,0,0
7402,RM-1115,3/26/2015,0,0,0,0,0,0,0
7403,RM-1115,3/27/2015,0,0,0,0,0,0,0
7404,RM-1115,3/28/2015,0,0,0,0,0,0,0
7405,RM-1115,3/29/2015,0,0,0,0,0,0,0
7406,RM-1115,3/30/2015,0,0,0,0,0,0,0
7407,RM-1115,3/31/2015,0,0,0,0,0,0,0
7408,RM-1115,4/1/2015,0,0,0,0,0,0,0
7409,RM-1115,4/2/2015,0,0,0,0,0,0,0
7410,RM-1115,4/3/2015,0,0,0,0,0,0,0
7411,RM-1115,4/4/2015,0,0,0,0,0,0,0
7412,RM-1115,4/5/2015,0,0,0,0,0,0,0
7413,RM-1115,4/6/2015,0,0,0,0,0,0,0
7414,RM-1115,4/7/2015,0,0,0,0,0,0,0
7415,RM-1115,4/8/2015,0,0,0,0,0,0,0
7416,RM-1115,4/9/2015,0,0,0,0,0,0,0
7417,RM-1115,4/10/2015,0,0,0,0,0,0,0
7418,RM-1115,4/11/2015,0,0,0,0,0,0,0
7419,RM-1115,4/12/2015,0,0,0,0,0,0,0
7420,RM-1115,4/13/2015,0,0,0,0,0,0,0
7421,RM-1115,4/14/2015,0,0,0,0,0,0,0
7422,RM-1115,4/15/2015,0,0,0,0,0,0,0
7423,RM-1115,4/16/2015,0,0,0,0,0,0,0
7424,RM-1115,4/17/2015,0,0,0,0,0,0,0
7425,RM-1115,4/18/2015,0,0,0,0,0,0,0
7426,RM-1115,4/19/2015,0,0,0,0,0,0,0
7427,RM-1115,4/20/2015,0,0,0,0,0,0,0
7428,RM-1115,4/21/2015,0,0,0,0,0,0,0
7429,RM-1115,4/22/2015,0,0,0,0,0,0,0
7430,RM-1115,4/23/2015,0,0,0,0,0,0,0
7431,RM-1115,4/24/2015,0,0,0,0,0,0,0
7432,RM-1115,4/25/2015,0,0,0,0,0,0,0
7433,RM-1115,4/26/2015,0,0,0,0,0,0,0
7434,RM-1115,4/27/2015,0,0,0,0,0,0,0
7435,RM-1115,4/28/2015,0,0,0,0,0,0,0
7436,RM-1115,4/29/2015,0,0,0,0,0,0,0
7437,RM-1115,4/30/2015,0,0,0,0,0,0,0
7438,RM-1115,5/1/2015,0,0,0,0,0,0,0
7439,RM-1115,5/2/2015,0,0,0,0,0,0,0
7440,RM-1115,5/3/2015,0,0,0,0,0,0,0
7441,RM-1115,5/4/2015,0,0,0,0,0,0,0
7442,RM-1115,5/5/2015,0,0,0,0,0,0,0
7443,RM-1115,5/6/2015,0,0,0,0,0,0,0
7444,RM-1115,5/7/2015,0,0,0,0,0,0,0
7445,RM-1115,5/8/2015,0,0,0,0,0,0,0
7446,RM-1115,5/9/2015,0,0,0,0,0,0,0
7447,RM-1115,5/10/2015,0,0,0,0,0,0,0
7448,RM-1115,5/11/2015,0,0,0,0,0,0,0
7449,RM-1115,5/12/2015,0,0,0,0,0,0,0
7450,RM-1115,5/13/2015,0,0,0,0,0,0,0
7451,RM-1115,5/14/2015,0,0,0,0,0,0,0
7452,RM-1115,5/15/2015,0,0,0,0,0,0,0
7453,RM-1115,5/16/2015,0,0,0,0,0,0,0
7454,RM-1115,5/17/2015,0,0,0,0,0,0,0
7455,RM-1115,5/18/2015,0,0,0,0,0,0,0
7456,RM-1115,5/19/2015,0,0,0,0,0,0,0
7457,RM-1115,5/20/2015,0,0,0,0,0,0,0
7458,RM-1115,5/21/2015,0,0,0,0,0,0,0
7459,RM-1115,5/22/2015,0,0,0,0,0,0,0
7460,RM-1115,5/23/2015,0,0,0,0,0,0,0
7461,RM-1115,5/24/2015,0,0,0,0,0,0,0
7462,RM-1115,5/25/2015,0,0,0,0,0,0,0
7463,RM-1115,5/26/2015,0,0,0,0,0,0,0
7464,RM-1115,5/27/2015,0,0,0,0,0,0,0
7465,RM-1115,5/28/2015,0,0,0,0,0,0,0
7466,RM-1115,5/29/2015,0,0,0,0,0,0,0
7467,RM-1115,5/30/2015,0,0,0,0,0,0,0
7468,RM-1115,5/31/2015,0,0,0,0,0,0,0
7469,RM-1116,6/28/2013,0,0,0,0,0,0,0
7470,RM-1116,6/29/2013,0,0,0,0,0,0,0
7767,RM-1116,5/6/2014,0,0,0,0,0,0,0
7798,RM-1116,6/6/2014,0,0,0,0,0,0,0
7799,RM-1116,6/7/2014,0,0,0,0,0,0,0
7800,RM-1116,6/8/2014,0,0,0,0,0,0,0
7801,RM-1116,6/9/2014,0,0,0,0,0,0,0
7802,RM-1116,6/10/2014,0,0,0,0,0,0,0
7803,RM-1116,6/11/2014,0,0,0,0,0,0,0
7804,RM-1116,6/12/2014,0,0,0,0,0,0,0
7805,RM-1116,6/13/2014,0,0,0,0,0,0,0
7806,RM-1116,6/14/2014,0,0,0,0,0,0,0
7807,RM-1116,6/15/2014,0,0,0,0,0,0,0
7808,RM-1116,6/16/2014,0,0,0,0,0,0,0
7809,RM-1116,6/17/2014,0,0,0,0,0,0,0
7810,RM-1116,6/18/2014,0,0,0,0,0,0,0
7811,RM-1116,6/19/2014,0,0,0,0,0,0,0
7812,RM-1116,6/20/2014,0,0,0,0,0,0,0
7813,RM-1116,6/21/2014,0,0,0,0,0,0,0
7814,RM-1116,6/22/2014,0,0,0,0,0,0,0
7815,RM-1116,6/23/2014,0,0,0,0,0,0,0
7816,RM-1116,6/24/2014,0,0,0,0,0,0,0
7817,RM-1116,6/25/2014,0,0,0,0,0,0,0
7818,RM-1116,6/26/2014,0,0,0,0,0,0,0
7819,RM-1116,6/27/2014,0,0,0,0,0,0,0
7820,RM-1116,6/28/2014,0,0,0,0,0,0,0
7821,RM-1116,6/29/2014,0,0,0,0,0,0,0
7822,RM-1116,6/30/2014,0,0,0,0,0,0,0
7823,RM-1116,7/1/2014,0,0,0,0,0,0,0
7824,RM-1116,7/2/2014,0,0,0,0,0,0,0
7825,RM-1116,7/3/2014,0,0,0,0,0,0,0
7826,RM-1116,7/4/2014,0,0,0,0,0,0,0
7827,RM-1116,7/5/2014,0,0,0,0,0,0,0
7828,RM-1116,7/6/2014,0,0,0,0,0,0,0
7829,RM-1116,7/7/2014,0,0,0,0,0,0,0
7830,RM-1116,7/8/2014,0,0,0,0,0,0,0
7831,RM-1116,7/9/2014,0,0,0,0,0,0,0
7832,RM-1116,7/10/2014,0,0,0,0,0,0,0
7833,RM-1116,7/11/2014,0,0,0,0,0,0,0
7834,RM-1116,7/12/2014,0,0,0,0,0,0,0
7835,RM-1116,7/13/2014,0,0,0,0,0,0,0
7836,RM-1116,7/14/2014,0,0,0,0,0,0,0
7837,RM-1116,7/15/2014,0,0,0,0,0,0,0
7838,RM-1116,7/16/2014,0,0,0,0,0,0,0
7839,RM-1116,7/17/2014,0,0,0,0,0,0,0
7840,RM-1116,7/18/2014,0,0,0,0,0,0,0
7841,RM-1116,7/19/2014,0,0,0,0,0,0,0
7842,RM-1116,7/20/2014,0,0,0,0,0,0,0
7843,RM-1116,7/21/2014,0,0,0,0,0,0,0
7844,RM-1116,7/22/2014,0,0,0,0,0,0,0
7845,RM-1116,7/23/2014,0,0,0,0,0,0,0
7846,RM-1116,7/24/2014,0,0,0,0,0,0,0
7847,RM-1116,7/25/2014,0,0,0,0,0,0,0
7848,RM-1116,7/26/2014,0,0,0,0,0,0,0
7849,RM-1116,7/27/2014,0,0,0,0,0,0,0
7850,RM-1116,7/28/2014,0,0,0,0,0,0,0
7851,RM-1116,7/29/2014,0,0,0,0,0,0,0
7852,RM-1116,7/30/2014,0,0,0,0,0,0,0
7853,RM-1116,7/31/2014,0,0,0,0,0,0,0
7854,RM-1116,8/1/2014,0,0,0,0,0,0,0
7855,RM-1116,8/2/2014,0,0,0,0,0,0,0
7856,RM-1116,8/3/2014,0,0,0,0,0,0,0
7857,RM-1116,8/4/2014,0,0,0,0,0,0,0
7858,RM-1116,8/5/2014,0,0,0,0,0,0,0
7859,RM-1116,8/6/2014,0,0,0,0,0,0,0
7860,RM-1116,8/7/2014,0,0,0,0,0,0,0
7861,RM-1116,8/8/2014,0,0,0,0,0,0,0
7862,RM-1116,8/9/2014,0,0,0,0,0,0,0
7863,RM-1116,8/10/2014,0,0,0,0,0,0,0
7864,RM-1116,8/11/2014,0,0,0,0,0,0,0
7865,RM-1116,8/12/2014,0,0,0,0,0,0,0
7866,RM-1116,8/13/2014,0,0,0,0,0,0,0
7867,RM-1116,8/14/2014,0,0,0,0,0,0,0
7868,RM-1116,8/15/2014,0,0,0,0,0,0,0
7869,RM-1116,8/16/2014,0,0,0,0,0,0,0
7870,RM-1116,8/17/2014,0,0,0,0,0,0,0
7871,RM-1116,8/18/2014,0,0,0,0,0,0,0
7872,RM-1116,8/19/2014,0,0,0,0,0,0,0
7873,RM-1116,8/20/2014,0,0,0,0,0,0,0
7874,RM-1116,8/21/2014,0,0,0,0,0,0,0
7875,RM-1116,8/22/2014,0,0,0,0,0,0,0
7876,RM-1116,8/23/2014,0,0,0,0,0,0,0
7877,RM-1116,8/24/2014,0,0,0,0,0,0,0
7878,RM-1116,8/25/2014,0,0,0,0,0,0,0
7879,RM-1116,8/26/2014,0,0,0,0,0,0,0
7880,RM-1116,8/27/2014,0,0,0,0,0,0,0
7881,RM-1116,8/28/2014,0,0,0,0,0,0,0
7882,RM-1116,8/29/2014,0,0,0,0,0,0,0
7883,RM-1116,8/30/2014,0,0,0,0,0,0,0
7884,RM-1116,8/31/2014,0,0,0,0,0,0,0
7885,RM-1116,9/1/2014,0,0,0,0,0,0,0
7886,RM-1116,9/2/2014,0,0,0,0,0,0,0
7887,RM-1116,9/3/2014,0,0,0,0,0,0,0
7888,RM-1116,9/4/2014,0,0,0,0,0,0,0
7889,RM-1116,9/5/2014,0,0,0,0,0,0,0
7890,RM-1116,9/6/2014,0,0,0,0,0,0,0
7891,RM-1116,9/7/2014,0,0,0,0,0,0,0
7892,RM-1116,9/8/2014,0,0,0,0,0,0,0
7893,RM-1116,9/9/2014,0,0,0,0,0,0,0
7894,RM-1116,9/10/2014,0,0,0,0,0,0,0
7895,RM-1116,9/11/2014,0,0,0,0,0,0,0
7896,RM-1116,9/12/2014,0,0,0,0,0,0,0
7897,RM-1116,9/13/2014,0,0,0,0,0,0,0
7898,RM-1116,9/14/2014,0,0,0,0,0,0,0
7899,RM-1116,9/15/2014,0,0,0,0,0,0,0
7900,RM-1116,9/16/2014,0,0,0,0,0,0,0
7901,RM-1116,9/17/2014,0,0,0,0,0,0,0
7902,RM-1116,9/18/2014,0,0,0,0,0,0,0
7903,RM-1116,9/19/2014,0,0,0,0,0,0,0
7904,RM-1116,9/20/2014,0,0,0,0,0,0,0
7905,RM-1116,9/21/2014,0,0,0,0,0,0,0
7906,RM-1116,9/22/2014,0,0,0,0,0,0,0
7907,RM-1116,9/23/2014,0,0,0,0,0,0,0
7908,RM-1116,9/24/2014,0,0,0,0,0,0,0
7909,RM-1116,9/25/2014,0,0,0,0,0,0,0
7910,RM-1116,9/28/2014,0,0,0,0,0,0,0
7911,RM-1116,9/29/2014,0,0,0,0,0,0,0
7912,RM-1116,9/30/2014,0,0,0,0,0,0,0
7913,RM-1116,10/1/2014,0,0,0,0,0,0,0
7914,RM-1116,10/2/2014,0,0,0,0,0,0,0
7915,RM-1116,10/3/2014,0,0,0,0,0,0,0
7916,RM-1116,10/4/2014,0,0,0,0,0,0,0
7917,RM-1116,10/5/2014,0,0,0,0,0,0,0
7918,RM-1116,10/6/2014,0,0,0,0,0,0,0
7919,RM-1116,10/7/2014,0,0,0,0,0,0,0
7920,RM-1116,10/8/2014,0,0,0,0,0,0,0
7921,RM-1116,10/9/2014,0,0,0,0,0,0,0
7922,RM-1116,10/10/2014,0,0,0,0,0,0,0
7923,RM-1116,10/11/2014,0,0,0,0,0,0,0
7924,RM-1116,10/12/2014,0,0,0,0,0,0,0
7925,RM-1116,10/13/2014,0,0,0,0,0,0,0
7926,RM-1116,10/14/2014,0,0,0,0,0,0,0
7927,RM-1116,10/15/2014,0,0,0,0,0,0,0
7928,RM-1116,10/16/2014,0,0,0,0,0,0,0
7929,RM-1116,10/17/2014,0,0,0,0,0,0,0
7930,RM-1116,10/18/2014,0,0,0,0,0,0,0
7931,RM-1116,10/19/2014,0,0,0,0,0,0,0
7932,RM-1116,10/20/2014,0,0,0,0,0,0,0
7933,RM-1116,10/21/2014,0,0,0,0,0,0,0
7934,RM-1116,10/22/2014,0,0,0,0,0,0,0
7935,RM-1116,10/23/2014,0,0,0,0,0,0,0
7936,RM-1116,10/24/2014,0,0,0,0,0,0,0
7937,RM-1116,10/25/2014,0,0,0,0,0,0,0
7938,RM-1116,10/26/2014,0,0,0,0,0,0,0
7939,RM-1116,10/27/2014,0,0,0,0,0,0,0
7940,RM-1116,10/28/2014,0,0,0,0,0,0,0
7941,RM-1116,10/29/2014,0,0,0,0,0,0,0
7942,RM-1116,10/30/2014,0,0,0,0,0,0,0
7943,RM-1116,10/31/2014,0,0,0,0,0,0,0
7944,RM-1116,11/1/2014,0,0,0,0,0,0,0
7945,RM-1116,11/2/2014,0,0,0,0,0,0,0
7946,RM-1116,11/3/2014,0,0,0,0,0,0,0
7947,RM-1116,11/4/2014,0,0,0,0,0,0,0
7948,RM-1116,11/5/2014,0,0,0,0,0,0,0
7949,RM-1116,11/6/2014,0,0,0,0,0,0,0
7950,RM-1116,11/7/2014,0,0,0,0,0,0,0
7951,RM-1116,11/8/2014,0,0,0,0,0,0,0
7952,RM-1116,11/9/2014,0,0,0,0,0,0,0
7953,RM-1116,11/10/2014,0,0,0,0,0,0,0
7954,RM-1116,11/11/2014,0,0,0,0,0,0,0
7955,RM-1116,11/12/2014,0,0,0,0,0,0,0
7956,RM-1116,11/13/2014,0,0,0,0,0,0,0
7957,RM-1116,11/14/2014,0,0,0,0,0,0,0
7958,RM-1116,11/15/2014,0,0,0,0,0,0,0
7959,RM-1116,11/16/2014,0,0,0,0,0,0,0
7960,RM-1116,11/17/2014,0,0,0,0,0,0,0
7961,RM-1116,11/18/2014,0,0,0,0,0,0,0
7962,RM-1116,11/19/2014,0,0,0,0,0,0,0
7963,RM-1116,11/20/2014,0,0,0,0,0,0,0
7964,RM-1116,11/21/2014,0,0,0,0,0,0,0
7965,RM-1116,11/22/2014,0,0,0,0,0,0,0
7966,RM-1116,11/23/2014,0,0,0,0,0,0,0
7967,RM-1116,11/24/2014,0,0,0,0,0,0,0
7968,RM-1116,11/25/2014,0,0,0,0,0,0,0
7969,RM-1116,11/26/2014,0,0,0,0,0,0,0
7970,RM-1116,11/27/2014,0,0,0,0,0,0,0
7971,RM-1116,11/28/2014,0,0,0,0,0,0,0
7972,RM-1116,11/29/2014,0,0,0,0,0,0,0
7973,RM-1116,11/30/2014,0,0,0,0,0,0,0
7974,RM-1116,12/1/2014,0,0,0,0,0,0,0
7975,RM-1116,12/2/2014,0,0,0,0,0,0,0
7976,RM-1116,12/3/2014,0,0,0,0,0,0,0
7977,RM-1116,12/4/2014,0,0,0,0,0,0,0
7978,RM-1116,12/5/2014,0,0,0,0,0,0,0
7979,RM-1116,12/6/2014,0,0,0,0,0,0,0
7980,RM-1116,12/7/2014,0,0,0,0,0,0,0
7981,RM-1116,12/8/2014,0,0,0,0,0,0,0
7982,RM-1116,12/9/2014,0,0,0,0,0,0,0
7983,RM-1116,12/10/2014,0,0,0,0,0,0,0
7984,RM-1116,12/11/2014,0,0,0,0,0,0,0
7985,RM-1116,12/12/2014,0,0,0,0,0,0,0
7986,RM-1116,12/13/2014,0,0,0,0,0,0,0
7987,RM-1116,12/14/2014,0,0,0,0,0,0,0
7988,RM-1116,12/15/2014,0,0,0,0,0,0,0
7989,RM-1116,12/16/2014,0,0,0,0,0,0,0
7990,RM-1116,12/17/2014,0,0,0,0,0,0,0
7991,RM-1116,12/18/2014,0,0,0,0,0,0,0
7992,RM-1116,12/19/2014,0,0,0,0,0,0,0
7993,RM-1116,12/20/2014,0,0,0,0,0,0,0
7994,RM-1116,12/21/2014,0,0,0,0,0,0,0
7995,RM-1116,12/22/2014,0,0,0,0,0,0,0
7996,RM-1116,12/23/2014,0,0,0,0,0,0,0
7997,RM-1116,12/24/2014,0,0,0,0,0,0,0
7998,RM-1116,12/25/2014,0,0,0,0,0,0,0
7999,RM-1116,12/26/2014,0,0,0,0,0,0,0
8000,RM-1116,12/27/2014,0,0,0,0,0,0,0
8001,RM-1116,12/28/2014,0,0,0,0,0,0,0
8002,RM-1116,12/29/2014,0,0,0,0,0,0,0
8003,RM-1116,12/30/2014,0,0,0,0,0,0,0
8004,RM-1116,12/31/2014,0,0,0,0,0,0,0
8005,RM-1116,1/1/2015,0,0,0,0,0,0,0
8006,RM-1116,1/2/2015,0,0,0,0,0,0,0
8007,RM-1116,1/3/2015,0,0,0,0,0,0,0
8008,RM-1116,1/4/2015,0,0,0,0,0,0,0
8009,RM-1116,1/5/2015,0,0,0,0,0,0,0
8010,RM-1116,1/6/2015,0,0,0,0,0,0,0
8011,RM-1116,1/7/2015,0,0,0,0,0,0,0
8012,RM-1116,1/8/2015,0,0,0,0,0,0,0
8013,RM-1116,1/9/2015,0,0,0,0,0,0,0
8014,RM-1116,1/10/2015,0,0,0,0,0,0,0
8015,RM-1116,1/11/2015,0,0,0,0,0,0,0
8016,RM-1116,1/12/2015,0,0,0,0,0,0,0
8017,RM-1116,1/13/2015,0,0,0,0,0,0,0
8018,RM-1116,1/14/2015,0,0,0,0,0,0,0
8019,RM-1116,1/15/2015,0,0,0,0,0,0,0
8020,RM-1116,1/16/2015,0,0,0,0,0,0,0
8021,RM-1116,1/17/2015,0,0,0,0,0,0,0
8022,RM-1116,1/18/2015,0,0,0,0,0,0,0
8023,RM-1116,1/19/2015,0,0,0,0,0,0,0
8024,RM-1116,1/20/2015,0,0,0,0,0,0,0
8025,RM-1116,1/21/2015,0,0,0,0,0,0,0
8026,RM-1116,1/22/2015,0,0,0,0,0,0,0
8027,RM-1116,1/23/2015,0,0,0,0,0,0,0
8028,RM-1116,1/24/2015,0,0,0,0,0,0,0
8029,RM-1116,1/25/2015,0,0,0,0,0,0,0
8030,RM-1116,1/26/2015,0,0,0,0,0,0,0
8031,RM-1116,1/27/2015,0,0,0,0,0,0,0
8032,RM-1116,1/28/2015,0,0,0,0,0,0,0
8033,RM-1116,1/29/2015,0,0,0,0,0,0,0
8034,RM-1116,1/30/2015,0,0,0,0,0,0,0
8035,RM-1116,1/31/2015,0,0,0,0,0,0,0
8036,RM-1116,2/1/2015,0,0,0,0,0,0,0
8037,RM-1116,2/2/2015,0,0,0,0,0,0,0
8038,RM-1116,2/3/2015,0,0,0,0,0,0,0
8039,RM-1116,2/4/2015,0,0,0,0,0,0,0
8040,RM-1116,2/5/2015,0,0,0,0,0,0,0
8041,RM-1116,2/6/2015,0,0,0,0,0,0,0
8042,RM-1116,2/7/2015,0,0,0,0,0,0,0
8043,RM-1116,2/8/2015,0,0,0,0,0,0,0
8044,RM-1116,2/9/2015,0,0,0,0,0,0,0
8045,RM-1116,2/10/2015,0,0,0,0,0,0,0
8046,RM-1116,2/11/2015,0,0,0,0,0,0,0
8047,RM-1116,2/12/2015,0,0,0,0,0,0,0
8048,RM-1116,2/13/2015,0,0,0,0,0,0,0
8049,RM-1116,2/14/2015,0,0,0,0,0,0,0
8050,RM-1116,2/15/2015,0,0,0,0,0,0,0
8051,RM-1116,2/16/2015,0,0,0,0,0,0,0
8052,RM-1116,2/17/2015,0,0,0,0,0,0,0
8053,RM-1116,2/18/2015,0,0,0,0,0,0,0
8054,RM-1116,2/19/2015,0,0,0,0,0,0,0
8055,RM-1116,2/20/2015,0,0,0,0,0,0,0
8056,RM-1116,2/21/2015,0,0,0,0,0,0,0
8057,RM-1116,2/22/2015,0,0,0,0,0,0,0
8058,RM-1116,2/23/2015,0,0,0,0,0,0,0
8059,RM-1116,2/24/2015,0,0,0,0,0,0,0
8060,RM-1116,2/25/2015,0,0,0,0,0,0,0
8061,RM-1116,2/26/2015,0,0,0,0,0,0,0
8062,RM-1116,2/27/2015,0,0,0,0,0,0,0
8063,RM-1116,2/28/2015,0,0,0,0,0,0,0
8064,RM-1116,3/1/2015,0,0,0,0,0,0,0
8065,RM-1116,3/2/2015,0,0,0,0,0,0,0
8066,RM-1116,3/3/2015,0,0,0,0,0,0,0
8067,RM-1116,3/4/2015,0,0,0,0,0,0,0
8068,RM-1116,3/5/2015,0,0,0,0,0,0,0
8069,RM-1116,3/6/2015,0,0,0,0,0,0,0
8070,RM-1116,3/7/2015,0,0,0,0,0,0,0
8071,RM-1116,3/8/2015,0,0,0,0,0,0,0
8072,RM-1116,3/9/2015,0,0,0,0,0,0,0
8073,RM-1116,3/10/2015,0,0,0,0,0,0,0
8074,RM-1116,3/11/2015,0,0,0,0,0,0,0
8075,RM-1116,3/12/2015,0,0,0,0,0,0,0
8076,RM-1116,3/13/2015,0,0,0,0,0,0,0
8077,RM-1116,3/14/2015,0,0,0,0,0,0,0
8078,RM-1116,3/15/2015,0,0,0,0,0,0,0
8079,RM-1116,3/16/2015,0,0,0,0,0,0,0
8080,RM-1116,3/17/2015,0,0,0,0,0,0,0
8081,RM-1116,3/18/2015,0,0,0,0,0,0,0
8082,RM-1116,3/19/2015,0,0,0,0,0,0,0
8083,RM-1116,3/20/2015,0,0,0,0,0,0,0
8084,RM-1116,3/21/2015,0,0,0,0,0,0,0
8085,RM-1116,3/22/2015,0,0,0,0,0,0,0
8086,RM-1116,3/23/2015,0,0,0,0,0,0,0
8087,RM-1116,3/24/2015,0,0,0,0,0,0,0
8088,RM-1116,3/25/2015,0,0,0,0,0,0,0
8089,RM-1116,3/26/2015,0,0,0,0,0,0,0
8090,RM-1116,3/27/2015,0,0,0,0,0,0,0
8091,RM-1116,3/28/2015,0,0,0,0,0,0,0
8092,RM-1116,3/29/2015,0,0,0,0,0,0,0
8093,RM-1116,3/30/2015,0,0,0,0,0,0,0
8094,RM-1116,3/31/2015,0,0,0,0,0,0,0
8095,RM-1116,4/1/2015,0,0,0,0,0,0,0
8096,RM-1116,4/2/2015,0,0,0,0,0,0,0
8097,RM-1116,4/3/2015,0,0,0,0,0,0,0
8098,RM-1116,4/4/2015,0,0,0,0,0,0,0
8513,RM-1117,7/3/2014,0,0,0,0,0,0,0
8514,RM-1117,7/4/2014,0,0,0,0,0,0,0
8515,RM-1117,7/5/2014,0,0,0,0,0,0,0
8516,RM-1117,7/6/2014,0,0,0,0,0,0,0
8517,RM-1117,7/7/2014,0,0,0,0,0,0,0
8518,RM-1117,7/8/2014,0,0,0,0,0,0,0
8519,RM-1117,7/9/2014,0,0,0,0,0,0,0
8520,RM-1117,7/10/2014,0,0,0,0,0,0,0
8521,RM-1117,7/11/2014,0,0,0,0,0,0,0
8522,RM-1117,7/12/2014,0,0,0,0,0,0,0
8523,RM-1117,7/13/2014,0,0,0,0,0,0,0
8524,RM-1117,7/14/2014,0,0,0,0,0,0,0
8525,RM-1117,7/15/2014,0,0,0,0,0,0,0
8526,RM-1117,7/16/2014,0,0,0,0,0,0,0
8527,RM-1117,7/17/2014,0,0,0,0,0,0,0
8528,RM-1117,7/18/2014,0,0,0,0,0,0,0
8529,RM-1117,7/19/2014,0,0,0,0,0,0,0
8530,RM-1117,7/20/2014,0,0,0,0,0,0,0
8531,RM-1117,7/21/2014,0,0,0,0,0,0,0
8532,RM-1117,7/22/2014,0,0,0,0,0,0,0
8533,RM-1117,7/23/2014,0,0,0,0,0,0,0
8534,RM-1117,7/24/2014,0,0,0,0,0,0,0
8535,RM-1117,7/25/2014,0,0,0,0,0,0,0
8536,RM-1117,7/26/2014,0,0,0,0,0,0,0
8537,RM-1117,7/27/2014,0,0,0,0,0,0,0
8538,RM-1117,7/28/2014,0,0,0,0,0,0,0
8539,RM-1117,7/29/2014,0,0,0,0,0,0,0
8540,RM-1117,7/30/2014,0,0,0,0,0,0,0
8541,RM-1117,7/31/2014,0,0,0,0,0,0,0
8542,RM-1117,8/1/2014,0,0,0,0,0,0,0
8543,RM-1117,8/2/2014,0,0,0,0,0,0,0
8544,RM-1117,8/3/2014,0,0,0,0,0,0,0
8545,RM-1117,8/4/2014,0,0,0,0,0,0,0
8546,RM-1117,8/5/2014,0,0,0,0,0,0,0
8547,RM-1117,8/6/2014,0,0,0,0,0,0,0
8548,RM-1117,8/7/2014,0,0,0,0,0,0,0
8549,RM-1117,8/8/2014,0,0,0,0,0,0,0
8550,RM-1117,8/9/2014,0,0,0,0,0,0,0
8551,RM-1117,8/10/2014,0,0,0,0,0,0,0
8552,RM-1117,8/11/2014,0,0,0,0,0,0,0
8553,RM-1117,8/12/2014,0,0,0,0,0,0,0
8554,RM-1117,8/13/2014,0,0,0,0,0,0,0
8555,RM-1117,8/14/2014,0,0,0,0,0,0,0
8556,RM-1117,8/15/2014,0,0,0,0,0,0,0
8557,RM-1117,8/16/2014,0,0,0,0,0,0,0
8558,RM-1117,8/17/2014,0,0,0,0,0,0,0
8559,RM-1117,8/18/2014,0,0,0,0,0,0,0
8560,RM-1117,8/19/2014,0,0,0,0,0,0,0
8561,RM-1117,8/20/2014,0,0,0,0,0,0,0
8562,RM-1117,8/21/2014,0,0,0,0,0,0,0
8563,RM-1117,8/22/2014,0,0,0,0,0,0,0
8564,RM-1117,8/23/2014,0,0,0,0,0,0,0
8565,RM-1117,8/24/2014,0,0,0,0,0,0,0
8566,RM-1117,8/25/2014,0,0,0,0,0,0,0
8567,RM-1117,8/26/2014,0,0,0,0,0,0,0
8568,RM-1117,8/27/2014,0,0,0,0,0,0,0
8569,RM-1117,8/28/2014,0,0,0,0,0,0,0
8570,RM-1117,8/29/2014,0,0,0,0,0,0,0
8571,RM-1117,8/30/2014,0,0,0,0,0,0,0
8572,RM-1117,8/31/2014,0,0,0,0,0,0,0
8573,RM-1117,9/1/2014,0,0,0,0,0,0,0
8574,RM-1117,9/2/2014,0,0,0,0,0,0,0
8575,RM-1117,9/3/2014,0,0,0,0,0,0,0
8576,RM-1117,9/4/2014,0,0,0,0,0,0,0
8577,RM-1117,9/5/2014,0,0,0,0,0,0,0
8578,RM-1117,9/6/2014,0,0,0,0,0,0,0
8579,RM-1117,9/7/2014,0,0,0,0,0,0,0
8580,RM-1117,9/8/2014,0,0,0,0,0,0,0
8581,RM-1117,9/9/2014,0,0,0,0,0,0,0
8582,RM-1117,9/10/2014,0,0,0,0,0,0,0
8583,RM-1117,9/11/2014,0,0,0,0,0,0,0
8584,RM-1117,9/12/2014,0,0,0,0,0,0,0
8585,RM-1117,9/13/2014,0,0,0,0,0,0,0
8586,RM-1117,9/14/2014,0,0,0,0,0,0,0
8587,RM-1117,9/15/2014,0,0,0,0,0,0,0
8588,RM-1117,9/16/2014,0,0,0,0,0,0,0
8589,RM-1117,9/17/2014,0,0,0,0,0,0,0
8590,RM-1117,9/18/2014,0,0,0,0,0,0,0
8591,RM-1117,9/19/2014,0,0,0,0,0,0,0
8592,RM-1117,9/20/2014,0,0,0,0,0,0,0
8593,RM-1117,9/21/2014,0,0,0,0,0,0,0
8594,RM-1117,9/22/2014,0,0,0,0,0,0,0
8595,RM-1117,9/23/2014,0,0,0,0,0,0,0
8596,RM-1117,9/24/2014,0,0,0,0,0,0,0
8597,RM-1117,9/25/2014,0,0,0,0,0,0,0
8598,RM-1117,9/28/2014,0,0,0,0,0,0,0
8599,RM-1117,9/29/2014,0,0,0,0,0,0,0
8600,RM-1117,9/30/2014,0,0,0,0,0,0,0
8601,RM-1117,10/1/2014,0,0,0,0,0,0,0
8602,RM-1117,10/2/2014,0,0,0,0,0,0,0
8603,RM-1117,10/3/2014,0,0,0,0,0,0,0
8604,RM-1117,10/4/2014,0,0,0,0,0,0,0
8605,RM-1117,10/5/2014,0,0,0,0,0,0,0
8606,RM-1117,10/6/2014,0,0,0,0,0,0,0
8607,RM-1117,10/7/2014,0,0,0,0,0,0,0
8608,RM-1117,10/8/2014,0,0,0,0,0,0,0
8609,RM-1117,10/9/2014,0,0,0,0,0,0,0
8610,RM-1117,10/10/2014,0,0,0,0,0,0,0
8611,RM-1117,10/11/2014,0,0,0,0,0,0,0
8612,RM-1117,10/12/2014,0,0,0,0,0,0,0
8613,RM-1117,10/13/2014,0,0,0,0,0,0,0
8614,RM-1117,10/14/2014,0,0,0,0,0,0,0
8615,RM-1117,10/15/2014,0,0,0,0,0,0,0
8616,RM-1117,10/16/2014,0,0,0,0,0,0,0
8617,RM-1117,10/17/2014,0,0,0,0,0,0,0
8618,RM-1117,10/18/2014,0,0,0,0,0,0,0
8619,RM-1117,10/19/2014,0,0,0,0,0,0,0
8620,RM-1117,10/20/2014,0,0,0,0,0,0,0
8621,RM-1117,10/21/2014,0,0,0,0,0,0,0
8622,RM-1117,10/22/2014,0,0,0,0,0,0,0
8623,RM-1117,10/23/2014,0,0,0,0,0,0,0
8624,RM-1117,10/24/2014,0,0,0,0,0,0,0
8625,RM-1117,10/25/2014,0,0,0,0,0,0,0
8626,RM-1117,10/26/2014,0,0,0,0,0,0,0
8627,RM-1117,10/27/2014,0,0,0,0,0,0,0
8628,RM-1117,10/28/2014,0,0,0,0,0,0,0
8629,RM-1117,10/29/2014,0,0,0,0,0,0,0
8630,RM-1117,10/30/2014,0,0,0,0,0,0,0
8631,RM-1117,10/31/2014,0,0,0,0,0,0,0
8632,RM-1117,11/1/2014,0,0,0,0,0,0,0
8633,RM-1117,11/2/2014,0,0,0,0,0,0,0
8634,RM-1117,11/3/2014,0,0,0,0,0,0,0
8635,RM-1117,11/4/2014,0,0,0,0,0,0,0
8636,RM-1117,11/5/2014,0,0,0,0,0,0,0
8637,RM-1117,11/6/2014,0,0,0,0,0,0,0
8638,RM-1117,11/7/2014,0,0,0,0,0,0,0
8639,RM-1117,11/8/2014,0,0,0,0,0,0,0
8640,RM-1117,11/9/2014,0,0,0,0,0,0,0
8641,RM-1117,11/10/2014,0,0,0,0,0,0,0
8642,RM-1117,11/11/2014,0,0,0,0,0,0,0
8643,RM-1117,11/12/2014,0,0,0,0,0,0,0
8644,RM-1117,11/13/2014,0,0,0,0,0,0,0
8645,RM-1117,11/14/2014,0,0,0,0,0,0,0
8646,RM-1117,11/15/2014,0,0,0,0,0,0,0
8647,RM-1117,11/16/2014,0,0,0,0,0,0,0
8648,RM-1117,11/17/2014,0,0,0,0,0,0,0
8649,RM-1117,11/18/2014,0,0,0,0,0,0,0
8650,RM-1117,11/19/2014,0,0,0,0,0,0,0
8651,RM-1117,11/20/2014,0,0,0,0,0,0,0
8652,RM-1117,11/21/2014,0,0,0,0,0,0,0
8653,RM-1117,11/22/2014,0,0,0,0,0,0,0
8654,RM-1117,11/23/2014,0,0,0,0,0,0,0
8655,RM-1117,11/24/2014,0,0,0,0,0,0,0
8656,RM-1117,11/25/2014,0,0,0,0,0,0,0
8657,RM-1117,11/26/2014,0,0,0,0,0,0,0
8658,RM-1117,11/27/2014,0,0,0,0,0,0,0
8659,RM-1117,11/28/2014,0,0,0,0,0,0,0
8660,RM-1117,11/29/2014,0,0,0,0,0,0,0
8661,RM-1117,11/30/2014,0,0,0,0,0,0,0
8662,RM-1117,12/1/2014,0,0,0,0,0,0,0
8663,RM-1117,12/2/2014,0,0,0,0,0,0,0
8664,RM-1117,12/3/2014,0,0,0,0,0,0,0
8665,RM-1117,12/4/2014,0,0,0,0,0,0,0
8666,RM-1117,12/5/2014,0,0,0,0,0,0,0
8667,RM-1117,12/6/2014,0,0,0,0,0,0,0
8668,RM-1117,12/7/2014,0,0,0,0,0,0,0
8669,RM-1117,12/8/2014,0,0,0,0,0,0,0
8670,RM-1117,12/9/2014,0,0,0,0,0,0,0
8671,RM-1117,12/10/2014,0,0,0,0,0,0,0
8672,RM-1117,12/11/2014,0,0,0,0,0,0,0
8673,RM-1117,12/12/2014,0,0,0,0,0,0,0
8674,RM-1117,12/13/2014,0,0,0,0,0,0,0
8675,RM-1117,12/14/2014,0,0,0,0,0,0,0
8676,RM-1117,12/15/2014,0,0,0,0,0,0,0
8677,RM-1117,12/16/2014,0,0,0,0,0,0,0
8678,RM-1117,12/17/2014,0,0,0,0,0,0,0
8679,RM-1117,12/18/2014,0,0,0,0,0,0,0
8680,RM-1117,12/19/2014,0,0,0,0,0,0,0
8681,RM-1117,12/20/2014,0,0,0,0,0,0,0
8682,RM-1117,12/21/2014,0,0,0,0,0,0,0
8683,RM-1117,12/22/2014,0,0,0,0,0,0,0
8684,RM-1117,12/23/2014,0,0,0,0,0,0,0
8685,RM-1117,12/24/2014,0,0,0,0,0,0,0
8686,RM-1117,12/25/2014,0,0,0,0,0,0,0
8687,RM-1117,12/26/2014,0,0,0,0,0,0,0
8688,RM-1117,12/27/2014,0,0,0,0,0,0,0
8689,RM-1117,12/28/2014,0,0,0,0,0,0,0
8690,RM-1117,12/29/2014,0,0,0,0,0,0,0
8691,RM-1117,12/30/2014,0,0,0,0,0,0,0
8692,RM-1117,12/31/2014,0,0,0,0,0,0,0
8693,RM-1117,1/1/2015,0,0,0,0,0,0,0
8694,RM-1117,1/2/2015,0,0,0,0,0,0,0
8695,RM-1117,1/3/2015,0,0,0,0,0,0,0
8696,RM-1117,1/4/2015,0,0,0,0,0,0,0
8697,RM-1117,1/5/2015,0,0,0,0,0,0,0
8698,RM-1117,1/6/2015,0,0,0,0,0,0,0
8699,RM-1117,1/7/2015,0,0,0,0,0,0,0
8700,RM-1117,1/8/2015,0,0,0,0,0,0,0
8701,RM-1117,1/9/2015,0,0,0,0,0,0,0
8702,RM-1117,1/10/2015,0,0,0,0,0,0,0
8703,RM-1117,1/11/2015,0,0,0,0,0,0,0
8704,RM-1117,1/12/2015,0,0,0,0,0,0,0
8705,RM-1117,1/13/2015,0,0,0,0,0,0,0
8706,RM-1117,1/14/2015,0,0,0,0,0,0,0
8707,RM-1117,1/15/2015,0,0,0,0,0,0,0
8708,RM-1117,1/16/2015,0,0,0,0,0,0,0
8709,RM-1117,1/17/2015,0,0,0,0,0,0,0
8710,RM-1117,1/18/2015,0,0,0,0,0,0,0
8711,RM-1117,1/19/2015,0,0,0,0,0,0,0
8712,RM-1117,1/20/2015,0,0,0,0,0,0,0
8713,RM-1117,1/21/2015,0,0,0,0,0,0,0
8714,RM-1117,1/22/2015,0,0,0,0,0,0,0
8715,RM-1117,1/23/2015,0,0,0,0,0,0,0
8716,RM-1117,1/24/2015,0,0,0,0,0,0,0
8717,RM-1117,1/25/2015,0,0,0,0,0,0,0
8718,RM-1117,1/26/2015,0,0,0,0,0,0,0
8719,RM-1117,1/27/2015,0,0,0,0,0,0,0
8720,RM-1117,1/28/2015,0,0,0,0,0,0,0
8721,RM-1117,1/29/2015,0,0,0,0,0,0,0
8722,RM-1117,1/30/2015,0,0,0,0,0,0,0
8723,RM-1117,1/31/2015,0,0,0,0,0,0,0
8724,RM-1117,2/1/2015,0,0,0,0,0,0,0
8725,RM-1117,2/2/2015,0,0,0,0,0,0,0
8726,RM-1117,2/3/2015,0,0,0,0,0,0,0
8727,RM-1117,2/4/2015,0,0,0,0,0,0,0
8728,RM-1117,2/5/2015,0,0,0,0,0,0,0
8729,RM-1117,2/6/2015,0,0,0,0,0,0,0
8730,RM-1117,2/7/2015,0,0,0,0,0,0,0
8731,RM-1117,2/8/2015,0,0,0,0,0,0,0
8732,RM-1117,2/9/2015,0,0,0,0,0,0,0
8733,RM-1117,2/10/2015,0,0,0,0,0,0,0
8734,RM-1117,2/11/2015,0,0,0,0,0,0,0
8735,RM-1117,2/12/2015,0,0,0,0,0,0,0
8736,RM-1117,2/13/2015,0,0,0,0,0,0,0
8737,RM-1117,2/14/2015,0,0,0,0,0,0,0
8738,RM-1117,2/15/2015,0,0,0,0,0,0,0
8739,RM-1117,2/16/2015,0,0,0,0,0,0,0
8740,RM-1117,2/17/2015,0,0,0,0,0,0,0
8741,RM-1117,2/18/2015,0,0,0,0,0,0,0
8742,RM-1117,2/19/2015,0,0,0,0,0,0,0
8743,RM-1117,2/20/2015,0,0,0,0,0,0,0
8744,RM-1117,2/21/2015,0,0,0,0,0,0,0
8745,RM-1117,2/22/2015,0,0,0,0,0,0,0
8746,RM-1117,2/23/2015,0,0,0,0,0,0,0
8747,RM-1117,2/24/2015,0,0,0,0,0,0,0
8748,RM-1117,2/25/2015,0,0,0,0,0,0,0
8749,RM-1117,2/26/2015,0,0,0,0,0,0,0
8750,RM-1117,2/27/2015,0,0,0,0,0,0,0
8751,RM-1117,2/28/2015,0,0,0,0,0,0,0
8752,RM-1117,3/1/2015,0,0,0,0,0,0,0
8753,RM-1117,3/2/2015,0,0,0,0,0,0,0
8754,RM-1117,3/3/2015,0,0,0,0,0,0,0
8755,RM-1117,3/4/2015,0,0,0,0,0,0,0
8756,RM-1117,3/5/2015,0,0,0,0,0,0,0
8757,RM-1117,3/6/2015,0,0,0,0,0,0,0
8758,RM-1117,3/7/2015,0,0,0,0,0,0,0
8759,RM-1117,3/8/2015,0,0,0,0,0,0,0
8760,RM-1117,3/9/2015,0,0,0,0,0,0,0
8761,RM-1117,3/10/2015,0,0,0,0,0,0,0
8762,RM-1117,3/11/2015,0,0,0,0,0,0,0
8763,RM-1117,3/12/2015,0,0,0,0,0,0,0
8764,RM-1117,3/13/2015,0,0,0,0,0,0,0
8765,RM-1117,3/14/2015,0,0,0,0,0,0,0
8766,RM-1117,3/15/2015,0,0,0,0,0,0,0
8767,RM-1117,3/16/2015,0,0,0,0,0,0,0
8768,RM-1117,3/17/2015,0,0,0,0,0,0,0
8769,RM-1117,3/18/2015,0,0,0,0,0,0,0
8770,RM-1117,3/19/2015,0,0,0,0,0,0,0
8771,RM-1117,3/20/2015,0,0,0,0,0,0,0
8772,RM-1117,3/21/2015,0,0,0,0,0,0,0
8773,RM-1117,3/22/2015,0,0,0,0,0,0,0
8774,RM-1117,3/23/2015,0,0,0,0,0,0,0
8775,RM-1117,3/24/2015,0,0,0,0,0,0,0
8776,RM-1117,3/25/2015,0,0,0,0,0,0,0
8777,RM-1117,3/26/2015,0,0,0,0,0,0,0
8778,RM-1117,3/27/2015,0,0,0,0,0,0,0
8779,RM-1117,3/28/2015,0,0,0,0,0,0,0
8780,RM-1117,3/29/2015,0,0,0,0,0,0,0
8781,RM-1117,3/30/2015,0,0,0,0,0,0,0
8782,RM-1117,3/31/2015,0,0,0,0,0,0,0
8783,RM-1117,4/1/2015,0,0,0,0,0,0,0
8784,RM-1117,4/2/2015,0,0,0,0,0,0,0
8785,RM-1117,4/3/2015,0,0,0,0,0,0,0
8786,RM-1117,4/4/2015,0,0,0,0,0,0,0
8787,RM-1117,4/5/2015,0,0,0,0,0,0,0
8788,RM-1117,4/6/2015,0,0,0,0,0,0,0
8789,RM-1117,4/7/2015,0,0,0,0,0,0,0
8790,RM-1117,4/8/2015,0,0,0,0,0,0,0
8791,RM-1117,4/9/2015,0,0,0,0,0,0,0
8792,RM-1117,4/10/2015,0,0,0,0,0,0,0
8793,RM-1117,4/11/2015,0,0,0,0,0,0,0
8794,RM-1117,4/12/2015,0,0,0,0,0,0,0
8795,RM-1117,4/13/2015,0,0,0,0,0,0,0
8796,RM-1117,4/14/2015,0,0,0,0,0,0,0
8797,RM-1117,4/15/2015,0,0,0,0,0,0,0
8798,RM-1117,4/16/2015,0,0,0,0,0,0,0
8799,RM-1117,4/17/2015,0,0,0,0,0,0,0
8800,RM-1117,4/18/2015,0,0,0,0,0,0,0
8801,RM-1117,4/19/2015,0,0,0,0,0,0,0
8802,RM-1117,4/20/2015,0,0,0,0,0,0,0
8803,RM-1117,4/21/2015,0,0,0,0,0,0,0
8804,RM-1117,4/22/2015,0,0,0,0,0,0,0
8805,RM-1117,4/23/2015,0,0,0,0,0,0,0
8806,RM-1117,4/24/2015,0,0,0,0,0,0,0
8807,RM-1117,4/25/2015,0,0,0,0,0,0,0
8808,RM-1117,4/26/2015,0,0,0,0,0,0,0
8809,RM-1117,4/27/2015,0,0,0,0,0,0,0
8810,RM-1117,4/28/2015,0,0,0,0,0,0,0
8811,RM-1117,4/29/2015,0,0,0,0,0,0,0
8812,RM-1117,4/30/2015,0,0,0,0,0,0,0
8813,RM-1117,5/1/2015,0,0,0,0,0,0,0
8814,RM-1117,5/2/2015,0,0,0,0,0,0,0
8815,RM-1117,5/3/2015,0,0,0,0,0,0,0
8816,RM-1117,5/4/2015,0,0,0,0,0,0,0
8817,RM-1117,5/5/2015,0,0,0,0,0,0,0
8818,RM-1117,5/6/2015,0,0,0,0,0,0,0
8819,RM-1117,5/7/2015,0,0,0,0,0,0,0
8820,RM-1117,5/8/2015,0,0,0,0,0,0,0
8821,RM-1117,5/9/2015,0,0,0,0,0,0,0
8822,RM-1117,5/10/2015,0,0,0,0,0,0,0
8823,RM-1117,5/11/2015,0,0,0,0,0,0,0
8824,RM-1117,5/12/2015,0,0,0,0,0,0,0
8825,RM-1117,5/13/2015,0,0,0,0,0,0,0
8826,RM-1117,5/14/2015,0,0,0,0,0,0,0
8827,RM-1117,5/15/2015,0,0,0,0,0,0,0
8828,RM-1117,5/16/2015,0,0,0,0,0,0,0
8829,RM-1117,5/17/2015,0,0,0,0,0,0,0
8830,RM-1117,5/18/2015,0,0,0,0,0,0,0
8831,RM-1117,5/19/2015,0,0,0,0,0,0,0
8832,RM-1117,5/20/2015,0,0,0,0,0,0,0
8833,RM-1117,5/21/2015,0,0,0,0,0,0,0
8834,RM-1117,5/22/2015,0,0,0,0,0,0,0
8835,RM-1117,5/23/2015,0,0,0,0,0,0,0
8836,RM-1117,5/24/2015,0,0,0,0,0,0,0
8837,RM-1117,5/25/2015,0,0,0,0,0,0,0
8838,RM-1117,5/26/2015,0,0,0,0,0,0,0
8839,RM-1117,5/27/2015,0,0,0,0,0,0,0
8840,RM-1117,5/28/2015,0,0,0,0,0,0,0
8841,RM-1117,5/29/2015,0,0,0,0,0,0,0
8842,RM-1117,5/30/2015,0,0,0,0,0,0,0
8843,RM-1117,5/31/2015,0,0,0,0,0,0,0
9102,RM-1122,3/29/2014,0,0,0,0,0,0,0
9103,RM-1122,3/30/2014,0,0,0,0,0,0,0
9104,RM-1122,3/31/2014,0,0,0,0,0,0,0
9105,RM-1122,4/1/2014,0,0,0,0,0,0,0
9106,RM-1122,4/2/2014,0,0,0,0,0,0,0
9107,RM-1122,4/3/2014,0,0,0,0,0,0,0
9108,RM-1122,4/4/2014,0,0,0,0,0,0,0
9109,RM-1122,4/5/2014,0,0,0,0,0,0,0
9110,RM-1122,4/6/2014,0,0,0,0,0,0,0
9111,RM-1122,4/7/2014,0,0,0,0,0,0,0
9112,RM-1122,4/8/2014,0,0,0,0,0,0,0
9113,RM-1122,4/9/2014,0,0,0,0,0,0,0
9114,RM-1122,4/10/2014,0,0,0,0,0,0,0
9115,RM-1122,4/11/2014,0,0,0,0,0,0,0
9116,RM-1122,4/12/2014,0,0,0,0,0,0,0
9117,RM-1122,4/13/2014,0,0,0,0,0,0,0
9118,RM-1122,4/14/2014,0,0,0,0,0,0,0
9119,RM-1122,4/15/2014,0,0,0,0,0,0,0
9120,RM-1122,4/16/2014,0,0,0,0,0,0,0
9121,RM-1122,4/17/2014,0,0,0,0,0,0,0
9122,RM-1122,4/18/2014,0,0,0,0,0,0,0
9123,RM-1122,4/19/2014,0,0,0,0,0,0,0
9124,RM-1122,4/20/2014,0,0,0,0,0,0,0
9125,RM-1122,4/21/2014,0,0,0,0,0,0,0
9126,RM-1122,4/22/2014,0,0,0,0,0,0,0
9127,RM-1122,4/23/2014,0,0,0,0,0,0,0
9128,RM-1122,4/24/2014,0,0,0,0,0,0,0
9129,RM-1122,4/25/2014,0,0,0,0,0,0,0
9130,RM-1122,4/26/2014,0,0,0,0,0,0,0
9131,RM-1122,4/27/2014,0,0,0,0,0,0,0
9132,RM-1122,4/28/2014,0,0,0,0,0,0,0
9133,RM-1122,4/29/2014,0,0,0,0,0,0,0
9134,RM-1122,4/30/2014,0,0,0,0,0,0,0
9135,RM-1122,5/1/2014,0,0,0,0,0,0,0
9136,RM-1122,5/2/2014,0,0,0,0,0,0,0
9137,RM-1122,5/3/2014,0,0,0,0,0,0,0
9138,RM-1122,5/4/2014,0,0,0,0,0,0,0
9139,RM-1122,5/5/2014,0,0,0,0,0,0,0
9140,RM-1122,5/6/2014,0,0,0,0,0,0,0
9141,RM-1122,5/7/2014,0,0,0,0,0,0,0
9142,RM-1122,5/8/2014,0,0,0,0,0,0,0
9143,RM-1122,5/9/2014,0,0,0,0,0,0,0
9144,RM-1122,5/10/2014,0,0,0,0,0,0,0
9145,RM-1122,5/11/2014,0,0,0,0,0,0,0
9146,RM-1122,5/12/2014,0,0,0,0,0,0,0
9147,RM-1122,5/13/2014,0,0,0,0,0,0,0
9148,RM-1122,5/14/2014,0,0,0,0,0,0,0
9149,RM-1122,5/15/2014,0,0,0,0,0,0,0
9150,RM-1122,5/16/2014,0,0,0,0,0,0,0
9151,RM-1122,5/17/2014,0,0,0,0,0,0,0
9152,RM-1122,5/18/2014,0,0,0,0,0,0,0
9153,RM-1122,5/19/2014,0,0,0,0,0,0,0
9154,RM-1122,5/20/2014,0,0,0,0,0,0,0
9155,RM-1122,5/21/2014,0,0,0,0,0,0,0
9156,RM-1122,5/22/2014,0,0,0,0,0,0,0
9157,RM-1122,5/23/2014,0,0,0,0,0,0,0
9158,RM-1122,5/24/2014,0,0,0,0,0,0,0
9159,RM-1122,5/25/2014,0,0,0,0,0,0,0
9160,RM-1122,5/26/2014,0,0,0,0,0,0,0
9161,RM-1122,5/27/2014,0,0,0,0,0,0,0
9162,RM-1122,5/28/2014,0,0,0,0,0,0,0
9163,RM-1122,5/29/2014,0,0,0,0,0,0,0
9164,RM-1122,5/30/2014,0,0,0,0,0,0,0
9165,RM-1122,5/31/2014,0,0,0,0,0,0,0
9166,RM-1122,6/1/2014,0,0,0,0,0,0,0
9167,RM-1122,6/2/2014,0,0,0,0,0,0,0
9168,RM-1122,6/3/2014,0,0,0,0,0,0,0
9169,RM-1122,6/4/2014,0,0,0,0,0,0,0
9170,RM-1122,6/5/2014,0,0,0,0,0,0,0
9171,RM-1122,6/6/2014,0,0,0,0,0,0,0
9172,RM-1122,6/7/2014,0,0,0,0,0,0,0
9173,RM-1122,6/8/2014,0,0,0,0,0,0,0
9174,RM-1122,6/9/2014,0,0,0,0,0,0,0
9175,RM-1122,6/10/2014,0,0,0,0,0,0,0
9176,RM-1122,6/11/2014,0,0,0,0,0,0,0
9177,RM-1122,6/12/2014,0,0,0,0,0,0,0
9178,RM-1122,6/13/2014,0,0,0,0,0,0,0
9179,RM-1122,6/14/2014,0,0,0,0,0,0,0
9180,RM-1122,6/15/2014,0,0,0,0,0,0,0
9181,RM-1122,6/16/2014,0,0,0,0,0,0,0
9182,RM-1122,6/17/2014,0,0,0,0,0,0,0
9183,RM-1122,6/18/2014,0,0,0,0,0,0,0
9184,RM-1122,6/19/2014,0,0,0,0,0,0,0
9185,RM-1122,6/20/2014,0,0,0,0,0,0,0
9186,RM-1122,6/21/2014,0,0,0,0,0,0,0
9187,RM-1122,6/22/2014,0,0,0,0,0,0,0
9188,RM-1122,6/23/2014,0,0,0,0,0,0,0
9189,RM-1122,6/24/2014,0,0,0,0,0,0,0
9190,RM-1122,6/25/2014,0,0,0,0,0,0,0
9191,RM-1122,6/26/2014,0,0,0,0,0,0,0
9192,RM-1122,6/27/2014,0,0,0,0,0,0,0
9193,RM-1122,6/28/2014,0,0,0,0,0,0,0
9194,RM-1122,6/29/2014,0,0,0,0,0,0,0
9195,RM-1122,6/30/2014,0,0,0,0,0,0,0
9196,RM-1122,7/1/2014,0,0,0,0,0,0,0
9197,RM-1122,7/2/2014,0,0,0,0,0,0,0
9198,RM-1122,7/3/2014,0,0,0,0,0,0,0
9199,RM-1122,7/4/2014,0,0,0,0,0,0,0
9200,RM-1122,7/5/2014,0,0,0,0,0,0,0
9201,RM-1122,7/6/2014,0,0,0,0,0,0,0
9202,RM-1122,7/7/2014,0,0,0,0,0,0,0
9203,RM-1122,7/8/2014,0,0,0,0,0,0,0
9204,RM-1122,7/9/2014,0,0,0,0,0,0,0
9205,RM-1122,7/10/2014,0,0,0,0,0,0,0
9206,RM-1122,7/11/2014,0,0,0,0,0,0,0
9207,RM-1122,7/12/2014,0,0,0,0,0,0,0
9208,RM-1122,7/13/2014,0,0,0,0,0,0,0
9209,RM-1122,7/14/2014,0,0,0,0,0,0,0
9210,RM-1122,7/15/2014,0,0,0,0,0,0,0
9211,RM-1122,7/16/2014,0,0,0,0,0,0,0
9212,RM-1122,7/17/2014,0,0,0,0,0,0,0
9213,RM-1122,7/18/2014,0,0,0,0,0,0,0
9214,RM-1122,7/19/2014,0,0,0,0,0,0,0
9215,RM-1122,7/20/2014,0,0,0,0,0,0,0
9216,RM-1122,7/21/2014,0,0,0,0,0,0,0
9217,RM-1122,7/22/2014,0,0,0,0,0,0,0
9218,RM-1122,7/23/2014,0,0,0,0,0,0,0
9219,RM-1122,7/24/2014,0,0,0,0,0,0,0
9220,RM-1122,7/25/2014,0,0,0,0,0,0,0
9221,RM-1122,7/26/2014,0,0,0,0,0,0,0
9222,RM-1122,7/27/2014,0,0,0,0,0,0,0
9223,RM-1122,7/28/2014,0,0,0,0,0,0,0
9224,RM-1122,7/29/2014,0,0,0,0,0,0,0
9225,RM-1122,7/30/2014,0,0,0,0,0,0,0
9226,RM-1122,7/31/2014,0,0,0,0,0,0,0
9227,RM-1122,8/1/2014,0,0,0,0,0,0,0
9228,RM-1122,8/2/2014,0,0,0,0,0,0,0
9229,RM-1122,8/3/2014,0,0,0,0,0,0,0
9230,RM-1122,8/4/2014,0,0,0,0,0,0,0
9231,RM-1122,8/5/2014,0,0,0,0,0,0,0
9232,RM-1122,8/6/2014,0,0,0,0,0,0,0
9233,RM-1122,8/7/2014,0,0,0,0,0,0,0
9234,RM-1122,8/8/2014,0,0,0,0,0,0,0
9235,RM-1122,8/9/2014,0,0,0,0,0,0,0
9236,RM-1122,8/10/2014,0,0,0,0,0,0,0
9237,RM-1122,8/11/2014,0,0,0,0,0,0,0
9238,RM-1122,8/12/2014,0,0,0,0,0,0,0
9239,RM-1122,8/13/2014,0,0,0,0,0,0,0
9240,RM-1122,8/14/2014,0,0,0,0,0,0,0
9241,RM-1122,8/15/2014,0,0,0,0,0,0,0
9242,RM-1122,8/16/2014,0,0,0,0,0,0,0
9243,RM-1122,8/17/2014,0,0,0,0,0,0,0
9244,RM-1122,8/18/2014,0,0,0,0,0,0,0
9245,RM-1122,8/19/2014,0,0,0,0,0,0,0
9246,RM-1122,8/20/2014,0,0,0,0,0,0,0
9247,RM-1122,8/21/2014,0,0,0,0,0,0,0
9248,RM-1122,8/22/2014,0,0,0,0,0,0,0
9249,RM-1122,8/23/2014,0,0,0,0,0,0,0
9250,RM-1122,8/24/2014,0,0,0,0,0,0,0
9251,RM-1122,8/25/2014,0,0,0,0,0,0,0
9252,RM-1122,8/26/2014,0,0,0,0,0,0,0
9253,RM-1122,8/27/2014,0,0,0,0,0,0,0
9254,RM-1122,8/28/2014,0,0,0,0,0,0,0
9255,RM-1122,8/29/2014,0,0,0,0,0,0,0
9256,RM-1122,8/30/2014,0,0,0,0,0,0,0
9257,RM-1122,8/31/2014,0,0,0,0,0,0,0
9258,RM-1122,9/1/2014,0,0,0,0,0,0,0
9259,RM-1122,9/2/2014,0,0,0,0,0,0,0
9260,RM-1122,9/3/2014,0,0,0,0,0,0,0
9261,RM-1122,9/4/2014,0,0,0,0,0,0,0
9262,RM-1122,9/5/2014,0,0,0,0,0,0,0
9263,RM-1122,9/6/2014,0,0,0,0,0,0,0
9264,RM-1122,9/7/2014,0,0,0,0,0,0,0
9265,RM-1122,9/8/2014,0,0,0,0,0,0,0
9266,RM-1122,9/9/2014,0,0,0,0,0,0,0
9267,RM-1122,9/10/2014,0,0,0,0,0,0,0
9268,RM-1122,9/11/2014,0,0,0,0,0,0,0
9269,RM-1122,9/12/2014,0,0,0,0,0,0,0
9270,RM-1122,9/13/2014,0,0,0,0,0,0,0
9271,RM-1122,9/14/2014,0,0,0,0,0,0,0
9272,RM-1122,9/15/2014,0,0,0,0,0,0,0
9273,RM-1122,9/16/2014,0,0,0,0,0,0,0
9274,RM-1122,9/17/2014,0,0,0,0,0,0,0
9275,RM-1122,9/18/2014,0,0,0,0,0,0,0
9276,RM-1122,9/19/2014,0,0,0,0,0,0,0
9277,RM-1122,9/20/2014,0,0,0,0,0,0,0
9278,RM-1122,9/21/2014,0,0,0,0,0,0,0
9279,RM-1122,9/22/2014,0,0,0,0,0,0,0
9280,RM-1122,9/23/2014,0,0,0,0,0,0,0
9281,RM-1122,9/24/2014,0,0,0,0,0,0,0
9282,RM-1122,9/25/2014,0,0,0,0,0,0,0
9283,RM-1122,9/28/2014,0,0,0,0,0,0,0
9284,RM-1122,9/29/2014,0,0,0,0,0,0,0
9285,RM-1122,9/30/2014,0,0,0,0,0,0,0
9286,RM-1122,10/1/2014,0,0,0,0,0,0,0
9287,RM-1122,10/2/2014,0,0,0,0,0,0,0
9288,RM-1122,10/3/2014,0,0,0,0,0,0,0
9289,RM-1122,10/4/2014,0,0,0,0,0,0,0
9290,RM-1122,10/5/2014,0,0,0,0,0,0,0
9291,RM-1122,10/6/2014,0,0,0,0,0,0,0
9292,RM-1122,10/7/2014,0,0,0,0,0,0,0
9293,RM-1122,10/8/2014,0,0,0,0,0,0,0
9294,RM-1122,10/9/2014,0,0,0,0,0,0,0
9295,RM-1122,10/10/2014,0,0,0,0,0,0,0
9296,RM-1122,10/11/2014,0,0,0,0,0,0,0
9297,RM-1122,10/12/2014,0,0,0,0,0,0,0
9298,RM-1122,10/13/2014,0,0,0,0,0,0,0
9299,RM-1122,10/14/2014,0,0,0,0,0,0,0
9300,RM-1122,10/15/2014,0,0,0,0,0,0,0
9301,RM-1122,10/16/2014,0,0,0,0,0,0,0
9302,RM-1122,10/17/2014,0,0,0,0,0,0,0
9303,RM-1122,10/18/2014,0,0,0,0,0,0,0
9304,RM-1122,10/19/2014,0,0,0,0,0,0,0
9305,RM-1122,10/20/2014,0,0,0,0,0,0,0
9306,RM-1122,10/21/2014,0,0,0,0,0,0,0
9307,RM-1122,10/22/2014,0,0,0,0,0,0,0
9308,RM-1122,10/23/2014,0,0,0,0,0,0,0
9309,RM-1122,10/24/2014,0,0,0,0,0,0,0
9310,RM-1122,10/25/2014,0,0,0,0,0,0,0
9311,RM-1122,10/26/2014,0,0,0,0,0,0,0
9312,RM-1122,10/27/2014,0,0,0,0,0,0,0
9313,RM-1122,10/28/2014,0,0,0,0,0,0,0
9314,RM-1122,10/29/2014,0,0,0,0,0,0,0
9315,RM-1122,10/30/2014,0,0,0,0,0,0,0
9316,RM-1122,10/31/2014,0,0,0,0,0,0,0
9317,RM-1122,11/1/2014,0,0,0,0,0,0,0
9318,RM-1122,11/2/2014,0,0,0,0,0,0,0
9319,RM-1122,11/3/2014,0,0,0,0,0,0,0
9320,RM-1122,11/4/2014,0,0,0,0,0,0,0
9321,RM-1122,11/5/2014,0,0,0,0,0,0,0
9322,RM-1122,11/6/2014,0,0,0,0,0,0,0
9323,RM-1122,11/7/2014,0,0,0,0,0,0,0
9324,RM-1122,11/8/2014,0,0,0,0,0,0,0
9325,RM-1122,11/9/2014,0,0,0,0,0,0,0
9326,RM-1122,11/10/2014,0,0,0,0,0,0,0
9327,RM-1122,11/11/2014,0,0,0,0,0,0,0
9328,RM-1122,11/12/2014,0,0,0,0,0,0,0
9329,RM-1122,11/13/2014,0,0,0,0,0,0,0
9330,RM-1122,11/14/2014,0,0,0,0,0,0,0
9331,RM-1122,11/15/2014,0,0,0,0,0,0,0
9332,RM-1122,11/16/2014,0,0,0,0,0,0,0
9333,RM-1122,11/17/2014,0,0,0,0,0,0,0
9334,RM-1122,11/18/2014,0,0,0,0,0,0,0
9335,RM-1122,11/19/2014,0,0,0,0,0,0,0
9336,RM-1122,11/20/2014,0,0,0,0,0,0,0
9337,RM-1122,11/21/2014,0,0,0,0,0,0,0
9338,RM-1122,11/22/2014,0,0,0,0,0,0,0
9339,RM-1122,11/23/2014,0,0,0,0,0,0,0
9340,RM-1122,11/24/2014,0,0,0,0,0,0,0
9341,RM-1122,11/25/2014,0,0,0,0,0,0,0
9342,RM-1122,11/26/2014,0,0,0,0,0,0,0
9343,RM-1122,11/27/2014,0,0,0,0,0,0,0
9344,RM-1122,11/28/2014,0,0,0,0,0,0,0
9345,RM-1122,11/29/2014,0,0,0,0,0,0,0
9346,RM-1122,11/30/2014,0,0,0,0,0,0,0
9347,RM-1122,12/1/2014,0,0,0,0,0,0,0
9348,RM-1122,12/2/2014,0,0,0,0,0,0,0
9349,RM-1122,12/3/2014,0,0,0,0,0,0,0
9350,RM-1122,12/4/2014,0,0,0,0,0,0,0
9351,RM-1122,12/5/2014,0,0,0,0,0,0,0
9352,RM-1122,12/6/2014,0,0,0,0,0,0,0
9353,RM-1122,12/7/2014,0,0,0,0,0,0,0
9354,RM-1122,12/8/2014,0,0,0,0,0,0,0
9355,RM-1122,12/9/2014,0,0,0,0,0,0,0
9356,RM-1122,12/10/2014,0,0,0,0,0,0,0
9357,RM-1122,12/11/2014,0,0,0,0,0,0,0
9358,RM-1122,12/12/2014,0,0,0,0,0,0,0
9359,RM-1122,12/13/2014,0,0,0,0,0,0,0
9360,RM-1122,12/14/2014,0,0,0,0,0,0,0
9361,RM-1122,12/15/2014,0,0,0,0,0,0,0
9362,RM-1122,12/16/2014,0,0,0,0,0,0,0
9363,RM-1122,12/17/2014,0,0,0,0,0,0,0
9364,RM-1122,12/18/2014,0,0,0,0,0,0,0
9365,RM-1122,12/19/2014,0,0,0,0,0,0,0
9366,RM-1122,12/20/2014,0,0,0,0,0,0,0
9367,RM-1122,12/21/2014,0,0,0,0,0,0,0
9368,RM-1122,12/22/2014,0,0,0,0,0,0,0
9369,RM-1122,12/23/2014,0,0,0,0,0,0,0
9370,RM-1122,12/24/2014,0,0,0,0,0,0,0
9371,RM-1122,12/25/2014,0,0,0,0,0,0,0
9372,RM-1122,12/26/2014,0,0,0,0,0,0,0
9373,RM-1122,12/27/2014,0,0,0,0,0,0,0
9374,RM-1122,12/28/2014,0,0,0,0,0,0,0
9375,RM-1122,12/29/2014,0,0,0,0,0,0,0
9376,RM-1122,12/30/2014,0,0,0,0,0,0,0
9377,RM-1122,12/31/2014,0,0,0,0,0,0,0
9378,RM-1122,1/1/2015,0,0,0,0,0,0,0
9379,RM-1122,1/2/2015,0,0,0,0,0,0,0
9380,RM-1122,1/3/2015,0,0,0,0,0,0,0
9381,RM-1122,1/4/2015,0,0,0,0,0,0,0
9382,RM-1122,1/5/2015,0,0,0,0,0,0,0
9383,RM-1122,1/6/2015,0,0,0,0,0,0,0
9384,RM-1122,1/7/2015,0,0,0,0,0,0,0
9385,RM-1122,1/8/2015,0,0,0,0,0,0,0
9386,RM-1122,1/9/2015,0,0,0,0,0,0,0
9387,RM-1122,1/10/2015,0,0,0,0,0,0,0
9388,RM-1122,1/11/2015,0,0,0,0,0,0,0
9389,RM-1122,1/12/2015,0,0,0,0,0,0,0
9390,RM-1122,1/13/2015,0,0,0,0,0,0,0
9391,RM-1122,1/14/2015,0,0,0,0,0,0,0
9392,RM-1122,1/15/2015,0,0,0,0,0,0,0
9393,RM-1122,1/16/2015,0,0,0,0,0,0,0
9394,RM-1122,1/17/2015,0,0,0,0,0,0,0
9395,RM-1122,1/18/2015,0,0,0,0,0,0,0
9396,RM-1122,1/19/2015,0,0,0,0,0,0,0
9397,RM-1122,1/20/2015,0,0,0,0,0,0,0
9398,RM-1122,1/21/2015,0,0,0,0,0,0,0
9399,RM-1122,1/22/2015,0,0,0,0,0,0,0
9400,RM-1122,1/23/2015,0,0,0,0,0,0,0
9401,RM-1122,1/24/2015,0,0,0,0,0,0,0
9402,RM-1122,1/25/2015,0,0,0,0,0,0,0
9403,RM-1122,1/26/2015,0,0,0,0,0,0,0
9404,RM-1122,1/27/2015,0,0,0,0,0,0,0
9405,RM-1122,1/28/2015,0,0,0,0,0,0,0
9406,RM-1122,1/29/2015,0,0,0,0,0,0,0
9407,RM-1122,1/30/2015,0,0,0,0,0,0,0
9408,RM-1122,1/31/2015,0,0,0,0,0,0,0
9409,RM-1122,2/1/2015,0,0,0,0,0,0,0
9410,RM-1122,2/2/2015,0,0,0,0,0,0,0
9411,RM-1122,2/3/2015,0,0,0,0,0,0,0
9412,RM-1122,2/4/2015,0,0,0,0,0,0,0
9413,RM-1122,2/5/2015,0,0,0,0,0,0,0
9414,RM-1122,2/6/2015,0,0,0,0,0,0,0
9415,RM-1122,2/7/2015,0,0,0,0,0,0,0
9416,RM-1122,2/8/2015,0,0,0,0,0,0,0
9417,RM-1122,2/9/2015,0,0,0,0,0,0,0
9418,RM-1122,2/10/2015,0,0,0,0,0,0,0
9419,RM-1122,2/11/2015,0,0,0,0,0,0,0
9420,RM-1122,2/12/2015,0,0,0,0,0,0,0
9421,RM-1122,2/13/2015,0,0,0,0,0,0,0
9422,RM-1122,2/14/2015,0,0,0,0,0,0,0
9423,RM-1122,2/15/2015,0,0,0,0,0,0,0
9424,RM-1122,2/16/2015,0,0,0,0,0,0,0
9425,RM-1122,2/17/2015,0,0,0,0,0,0,0
9426,RM-1122,2/18/2015,0,0,0,0,0,0,0
9427,RM-1122,2/19/2015,0,0,0,0,0,0,0
9428,RM-1122,2/20/2015,0,0,0,0,0,0,0
9429,RM-1122,2/21/2015,0,0,0,0,0,0,0
9430,RM-1122,2/22/2015,0,0,0,0,0,0,0
9431,RM-1122,2/23/2015,0,0,0,0,0,0,0
9432,RM-1122,2/24/2015,0,0,0,0,0,0,0
9433,RM-1122,2/25/2015,0,0,0,0,0,0,0
9434,RM-1122,2/26/2015,0,0,0,0,0,0,0
9435,RM-1122,2/27/2015,0,0,0,0,0,0,0
9436,RM-1122,2/28/2015,0,0,0,0,0,0,0
9437,RM-1122,3/1/2015,0,0,0,0,0,0,0
9438,RM-1122,3/2/2015,0,0,0,0,0,0,0
9439,RM-1122,3/3/2015,0,0,0,0,0,0,0
9440,RM-1122,3/4/2015,0,0,0,0,0,0,0
9441,RM-1122,3/5/2015,0,0,0,0,0,0,0
9442,RM-1122,3/6/2015,0,0,0,0,0,0,0
9443,RM-1122,3/7/2015,0,0,0,0,0,0,0
9444,RM-1122,3/8/2015,0,0,0,0,0,0,0
9445,RM-1122,3/9/2015,0,0,0,0,0,0,0
9446,RM-1122,3/10/2015,0,0,0,0,0,0,0
9447,RM-1122,3/11/2015,0,0,0,0,0,0,0
9448,RM-1122,3/12/2015,0,0,0,0,0,0,0
9449,RM-1122,3/13/2015,0,0,0,0,0,0,0
9450,RM-1122,3/14/2015,0,0,0,0,0,0,0
9451,RM-1122,3/15/2015,0,0,0,0,0,0,0
9452,RM-1122,3/16/2015,0,0,0,0,0,0,0
9453,RM-1122,3/17/2015,0,0,0,0,0,0,0
9454,RM-1122,3/18/2015,0,0,0,0,0,0,0
9455,RM-1122,3/19/2015,0,0,0,0,0,0,0
9456,RM-1122,3/20/2015,0,0,0,0,0,0,0
9457,RM-1122,3/21/2015,0,0,0,0,0,0,0
9458,RM-1122,3/22/2015,0,0,0,0,0,0,0
9459,RM-1122,3/23/2015,0,0,0,0,0,0,0
9460,RM-1122,3/24/2015,0,0,0,0,0,0,0
9461,RM-1122,3/25/2015,0,0,0,0,0,0,0
9462,RM-1122,3/26/2015,0,0,0,0,0,0,0
9463,RM-1122,3/27/2015,0,0,0,0,0,0,0
9464,RM-1122,3/28/2015,0,0,0,0,0,0,0
9529,RM-1123,7/1/2013,0,0,0,0,0,0,0
9530,RM-1123,7/2/2013,0,0,0,0,0,0,0
9531,RM-1123,7/3/2013,0,0,0,0,0,0,0
9532,RM-1123,7/4/2013,0,0,0,0,0,0,0
9533,RM-1123,7/5/2013,0,0,0,0,0,0,0
9534,RM-1123,7/6/2013,0,0,0,0,0,0,0
9535,RM-1123,7/7/2013,0,0,0,0,0,0,0
9536,RM-1123,7/8/2013,0,0,0,0,0,0,0
9537,RM-1123,7/9/2013,0,0,0,0,0,0,0
9538,RM-1123,7/10/2013,0,0,0,0,0,0,0
9539,RM-1123,7/11/2013,0,0,0,0,0,0,0
9540,RM-1123,7/12/2013,0,0,0,0,0,0,0
9541,RM-1123,7/13/2013,0,0,0,0,0,0,0
9542,RM-1123,7/14/2013,0,0,0,0,0,0,0
9543,RM-1123,7/15/2013,0,0,0,0,0,0,0
9544,RM-1123,7/17/2013,0,0,0,0,0,0,0
9545,RM-1123,7/18/2013,0,0,0,0,0,0,0
9546,RM-1123,7/19/2013,0,0,0,0,0,0,0
9547,RM-1123,7/20/2013,0,0,0,0,0,0,0
9548,RM-1123,7/21/2013,0,0,0,0,0,0,0
9549,RM-1123,7/22/2013,0,0,0,0,0,0,0
9550,RM-1123,7/23/2013,0,0,0,0,0,0,0
9551,RM-1123,7/24/2013,0,0,0,0,0,0,0
9552,RM-1123,7/25/2013,0,0,0,0,0,0,0
9553,RM-1123,7/26/2013,0,0,0,0,0,0,0
9554,RM-1123,7/27/2013,0,0,0,0,0,0,0
9555,RM-1123,7/28/2013,0,0,0,0,0,0,0
9556,RM-1123,7/29/2013,0,0,0,0,0,0,0
9557,RM-1123,7/30/2013,0,0,0,0,0,0,0
9558,RM-1123,7/31/2013,0,0,0,0,0,0,0
9559,RM-1123,8/1/2013,0,0,0,0,0,0,0
9560,RM-1123,8/2/2013,0,0,0,0,0,0,0
9561,RM-1123,8/3/2013,0,0,0,0,0,0,0
9562,RM-1123,8/4/2013,0,0,0,0,0,0,0
9563,RM-1123,8/5/2013,0,0,0,0,0,0,0
9564,RM-1123,8/6/2013,0,0,0,0,0,0,0
10137,RM-1123,3/16/2015,0,0,0,0,0,0,0
10138,RM-1123,3/17/2015,0,0,0,0,0,0,0
10139,RM-1123,3/18/2015,0,0,0,0,0,0,0
10140,RM-1123,3/19/2015,0,0,0,0,0,0,0
10141,RM-1123,3/20/2015,0,0,0,0,0,0,0
10142,RM-1123,3/21/2015,0,0,0,0,0,0,0
10143,RM-1123,3/22/2015,0,0,0,0,0,0,0
10144,RM-1123,3/23/2015,0,0,0,0,0,0,0
10145,RM-1123,3/24/2015,0,0,0,0,0,0,0
10146,RM-1123,3/25/2015,0,0,0,0,0,0,0
10147,RM-1123,3/26/2015,0,0,0,0,0,0,0
10148,RM-1123,3/27/2015,0,0,0,0,0,0,0
10149,RM-1123,3/28/2015,0,0,0,0,0,0,0
10150,RM-1123,3/29/2015,0,0,0,0,0,0,0
10151,RM-1123,3/30/2015,0,0,0,0,0,0,0
10152,RM-1123,3/31/2015,0,0,0,0,0,0,0
10153,RM-1123,4/1/2015,0,0,0,0,0,0,0
10154,RM-1123,4/2/2015,0,0,0,0,0,0,0
10155,RM-1123,4/3/2015,0,0,0,0,0,0,0
10156,RM-1123,4/4/2015,0,0,0,0,0,0,0
10157,RM-1123,4/5/2015,0,0,0,0,0,0,0
10158,RM-1123,4/6/2015,0,0,0,0,0,0,0
10159,RM-1123,4/7/2015,0,0,0,0,0,0,0
10160,RM-1123,4/8/2015,0,0,0,0,0,0,0
10161,RM-1123,4/9/2015,0,0,0,0,0,0,0
10162,RM-1123,4/10/2015,0,0,0,0,0,0,0
10163,RM-1123,4/11/2015,0,0,0,0,0,0,0
10164,RM-1123,4/12/2015,0,0,0,0,0,0,0
10165,RM-1123,4/13/2015,0,0,0,0,0,0,0
10166,RM-1123,4/14/2015,0,0,0,0,0,0,0
10167,RM-1123,4/15/2015,0,0,0,0,0,0,0
10168,RM-1123,4/16/2015,0,0,0,0,0,0,0
10169,RM-1123,4/17/2015,0,0,0,0,0,0,0
10170,RM-1123,4/18/2015,0,0,0,0,0,0,0
10171,RM-1123,4/19/2015,0,0,0,0,0,0,0
10172,RM-1123,4/20/2015,0,0,0,0,0,0,0
10173,RM-1123,4/21/2015,0,0,0,0,0,0,0
10174,RM-1123,4/22/2015,0,0,0,0,0,0,0
10175,RM-1123,4/23/2015,0,0,0,0,0,0,0
10176,RM-1123,4/24/2015,0,0,0,0,0,0,0
10177,RM-1123,4/25/2015,0,0,0,0,0,0,0
10178,RM-1123,4/26/2015,0,0,0,0,0,0,0
10179,RM-1123,4/27/2015,0,0,0,0,0,0,0
10180,RM-1123,4/28/2015,0,0,0,0,0,0,0
10181,RM-1123,4/29/2015,0,0,0,0,0,0,0
10182,RM-1123,4/30/2015,0,0,0,0,0,0,0
10183,RM-1123,5/1/2015,0,0,0,0,0,0,0
10184,RM-1123,5/2/2015,0,0,0,0,0,0,0
10185,RM-1123,5/3/2015,0,0,0,0,0,0,0
10186,RM-1123,5/4/2015,0,0,0,0,0,0,0
10187,RM-1123,5/5/2015,0,0,0,0,0,0,0
10188,RM-1123,5/6/2015,0,0,0,0,0,0,0
10189,RM-1123,5/7/2015,0,0,0,0,0,0,0
10190,RM-1123,5/8/2015,0,0,0,0,0,0,0
10191,RM-1123,5/9/2015,0,0,0,0,0,0,0
10192,RM-1123,5/10/2015,0,0,0,0,0,0,0
10193,RM-1123,5/11/2015,0,0,0,0,0,0,0
10194,RM-1123,5/12/2015,0,0,0,0,0,0,0
10195,RM-1123,5/13/2015,0,0,0,0,0,0,0
10196,RM-1123,5/14/2015,0,0,0,0,0,0,0
10197,RM-1123,5/15/2015,0,0,0,0,0,0,0
10198,RM-1123,5/16/2015,0,0,0,0,0,0,0
10199,RM-1123,5/17/2015,0,0,0,0,0,0,0
10200,RM-1123,5/18/2015,0,0,0,0,0,0,0
10201,RM-1123,5/19/2015,0,0,0,0,0,0,0
10202,RM-1123,5/20/2015,0,0,0,0,0,0,0
10203,RM-1123,5/21/2015,0,0,0,0,0,0,0
10204,RM-1123,5/22/2015,0,0,0,0,0,0,0
10205,RM-1123,5/23/2015,0,0,0,0,0,0,0
10206,RM-1123,5/24/2015,0,0,0,0,0,0,0
10207,RM-1123,5/25/2015,0,0,0,0,0,0,0
10208,RM-1123,5/26/2015,0,0,0,0,0,0,0
10209,RM-1123,5/27/2015,0,0,0,0,0,0,0
10210,RM-1123,5/28/2015,0,0,0,0,0,0,0
10211,RM-1123,5/29/2015,0,0,0,0,0,0,0
10212,RM-1123,5/30/2015,0,0,0,0,0,0,0
10213,RM-1123,5/31/2015,0,0,0,0,0,0,0
10214,RM-1124,7/1/2013,0,0,0,0,0,0,0
10215,RM-1124,7/2/2013,0,0,0,0,0,0,0
10216,RM-1124,7/3/2013,0,0,0,0,0,0,0
10217,RM-1124,7/4/2013,0,0,0,0,0,0,0
10218,RM-1124,7/5/2013,0,0,0,0,0,0,0
10219,RM-1124,7/6/2013,0,0,0,0,0,0,0
10220,RM-1124,7/7/2013,0,0,0,0,0,0,0
10221,RM-1124,7/8/2013,0,0,0,0,0,0,0
10222,RM-1124,7/9/2013,0,0,0,0,0,0,0
10223,RM-1124,7/10/2013,0,0,0,0,0,0,0
10224,RM-1124,7/11/2013,0,0,0,0,0,0,0
10225,RM-1124,7/12/2013,0,0,0,0,0,0,0
10226,RM-1124,7/13/2013,0,0,0,0,0,0,0
10227,RM-1124,7/14/2013,0,0,0,0,0,0,0
10228,RM-1124,7/15/2013,0,0,0,0,0,0,0
10229,RM-1124,7/17/2013,0,0,0,0,0,0,0
10230,RM-1124,7/18/2013,0,0,0,0,0,0,0
10231,RM-1124,7/19/2013,0,0,0,0,0,0,0
10232,RM-1124,7/20/2013,0,0,0,0,0,0,0
10233,RM-1124,7/21/2013,0,0,0,0,0,0,0
10234,RM-1124,7/22/2013,0,0,0,0,0,0,0
10235,RM-1124,7/23/2013,0,0,0,0,0,0,0
10236,RM-1124,7/24/2013,0,0,0,0,0,0,0
10237,RM-1124,7/25/2013,0,0,0,0,0,0,0
10238,RM-1124,7/26/2013,0,0,0,0,0,0,0
10239,RM-1124,7/27/2013,0,0,0,0,0,0,0
10240,RM-1124,7/28/2013,0,0,0,0,0,0,0
10241,RM-1124,7/29/2013,0,0,0,0,0,0,0
10242,RM-1124,7/30/2013,0,0,0,0,0,0,0
10243,RM-1124,7/31/2013,0,0,0,0,0,0,0
10244,RM-1124,8/1/2013,0,0,0,0,0,0,0
10245,RM-1124,8/2/2013,0,0,0,0,0,0,0
10246,RM-1124,8/3/2013,0,0,0,0,0,0,0
10247,RM-1124,8/4/2013,0,0,0,0,0,0,0
10248,RM-1124,8/5/2013,0,0,0,0,0,0,0
10249,RM-1124,8/6/2013,0,0,0,0,0,0,0
10250,RM-1124,8/7/2013,0,0,0,0,0,0,0
10251,RM-1124,8/8/2013,0,0,0,0,0,0,0
10252,RM-1124,8/9/2013,0,0,0,0,0,0,0
10253,RM-1124,8/10/2013,0,0,0,0,0,0,0
10254,RM-1124,8/11/2013,0,0,0,0,0,0,0
10255,RM-1124,8/12/2013,0,0,0,0,0,0,0
10256,RM-1124,8/13/2013,0,0,0,0,0,0,0
10257,RM-1124,8/14/2013,0,0,0,0,0,0,0
10258,RM-1124,8/15/2013,0,0,0,0,0,0,0
10259,RM-1124,8/16/2013,0,0,0,0,0,0,0
10260,RM-1124,8/17/2013,0,0,0,0,0,0,0
10261,RM-1124,8/18/2013,0,0,0,0,0,0,0
10262,RM-1124,8/19/2013,0,0,0,0,0,0,0
10263,RM-1124,8/20/2013,0,0,0,0,0,0,0
10264,RM-1124,8/21/2013,0,0,0,0,0,0,0
10265,RM-1124,8/22/2013,0,0,0,0,0,0,0
10266,RM-1124,8/27/2013,0,0,0,0,0,0,0
10267,RM-1124,8/28/2013,0,0,0,0,0,0,0
10268,RM-1124,8/29/2013,0,0,0,0,0,0,0
10269,RM-1124,8/30/2013,0,0,0,0,0,0,0
10270,RM-1124,9/4/2013,0,0,0,0,0,0,0
10271,RM-1124,9/5/2013,0,0,0,0,0,0,0
10272,RM-1124,9/6/2013,0,0,0,0,0,0,0
10273,RM-1124,9/7/2013,0,0,0,0,0,0,0
10274,RM-1124,9/9/2013,0,0,0,0,0,0,0
10275,RM-1124,9/10/2013,0,0,0,0,0,0,0
10276,RM-1124,9/11/2013,0,0,0,0,0,0,0
10277,RM-1124,9/12/2013,0,0,0,0,0,0,0
10278,RM-1124,9/13/2013,0,0,0,0,0,0,0
10279,RM-1124,9/14/2013,0,0,0,0,0,0,0
10280,RM-1124,9/15/2013,0,0,0,0,0,0,0
10281,RM-1124,9/16/2013,0,0,0,0,0,0,0
10282,RM-1124,9/17/2013,0,0,0,0,0,0,0
10283,RM-1124,9/18/2013,0,0,0,0,0,0,0
10284,RM-1124,9/19/2013,0,0,0,0,0,0,0
10285,RM-1124,9/20/2013,0,0,0,0,0,0,0
10286,RM-1124,9/21/2013,0,0,0,0,0,0,0
10287,RM-1124,9/22/2013,0,0,0,0,0,0,0
10288,RM-1124,9/23/2013,0,0,0,0,0,0,0
10289,RM-1124,9/24/2013,0,0,0,0,0,0,0
10290,RM-1124,9/25/2013,0,0,0,0,0,0,0
10291,RM-1124,9/26/2013,0,0,0,0,0,0,0
10292,RM-1124,9/27/2013,0,0,0,0,0,0,0
10293,RM-1124,9/28/2013,0,0,0,0,0,0,0
10294,RM-1124,9/29/2013,0,0,0,0,0,0,0
10295,RM-1124,9/30/2013,0,0,0,0,0,0,0
10296,RM-1124,10/1/2013,0,0,0,0,0,0,0
10297,RM-1124,10/2/2013,0,0,0,0,0,0,0
10298,RM-1124,10/3/2013,0,0,0,0,0,0,0
10299,RM-1124,10/4/2013,0,0,0,0,0,0,0
10300,RM-1124,10/5/2013,0,0,0,0,0,0,0
10301,RM-1124,10/6/2013,0,0,0,0,0,0,0
10302,RM-1124,10/7/2013,0,0,0,0,0,0,0
10303,RM-1124,10/8/2013,0,0,0,0,0,0,0
10304,RM-1124,10/9/2013,0,0,0,0,0,0,0
10305,RM-1124,10/10/2013,0,0,0,0,0,0,0
10306,RM-1124,10/11/2013,0,0,0,0,0,0,0
10307,RM-1124,10/12/2013,0,0,0,0,0,0,0
10308,RM-1124,10/13/2013,0,0,0,0,0,0,0
10309,RM-1124,10/14/2013,0,0,0,0,0,0,0
10310,RM-1124,10/15/2013,0,0,0,0,0,0,0
10425,RM-1124,2/10/2014,0,0,0,0,0,0,0
10426,RM-1124,2/11/2014,0,0,0,0,0,0,0
10427,RM-1124,2/12/2014,0,0,0,0,0,0,0
10428,RM-1124,2/13/2014,0,0,0,0,0,0,0
10429,RM-1124,2/14/2014,0,0,0,0,0,0,0
10430,RM-1124,2/15/2014,0,0,0,0,0,0,0
10431,RM-1124,2/16/2014,0,0,0,0,0,0,0
10432,RM-1124,2/17/2014,0,0,0,0,0,0,0
10433,RM-1124,2/18/2014,0,0,0,0,0,0,0
10434,RM-1124,2/19/2014,0,0,0,0,0,0,0
10435,RM-1124,2/20/2014,0,0,0,0,0,0,0
10436,RM-1124,2/21/2014,0,0,0,0,0,0,0
10437,RM-1124,2/22/2014,0,0,0,0,0,0,0
10438,RM-1124,2/23/2014,0,0,0,0,0,0,0
10439,RM-1124,2/24/2014,0,0,0,0,0,0,0
10440,RM-1124,2/25/2014,0,0,0,0,0,0,0
10441,RM-1124,2/26/2014,0,0,0,0,0,0,0
10442,RM-1124,2/27/2014,0,0,0,0,0,0,0
10443,RM-1124,2/28/2014,0,0,0,0,0,0,0
10444,RM-1124,3/1/2014,0,0,0,0,0,0,0
10445,RM-1124,3/2/2014,0,0,0,0,0,0,0
10446,RM-1124,3/3/2014,0,0,0,0,0,0,0
10447,RM-1124,3/4/2014,0,0,0,0,0,0,0
10448,RM-1124,3/5/2014,0,0,0,0,0,0,0
10449,RM-1124,3/6/2014,0,0,0,0,0,0,0
10450,RM-1124,3/7/2014,0,0,0,0,0,0,0
10451,RM-1124,3/8/2014,0,0,0,0,0,0,0
10452,RM-1124,3/9/2014,0,0,0,0,0,0,0
10453,RM-1124,3/10/2014,0,0,0,0,0,0,0
10454,RM-1124,3/11/2014,0,0,0,0,0,0,0
10455,RM-1124,3/12/2014,0,0,0,0,0,0,0
10456,RM-1124,3/13/2014,0,0,0,0,0,0,0
10457,RM-1124,3/14/2014,0,0,0,0,0,0,0
10458,RM-1124,3/15/2014,0,0,0,0,0,0,0
10459,RM-1124,3/16/2014,0,0,0,0,0,0,0
10460,RM-1124,3/17/2014,0,0,0,0,0,0,0
10461,RM-1124,3/18/2014,0,0,0,0,0,0,0
10462,RM-1124,3/19/2014,0,0,0,0,0,0,0
10463,RM-1124,3/20/2014,0,0,0,0,0,0,0
10464,RM-1124,3/21/2014,0,0,0,0,0,0,0
10465,RM-1124,3/22/2014,0,0,0,0,0,0,0
10466,RM-1124,3/23/2014,0,0,0,0,0,0,0
10467,RM-1124,3/24/2014,0,0,0,0,0,0,0
10468,RM-1124,3/25/2014,0,0,0,0,0,0,0
10469,RM-1124,3/26/2014,0,0,0,0,0,0,0
10470,RM-1124,3/27/2014,0,0,0,0,0,0,0
10471,RM-1124,3/28/2014,0,0,0,0,0,0,0
10472,RM-1124,3/29/2014,0,0,0,0,0,0,0
10473,RM-1124,3/30/2014,0,0,0,0,0,0,0
10474,RM-1124,3/31/2014,0,0,0,0,0,0,0
10475,RM-1124,4/1/2014,0,0,0,0,0,0,0
10476,RM-1124,4/2/2014,0,0,0,0,0,0,0
10477,RM-1124,4/3/2014,0,0,0,0,0,0,0
10478,RM-1124,4/4/2014,0,0,0,0,0,0,0
10479,RM-1124,4/5/2014,0,0,0,0,0,0,0
10480,RM-1124,4/6/2014,0,0,0,0,0,0,0
10481,RM-1124,4/7/2014,0,0,0,0,0,0,0
10482,RM-1124,4/8/2014,0,0,0,0,0,0,0
10483,RM-1124,4/9/2014,0,0,0,0,0,0,0
10484,RM-1124,4/10/2014,0,0,0,0,0,0,0
10485,RM-1124,4/11/2014,0,0,0,0,0,0,0
10486,RM-1124,4/12/2014,0,0,0,0,0,0,0
10487,RM-1124,4/13/2014,0,0,0,0,0,0,0
10488,RM-1124,4/14/2014,0,0,0,0,0,0,0
10489,RM-1124,4/15/2014,0,0,0,0,0,0,0
10490,RM-1124,4/16/2014,0,0,0,0,0,0,0
10491,RM-1124,4/17/2014,0,0,0,0,0,0,0
10492,RM-1124,4/18/2014,0,0,0,0,0,0,0
10493,RM-1124,4/19/2014,0,0,0,0,0,0,0
10494,RM-1124,4/20/2014,0,0,0,0,0,0,0
10495,RM-1124,4/21/2014,0,0,0,0,0,0,0
10496,RM-1124,4/22/2014,0,0,0,0,0,0,0
10497,RM-1124,4/23/2014,0,0,0,0,0,0,0
10498,RM-1124,4/24/2014,0,0,0,0,0,0,0
10499,RM-1124,4/25/2014,0,0,0,0,0,0,0
10500,RM-1124,4/26/2014,0,0,0,0,0,0,0
10501,RM-1124,4/27/2014,0,0,0,0,0,0,0
10502,RM-1124,4/28/2014,0,0,0,0,0,0,0
10503,RM-1124,4/29/2014,0,0,0,0,0,0,0
10504,RM-1124,4/30/2014,0,0,0,0,0,0,0
10505,RM-1124,5/1/2014,0,0,0,0,0,0,0
10506,RM-1124,5/2/2014,0,0,0,0,0,0,0
10507,RM-1124,5/3/2014,0,0,0,0,0,0,0
10508,RM-1124,5/4/2014,0,0,0,0,0,0,0
10509,RM-1124,5/5/2014,0,0,0,0,0,0,0
10510,RM-1124,5/6/2014,0,0,0,0,0,0,0
10511,RM-1124,5/7/2014,0,0,0,0,0,0,0
10512,RM-1124,5/8/2014,0,0,0,0,0,0,0
10513,RM-1124,5/9/2014,0,0,0,0,0,0,0
10514,RM-1124,5/10/2014,0,0,0,0,0,0,0
10515,RM-1124,5/11/2014,0,0,0,0,0,0,0
10516,RM-1124,5/12/2014,0,0,0,0,0,0,0
10517,RM-1124,5/13/2014,0,0,0,0,0,0,0
10518,RM-1124,5/14/2014,0,0,0,0,0,0,0
10519,RM-1124,5/15/2014,0,0,0,0,0,0,0
10520,RM-1124,5/16/2014,0,0,0,0,0,0,0
10521,RM-1124,5/17/2014,0,0,0,0,0,0,0
10522,RM-1124,5/18/2014,0,0,0,0,0,0,0
10523,RM-1124,5/19/2014,0,0,0,0,0,0,0
10524,RM-1124,5/20/2014,0,0,0,0,0,0,0
10525,RM-1124,5/21/2014,0,0,0,0,0,0,0
10526,RM-1124,5/22/2014,0,0,0,0,0,0,0
10527,RM-1124,5/23/2014,0,0,0,0,0,0,0
10528,RM-1124,5/24/2014,0,0,0,0,0,0,0
10529,RM-1124,5/25/2014,0,0,0,0,0,0,0
10530,RM-1124,5/26/2014,0,0,0,0,0,0,0
10531,RM-1124,5/27/2014,0,0,0,0,0,0,0
10532,RM-1124,5/28/2014,0,0,0,0,0,0,0
10533,RM-1124,5/29/2014,0,0,0,0,0,0,0
10534,RM-1124,5/30/2014,0,0,0,0,0,0,0
10535,RM-1124,5/31/2014,0,0,0,0,0,0,0
10536,RM-1124,6/1/2014,0,0,0,0,0,0,0
10537,RM-1124,6/2/2014,0,0,0,0,0,0,0
10538,RM-1124,6/3/2014,0,0,0,0,0,0,0
10539,RM-1124,6/4/2014,0,0,0,0,0,0,0
10540,RM-1124,6/5/2014,0,0,0,0,0,0,0
10541,RM-1124,6/6/2014,0,0,0,0,0,0,0
10542,RM-1124,6/7/2014,0,0,0,0,0,0,0
10543,RM-1124,6/8/2014,0,0,0,0,0,0,0
10544,RM-1124,6/9/2014,0,0,0,0,0,0,0
10545,RM-1124,6/10/2014,0,0,0,0,0,0,0
10546,RM-1124,6/11/2014,0,0,0,0,0,0,0
10547,RM-1124,6/12/2014,0,0,0,0,0,0,0
10548,RM-1124,6/13/2014,0,0,0,0,0,0,0
10549,RM-1124,6/14/2014,0,0,0,0,0,0,0
10550,RM-1124,6/15/2014,0,0,0,0,0,0,0
10551,RM-1124,6/16/2014,0,0,0,0,0,0,0
10552,RM-1124,6/17/2014,0,0,0,0,0,0,0
10553,RM-1124,6/18/2014,0,0,0,0,0,0,0
10554,RM-1124,6/19/2014,0,0,0,0,0,0,0
10555,RM-1124,6/20/2014,0,0,0,0,0,0,0
10556,RM-1124,6/21/2014,0,0,0,0,0,0,0
10557,RM-1124,6/22/2014,0,0,0,0,0,0,0
10558,RM-1124,6/23/2014,0,0,0,0,0,0,0
10559,RM-1124,6/24/2014,0,0,0,0,0,0,0
10560,RM-1124,6/25/2014,0,0,0,0,0,0,0
10561,RM-1124,6/26/2014,0,0,0,0,0,0,0
10562,RM-1124,6/27/2014,0,0,0,0,0,0,0
10563,RM-1124,6/28/2014,0,0,0,0,0,0,0
10564,RM-1124,6/29/2014,0,0,0,0,0,0,0
10565,RM-1124,6/30/2014,0,0,0,0,0,0,0
10566,RM-1124,7/1/2014,0,0,0,0,0,0,0
10567,RM-1124,7/2/2014,0,0,0,0,0,0,0
10568,RM-1124,7/3/2014,0,0,0,0,0,0,0
10569,RM-1124,7/4/2014,0,0,0,0,0,0,0
10570,RM-1124,7/5/2014,0,0,0,0,0,0,0
10571,RM-1124,7/6/2014,0,0,0,0,0,0,0
10572,RM-1124,7/7/2014,0,0,0,0,0,0,0
10573,RM-1124,7/8/2014,0,0,0,0,0,0,0
10574,RM-1124,7/9/2014,0,0,0,0,0,0,0
10575,RM-1124,7/10/2014,0,0,0,0,0,0,0
10576,RM-1124,7/11/2014,0,0,0,0,0,0,0
10577,RM-1124,7/12/2014,0,0,0,0,0,0,0
10578,RM-1124,7/13/2014,0,0,0,0,0,0,0
10579,RM-1124,7/14/2014,0,0,0,0,0,0,0
10580,RM-1124,7/15/2014,0,0,0,0,0,0,0
10581,RM-1124,7/16/2014,0,0,0,0,0,0,0
10582,RM-1124,7/17/2014,0,0,0,0,0,0,0
10583,RM-1124,7/18/2014,0,0,0,0,0,0,0
10584,RM-1124,7/19/2014,0,0,0,0,0,0,0
10585,RM-1124,7/20/2014,0,0,0,0,0,0,0
10586,RM-1124,7/21/2014,0,0,0,0,0,0,0
10587,RM-1124,7/22/2014,0,0,0,0,0,0,0
10588,RM-1124,7/23/2014,0,0,0,0,0,0,0
10589,RM-1124,7/24/2014,0,0,0,0,0,0,0
10590,RM-1124,7/25/2014,0,0,0,0,0,0,0
10591,RM-1124,7/26/2014,0,0,0,0,0,0,0
10592,RM-1124,7/27/2014,0,0,0,0,0,0,0
10593,RM-1124,7/28/2014,0,0,0,0,0,0,0
10594,RM-1124,7/29/2014,0,0,0,0,0,0,0
10595,RM-1124,7/30/2014,0,0,0,0,0,0,0
10596,RM-1124,7/31/2014,0,0,0,0,0,0,0
10597,RM-1124,8/1/2014,0,0,0,0,0,0,0
10598,RM-1124,8/2/2014,0,0,0,0,0,0,0
10599,RM-1124,8/3/2014,0,0,0,0,0,0,0
10600,RM-1124,8/4/2014,0,0,0,0,0,0,0
10601,RM-1124,8/5/2014,0,0,0,0,0,0,0
10602,RM-1124,8/6/2014,0,0,0,0,0,0,0
10603,RM-1124,8/7/2014,0,0,0,0,0,0,0
10604,RM-1124,8/8/2014,0,0,0,0,0,0,0
10605,RM-1124,8/9/2014,0,0,0,0,0,0,0
10606,RM-1124,8/10/2014,0,0,0,0,0,0,0
10607,RM-1124,8/11/2014,0,0,0,0,0,0,0
10608,RM-1124,8/12/2014,0,0,0,0,0,0,0
10609,RM-1124,8/13/2014,0,0,0,0,0,0,0
10610,RM-1124,8/14/2014,0,0,0,0,0,0,0
10611,RM-1124,8/15/2014,0,0,0,0,0,0,0
10612,RM-1124,8/16/2014,0,0,0,0,0,0,0
10613,RM-1124,8/17/2014,0,0,0,0,0,0,0
10614,RM-1124,8/18/2014,0,0,0,0,0,0,0
10615,RM-1124,8/19/2014,0,0,0,0,0,0,0
10616,RM-1124,8/20/2014,0,0,0,0,0,0,0
10617,RM-1124,8/21/2014,0,0,0,0,0,0,0
10618,RM-1124,8/22/2014,0,0,0,0,0,0,0
10619,RM-1124,8/23/2014,0,0,0,0,0,0,0
10620,RM-1124,8/24/2014,0,0,0,0,0,0,0
10621,RM-1124,8/25/2014,0,0,0,0,0,0,0
10622,RM-1124,8/26/2014,0,0,0,0,0,0,0
10623,RM-1124,8/27/2014,0,0,0,0,0,0,0
10624,RM-1124,8/28/2014,0,0,0,0,0,0,0
10625,RM-1124,8/29/2014,0,0,0,0,0,0,0
10626,RM-1124,8/30/2014,0,0,0,0,0,0,0
10627,RM-1124,8/31/2014,0,0,0,0,0,0,0
10628,RM-1124,9/1/2014,0,0,0,0,0,0,0
10629,RM-1124,9/2/2014,0,0,0,0,0,0,0
10630,RM-1124,9/3/2014,0,0,0,0,0,0,0
10631,RM-1124,9/4/2014,0,0,0,0,0,0,0
10632,RM-1124,9/5/2014,0,0,0,0,0,0,0
10633,RM-1124,9/6/2014,0,0,0,0,0,0,0
10634,RM-1124,9/7/2014,0,0,0,0,0,0,0
10635,RM-1124,9/8/2014,0,0,0,0,0,0,0
10636,RM-1124,9/9/2014,0,0,0,0,0,0,0
10637,RM-1124,9/10/2014,0,0,0,0,0,0,0
10638,RM-1124,9/11/2014,0,0,0,0,0,0,0
10639,RM-1124,9/12/2014,0,0,0,0,0,0,0
10640,RM-1124,9/13/2014,0,0,0,0,0,0,0
10641,RM-1124,9/14/2014,0,0,0,0,0,0,0
10642,RM-1124,9/15/2014,0,0,0,0,0,0,0
10643,RM-1124,9/16/2014,0,0,0,0,0,0,0
10644,RM-1124,9/17/2014,0,0,0,0,0,0,0
10645,RM-1124,9/18/2014,0,0,0,0,0,0,0
10646,RM-1124,9/19/2014,0,0,0,0,0,0,0
10647,RM-1124,9/20/2014,0,0,0,0,0,0,0
10648,RM-1124,9/21/2014,0,0,0,0,0,0,0
10649,RM-1124,9/22/2014,0,0,0,0,0,0,0
10650,RM-1124,9/23/2014,0,0,0,0,0,0,0
10651,RM-1124,9/24/2014,0,0,0,0,0,0,0
10652,RM-1124,9/25/2014,0,0,0,0,0,0,0
10653,RM-1124,9/28/2014,0,0,0,0,0,0,0
10654,RM-1124,9/29/2014,0,0,0,0,0,0,0
10655,RM-1124,9/30/2014,0,0,0,0,0,0,0
10656,RM-1124,10/1/2014,0,0,0,0,0,0,0
10657,RM-1124,10/2/2014,0,0,0,0,0,0,0
10658,RM-1124,10/3/2014,0,0,0,0,0,0,0
10659,RM-1124,10/4/2014,0,0,0,0,0,0,0
10660,RM-1124,10/5/2014,0,0,0,0,0,0,0
10661,RM-1124,10/6/2014,0,0,0,0,0,0,0
10662,RM-1124,10/7/2014,0,0,0,0,0,0,0
10663,RM-1124,10/8/2014,0,0,0,0,0,0,0
10664,RM-1124,10/9/2014,0,0,0,0,0,0,0
10665,RM-1124,10/10/2014,0,0,0,0,0,0,0
10666,RM-1124,10/11/2014,0,0,0,0,0,0,0
10667,RM-1124,10/12/2014,0,0,0,0,0,0,0
10668,RM-1124,10/13/2014,0,0,0,0,0,0,0
10669,RM-1124,10/14/2014,0,0,0,0,0,0,0
10670,RM-1124,10/15/2014,0,0,0,0,0,0,0
10671,RM-1124,10/16/2014,0,0,0,0,0,0,0
10672,RM-1124,10/17/2014,0,0,0,0,0,0,0
10673,RM-1124,10/18/2014,0,0,0,0,0,0,0
10674,RM-1124,10/19/2014,0,0,0,0,0,0,0
10675,RM-1124,10/20/2014,0,0,0,0,0,0,0
10676,RM-1124,10/21/2014,0,0,0,0,0,0,0
10677,RM-1124,10/22/2014,0,0,0,0,0,0,0
10678,RM-1124,10/23/2014,0,0,0,0,0,0,0
10679,RM-1124,10/24/2014,0,0,0,0,0,0,0
10680,RM-1124,10/25/2014,0,0,0,0,0,0,0
10681,RM-1124,10/26/2014,0,0,0,0,0,0,0
10682,RM-1124,10/27/2014,0,0,0,0,0,0,0
10683,RM-1124,10/28/2014,0,0,0,0,0,0,0
10684,RM-1124,10/29/2014,0,0,0,0,0,0,0
10685,RM-1124,10/30/2014,0,0,0,0,0,0,0
10686,RM-1124,10/31/2014,0,0,0,0,0,0,0
10687,RM-1124,11/1/2014,0,0,0,0,0,0,0
10688,RM-1124,11/2/2014,0,0,0,0,0,0,0
10689,RM-1124,11/3/2014,0,0,0,0,0,0,0
10690,RM-1124,11/4/2014,0,0,0,0,0,0,0
10691,RM-1124,11/5/2014,0,0,0,0,0,0,0
10692,RM-1124,11/6/2014,0,0,0,0,0,0,0
10693,RM-1124,11/7/2014,0,0,0,0,0,0,0
10694,RM-1124,11/8/2014,0,0,0,0,0,0,0
10695,RM-1124,11/9/2014,0,0,0,0,0,0,0
10696,RM-1124,11/10/2014,0,0,0,0,0,0,0
10697,RM-1124,11/11/2014,0,0,0,0,0,0,0
10698,RM-1124,11/12/2014,0,0,0,0,0,0,0
10699,RM-1124,11/13/2014,0,0,0,0,0,0,0
10700,RM-1124,11/14/2014,0,0,0,0,0,0,0
10701,RM-1124,11/15/2014,0,0,0,0,0,0,0
10702,RM-1124,11/16/2014,0,0,0,0,0,0,0
10703,RM-1124,11/17/2014,0,0,0,0,0,0,0
10704,RM-1124,11/18/2014,0,0,0,0,0,0,0
10705,RM-1124,11/19/2014,0,0,0,0,0,0,0
10706,RM-1124,11/20/2014,0,0,0,0,0,0,0
10707,RM-1124,11/21/2014,0,0,0,0,0,0,0
10708,RM-1124,11/22/2014,0,0,0,0,0,0,0
10709,RM-1124,11/23/2014,0,0,0,0,0,0,0
10710,RM-1124,11/24/2014,0,0,0,0,0,0,0
10711,RM-1124,11/25/2014,0,0,0,0,0,0,0
10712,RM-1124,11/26/2014,0,0,0,0,0,0,0
10713,RM-1124,11/27/2014,0,0,0,0,0,0,0
10714,RM-1124,11/28/2014,0,0,0,0,0,0,0
10715,RM-1124,11/29/2014,0,0,0,0,0,0,0
10716,RM-1124,11/30/2014,0,0,0,0,0,0,0
10717,RM-1124,12/1/2014,0,0,0,0,0,0,0
10718,RM-1124,12/2/2014,0,0,0,0,0,0,0
10719,RM-1124,12/3/2014,0,0,0,0,0,0,0
10720,RM-1124,12/4/2014,0,0,0,0,0,0,0
10721,RM-1124,12/5/2014,0,0,0,0,0,0,0
10722,RM-1124,12/6/2014,0,0,0,0,0,0,0
10723,RM-1124,12/7/2014,0,0,0,0,0,0,0
10724,RM-1124,12/8/2014,0,0,0,0,0,0,0
10725,RM-1124,12/9/2014,0,0,0,0,0,0,0
10726,RM-1124,12/10/2014,0,0,0,0,0,0,0
10727,RM-1124,12/11/2014,0,0,0,0,0,0,0
10728,RM-1124,12/12/2014,0,0,0,0,0,0,0
10729,RM-1124,12/13/2014,0,0,0,0,0,0,0
10730,RM-1124,12/14/2014,0,0,0,0,0,0,0
10731,RM-1124,12/15/2014,0,0,0,0,0,0,0
10732,RM-1124,12/16/2014,0,0,0,0,0,0,0
10733,RM-1124,12/17/2014,0,0,0,0,0,0,0
10734,RM-1124,12/18/2014,0,0,0,0,0,0,0
10735,RM-1124,12/19/2014,0,0,0,0,0,0,0
10736,RM-1124,12/20/2014,0,0,0,0,0,0,0
10737,RM-1124,12/21/2014,0,0,0,0,0,0,0
10738,RM-1124,12/22/2014,0,0,0,0,0,0,0
10739,RM-1124,12/23/2014,0,0,0,0,0,0,0
10740,RM-1124,12/24/2014,0,0,0,0,0,0,0
10741,RM-1124,12/25/2014,0,0,0,0,0,0,0
10742,RM-1124,12/26/2014,0,0,0,0,0,0,0
10743,RM-1124,12/27/2014,0,0,0,0,0,0,0
10744,RM-1124,12/28/2014,0,0,0,0,0,0,0
10745,RM-1124,12/29/2014,0,0,0,0,0,0,0
10746,RM-1124,12/30/2014,0,0,0,0,0,0,0
10747,RM-1124,12/31/2014,0,0,0,0,0,0,0
10748,RM-1124,1/1/2015,0,0,0,0,0,0,0
10749,RM-1124,1/2/2015,0,0,0,0,0,0,0
10750,RM-1124,1/3/2015,0,0,0,0,0,0,0
10751,RM-1124,1/4/2015,0,0,0,0,0,0,0
10752,RM-1124,1/5/2015,0,0,0,0,0,0,0
10753,RM-1124,1/6/2015,0,0,0,0,0,0,0
10754,RM-1124,1/7/2015,0,0,0,0,0,0,0
10755,RM-1124,1/8/2015,0,0,0,0,0,0,0
10756,RM-1124,1/9/2015,0,0,0,0,0,0,0
10757,RM-1124,1/10/2015,0,0,0,0,0,0,0
10758,RM-1124,1/11/2015,0,0,0,0,0,0,0
10759,RM-1124,1/12/2015,0,0,0,0,0,0,0
10760,RM-1124,1/13/2015,0,0,0,0,0,0,0
10761,RM-1124,1/14/2015,0,0,0,0,0,0,0
10762,RM-1124,1/15/2015,0,0,0,0,0,0,0
10763,RM-1124,1/16/2015,0,0,0,0,0,0,0
10764,RM-1124,1/17/2015,0,0,0,0,0,0,0
10765,RM-1124,1/18/2015,0,0,0,0,0,0,0
10766,RM-1124,1/19/2015,0,0,0,0,0,0,0
10767,RM-1124,1/20/2015,0,0,0,0,0,0,0
10768,RM-1124,1/21/2015,0,0,0,0,0,0,0
10769,RM-1124,1/22/2015,0,0,0,0,0,0,0
10770,RM-1124,1/23/2015,0,0,0,0,0,0,0
10771,RM-1124,1/24/2015,0,0,0,0,0,0,0
10772,RM-1124,1/25/2015,0,0,0,0,0,0,0
10773,RM-1124,1/26/2015,0,0,0,0,0,0,0
10774,RM-1124,1/27/2015,0,0,0,0,0,0,0
10775,RM-1124,1/28/2015,0,0,0,0,0,0,0
10776,RM-1124,1/29/2015,0,0,0,0,0,0,0
10777,RM-1124,1/30/2015,0,0,0,0,0,0,0
10778,RM-1124,1/31/2015,0,0,0,0,0,0,0
10779,RM-1124,2/1/2015,0,0,0,0,0,0,0
10780,RM-1124,2/2/2015,0,0,0,0,0,0,0
10781,RM-1124,2/3/2015,0,0,0,0,0,0,0
10782,RM-1124,2/4/2015,0,0,0,0,0,0,0
10783,RM-1124,2/5/2015,0,0,0,0,0,0,0
10784,RM-1124,2/6/2015,0,0,0,0,0,0,0
10785,RM-1124,2/7/2015,0,0,0,0,0,0,0
10786,RM-1124,2/8/2015,0,0,0,0,0,0,0
10787,RM-1124,2/9/2015,0,0,0,0,0,0,0
10788,RM-1124,2/10/2015,0,0,0,0,0,0,0
10789,RM-1124,2/11/2015,0,0,0,0,0,0,0
10790,RM-1124,2/12/2015,0,0,0,0,0,0,0
10791,RM-1124,2/13/2015,0,0,0,0,0,0,0
10792,RM-1124,2/14/2015,0,0,0,0,0,0,0
10793,RM-1124,2/15/2015,0,0,0,0,0,0,0
10794,RM-1124,2/16/2015,0,0,0,0,0,0,0
10795,RM-1124,2/17/2015,0,0,0,0,0,0,0
10796,RM-1124,2/18/2015,0,0,0,0,0,0,0
10797,RM-1124,2/19/2015,0,0,0,0,0,0,0
10798,RM-1124,2/20/2015,0,0,0,0,0,0,0
10799,RM-1124,2/21/2015,0,0,0,0,0,0,0
10800,RM-1124,2/22/2015,0,0,0,0,0,0,0
10801,RM-1124,2/23/2015,0,0,0,0,0,0,0
10802,RM-1124,2/24/2015,0,0,0,0,0,0,0
10803,RM-1124,2/25/2015,0,0,0,0,0,0,0
10804,RM-1124,2/26/2015,0,0,0,0,0,0,0
10805,RM-1124,2/27/2015,0,0,0,0,0,0,0
10806,RM-1124,2/28/2015,0,0,0,0,0,0,0
10807,RM-1124,3/1/2015,0,0,0,0,0,0,0
10808,RM-1124,3/2/2015,0,0,0,0,0,0,0
10809,RM-1124,3/3/2015,0,0,0,0,0,0,0
10810,RM-1124,3/4/2015,0,0,0,0,0,0,0
10811,RM-1124,3/5/2015,0,0,0,0,0,0,0
10812,RM-1124,3/6/2015,0,0,0,0,0,0,0
10813,RM-1124,3/7/2015,0,0,0,0,0,0,0
10814,RM-1124,3/8/2015,0,0,0,0,0,0,0
10815,RM-1124,3/9/2015,0,0,0,0,0,0,0
10816,RM-1124,3/10/2015,0,0,0,0,0,0,0
10817,RM-1124,3/11/2015,0,0,0,0,0,0,0
10818,RM-1124,3/12/2015,0,0,0,0,0,0,0
10819,RM-1124,3/13/2015,0,0,0,0,0,0,0
10820,RM-1124,3/14/2015,0,0,0,0,0,0,0
10821,RM-1124,3/15/2015,0,0,0,0,0,0,0
10822,RM-1124,3/16/2015,0,0,0,0,0,0,0
10823,RM-1124,3/17/2015,0,0,0,0,0,0,0
10824,RM-1124,3/18/2015,0,0,0,0,0,0,0
10825,RM-1124,3/19/2015,0,0,0,0,0,0,0
10826,RM-1124,3/20/2015,0,0,0,0,0,0,0
10827,RM-1124,3/21/2015,0,0,0,0,0,0,0
10828,RM-1124,3/22/2015,0,0,0,0,0,0,0
10829,RM-1124,3/23/2015,0,0,0,0,0,0,0
10830,RM-1124,3/24/2015,0,0,0,0,0,0,0
10831,RM-1124,3/25/2015,0,0,0,0,0,0,0
10832,RM-1124,3/26/2015,0,0,0,0,0,0,0
10833,RM-1124,3/27/2015,0,0,0,0,0,0,0
10834,RM-1124,3/28/2015,0,0,0,0,0,0,0
10835,RM-1124,3/29/2015,0,0,0,0,0,0,0
10836,RM-1124,3/30/2015,0,0,0,0,0,0,0
10837,RM-1124,3/31/2015,0,0,0,0,0,0,0
10838,RM-1124,4/1/2015,0,0,0,0,0,0,0
10839,RM-1124,4/2/2015,0,0,0,0,0,0,0
10840,RM-1124,4/3/2015,0,0,0,0,0,0,0
10841,RM-1124,4/4/2015,0,0,0,0,0,0,0
10842,RM-1124,4/5/2015,0,0,0,0,0,0,0
10843,RM-1124,4/6/2015,0,0,0,0,0,0,0
10844,RM-1124,4/7/2015,0,0,0,0,0,0,0
10845,RM-1124,4/8/2015,0,0,0,0,0,0,0
10846,RM-1124,4/9/2015,0,0,0,0,0,0,0
10847,RM-1124,4/10/2015,0,0,0,0,0,0,0
10848,RM-1124,4/11/2015,0,0,0,0,0,0,0
10849,RM-1124,4/12/2015,0,0,0,0,0,0,0
10850,RM-1124,4/13/2015,0,0,0,0,0,0,0
10851,RM-1124,4/14/2015,0,0,0,0,0,0,0
10852,RM-1124,4/15/2015,0,0,0,0,0,0,0
10853,RM-1124,4/16/2015,0,0,0,0,0,0,0
10854,RM-1124,4/17/2015,0,0,0,0,0,0,0
10855,RM-1124,4/18/2015,0,0,0,0,0,0,0
10856,RM-1124,4/19/2015,0,0,0,0,0,0,0
10857,RM-1124,4/20/2015,0,0,0,0,0,0,0
10858,RM-1124,4/21/2015,0,0,0,0,0,0,0
10859,RM-1124,4/22/2015,0,0,0,0,0,0,0
10860,RM-1124,4/23/2015,0,0,0,0,0,0,0
10861,RM-1124,4/24/2015,0,0,0,0,0,0,0
10862,RM-1124,4/25/2015,0,0,0,0,0,0,0
10863,RM-1124,4/26/2015,0,0,0,0,0,0,0
10864,RM-1124,4/27/2015,0,0,0,0,0,0,0
10865,RM-1124,4/28/2015,0,0,0,0,0,0,0
10866,RM-1124,4/29/2015,0,0,0,0,0,0,0
10867,RM-1124,4/30/2015,0,0,0,0,0,0,0
10868,RM-1124,5/1/2015,0,0,0,0,0,0,0
10869,RM-1124,5/2/2015,0,0,0,0,0,0,0
10870,RM-1124,5/3/2015,0,0,0,0,0,0,0
10871,RM-1124,5/4/2015,0,0,0,0,0,0,0
10872,RM-1124,5/5/2015,0,0,0,0,0,0,0
10873,RM-1124,5/6/2015,0,0,0,0,0,0,0
10874,RM-1124,5/7/2015,0,0,0,0,0,0,0
10875,RM-1124,5/8/2015,0,0,0,0,0,0,0
10876,RM-1124,5/9/2015,0,0,0,0,0,0,0
10877,RM-1124,5/10/2015,0,0,0,0,0,0,0
10878,RM-1124,5/11/2015,0,0,0,0,0,0,0
10879,RM-1124,5/12/2015,0,0,0,0,0,0,0
10880,RM-1124,5/13/2015,0,0,0,0,0,0,0
10881,RM-1124,5/14/2015,0,0,0,0,0,0,0
10882,RM-1124,5/15/2015,0,0,0,0,0,0,0
10883,RM-1124,5/16/2015,0,0,0,0,0,0,0
10884,RM-1124,5/17/2015,0,0,0,0,0,0,0
10885,RM-1124,5/18/2015,0,0,0,0,0,0,0
10886,RM-1124,5/19/2015,0,0,0,0,0,0,0
10887,RM-1124,5/20/2015,0,0,0,0,0,0,0
10888,RM-1124,5/21/2015,0,0,0,0,0,0,0
10889,RM-1124,5/22/2015,0,0,0,0,0,0,0
10890,RM-1124,5/23/2015,0,0,0,0,0,0,0
10891,RM-1124,5/24/2015,0,0,0,0,0,0,0
10892,RM-1124,5/25/2015,0,0,0,0,0,0,0
10893,RM-1124,5/26/2015,0,0,0,0,0,0,0
10894,RM-1124,5/27/2015,0,0,0,0,0,0,0
10895,RM-1124,5/28/2015,0,0,0,0,0,0,0
10896,RM-1124,5/29/2015,0,0,0,0,0,0,0
10897,RM-1124,5/30/2015,0,0,0,0,0,0,0
10898,RM-1124,5/31/2015,0,0,0,0,0,0,0
10899,RM-1125,7/1/2013,0,0,0,0,0,0,0
10900,RM-1125,7/2/2013,0,0,0,0,0,0,0
10901,RM-1125,7/3/2013,0,0,0,0,0,0,0
10902,RM-1125,7/4/2013,0,0,0,0,0,0,0
10903,RM-1125,7/5/2013,0,0,0,0,0,0,0
10904,RM-1125,7/6/2013,0,0,0,0,0,0,0
10905,RM-1125,7/7/2013,0,0,0,0,0,0,0
10906,RM-1125,7/8/2013,0,0,0,0,0,0,0
10907,RM-1125,7/9/2013,0,0,0,0,0,0,0
10908,RM-1125,7/10/2013,0,0,0,0,0,0,0
10909,RM-1125,7/11/2013,0,0,0,0,0,0,0
10910,RM-1125,7/12/2013,0,0,0,0,0,0,0
10911,RM-1125,7/13/2013,0,0,0,0,0,0,0
10912,RM-1125,7/14/2013,0,0,0,0,0,0,0
10913,RM-1125,7/15/2013,0,0,0,0,0,0,0
10914,RM-1125,7/17/2013,0,0,0,0,0,0,0
10915,RM-1125,7/18/2013,0,0,0,0,0,0,0
10916,RM-1125,7/19/2013,0,0,0,0,0,0,0
10917,RM-1125,7/20/2013,0,0,0,0,0,0,0
10918,RM-1125,7/21/2013,0,0,0,0,0,0,0
10919,RM-1125,7/22/2013,0,0,0,0,0,0,0
10920,RM-1125,7/23/2013,0,0,0,0,0,0,0
10921,RM-1125,7/24/2013,0,0,0,0,0,0,0
10922,RM-1125,7/25/2013,0,0,0,0,0,0,0
10923,RM-1125,7/26/2013,0,0,0,0,0,0,0
10924,RM-1125,7/27/2013,0,0,0,0,0,0,0
10925,RM-1125,7/28/2013,0,0,0,0,0,0,0
10926,RM-1125,7/29/2013,0,0,0,0,0,0,0
10927,RM-1125,7/30/2013,0,0,0,0,0,0,0
10928,RM-1125,7/31/2013,0,0,0,0,0,0,0
10929,RM-1125,8/1/2013,0,0,0,0,0,0,0
10930,RM-1125,8/2/2013,0,0,0,0,0,0,0
10931,RM-1125,8/3/2013,0,0,0,0,0,0,0
10932,RM-1125,8/4/2013,0,0,0,0,0,0,0
10933,RM-1125,8/5/2013,0,0,0,0,0,0,0
10934,RM-1125,8/6/2013,0,0,0,0,0,0,0
10935,RM-1125,8/7/2013,0,0,0,0,0,0,0
10936,RM-1125,8/8/2013,0,0,0,0,0,0,0
10937,RM-1125,8/9/2013,0,0,0,0,0,0,0
10938,RM-1125,8/10/2013,0,0,0,0,0,0,0
10939,RM-1125,8/11/2013,0,0,0,0,0,0,0
10940,RM-1125,8/12/2013,0,0,0,0,0,0,0
10941,RM-1125,8/13/2013,0,0,0,0,0,0,0
10942,RM-1125,8/14/2013,0,0,0,0,0,0,0
10943,RM-1125,8/15/2013,0,0,0,0,0,0,0
10944,RM-1125,8/16/2013,0,0,0,0,0,0,0
10945,RM-1125,8/17/2013,0,0,0,0,0,0,0
10946,RM-1125,8/18/2013,0,0,0,0,0,0,0
10947,RM-1125,8/19/2013,0,0,0,0,0,0,0
10948,RM-1125,8/20/2013,0,0,0,0,0,0,0
10949,RM-1125,8/21/2013,0,0,0,0,0,0,0
10950,RM-1125,8/22/2013,0,0,0,0,0,0,0
10951,RM-1125,8/27/2013,0,0,0,0,0,0,0
10952,RM-1125,8/28/2013,0,0,0,0,0,0,0
10953,RM-1125,8/29/2013,0,0,0,0,0,0,0
10954,RM-1125,8/30/2013,0,0,0,0,0,0,0
10955,RM-1125,9/4/2013,0,0,0,0,0,0,0
10956,RM-1125,9/5/2013,0,0,0,0,0,0,0
10957,RM-1125,9/6/2013,0,0,0,0,0,0,0
10958,RM-1125,9/7/2013,0,0,0,0,0,0,0
10959,RM-1125,9/9/2013,0,0,0,0,0,0,0
10960,RM-1125,9/10/2013,0,0,0,0,0,0,0
10961,RM-1125,9/11/2013,0,0,0,0,0,0,0
10962,RM-1125,9/12/2013,0,0,0,0,0,0,0
10963,RM-1125,9/13/2013,0,0,0,0,0,0,0
10964,RM-1125,9/14/2013,0,0,0,0,0,0,0
10965,RM-1125,9/15/2013,0,0,0,0,0,0,0
10966,RM-1125,9/16/2013,0,0,0,0,0,0,0
10967,RM-1125,9/17/2013,0,0,0,0,0,0,0
10968,RM-1125,9/18/2013,0,0,0,0,0,0,0
10969,RM-1125,9/19/2013,0,0,0,0,0,0,0
10970,RM-1125,9/20/2013,0,0,0,0,0,0,0
10971,RM-1125,9/21/2013,0,0,0,0,0,0,0
10972,RM-1125,9/22/2013,0,0,0,0,0,0,0
10973,RM-1125,9/23/2013,0,0,0,0,0,0,0
10974,RM-1125,9/24/2013,0,0,0,0,0,0,0
10975,RM-1125,9/25/2013,0,0,0,0,0,0,0
10976,RM-1125,9/26/2013,0,0,0,0,0,0,0
10977,RM-1125,9/27/2013,0,0,0,0,0,0,0
10978,RM-1125,9/28/2013,0,0,0,0,0,0,0
10979,RM-1125,9/29/2013,0,0,0,0,0,0,0
10980,RM-1125,9/30/2013,0,0,0,0,0,0,0
10981,RM-1125,10/1/2013,0,0,0,0,0,0,0
10982,RM-1125,10/2/2013,0,0,0,0,0,0,0
10983,RM-1125,10/3/2013,0,0,0,0,0,0,0
10984,RM-1125,10/4/2013,0,0,0,0,0,0,0
10985,RM-1125,10/5/2013,0,0,0,0,0,0,0
10986,RM-1125,10/6/2013,0,0,0,0,0,0,0
10987,RM-1125,10/7/2013,0,0,0,0,0,0,0
10988,RM-1125,10/8/2013,0,0,0,0,0,0,0
10989,RM-1125,10/9/2013,0,0,0,0,0,0,0
10990,RM-1125,10/10/2013,0,0,0,0,0,0,0
10991,RM-1125,10/11/2013,0,0,0,0,0,0,0
10992,RM-1125,10/12/2013,0,0,0,0,0,0,0
10993,RM-1125,10/13/2013,0,0,0,0,0,0,0
10994,RM-1125,10/14/2013,0,0,0,0,0,0,0
10995,RM-1125,10/15/2013,0,0,0,0,0,0,0
10996,RM-1125,10/16/2013,0,0,0,0,0,0,0
10997,RM-1125,10/17/2013,0,0,0,0,0,0,0
10998,RM-1125,10/18/2013,0,0,0,0,0,0,0
10999,RM-1125,10/19/2013,0,0,0,0,0,0,0
11000,RM-1125,10/20/2013,0,0,0,0,0,0,0
11001,RM-1125,10/21/2013,0,0,0,0,0,0,0
11002,RM-1125,10/22/2013,0,0,0,0,0,0,0
11003,RM-1125,10/23/2013,0,0,0,0,0,0,0
11004,RM-1125,10/24/2013,0,0,0,0,0,0,0
11005,RM-1125,10/25/2013,0,0,0,0,0,0,0
11006,RM-1125,10/26/2013,0,0,0,0,0,0,0
11007,RM-1125,10/27/2013,0,0,0,0,0,0,0
11008,RM-1125,10/28/2013,0,0,0,0,0,0,0
11009,RM-1125,10/29/2013,0,0,0,0,0,0,0
11010,RM-1125,10/30/2013,0,0,0,0,0,0,0
11011,RM-1125,10/31/2013,0,0,0,0,0,0,0
11012,RM-1125,11/1/2013,0,0,0,0,0,0,0
11013,RM-1125,11/2/2013,0,0,0,0,0,0,0
11014,RM-1125,11/3/2013,0,0,0,0,0,0,0
11015,RM-1125,11/4/2013,0,0,0,0,0,0,0
11016,RM-1125,11/5/2013,0,0,0,0,0,0,0
11017,RM-1125,11/6/2013,0,0,0,0,0,0,0
11018,RM-1125,11/7/2013,0,0,0,0,0,0,0
11019,RM-1125,11/8/2013,0,0,0,0,0,0,0
11020,RM-1125,11/9/2013,0,0,0,0,0,0,0
11021,RM-1125,11/10/2013,0,0,0,0,0,0,0
11022,RM-1125,11/11/2013,0,0,0,0,0,0,0
11023,RM-1125,11/12/2013,0,0,0,0,0,0,0
11024,RM-1125,11/13/2013,0,0,0,0,0,0,0
11025,RM-1125,11/14/2013,0,0,0,0,0,0,0
11026,RM-1125,11/15/2013,0,0,0,0,0,0,0
11027,RM-1125,11/19/2013,0,0,0,0,0,0,0
11028,RM-1125,11/20/2013,0,0,0,0,0,0,0
11029,RM-1125,11/21/2013,0,0,0,0,0,0,0
11030,RM-1125,11/22/2013,0,0,0,0,0,0,0
11031,RM-1125,11/23/2013,0,0,0,0,0,0,0
11032,RM-1125,11/24/2013,0,0,0,0,0,0,0
11033,RM-1125,11/25/2013,0,0,0,0,0,0,0
11034,RM-1125,11/26/2013,0,0,0,0,0,0,0
11035,RM-1125,11/27/2013,0,0,0,0,0,0,0
11036,RM-1125,11/28/2013,0,0,0,0,0,0,0
11037,RM-1125,11/29/2013,0,0,0,0,0,0,0
11038,RM-1125,11/30/2013,0,0,0,0,0,0,0
11039,RM-1125,12/1/2013,0,0,0,0,0,0,0
11040,RM-1125,12/2/2013,0,0,0,0,0,0,0
11041,RM-1125,12/3/2013,0,0,0,0,0,0,0
11042,RM-1125,12/4/2013,0,0,0,0,0,0,0
11043,RM-1125,12/5/2013,0,0,0,0,0,0,0
11044,RM-1125,12/6/2013,0,0,0,0,0,0,0
11045,RM-1125,12/7/2013,0,0,0,0,0,0,0
11046,RM-1125,12/8/2013,0,0,0,0,0,0,0
11047,RM-1125,12/9/2013,0,0,0,0,0,0,0
11048,RM-1125,12/10/2013,0,0,0,0,0,0,0
11049,RM-1125,12/11/2013,0,0,0,0,0,0,0
11050,RM-1125,12/12/2013,0,0,0,0,0,0,0
11051,RM-1125,12/13/2013,0,0,0,0,0,0,0
11052,RM-1125,12/14/2013,0,0,0,0,0,0,0
11053,RM-1125,12/15/2013,0,0,0,0,0,0,0
11054,RM-1125,12/16/2013,0,0,0,0,0,0,0
11055,RM-1125,12/17/2013,0,0,0,0,0,0,0
11056,RM-1125,12/18/2013,0,0,0,0,0,0,0
11057,RM-1125,12/19/2013,0,0,0,0,0,0,0
11058,RM-1125,12/20/2013,0,0,0,0,0,0,0
11059,RM-1125,12/21/2013,0,0,0,0,0,0,0
11060,RM-1125,12/22/2013,0,0,0,0,0,0,0
11061,RM-1125,12/23/2013,0,0,0,0,0,0,0
11062,RM-1125,12/24/2013,0,0,0,0,0,0,0
11063,RM-1125,12/25/2013,0,0,0,0,0,0,0
11064,RM-1125,12/26/2013,0,0,0,0,0,0,0
11065,RM-1125,12/27/2013,0,0,0,0,0,0,0
11066,RM-1125,12/28/2013,0,0,0,0,0,0,0
11067,RM-1125,12/29/2013,0,0,0,0,0,0,0
11068,RM-1125,12/30/2013,0,0,0,0,0,0,0
11069,RM-1125,12/31/2013,0,0,0,0,0,0,0
11070,RM-1125,1/1/2014,0,0,0,0,0,0,0
11071,RM-1125,1/2/2014,0,0,0,0,0,0,0
11072,RM-1125,1/3/2014,0,0,0,0,0,0,0
11073,RM-1125,1/4/2014,0,0,0,0,0,0,0
11074,RM-1125,1/5/2014,0,0,0,0,0,0,0
11075,RM-1125,1/6/2014,0,0,0,0,0,0,0
11076,RM-1125,1/7/2014,0,0,0,0,0,0,0
11077,RM-1125,1/8/2014,0,0,0,0,0,0,0
11078,RM-1125,1/9/2014,0,0,0,0,0,0,0
11079,RM-1125,1/10/2014,0,0,0,0,0,0,0
11080,RM-1125,1/11/2014,0,0,0,0,0,0,0
11081,RM-1125,1/12/2014,0,0,0,0,0,0,0
11082,RM-1125,1/13/2014,0,0,0,0,0,0,0
11083,RM-1125,1/14/2014,0,0,0,0,0,0,0
11084,RM-1125,1/15/2014,0,0,0,0,0,0,0
11085,RM-1125,1/16/2014,0,0,0,0,0,0,0
11086,RM-1125,1/17/2014,0,0,0,0,0,0,0
11087,RM-1125,1/18/2014,0,0,0,0,0,0,0
11088,RM-1125,1/19/2014,0,0,0,0,0,0,0
11089,RM-1125,1/20/2014,0,0,0,0,0,0,0
11090,RM-1125,1/21/2014,0,0,0,0,0,0,0
11091,RM-1125,1/22/2014,0,0,0,0,0,0,0
11092,RM-1125,1/23/2014,0,0,0,0,0,0,0
11093,RM-1125,1/24/2014,0,0,0,0,0,0,0
11094,RM-1125,1/25/2014,0,0,0,0,0,0,0
11095,RM-1125,1/26/2014,0,0,0,0,0,0,0
11096,RM-1125,1/27/2014,0,0,0,0,0,0,0
11097,RM-1125,1/28/2014,0,0,0,0,0,0,0
11098,RM-1125,1/29/2014,0,0,0,0,0,0,0
11099,RM-1125,1/30/2014,0,0,0,0,0,0,0
11100,RM-1125,1/31/2014,0,0,0,0,0,0,0
11101,RM-1125,2/1/2014,0,0,0,0,0,0,0
11102,RM-1125,2/2/2014,0,0,0,0,0,0,0
11103,RM-1125,2/3/2014,0,0,0,0,0,0,0
11104,RM-1125,2/4/2014,0,0,0,0,0,0,0
11105,RM-1125,2/5/2014,0,0,0,0,0,0,0
11106,RM-1125,2/6/2014,0,0,0,0,0,0,0
11107,RM-1125,2/7/2014,0,0,0,0,0,0,0
11108,RM-1125,2/8/2014,0,0,0,0,0,0,0
11109,RM-1125,2/9/2014,0,0,0,0,0,0,0
11110,RM-1125,2/10/2014,0,0,0,0,0,0,0
11111,RM-1125,2/11/2014,0,0,0,0,0,0,0
11112,RM-1125,2/12/2014,0,0,0,0,0,0,0
11113,RM-1125,2/13/2014,0,0,0,0,0,0,0
11114,RM-1125,2/14/2014,0,0,0,0,0,0,0
11115,RM-1125,2/15/2014,0,0,0,0,0,0,0
11116,RM-1125,2/16/2014,0,0,0,0,0,0,0
11117,RM-1125,2/17/2014,0,0,0,0,0,0,0
11118,RM-1125,2/18/2014,0,0,0,0,0,0,0
11119,RM-1125,2/19/2014,0,0,0,0,0,0,0
11120,RM-1125,2/20/2014,0,0,0,0,0,0,0
11121,RM-1125,2/21/2014,0,0,0,0,0,0,0
11122,RM-1125,2/22/2014,0,0,0,0,0,0,0
11123,RM-1125,2/23/2014,0,0,0,0,0,0,0
11124,RM-1125,2/24/2014,0,0,0,0,0,0,0
11125,RM-1125,2/25/2014,0,0,0,0,0,0,0
11126,RM-1125,2/26/2014,0,0,0,0,0,0,0
11127,RM-1125,2/27/2014,0,0,0,0,0,0,0
11128,RM-1125,2/28/2014,0,0,0,0,0,0,0
11129,RM-1125,3/1/2014,0,0,0,0,0,0,0
11130,RM-1125,3/2/2014,0,0,0,0,0,0,0
11131,RM-1125,3/3/2014,0,0,0,0,0,0,0
11132,RM-1125,3/4/2014,0,0,0,0,0,0,0
11133,RM-1125,3/5/2014,0,0,0,0,0,0,0
11134,RM-1125,3/6/2014,0,0,0,0,0,0,0
11135,RM-1125,3/7/2014,0,0,0,0,0,0,0
11136,RM-1125,3/8/2014,0,0,0,0,0,0,0
11137,RM-1125,3/9/2014,0,0,0,0,0,0,0
11138,RM-1125,3/10/2014,0,0,0,0,0,0,0
11139,RM-1125,3/11/2014,0,0,0,0,0,0,0
11140,RM-1125,3/12/2014,0,0,0,0,0,0,0
11141,RM-1125,3/13/2014,0,0,0,0,0,0,0
11142,RM-1125,3/14/2014,0,0,0,0,0,0,0
11143,RM-1125,3/15/2014,0,0,0,0,0,0,0
11144,RM-1125,3/16/2014,0,0,0,0,0,0,0
11145,RM-1125,3/17/2014,0,0,0,0,0,0,0
11146,RM-1125,3/18/2014,0,0,0,0,0,0,0
11147,RM-1125,3/19/2014,0,0,0,0,0,0,0
11148,RM-1125,3/20/2014,0,0,0,0,0,0,0
11149,RM-1125,3/21/2014,0,0,0,0,0,0,0
11150,RM-1125,3/22/2014,0,0,0,0,0,0,0
11151,RM-1125,3/23/2014,0,0,0,0,0,0,0
11152,RM-1125,3/24/2014,0,0,0,0,0,0,0
11153,RM-1125,3/25/2014,0,0,0,0,0,0,0
11154,RM-1125,3/26/2014,0,0,0,0,0,0,0
11155,RM-1125,3/27/2014,0,0,0,0,0,0,0
11156,RM-1125,3/28/2014,0,0,0,0,0,0,0
11157,RM-1125,3/29/2014,0,0,0,0,0,0,0
11158,RM-1125,3/30/2014,0,0,0,0,0,0,0
11159,RM-1125,3/31/2014,0,0,0,0,0,0,0
11160,RM-1125,4/1/2014,0,0,0,0,0,0,0
11161,RM-1125,4/2/2014,0,0,0,0,0,0,0
11162,RM-1125,4/3/2014,0,0,0,0,0,0,0
11163,RM-1125,4/4/2014,0,0,0,0,0,0,0
11164,RM-1125,4/5/2014,0,0,0,0,0,0,0
11165,RM-1125,4/6/2014,0,0,0,0,0,0,0
11166,RM-1125,4/7/2014,0,0,0,0,0,0,0
11167,RM-1125,4/8/2014,0,0,0,0,0,0,0
11168,RM-1125,4/9/2014,0,0,0,0,0,0,0
11169,RM-1125,4/10/2014,0,0,0,0,0,0,0
11170,RM-1125,4/11/2014,0,0,0,0,0,0,0
11171,RM-1125,4/12/2014,0,0,0,0,0,0,0
11172,RM-1125,4/13/2014,0,0,0,0,0,0,0
11173,RM-1125,4/14/2014,0,0,0,0,0,0,0
11174,RM-1125,4/15/2014,0,0,0,0,0,0,0
11175,RM-1125,4/16/2014,0,0,0,0,0,0,0
11176,RM-1125,4/17/2014,0,0,0,0,0,0,0
11177,RM-1125,4/18/2014,0,0,0,0,0,0,0
11178,RM-1125,4/19/2014,0,0,0,0,0,0,0
11179,RM-1125,4/20/2014,0,0,0,0,0,0,0
11180,RM-1125,4/21/2014,0,0,0,0,0,0,0
11181,RM-1125,4/22/2014,0,0,0,0,0,0,0
11182,RM-1125,4/23/2014,0,0,0,0,0,0,0
11183,RM-1125,4/24/2014,0,0,0,0,0,0,0
11184,RM-1125,4/25/2014,0,0,0,0,0,0,0
11185,RM-1125,4/26/2014,0,0,0,0,0,0,0
11186,RM-1125,4/27/2014,0,0,0,0,0,0,0
11187,RM-1125,4/28/2014,0,0,0,0,0,0,0
11188,RM-1125,4/29/2014,0,0,0,0,0,0,0
11189,RM-1125,4/30/2014,0,0,0,0,0,0,0
11190,RM-1125,5/1/2014,0,0,0,0,0,0,0
11191,RM-1125,5/2/2014,0,0,0,0,0,0,0
11192,RM-1125,5/3/2014,0,0,0,0,0,0,0
11193,RM-1125,5/4/2014,0,0,0,0,0,0,0
11194,RM-1125,5/5/2014,0,0,0,0,0,0,0
11195,RM-1125,5/6/2014,0,0,0,0,0,0,0
11196,RM-1125,5/7/2014,0,0,0,0,0,0,0
11197,RM-1125,5/8/2014,0,0,0,0,0,0,0
11198,RM-1125,5/9/2014,0,0,0,0,0,0,0
11199,RM-1125,5/10/2014,0,0,0,0,0,0,0
11200,RM-1125,5/11/2014,0,0,0,0,0,0,0
11201,RM-1125,5/12/2014,0,0,0,0,0,0,0
11202,RM-1125,5/13/2014,0,0,0,0,0,0,0
11203,RM-1125,5/14/2014,0,0,0,0,0,0,0
11204,RM-1125,5/15/2014,0,0,0,0,0,0,0
11205,RM-1125,5/16/2014,0,0,0,0,0,0,0
11206,RM-1125,5/17/2014,0,0,0,0,0,0,0
11207,RM-1125,5/18/2014,0,0,0,0,0,0,0
11208,RM-1125,5/19/2014,0,0,0,0,0,0,0
11209,RM-1125,5/20/2014,0,0,0,0,0,0,0
11210,RM-1125,5/21/2014,0,0,0,0,0,0,0
11211,RM-1125,5/22/2014,0,0,0,0,0,0,0
11212,RM-1125,5/23/2014,0,0,0,0,0,0,0
11213,RM-1125,5/24/2014,0,0,0,0,0,0,0
11214,RM-1125,5/25/2014,0,0,0,0,0,0,0
11215,RM-1125,5/26/2014,0,0,0,0,0,0,0
11216,RM-1125,5/27/2014,0,0,0,0,0,0,0
11217,RM-1125,5/28/2014,0,0,0,0,0,0,0
11218,RM-1125,5/29/2014,0,0,0,0,0,0,0
11219,RM-1125,5/30/2014,0,0,0,0,0,0,0
11220,RM-1125,5/31/2014,0,0,0,0,0,0,0
11221,RM-1125,6/1/2014,0,0,0,0,0,0,0
11222,RM-1125,6/2/2014,0,0,0,0,0,0,0
11223,RM-1125,6/3/2014,0,0,0,0,0,0,0
11224,RM-1125,6/4/2014,0,0,0,0,0,0,0
11225,RM-1125,6/5/2014,0,0,0,0,0,0,0
11226,RM-1125,6/6/2014,0,0,0,0,0,0,0
11227,RM-1125,6/7/2014,0,0,0,0,0,0,0
11228,RM-1125,6/8/2014,0,0,0,0,0,0,0
11229,RM-1125,6/9/2014,0,0,0,0,0,0,0
11230,RM-1125,6/10/2014,0,0,0,0,0,0,0
11231,RM-1125,6/11/2014,0,0,0,0,0,0,0
11232,RM-1125,6/12/2014,0,0,0,0,0,0,0
11233,RM-1125,6/13/2014,0,0,0,0,0,0,0
11234,RM-1125,6/14/2014,0,0,0,0,0,0,0
11235,RM-1125,6/15/2014,0,0,0,0,0,0,0
11236,RM-1125,6/16/2014,0,0,0,0,0,0,0
11237,RM-1125,6/17/2014,0,0,0,0,0,0,0
11238,RM-1125,6/18/2014,0,0,0,0,0,0,0
11239,RM-1125,6/19/2014,0,0,0,0,0,0,0
11240,RM-1125,6/20/2014,0,0,0,0,0,0,0
11241,RM-1125,6/21/2014,0,0,0,0,0,0,0
11242,RM-1125,6/22/2014,0,0,0,0,0,0,0
11243,RM-1125,6/23/2014,0,0,0,0,0,0,0
11244,RM-1125,6/24/2014,0,0,0,0,0,0,0
11245,RM-1125,6/25/2014,0,0,0,0,0,0,0
11246,RM-1125,6/26/2014,0,0,0,0,0,0,0
11247,RM-1125,6/27/2014,0,0,0,0,0,0,0
11248,RM-1125,6/28/2014,0,0,0,0,0,0,0
11249,RM-1125,6/29/2014,0,0,0,0,0,0,0
11250,RM-1125,6/30/2014,0,0,0,0,0,0,0
11251,RM-1125,7/1/2014,0,0,0,0,0,0,0
11252,RM-1125,7/2/2014,0,0,0,0,0,0,0
11253,RM-1125,7/3/2014,0,0,0,0,0,0,0
11254,RM-1125,7/4/2014,0,0,0,0,0,0,0
11255,RM-1125,7/5/2014,0,0,0,0,0,0,0
11256,RM-1125,7/6/2014,0,0,0,0,0,0,0
11257,RM-1125,7/7/2014,0,0,0,0,0,0,0
11258,RM-1125,7/8/2014,0,0,0,0,0,0,0
11259,RM-1125,7/9/2014,0,0,0,0,0,0,0
11260,RM-1125,7/10/2014,0,0,0,0,0,0,0
11261,RM-1125,7/11/2014,0,0,0,0,0,0,0
11262,RM-1125,7/12/2014,0,0,0,0,0,0,0
11263,RM-1125,7/13/2014,0,0,0,0,0,0,0
11264,RM-1125,7/14/2014,0,0,0,0,0,0,0
11265,RM-1125,7/15/2014,0,0,0,0,0,0,0
11266,RM-1125,7/16/2014,0,0,0,0,0,0,0
11267,RM-1125,7/17/2014,0,0,0,0,0,0,0
11268,RM-1125,7/18/2014,0,0,0,0,0,0,0
11269,RM-1125,7/19/2014,0,0,0,0,0,0,0
11270,RM-1125,7/20/2014,0,0,0,0,0,0,0
11271,RM-1125,7/21/2014,0,0,0,0,0,0,0
11272,RM-1125,7/22/2014,0,0,0,0,0,0,0
11273,RM-1125,7/23/2014,0,0,0,0,0,0,0
11274,RM-1125,7/24/2014,0,0,0,0,0,0,0
11275,RM-1125,7/25/2014,0,0,0,0,0,0,0
11276,RM-1125,7/26/2014,0,0,0,0,0,0,0
11277,RM-1125,7/27/2014,0,0,0,0,0,0,0
11278,RM-1125,7/28/2014,0,0,0,0,0,0,0
11279,RM-1125,7/29/2014,0,0,0,0,0,0,0
11280,RM-1125,7/30/2014,0,0,0,0,0,0,0
11281,RM-1125,7/31/2014,0,0,0,0,0,0,0
11282,RM-1125,8/1/2014,0,0,0,0,0,0,0
11283,RM-1125,8/2/2014,0,0,0,0,0,0,0
11284,RM-1125,8/3/2014,0,0,0,0,0,0,0
11285,RM-1125,8/4/2014,0,0,0,0,0,0,0
11286,RM-1125,8/5/2014,0,0,0,0,0,0,0
11287,RM-1125,8/6/2014,0,0,0,0,0,0,0
11288,RM-1125,8/7/2014,0,0,0,0,0,0,0
11289,RM-1125,8/8/2014,0,0,0,0,0,0,0
11290,RM-1125,8/9/2014,0,0,0,0,0,0,0
11291,RM-1125,8/10/2014,0,0,0,0,0,0,0
11292,RM-1125,8/11/2014,0,0,0,0,0,0,0
11293,RM-1125,8/12/2014,0,0,0,0,0,0,0
11294,RM-1125,8/13/2014,0,0,0,0,0,0,0
11295,RM-1125,8/14/2014,0,0,0,0,0,0,0
11296,RM-1125,8/15/2014,0,0,0,0,0,0,0
11297,RM-1125,8/16/2014,0,0,0,0,0,0,0
11298,RM-1125,8/17/2014,0,0,0,0,0,0,0
11299,RM-1125,8/18/2014,0,0,0,0,0,0,0
11300,RM-1125,8/19/2014,0,0,0,0,0,0,0
11301,RM-1125,8/20/2014,0,0,0,0,0,0,0
11302,RM-1125,8/21/2014,0,0,0,0,0,0,0
11303,RM-1125,8/22/2014,0,0,0,0,0,0,0
11304,RM-1125,8/23/2014,0,0,0,0,0,0,0
11305,RM-1125,8/24/2014,0,0,0,0,0,0,0
11306,RM-1125,8/25/2014,0,0,0,0,0,0,0
11307,RM-1125,8/26/2014,0,0,0,0,0,0,0
11308,RM-1125,8/27/2014,0,0,0,0,0,0,0
11309,RM-1125,8/28/2014,0,0,0,0,0,0,0
11310,RM-1125,8/29/2014,0,0,0,0,0,0,0
11311,RM-1125,8/30/2014,0,0,0,0,0,0,0
11312,RM-1125,8/31/2014,0,0,0,0,0,0,0
11313,RM-1125,9/1/2014,0,0,0,0,0,0,0
11314,RM-1125,9/2/2014,0,0,0,0,0,0,0
11315,RM-1125,9/3/2014,0,0,0,0,0,0,0
11316,RM-1125,9/4/2014,0,0,0,0,0,0,0
11317,RM-1125,9/5/2014,0,0,0,0,0,0,0
11318,RM-1125,9/6/2014,0,0,0,0,0,0,0
11319,RM-1125,9/7/2014,0,0,0,0,0,0,0
11320,RM-1125,9/8/2014,0,0,0,0,0,0,0
11321,RM-1125,9/9/2014,0,0,0,0,0,0,0
11322,RM-1125,9/10/2014,0,0,0,0,0,0,0
11323,RM-1125,9/11/2014,0,0,0,0,0,0,0
11324,RM-1125,9/12/2014,0,0,0,0,0,0,0
11325,RM-1125,9/13/2014,0,0,0,0,0,0,0
11326,RM-1125,9/14/2014,0,0,0,0,0,0,0
11327,RM-1125,9/15/2014,0,0,0,0,0,0,0
11328,RM-1125,9/16/2014,0,0,0,0,0,0,0
11329,RM-1125,9/17/2014,0,0,0,0,0,0,0
11330,RM-1125,9/18/2014,0,0,0,0,0,0,0
11331,RM-1125,9/19/2014,0,0,0,0,0,0,0
11332,RM-1125,9/20/2014,0,0,0,0,0,0,0
11333,RM-1125,9/21/2014,0,0,0,0,0,0,0
11334,RM-1125,9/22/2014,0,0,0,0,0,0,0
11335,RM-1125,9/23/2014,0,0,0,0,0,0,0
11336,RM-1125,9/24/2014,0,0,0,0,0,0,0
11337,RM-1125,9/25/2014,0,0,0,0,0,0,0
11338,RM-1125,9/28/2014,0,0,0,0,0,0,0
11339,RM-1125,9/29/2014,0,0,0,0,0,0,0
11340,RM-1125,9/30/2014,0,0,0,0,0,0,0
11341,RM-1125,10/1/2014,0,0,0,0,0,0,0
11342,RM-1125,10/2/2014,0,0,0,0,0,0,0
11343,RM-1125,10/3/2014,0,0,0,0,0,0,0
11344,RM-1125,10/4/2014,0,0,0,0,0,0,0
11345,RM-1125,10/5/2014,0,0,0,0,0,0,0
11346,RM-1125,10/6/2014,0,0,0,0,0,0,0
11347,RM-1125,10/7/2014,0,0,0,0,0,0,0
11348,RM-1125,10/8/2014,0,0,0,0,0,0,0
11349,RM-1125,10/9/2014,0,0,0,0,0,0,0
11350,RM-1125,10/10/2014,0,0,0,0,0,0,0
11351,RM-1125,10/11/2014,0,0,0,0,0,0,0
11352,RM-1125,10/12/2014,0,0,0,0,0,0,0
11353,RM-1125,10/13/2014,0,0,0,0,0,0,0
11354,RM-1125,10/14/2014,0,0,0,0,0,0,0
11355,RM-1125,10/15/2014,0,0,0,0,0,0,0
11356,RM-1125,10/16/2014,0,0,0,0,0,0,0
11357,RM-1125,10/17/2014,0,0,0,0,0,0,0
11358,RM-1125,10/18/2014,0,0,0,0,0,0,0
11359,RM-1125,10/19/2014,0,0,0,0,0,0,0
11360,RM-1125,10/20/2014,0,0,0,0,0,0,0
11361,RM-1125,10/21/2014,0,0,0,0,0,0,0
11362,RM-1125,10/22/2014,0,0,0,0,0,0,0
11363,RM-1125,10/23/2014,0,0,0,0,0,0,0
11364,RM-1125,10/24/2014,0,0,0,0,0,0,0
11365,RM-1125,10/25/2014,0,0,0,0,0,0,0
11366,RM-1125,10/26/2014,0,0,0,0,0,0,0
11367,RM-1125,10/27/2014,0,0,0,0,0,0,0
11368,RM-1125,10/28/2014,0,0,0,0,0,0,0
11369,RM-1125,10/29/2014,0,0,0,0,0,0,0
11370,RM-1125,10/30/2014,0,0,0,0,0,0,0
11371,RM-1125,10/31/2014,0,0,0,0,0,0,0
11372,RM-1125,11/1/2014,0,0,0,0,0,0,0
11373,RM-1125,11/2/2014,0,0,0,0,0,0,0
11374,RM-1125,11/3/2014,0,0,0,0,0,0,0
11375,RM-1125,11/4/2014,0,0,0,0,0,0,0
11376,RM-1125,11/5/2014,0,0,0,0,0,0,0
11377,RM-1125,11/6/2014,0,0,0,0,0,0,0
11378,RM-1125,11/7/2014,0,0,0,0,0,0,0
11379,RM-1125,11/8/2014,0,0,0,0,0,0,0
11380,RM-1125,11/9/2014,0,0,0,0,0,0,0
11381,RM-1125,11/10/2014,0,0,0,0,0,0,0
11382,RM-1125,11/11/2014,0,0,0,0,0,0,0
11383,RM-1125,11/12/2014,0,0,0,0,0,0,0
11384,RM-1125,11/13/2014,0,0,0,0,0,0,0
11385,RM-1125,11/14/2014,0,0,0,0,0,0,0
11386,RM-1125,11/15/2014,0,0,0,0,0,0,0
11387,RM-1125,11/16/2014,0,0,0,0,0,0,0
11388,RM-1125,11/17/2014,0,0,0,0,0,0,0
11389,RM-1125,11/18/2014,0,0,0,0,0,0,0
11390,RM-1125,11/19/2014,0,0,0,0,0,0,0
11391,RM-1125,11/20/2014,0,0,0,0,0,0,0
11392,RM-1125,11/21/2014,0,0,0,0,0,0,0
11393,RM-1125,11/22/2014,0,0,0,0,0,0,0
11394,RM-1125,11/23/2014,0,0,0,0,0,0,0
11395,RM-1125,11/24/2014,0,0,0,0,0,0,0
11396,RM-1125,11/25/2014,0,0,0,0,0,0,0
11397,RM-1125,11/26/2014,0,0,0,0,0,0,0
11398,RM-1125,11/27/2014,0,0,0,0,0,0,0
11399,RM-1125,11/28/2014,0,0,0,0,0,0,0
11400,RM-1125,11/29/2014,0,0,0,0,0,0,0
11401,RM-1125,11/30/2014,0,0,0,0,0,0,0
11402,RM-1125,12/1/2014,0,0,0,0,0,0,0
11403,RM-1125,12/2/2014,0,0,0,0,0,0,0
11404,RM-1125,12/3/2014,0,0,0,0,0,0,0
11405,RM-1125,12/4/2014,0,0,0,0,0,0,0
11406,RM-1125,12/5/2014,0,0,0,0,0,0,0
11407,RM-1125,12/6/2014,0,0,0,0,0,0,0
11408,RM-1125,12/7/2014,0,0,0,0,0,0,0
11409,RM-1125,12/8/2014,0,0,0,0,0,0,0
11410,RM-1125,12/9/2014,0,0,0,0,0,0,0
11411,RM-1125,12/10/2014,0,0,0,0,0,0,0
11412,RM-1125,12/11/2014,0,0,0,0,0,0,0
11413,RM-1125,12/12/2014,0,0,0,0,0,0,0
11414,RM-1125,12/13/2014,0,0,0,0,0,0,0
11415,RM-1125,12/14/2014,0,0,0,0,0,0,0
11416,RM-1125,12/15/2014,0,0,0,0,0,0,0
11417,RM-1125,12/16/2014,0,0,0,0,0,0,0
11418,RM-1125,12/17/2014,0,0,0,0,0,0,0
11419,RM-1125,12/18/2014,0,0,0,0,0,0,0
11420,RM-1125,12/19/2014,0,0,0,0,0,0,0
11421,RM-1125,12/20/2014,0,0,0,0,0,0,0
11422,RM-1125,12/21/2014,0,0,0,0,0,0,0
11423,RM-1125,12/22/2014,0,0,0,0,0,0,0
11424,RM-1125,12/23/2014,0,0,0,0,0,0,0
11425,RM-1125,12/24/2014,0,0,0,0,0,0,0
11426,RM-1125,12/25/2014,0,0,0,0,0,0,0
11427,RM-1125,12/26/2014,0,0,0,0,0,0,0
11428,RM-1125,12/27/2014,0,0,0,0,0,0,0
11429,RM-1125,12/28/2014,0,0,0,0,0,0,0
11430,RM-1125,12/29/2014,0,0,0,0,0,0,0
11431,RM-1125,12/30/2014,0,0,0,0,0,0,0
11432,RM-1125,12/31/2014,0,0,0,0,0,0,0
11433,RM-1125,1/1/2015,0,0,0,0,0,0,0
11434,RM-1125,1/2/2015,0,0,0,0,0,0,0
11435,RM-1125,1/3/2015,0,0,0,0,0,0,0
11436,RM-1125,1/4/2015,0,0,0,0,0,0,0
11437,RM-1125,1/5/2015,0,0,0,0,0,0,0
11438,RM-1125,1/6/2015,0,0,0,0,0,0,0
11439,RM-1125,1/7/2015,0,0,0,0,0,0,0
11440,RM-1125,1/8/2015,0,0,0,0,0,0,0
11441,RM-1125,1/9/2015,0,0,0,0,0,0,0
11442,RM-1125,1/10/2015,0,0,0,0,0,0,0
11443,RM-1125,1/11/2015,0,0,0,0,0,0,0
11444,RM-1125,1/12/2015,0,0,0,0,0,0,0
11445,RM-1125,1/13/2015,0,0,0,0,0,0,0
11446,RM-1125,1/14/2015,0,0,0,0,0,0,0
11447,RM-1125,1/15/2015,0,0,0,0,0,0,0
11448,RM-1125,1/16/2015,0,0,0,0,0,0,0
11449,RM-1125,1/17/2015,0,0,0,0,0,0,0
11450,RM-1125,1/18/2015,0,0,0,0,0,0,0
11451,RM-1125,1/19/2015,0,0,0,0,0,0,0
11452,RM-1125,1/20/2015,0,0,0,0,0,0,0
11453,RM-1125,1/21/2015,0,0,0,0,0,0,0
11454,RM-1125,1/22/2015,0,0,0,0,0,0,0
11455,RM-1125,1/23/2015,0,0,0,0,0,0,0
11456,RM-1125,1/24/2015,0,0,0,0,0,0,0
11457,RM-1125,1/25/2015,0,0,0,0,0,0,0
11458,RM-1125,1/26/2015,0,0,0,0,0,0,0
11459,RM-1125,1/27/2015,0,0,0,0,0,0,0
11460,RM-1125,1/28/2015,0,0,0,0,0,0,0
11461,RM-1125,1/29/2015,0,0,0,0,0,0,0
11462,RM-1125,1/30/2015,0,0,0,0,0,0,0
11463,RM-1125,1/31/2015,0,0,0,0,0,0,0
11464,RM-1125,2/1/2015,0,0,0,0,0,0,0
11465,RM-1125,2/2/2015,0,0,0,0,0,0,0
11466,RM-1125,2/3/2015,0,0,0,0,0,0,0
11467,RM-1125,2/4/2015,0,0,0,0,0,0,0
11468,RM-1125,2/5/2015,0,0,0,0,0,0,0
11469,RM-1125,2/6/2015,0,0,0,0,0,0,0
11470,RM-1125,2/7/2015,0,0,0,0,0,0,0
11471,RM-1125,2/8/2015,0,0,0,0,0,0,0
11472,RM-1125,2/9/2015,0,0,0,0,0,0,0
11473,RM-1125,2/10/2015,0,0,0,0,0,0,0
11474,RM-1125,2/11/2015,0,0,0,0,0,0,0
11475,RM-1125,2/12/2015,0,0,0,0,0,0,0
11476,RM-1125,2/13/2015,0,0,0,0,0,0,0
11477,RM-1125,2/14/2015,0,0,0,0,0,0,0
11478,RM-1125,2/15/2015,0,0,0,0,0,0,0
11479,RM-1125,2/16/2015,0,0,0,0,0,0,0
11480,RM-1125,2/17/2015,0,0,0,0,0,0,0
11481,RM-1125,2/18/2015,0,0,0,0,0,0,0
11482,RM-1125,2/19/2015,0,0,0,0,0,0,0
11483,RM-1125,2/20/2015,0,0,0,0,0,0,0
11484,RM-1125,2/21/2015,0,0,0,0,0,0,0
11485,RM-1125,2/22/2015,0,0,0,0,0,0,0
11486,RM-1125,2/23/2015,0,0,0,0,0,0,0
11487,RM-1125,2/24/2015,0,0,0,0,0,0,0
11488,RM-1125,2/25/2015,0,0,0,0,0,0,0
11489,RM-1125,2/26/2015,0,0,0,0,0,0,0
11490,RM-1125,2/27/2015,0,0,0,0,0,0,0
11491,RM-1125,2/28/2015,0,0,0,0,0,0,0
11492,RM-1125,3/1/2015,0,0,0,0,0,0,0
11493,RM-1125,3/2/2015,0,0,0,0,0,0,0
11494,RM-1125,3/3/2015,0,0,0,0,0,0,0
11495,RM-1125,3/4/2015,0,0,0,0,0,0,0
11496,RM-1125,3/5/2015,0,0,0,0,0,0,0
11497,RM-1125,3/6/2015,0,0,0,0,0,0,0
11498,RM-1125,3/7/2015,0,0,0,0,0,0,0
11499,RM-1125,3/8/2015,0,0,0,0,0,0,0
11500,RM-1125,3/9/2015,0,0,0,0,0,0,0
11501,RM-1125,3/10/2015,0,0,0,0,0,0,0
11502,RM-1125,3/11/2015,0,0,0,0,0,0,0
11503,RM-1125,3/12/2015,0,0,0,0,0,0,0
11504,RM-1125,3/13/2015,0,0,0,0,0,0,0
11505,RM-1125,3/14/2015,0,0,0,0,0,0,0
11506,RM-1125,3/15/2015,0,0,0,0,0,0,0
11507,RM-1125,3/16/2015,0,0,0,0,0,0,0
11508,RM-1125,3/17/2015,0,0,0,0,0,0,0
11509,RM-1125,3/18/2015,0,0,0,0,0,0,0
11510,RM-1125,3/19/2015,0,0,0,0,0,0,0
11511,RM-1125,3/20/2015,0,0,0,0,0,0,0
11512,RM-1125,3/21/2015,0,0,0,0,0,0,0
11513,RM-1125,3/22/2015,0,0,0,0,0,0,0
11514,RM-1125,3/23/2015,0,0,0,0,0,0,0
11515,RM-1125,3/24/2015,0,0,0,0,0,0,0
11516,RM-1125,3/25/2015,0,0,0,0,0,0,0
11517,RM-1125,3/26/2015,0,0,0,0,0,0,0
11518,RM-1125,3/27/2015,0,0,0,0,0,0,0
11519,RM-1125,3/28/2015,0,0,0,0,0,0,0
11520,RM-1125,3/29/2015,0,0,0,0,0,0,0
11521,RM-1125,3/30/2015,0,0,0,0,0,0,0
11522,RM-1125,3/31/2015,0,0,0,0,0,0,0
11523,RM-1125,4/1/2015,0,0,0,0,0,0,0
11524,RM-1125,4/2/2015,0,0,0,0,0,0,0
11525,RM-1125,4/3/2015,0,0,0,0,0,0,0
11526,RM-1125,4/4/2015,0,0,0,0,0,0,0
11527,RM-1125,4/5/2015,0,0,0,0,0,0,0
11528,RM-1125,4/6/2015,0,0,0,0,0,0,0
11529,RM-1125,4/7/2015,0,0,0,0,0,0,0
11530,RM-1125,4/8/2015,0,0,0,0,0,0,0
11531,RM-1125,4/9/2015,0,0,0,0,0,0,0
11532,RM-1125,4/10/2015,0,0,0,0,0,0,0
11533,RM-1125,4/11/2015,0,0,0,0,0,0,0
11534,RM-1125,4/12/2015,0,0,0,0,0,0,0
11535,RM-1125,4/13/2015,0,0,0,0,0,0,0
11536,RM-1125,4/14/2015,0,0,0,0,0,0,0
11537,RM-1125,4/15/2015,0,0,0,0,0,0,0
11538,RM-1125,4/16/2015,0,0,0,0,0,0,0
11539,RM-1125,4/17/2015,0,0,0,0,0,0,0
11540,RM-1125,4/18/2015,0,0,0,0,0,0,0
11541,RM-1125,4/19/2015,0,0,0,0,0,0,0
11542,RM-1125,4/20/2015,0,0,0,0,0,0,0
11543,RM-1125,4/21/2015,0,0,0,0,0,0,0
11544,RM-1125,4/22/2015,0,0,0,0,0,0,0
11545,RM-1125,4/23/2015,0,0,0,0,0,0,0
11546,RM-1125,4/24/2015,0,0,0,0,0,0,0
11547,RM-1125,4/25/2015,0,0,0,0,0,0,0
11548,RM-1125,4/26/2015,0,0,0,0,0,0,0
11549,RM-1125,4/27/2015,0,0,0,0,0,0,0
11550,RM-1125,4/28/2015,0,0,0,0,0,0,0
11551,RM-1125,4/29/2015,0,0,0,0,0,0,0
11552,RM-1125,4/30/2015,0,0,0,0,0,0,0
11553,RM-1125,5/1/2015,0,0,0,0,0,0,0
11554,RM-1125,5/2/2015,0,0,0,0,0,0,0
11555,RM-1125,5/3/2015,0,0,0,0,0,0,0
11556,RM-1125,5/4/2015,0,0,0,0,0,0,0
11557,RM-1125,5/5/2015,0,0,0,0,0,0,0
11558,RM-1125,5/6/2015,0,0,0,0,0,0,0
11559,RM-1125,5/7/2015,0,0,0,0,0,0,0
11560,RM-1125,5/8/2015,0,0,0,0,0,0,0
11561,RM-1125,5/9/2015,0,0,0,0,0,0,0
11562,RM-1125,5/10/2015,0,0,0,0,0,0,0
11563,RM-1125,5/11/2015,0,0,0,0,0,0,0
11564,RM-1125,5/12/2015,0,0,0,0,0,0,0
11565,RM-1125,5/13/2015,0,0,0,0,0,0,0
11566,RM-1125,5/14/2015,0,0,0,0,0,0,0
11567,RM-1125,5/15/2015,0,0,0,0,0,0,0
11568,RM-1125,5/16/2015,0,0,0,0,0,0,0
11569,RM-1125,5/17/2015,0,0,0,0,0,0,0
11570,RM-1125,5/18/2015,0,0,0,0,0,0,0
11571,RM-1125,5/19/2015,0,0,0,0,0,0,0
11572,RM-1125,5/20/2015,0,0,0,0,0,0,0
11573,RM-1125,5/21/2015,0,0,0,0,0,0,0
11574,RM-1125,5/22/2015,0,0,0,0,0,0,0
11575,RM-1125,5/23/2015,0,0,0,0,0,0,0
11576,RM-1125,5/24/2015,0,0,0,0,0,0,0
11577,RM-1125,5/25/2015,0,0,0,0,0,0,0
11578,RM-1125,5/26/2015,0,0,0,0,0,0,0
11579,RM-1125,5/27/2015,0,0,0,0,0,0,0
11580,RM-1125,5/28/2015,0,0,0,0,0,0,0
11581,RM-1125,5/29/2015,0,0,0,0,0,0,0
11582,RM-1125,5/30/2015,0,0,0,0,0,0,0
11583,RM-1125,5/31/2015,0,0,0,0,0,0,0
11597,RM-1126,7/14/2013,0,0,0,0,0,0,0
11598,RM-1126,7/15/2013,0,0,0,0,0,0,0
11599,RM-1126,7/17/2013,0,0,0,0,0,0,0
11600,RM-1126,7/18/2013,0,0,0,0,0,0,0
11601,RM-1126,7/19/2013,0,0,0,0,0,0,0
11602,RM-1126,7/20/2013,0,0,0,0,0,0,0
11603,RM-1126,7/21/2013,0,0,0,0,0,0,0
11604,RM-1126,7/22/2013,0,0,0,0,0,0,0
11605,RM-1126,7/23/2013,0,0,0,0,0,0,0
11606,RM-1126,7/24/2013,0,0,0,0,0,0,0
11607,RM-1126,7/25/2013,0,0,0,0,0,0,0
11608,RM-1126,7/26/2013,0,0,0,0,0,0,0
11609,RM-1126,7/27/2013,0,0,0,0,0,0,0
11610,RM-1126,7/28/2013,0,0,0,0,0,0,0
11611,RM-1126,7/29/2013,0,0,0,0,0,0,0
11612,RM-1126,7/30/2013,0,0,0,0,0,0,0
11613,RM-1126,7/31/2013,0,0,0,0,0,0,0
11614,RM-1126,8/1/2013,0,0,0,0,0,0,0
11615,RM-1126,8/2/2013,0,0,0,0,0,0,0
11616,RM-1126,8/3/2013,0,0,0,0,0,0,0
11617,RM-1126,8/4/2013,0,0,0,0,0,0,0
11618,RM-1126,8/5/2013,0,0,0,0,0,0,0
11619,RM-1126,8/6/2013,0,0,0,0,0,0,0
11620,RM-1126,8/7/2013,0,0,0,0,0,0,0
11621,RM-1126,8/8/2013,0,0,0,0,0,0,0
11622,RM-1126,8/9/2013,0,0,0,0,0,0,0
11623,RM-1126,8/10/2013,0,0,0,0,0,0,0
11624,RM-1126,8/11/2013,0,0,0,0,0,0,0
11625,RM-1126,1/8/2014,0,0,0,0,0,0,0
11626,RM-1126,1/9/2014,0,0,0,0,0,0,0
11627,RM-1126,1/10/2014,0,0,0,0,0,0,0
11628,RM-1126,1/11/2014,0,0,0,0,0,0,0
11629,RM-1126,1/12/2014,0,0,0,0,0,0,0
11630,RM-1126,1/13/2014,0,0,0,0,0,0,0
11631,RM-1126,1/14/2014,0,0,0,0,0,0,0
11632,RM-1126,1/15/2014,0,0,0,0,0,0,0
11633,RM-1126,1/16/2014,0,0,0,0,0,0,0
11634,RM-1126,1/17/2014,0,0,0,0,0,0,0
11635,RM-1126,1/18/2014,0,0,0,0,0,0,0
11636,RM-1126,1/19/2014,0,0,0,0,0,0,0
11637,RM-1126,1/20/2014,0,0,0,0,0,0,0
11638,RM-1126,1/21/2014,0,0,0,0,0,0,0
11639,RM-1126,1/22/2014,0,0,0,0,0,0,0
11640,RM-1126,1/23/2014,0,0,0,0,0,0,0
11641,RM-1126,1/24/2014,0,0,0,0,0,0,0
11642,RM-1126,1/25/2014,0,0,0,0,0,0,0
11643,RM-1126,1/26/2014,0,0,0,0,0,0,0
11644,RM-1126,1/27/2014,0,0,0,0,0,0,0
11645,RM-1126,1/28/2014,0,0,0,0,0,0,0
11646,RM-1126,1/29/2014,0,0,0,0,0,0,0
11647,RM-1126,1/30/2014,0,0,0,0,0,0,0
11648,RM-1126,1/31/2014,0,0,0,0,0,0,0
11649,RM-1126,2/1/2014,0,0,0,0,0,0,0
11650,RM-1126,2/2/2014,0,0,0,0,0,0,0
11651,RM-1126,2/3/2014,0,0,0,0,0,0,0
11652,RM-1126,2/4/2014,0,0,0,0,0,0,0
11653,RM-1126,2/5/2014,0,0,0,0,0,0,0
11654,RM-1126,2/6/2014,0,0,0,0,0,0,0
11655,RM-1126,2/7/2014,0,0,0,0,0,0,0
11656,RM-1126,2/8/2014,0,0,0,0,0,0,0
11657,RM-1126,2/9/2014,0,0,0,0,0,0,0
11658,RM-1126,2/10/2014,0,0,0,0,0,0,0
11659,RM-1126,2/11/2014,0,0,0,0,0,0,0
11660,RM-1126,2/12/2014,0,0,0,0,0,0,0
11661,RM-1126,2/13/2014,0,0,0,0,0,0,0
11662,RM-1126,2/14/2014,0,0,0,0,0,0,0
11663,RM-1126,2/15/2014,0,0,0,0,0,0,0
11664,RM-1126,2/16/2014,0,0,0,0,0,0,0
11665,RM-1126,2/17/2014,0,0,0,0,0,0,0
11666,RM-1126,2/18/2014,0,0,0,0,0,0,0
11667,RM-1126,2/19/2014,0,0,0,0,0,0,0
11668,RM-1126,2/20/2014,0,0,0,0,0,0,0
11669,RM-1126,2/21/2014,0,0,0,0,0,0,0
11670,RM-1126,2/22/2014,0,0,0,0,0,0,0
11671,RM-1126,2/23/2014,0,0,0,0,0,0,0
11672,RM-1126,2/24/2014,0,0,0,0,0,0,0
11673,RM-1126,2/25/2014,0,0,0,0,0,0,0
11674,RM-1126,2/26/2014,0,0,0,0,0,0,0
11675,RM-1126,2/27/2014,0,0,0,0,0,0,0
11676,RM-1126,2/28/2014,0,0,0,0,0,0,0
11677,RM-1126,3/1/2014,0,0,0,0,0,0,0
11678,RM-1126,3/2/2014,0,0,0,0,0,0,0
11679,RM-1126,3/3/2014,0,0,0,0,0,0,0
11680,RM-1126,3/4/2014,0,0,0,0,0,0,0
11681,RM-1126,3/5/2014,0,0,0,0,0,0,0
11682,RM-1126,3/6/2014,0,0,0,0,0,0,0
11683,RM-1126,3/7/2014,0,0,0,0,0,0,0
11684,RM-1126,3/8/2014,0,0,0,0,0,0,0
11685,RM-1126,3/9/2014,0,0,0,0,0,0,0
11686,RM-1126,3/10/2014,0,0,0,0,0,0,0
11687,RM-1126,3/11/2014,0,0,0,0,0,0,0
11688,RM-1126,3/12/2014,0,0,0,0,0,0,0
11689,RM-1126,3/13/2014,0,0,0,0,0,0,0
11690,RM-1126,3/14/2014,0,0,0,0,0,0,0
11691,RM-1126,3/15/2014,0,0,0,0,0,0,0
11692,RM-1126,3/16/2014,0,0,0,0,0,0,0
11693,RM-1126,3/17/2014,0,0,0,0,0,0,0
11694,RM-1126,3/18/2014,0,0,0,0,0,0,0
11695,RM-1126,3/19/2014,0,0,0,0,0,0,0
11696,RM-1126,3/20/2014,0,0,0,0,0,0,0
11697,RM-1126,3/21/2014,0,0,0,0,0,0,0
11698,RM-1126,3/22/2014,0,0,0,0,0,0,0
11699,RM-1126,3/23/2014,0,0,0,0,0,0,0
11700,RM-1126,3/24/2014,0,0,0,0,0,0,0
11701,RM-1126,3/25/2014,0,0,0,0,0,0,0
11702,RM-1126,3/26/2014,0,0,0,0,0,0,0
11703,RM-1126,3/27/2014,0,0,0,0,0,0,0
11704,RM-1126,3/28/2014,0,0,0,0,0,0,0
11705,RM-1126,3/29/2014,0,0,0,0,0,0,0
11706,RM-1126,3/30/2014,0,0,0,0,0,0,0
11707,RM-1126,3/31/2014,0,0,0,0,0,0,0
11708,RM-1126,4/1/2014,0,0,0,0,0,0,0
11709,RM-1126,4/2/2014,0,0,0,0,0,0,0
11710,RM-1126,4/3/2014,0,0,0,0,0,0,0
11711,RM-1126,4/4/2014,0,0,0,0,0,0,0
11712,RM-1126,4/5/2014,0,0,0,0,0,0,0
11713,RM-1126,4/6/2014,0,0,0,0,0,0,0
11714,RM-1126,4/7/2014,0,0,0,0,0,0,0
11715,RM-1126,4/8/2014,0,0,0,0,0,0,0
11716,RM-1126,4/9/2014,0,0,0,0,0,0,0
11717,RM-1126,4/10/2014,0,0,0,0,0,0,0
11718,RM-1126,4/11/2014,0,0,0,0,0,0,0
11719,RM-1126,4/12/2014,0,0,0,0,0,0,0
11720,RM-1126,4/13/2014,0,0,0,0,0,0,0
11721,RM-1126,4/14/2014,0,0,0,0,0,0,0
11722,RM-1126,4/15/2014,0,0,0,0,0,0,0
11723,RM-1126,4/16/2014,0,0,0,0,0,0,0
11724,RM-1126,4/17/2014,0,0,0,0,0,0,0
11725,RM-1126,4/18/2014,0,0,0,0,0,0,0
11726,RM-1126,4/19/2014,0,0,0,0,0,0,0
11727,RM-1126,4/20/2014,0,0,0,0,0,0,0
11728,RM-1126,4/21/2014,0,0,0,0,0,0,0
11729,RM-1126,4/22/2014,0,0,0,0,0,0,0
11730,RM-1126,4/23/2014,0,0,0,0,0,0,0
11731,RM-1126,4/24/2014,0,0,0,0,0,0,0
11732,RM-1126,4/25/2014,0,0,0,0,0,0,0
11733,RM-1126,4/26/2014,0,0,0,0,0,0,0
11734,RM-1126,4/27/2014,0,0,0,0,0,0,0
11735,RM-1126,4/28/2014,0,0,0,0,0,0,0
11736,RM-1126,4/29/2014,0,0,0,0,0,0,0
11737,RM-1126,4/30/2014,0,0,0,0,0,0,0
11738,RM-1126,5/1/2014,0,0,0,0,0,0,0
11739,RM-1126,5/2/2014,0,0,0,0,0,0,0
11740,RM-1126,5/3/2014,0,0,0,0,0,0,0
11741,RM-1126,5/4/2014,0,0,0,0,0,0,0
11742,RM-1126,5/5/2014,0,0,0,0,0,0,0
11743,RM-1126,5/6/2014,0,0,0,0,0,0,0
11744,RM-1126,5/7/2014,0,0,0,0,0,0,0
11745,RM-1126,5/8/2014,0,0,0,0,0,0,0
11746,RM-1126,5/9/2014,0,0,0,0,0,0,0
11747,RM-1126,5/10/2014,0,0,0,0,0,0,0
11748,RM-1126,5/11/2014,0,0,0,0,0,0,0
11749,RM-1126,5/12/2014,0,0,0,0,0,0,0
11750,RM-1126,5/13/2014,0,0,0,0,0,0,0
11751,RM-1126,5/14/2014,0,0,0,0,0,0,0
11752,RM-1126,5/15/2014,0,0,0,0,0,0,0
11753,RM-1126,5/16/2014,0,0,0,0,0,0,0
11754,RM-1126,5/17/2014,0,0,0,0,0,0,0
11755,RM-1126,5/18/2014,0,0,0,0,0,0,0
11756,RM-1126,5/19/2014,0,0,0,0,0,0,0
11757,RM-1126,5/20/2014,0,0,0,0,0,0,0
11758,RM-1126,5/21/2014,0,0,0,0,0,0,0
11759,RM-1126,5/22/2014,0,0,0,0,0,0,0
11760,RM-1126,5/23/2014,0,0,0,0,0,0,0
11761,RM-1126,5/24/2014,0,0,0,0,0,0,0
11762,RM-1126,5/25/2014,0,0,0,0,0,0,0
11763,RM-1126,5/26/2014,0,0,0,0,0,0,0
11764,RM-1126,5/27/2014,0,0,0,0,0,0,0
11765,RM-1126,5/28/2014,0,0,0,0,0,0,0
11766,RM-1126,5/29/2014,0,0,0,0,0,0,0
11767,RM-1126,5/30/2014,0,0,0,0,0,0,0
11768,RM-1126,5/31/2014,0,0,0,0,0,0,0
11769,RM-1126,6/1/2014,0,0,0,0,0,0,0
11770,RM-1126,6/2/2014,0,0,0,0,0,0,0
11771,RM-1126,6/3/2014,0,0,0,0,0,0,0
11772,RM-1126,6/4/2014,0,0,0,0,0,0,0
11773,RM-1126,6/5/2014,0,0,0,0,0,0,0
11774,RM-1126,6/6/2014,0,0,0,0,0,0,0
11775,RM-1126,6/7/2014,0,0,0,0,0,0,0
11776,RM-1126,6/8/2014,0,0,0,0,0,0,0
11777,RM-1126,6/9/2014,0,0,0,0,0,0,0
11778,RM-1126,6/10/2014,0,0,0,0,0,0,0
11779,RM-1126,6/11/2014,0,0,0,0,0,0,0
11780,RM-1126,6/12/2014,0,0,0,0,0,0,0
11781,RM-1126,6/13/2014,0,0,0,0,0,0,0
11782,RM-1126,6/14/2014,0,0,0,0,0,0,0
11783,RM-1126,6/15/2014,0,0,0,0,0,0,0
11784,RM-1126,6/16/2014,0,0,0,0,0,0,0
11785,RM-1126,6/17/2014,0,0,0,0,0,0,0
11786,RM-1126,6/18/2014,0,0,0,0,0,0,0
11787,RM-1126,6/19/2014,0,0,0,0,0,0,0
11788,RM-1126,6/20/2014,0,0,0,0,0,0,0
11789,RM-1126,6/21/2014,0,0,0,0,0,0,0
11790,RM-1126,6/22/2014,0,0,0,0,0,0,0
11791,RM-1126,6/23/2014,0,0,0,0,0,0,0
11792,RM-1126,6/24/2014,0,0,0,0,0,0,0
11793,RM-1126,6/25/2014,0,0,0,0,0,0,0
11794,RM-1126,6/26/2014,0,0,0,0,0,0,0
11795,RM-1126,6/27/2014,0,0,0,0,0,0,0
11796,RM-1126,6/28/2014,0,0,0,0,0,0,0
11797,RM-1126,6/29/2014,0,0,0,0,0,0,0
11798,RM-1126,6/30/2014,0,0,0,0,0,0,0
11799,RM-1126,7/1/2014,0,0,0,0,0,0,0
11800,RM-1126,7/2/2014,0,0,0,0,0,0,0
11801,RM-1126,7/3/2014,0,0,0,0,0,0,0
11802,RM-1126,7/4/2014,0,0,0,0,0,0,0
11803,RM-1126,7/5/2014,0,0,0,0,0,0,0
11804,RM-1126,7/6/2014,0,0,0,0,0,0,0
11805,RM-1126,7/7/2014,0,0,0,0,0,0,0
11806,RM-1126,7/8/2014,0,0,0,0,0,0,0
11807,RM-1126,7/9/2014,0,0,0,0,0,0,0
11808,RM-1126,7/10/2014,0,0,0,0,0,0,0
11809,RM-1126,7/11/2014,0,0,0,0,0,0,0
11810,RM-1126,7/12/2014,0,0,0,0,0,0,0
11811,RM-1126,7/13/2014,0,0,0,0,0,0,0
11812,RM-1126,7/14/2014,0,0,0,0,0,0,0
11813,RM-1126,7/15/2014,0,0,0,0,0,0,0
11814,RM-1126,7/16/2014,0,0,0,0,0,0,0
11815,RM-1126,7/17/2014,0,0,0,0,0,0,0
11816,RM-1126,7/18/2014,0,0,0,0,0,0,0
11817,RM-1126,7/19/2014,0,0,0,0,0,0,0
11818,RM-1126,7/20/2014,0,0,0,0,0,0,0
11819,RM-1126,7/21/2014,0,0,0,0,0,0,0
11820,RM-1126,7/22/2014,0,0,0,0,0,0,0
11821,RM-1126,7/23/2014,0,0,0,0,0,0,0
11822,RM-1126,7/24/2014,0,0,0,0,0,0,0
11823,RM-1126,7/25/2014,0,0,0,0,0,0,0
11824,RM-1126,7/26/2014,0,0,0,0,0,0,0
11825,RM-1126,7/27/2014,0,0,0,0,0,0,0
11826,RM-1126,7/28/2014,0,0,0,0,0,0,0
11827,RM-1126,7/29/2014,0,0,0,0,0,0,0
11828,RM-1126,7/30/2014,0,0,0,0,0,0,0
11829,RM-1126,7/31/2014,0,0,0,0,0,0,0
11830,RM-1126,8/1/2014,0,0,0,0,0,0,0
11831,RM-1126,8/2/2014,0,0,0,0,0,0,0
11832,RM-1126,8/3/2014,0,0,0,0,0,0,0
11833,RM-1126,8/4/2014,0,0,0,0,0,0,0
11834,RM-1126,8/5/2014,0,0,0,0,0,0,0
11835,RM-1126,8/6/2014,0,0,0,0,0,0,0
11836,RM-1126,8/7/2014,0,0,0,0,0,0,0
11837,RM-1126,8/8/2014,0,0,0,0,0,0,0
11838,RM-1126,8/9/2014,0,0,0,0,0,0,0
11839,RM-1126,8/10/2014,0,0,0,0,0,0,0
11840,RM-1126,8/11/2014,0,0,0,0,0,0,0
11841,RM-1126,8/12/2014,0,0,0,0,0,0,0
11842,RM-1126,8/13/2014,0,0,0,0,0,0,0
11843,RM-1126,8/14/2014,0,0,0,0,0,0,0
11844,RM-1126,8/15/2014,0,0,0,0,0,0,0
11845,RM-1126,8/16/2014,0,0,0,0,0,0,0
11846,RM-1126,8/17/2014,0,0,0,0,0,0,0
11847,RM-1126,8/18/2014,0,0,0,0,0,0,0
11848,RM-1126,8/19/2014,0,0,0,0,0,0,0
11849,RM-1126,8/20/2014,0,0,0,0,0,0,0
11850,RM-1126,8/21/2014,0,0,0,0,0,0,0
11851,RM-1126,8/22/2014,0,0,0,0,0,0,0
11852,RM-1126,8/23/2014,0,0,0,0,0,0,0
11853,RM-1126,8/24/2014,0,0,0,0,0,0,0
11854,RM-1126,8/25/2014,0,0,0,0,0,0,0
11855,RM-1126,8/26/2014,0,0,0,0,0,0,0
11856,RM-1126,8/27/2014,0,0,0,0,0,0,0
11857,RM-1126,8/28/2014,0,0,0,0,0,0,0
11858,RM-1126,8/29/2014,0,0,0,0,0,0,0
11859,RM-1126,8/30/2014,0,0,0,0,0,0,0
11860,RM-1126,8/31/2014,0,0,0,0,0,0,0
11861,RM-1126,9/1/2014,0,0,0,0,0,0,0
11862,RM-1126,9/2/2014,0,0,0,0,0,0,0
11863,RM-1126,9/3/2014,0,0,0,0,0,0,0
11864,RM-1126,9/4/2014,0,0,0,0,0,0,0
11865,RM-1126,9/5/2014,0,0,0,0,0,0,0
11866,RM-1126,9/6/2014,0,0,0,0,0,0,0
11867,RM-1126,9/7/2014,0,0,0,0,0,0,0
11868,RM-1126,9/8/2014,0,0,0,0,0,0,0
11869,RM-1126,9/9/2014,0,0,0,0,0,0,0
11870,RM-1126,9/10/2014,0,0,0,0,0,0,0
11871,RM-1126,9/11/2014,0,0,0,0,0,0,0
11872,RM-1126,9/12/2014,0,0,0,0,0,0,0
11873,RM-1126,9/13/2014,0,0,0,0,0,0,0
11874,RM-1126,9/14/2014,0,0,0,0,0,0,0
11875,RM-1126,9/15/2014,0,0,0,0,0,0,0
11876,RM-1126,9/16/2014,0,0,0,0,0,0,0
11877,RM-1126,9/17/2014,0,0,0,0,0,0,0
11878,RM-1126,9/18/2014,0,0,0,0,0,0,0
11879,RM-1126,9/19/2014,0,0,0,0,0,0,0
11880,RM-1126,9/20/2014,0,0,0,0,0,0,0
11881,RM-1126,9/21/2014,0,0,0,0,0,0,0
11882,RM-1126,9/22/2014,0,0,0,0,0,0,0
11883,RM-1126,9/23/2014,0,0,0,0,0,0,0
11884,RM-1126,9/24/2014,0,0,0,0,0,0,0
11885,RM-1126,9/25/2014,0,0,0,0,0,0,0
11886,RM-1126,9/28/2014,0,0,0,0,0,0,0
11887,RM-1126,9/29/2014,0,0,0,0,0,0,0
11888,RM-1126,9/30/2014,0,0,0,0,0,0,0
11889,RM-1126,10/1/2014,0,0,0,0,0,0,0
11890,RM-1126,10/2/2014,0,0,0,0,0,0,0
11891,RM-1126,10/3/2014,0,0,0,0,0,0,0
11892,RM-1126,10/4/2014,0,0,0,0,0,0,0
11893,RM-1126,10/5/2014,0,0,0,0,0,0,0
11894,RM-1126,10/6/2014,0,0,0,0,0,0,0
11895,RM-1126,10/7/2014,0,0,0,0,0,0,0
11896,RM-1126,10/8/2014,0,0,0,0,0,0,0
11897,RM-1126,10/9/2014,0,0,0,0,0,0,0
11898,RM-1126,10/10/2014,0,0,0,0,0,0,0
11899,RM-1126,10/11/2014,0,0,0,0,0,0,0
11900,RM-1126,10/12/2014,0,0,0,0,0,0,0
11901,RM-1126,10/13/2014,0,0,0,0,0,0,0
11902,RM-1126,10/14/2014,0,0,0,0,0,0,0
11903,RM-1126,10/15/2014,0,0,0,0,0,0,0
11904,RM-1126,10/16/2014,0,0,0,0,0,0,0
11905,RM-1126,10/17/2014,0,0,0,0,0,0,0
11906,RM-1126,10/18/2014,0,0,0,0,0,0,0
11907,RM-1126,10/19/2014,0,0,0,0,0,0,0
11908,RM-1126,10/20/2014,0,0,0,0,0,0,0
11909,RM-1126,10/21/2014,0,0,0,0,0,0,0
11910,RM-1126,10/22/2014,0,0,0,0,0,0,0
11911,RM-1126,10/23/2014,0,0,0,0,0,0,0
11912,RM-1126,10/24/2014,0,0,0,0,0,0,0
11913,RM-1126,10/25/2014,0,0,0,0,0,0,0
11914,RM-1126,10/26/2014,0,0,0,0,0,0,0
11915,RM-1126,10/27/2014,0,0,0,0,0,0,0
11916,RM-1126,10/28/2014,0,0,0,0,0,0,0
11917,RM-1126,10/29/2014,0,0,0,0,0,0,0
11918,RM-1126,10/30/2014,0,0,0,0,0,0,0
11919,RM-1126,10/31/2014,0,0,0,0,0,0,0
11920,RM-1126,11/1/2014,0,0,0,0,0,0,0
11921,RM-1126,11/2/2014,0,0,0,0,0,0,0
11922,RM-1126,11/3/2014,0,0,0,0,0,0,0
11923,RM-1126,11/4/2014,0,0,0,0,0,0,0
11924,RM-1126,11/5/2014,0,0,0,0,0,0,0
11925,RM-1126,11/6/2014,0,0,0,0,0,0,0
11926,RM-1126,11/7/2014,0,0,0,0,0,0,0
11927,RM-1126,11/8/2014,0,0,0,0,0,0,0
11928,RM-1126,11/9/2014,0,0,0,0,0,0,0
11929,RM-1126,11/10/2014,0,0,0,0,0,0,0
11930,RM-1126,11/11/2014,0,0,0,0,0,0,0
11931,RM-1126,11/12/2014,0,0,0,0,0,0,0
11932,RM-1126,11/13/2014,0,0,0,0,0,0,0
11933,RM-1126,11/14/2014,0,0,0,0,0,0,0
11934,RM-1126,11/15/2014,0,0,0,0,0,0,0
11935,RM-1126,11/16/2014,0,0,0,0,0,0,0
11936,RM-1126,11/17/2014,0,0,0,0,0,0,0
11937,RM-1126,11/18/2014,0,0,0,0,0,0,0
11938,RM-1126,11/19/2014,0,0,0,0,0,0,0
11939,RM-1126,11/20/2014,0,0,0,0,0,0,0
11940,RM-1126,11/21/2014,0,0,0,0,0,0,0
11941,RM-1126,11/22/2014,0,0,0,0,0,0,0
11942,RM-1126,11/23/2014,0,0,0,0,0,0,0
11943,RM-1126,11/24/2014,0,0,0,0,0,0,0
11944,RM-1126,11/25/2014,0,0,0,0,0,0,0
11945,RM-1126,11/26/2014,0,0,0,0,0,0,0
11946,RM-1126,11/27/2014,0,0,0,0,0,0,0
11947,RM-1126,11/28/2014,0,0,0,0,0,0,0
11948,RM-1126,11/29/2014,0,0,0,0,0,0,0
11949,RM-1126,11/30/2014,0,0,0,0,0,0,0
11950,RM-1126,12/1/2014,0,0,0,0,0,0,0
11951,RM-1126,12/2/2014,0,0,0,0,0,0,0
11952,RM-1126,12/3/2014,0,0,0,0,0,0,0
11953,RM-1126,12/4/2014,0,0,0,0,0,0,0
11954,RM-1126,12/5/2014,0,0,0,0,0,0,0
11955,RM-1126,12/6/2014,0,0,0,0,0,0,0
11956,RM-1126,12/7/2014,0,0,0,0,0,0,0
11957,RM-1126,12/8/2014,0,0,0,0,0,0,0
11958,RM-1126,12/9/2014,0,0,0,0,0,0,0
11959,RM-1126,12/10/2014,0,0,0,0,0,0,0
11960,RM-1126,12/11/2014,0,0,0,0,0,0,0
11961,RM-1126,12/12/2014,0,0,0,0,0,0,0
11962,RM-1126,12/13/2014,0,0,0,0,0,0,0
11963,RM-1126,12/14/2014,0,0,0,0,0,0,0
11964,RM-1126,12/15/2014,0,0,0,0,0,0,0
11965,RM-1126,12/16/2014,0,0,0,0,0,0,0
11966,RM-1126,12/17/2014,0,0,0,0,0,0,0
11967,RM-1126,12/18/2014,0,0,0,0,0,0,0
11968,RM-1126,12/19/2014,0,0,0,0,0,0,0
11969,RM-1126,12/20/2014,0,0,0,0,0,0,0
11970,RM-1126,12/21/2014,0,0,0,0,0,0,0
11971,RM-1126,12/22/2014,0,0,0,0,0,0,0
11972,RM-1126,12/23/2014,0,0,0,0,0,0,0
11973,RM-1126,12/24/2014,0,0,0,0,0,0,0
11974,RM-1126,12/25/2014,0,0,0,0,0,0,0
11975,RM-1126,12/26/2014,0,0,0,0,0,0,0
11976,RM-1126,12/27/2014,0,0,0,0,0,0,0
11977,RM-1126,12/28/2014,0,0,0,0,0,0,0
11978,RM-1126,12/29/2014,0,0,0,0,0,0,0
11979,RM-1126,12/30/2014,0,0,0,0,0,0,0
11980,RM-1126,12/31/2014,0,0,0,0,0,0,0
11981,RM-1126,1/1/2015,0,0,0,0,0,0,0
11982,RM-1126,1/2/2015,0,0,0,0,0,0,0
11983,RM-1126,1/3/2015,0,0,0,0,0,0,0
11984,RM-1126,1/4/2015,0,0,0,0,0,0,0
11985,RM-1126,1/5/2015,0,0,0,0,0,0,0
11986,RM-1126,1/6/2015,0,0,0,0,0,0,0
11987,RM-1126,1/7/2015,0,0,0,0,0,0,0
11988,RM-1126,1/8/2015,0,0,0,0,0,0,0
11989,RM-1126,1/9/2015,0,0,0,0,0,0,0
11990,RM-1126,1/10/2015,0,0,0,0,0,0,0
11991,RM-1126,1/11/2015,0,0,0,0,0,0,0
11992,RM-1126,1/12/2015,0,0,0,0,0,0,0
11993,RM-1126,1/13/2015,0,0,0,0,0,0,0
11994,RM-1126,1/14/2015,0,0,0,0,0,0,0
11995,RM-1126,1/15/2015,0,0,0,0,0,0,0
11996,RM-1126,1/16/2015,0,0,0,0,0,0,0
11997,RM-1126,1/17/2015,0,0,0,0,0,0,0
11998,RM-1126,1/18/2015,0,0,0,0,0,0,0
11999,RM-1126,1/19/2015,0,0,0,0,0,0,0
12000,RM-1126,1/20/2015,0,0,0,0,0,0,0
12001,RM-1126,1/21/2015,0,0,0,0,0,0,0
12002,RM-1126,1/22/2015,0,0,0,0,0,0,0
12003,RM-1126,1/23/2015,0,0,0,0,0,0,0
12004,RM-1126,1/24/2015,0,0,0,0,0,0,0
12005,RM-1126,1/25/2015,0,0,0,0,0,0,0
12006,RM-1126,1/26/2015,0,0,0,0,0,0,0
12007,RM-1126,1/27/2015,0,0,0,0,0,0,0
12008,RM-1126,1/28/2015,0,0,0,0,0,0,0
12009,RM-1126,1/29/2015,0,0,0,0,0,0,0
12010,RM-1126,1/30/2015,0,0,0,0,0,0,0
12011,RM-1126,1/31/2015,0,0,0,0,0,0,0
12012,RM-1126,2/1/2015,0,0,0,0,0,0,0
12013,RM-1126,2/2/2015,0,0,0,0,0,0,0
12014,RM-1126,2/3/2015,0,0,0,0,0,0,0
12015,RM-1126,2/4/2015,0,0,0,0,0,0,0
12016,RM-1126,2/5/2015,0,0,0,0,0,0,0
12017,RM-1126,2/6/2015,0,0,0,0,0,0,0
12018,RM-1126,2/7/2015,0,0,0,0,0,0,0
12019,RM-1126,2/8/2015,0,0,0,0,0,0,0
12020,RM-1126,2/9/2015,0,0,0,0,0,0,0
12021,RM-1126,2/10/2015,0,0,0,0,0,0,0
12022,RM-1126,2/11/2015,0,0,0,0,0,0,0
12023,RM-1126,2/12/2015,0,0,0,0,0,0,0
12024,RM-1126,2/13/2015,0,0,0,0,0,0,0
12025,RM-1126,2/14/2015,0,0,0,0,0,0,0
12026,RM-1126,2/15/2015,0,0,0,0,0,0,0
12027,RM-1126,2/16/2015,0,0,0,0,0,0,0
12028,RM-1126,2/17/2015,0,0,0,0,0,0,0
12029,RM-1126,2/18/2015,0,0,0,0,0,0,0
12030,RM-1126,2/19/2015,0,0,0,0,0,0,0
12031,RM-1126,2/20/2015,0,0,0,0,0,0,0
12032,RM-1126,2/21/2015,0,0,0,0,0,0,0
12033,RM-1126,2/22/2015,0,0,0,0,0,0,0
12034,RM-1126,2/23/2015,0,0,0,0,0,0,0
12035,RM-1126,2/24/2015,0,0,0,0,0,0,0
12036,RM-1126,2/25/2015,0,0,0,0,0,0,0
12037,RM-1126,2/26/2015,0,0,0,0,0,0,0
12038,RM-1126,2/27/2015,0,0,0,0,0,0,0
12039,RM-1126,2/28/2015,0,0,0,0,0,0,0
12040,RM-1126,3/1/2015,0,0,0,0,0,0,0
12041,RM-1126,3/2/2015,0,0,0,0,0,0,0
12042,RM-1126,3/3/2015,0,0,0,0,0,0,0
12043,RM-1126,3/4/2015,0,0,0,0,0,0,0
12044,RM-1126,3/5/2015,0,0,0,0,0,0,0
12045,RM-1126,3/6/2015,0,0,0,0,0,0,0
12046,RM-1126,3/7/2015,0,0,0,0,0,0,0
12047,RM-1126,3/8/2015,0,0,0,0,0,0,0
12048,RM-1126,3/9/2015,0,0,0,0,0,0,0
12049,RM-1126,3/10/2015,0,0,0,0,0,0,0
12050,RM-1126,3/11/2015,0,0,0,0,0,0,0
12051,RM-1126,3/12/2015,0,0,0,0,0,0,0
12052,RM-1126,3/13/2015,0,0,0,0,0,0,0
12053,RM-1126,3/14/2015,0,0,0,0,0,0,0
12054,RM-1126,3/15/2015,0,0,0,0,0,0,0
12055,RM-1126,3/16/2015,0,0,0,0,0,0,0
12056,RM-1126,3/17/2015,0,0,0,0,0,0,0
12057,RM-1126,3/18/2015,0,0,0,0,0,0,0
12058,RM-1126,3/19/2015,0,0,0,0,0,0,0
12059,RM-1126,3/20/2015,0,0,0,0,0,0,0
12060,RM-1126,3/21/2015,0,0,0,0,0,0,0
12061,RM-1126,3/22/2015,0,0,0,0,0,0,0
12062,RM-1126,3/23/2015,0,0,0,0,0,0,0
12063,RM-1126,3/24/2015,0,0,0,0,0,0,0
12064,RM-1126,3/25/2015,0,0,0,0,0,0,0
12065,RM-1126,3/26/2015,0,0,0,0,0,0,0
12066,RM-1126,3/27/2015,0,0,0,0,0,0,0
12067,RM-1126,3/28/2015,0,0,0,0,0,0,0
12068,RM-1126,3/29/2015,0,0,0,0,0,0,0
12069,RM-1126,3/30/2015,0,0,0,0,0,0,0
12070,RM-1126,3/31/2015,0,0,0,0,0,0,0
12071,RM-1126,4/1/2015,0,0,0,0,0,0,0
12072,RM-1126,4/2/2015,0,0,0,0,0,0,0
12073,RM-1126,4/3/2015,0,0,0,0,0,0,0
12074,RM-1126,4/4/2015,0,0,0,0,0,0,0
12075,RM-1126,4/5/2015,0,0,0,0,0,0,0
12076,RM-1126,4/6/2015,0,0,0,0,0,0,0
12077,RM-1126,4/7/2015,0,0,0,0,0,0,0
12078,RM-1126,4/8/2015,0,0,0,0,0,0,0
12079,RM-1126,4/9/2015,0,0,0,0,0,0,0
12080,RM-1126,4/10/2015,0,0,0,0,0,0,0
12081,RM-1126,4/11/2015,0,0,0,0,0,0,0
12082,RM-1126,4/12/2015,0,0,0,0,0,0,0
12083,RM-1126,4/13/2015,0,0,0,0,0,0,0
12084,RM-1126,4/14/2015,0,0,0,0,0,0,0
12085,RM-1126,4/15/2015,0,0,0,0,0,0,0
12086,RM-1126,4/16/2015,0,0,0,0,0,0,0
12087,RM-1126,4/17/2015,0,0,0,0,0,0,0
12088,RM-1126,4/18/2015,0,0,0,0,0,0,0
12089,RM-1126,4/19/2015,0,0,0,0,0,0,0
12090,RM-1126,4/20/2015,0,0,0,0,0,0,0
12091,RM-1126,4/21/2015,0,0,0,0,0,0,0
12092,RM-1126,4/22/2015,0,0,0,0,0,0,0
12093,RM-1126,4/23/2015,0,0,0,0,0,0,0
12094,RM-1126,4/24/2015,0,0,0,0,0,0,0
12095,RM-1126,4/25/2015,0,0,0,0,0,0,0
12096,RM-1126,4/26/2015,0,0,0,0,0,0,0
12097,RM-1126,4/27/2015,0,0,0,0,0,0,0
12098,RM-1126,4/28/2015,0,0,0,0,0,0,0
12099,RM-1126,4/29/2015,0,0,0,0,0,0,0
12100,RM-1126,4/30/2015,0,0,0,0,0,0,0
12101,RM-1126,5/1/2015,0,0,0,0,0,0,0
12102,RM-1126,5/2/2015,0,0,0,0,0,0,0
12103,RM-1126,5/3/2015,0,0,0,0,0,0,0
12104,RM-1126,5/4/2015,0,0,0,0,0,0,0
12105,RM-1126,5/5/2015,0,0,0,0,0,0,0
12106,RM-1126,5/6/2015,0,0,0,0,0,0,0
12107,RM-1126,5/7/2015,0,0,0,0,0,0,0
12108,RM-1126,5/8/2015,0,0,0,0,0,0,0
12109,RM-1126,5/9/2015,0,0,0,0,0,0,0
12110,RM-1126,5/10/2015,0,0,0,0,0,0,0
12111,RM-1126,5/11/2015,0,0,0,0,0,0,0
12112,RM-1126,5/12/2015,0,0,0,0,0,0,0
12113,RM-1126,5/13/2015,0,0,0,0,0,0,0
12114,RM-1126,5/14/2015,0,0,0,0,0,0,0
12115,RM-1126,5/15/2015,0,0,0,0,0,0,0
12116,RM-1126,5/16/2015,0,0,0,0,0,0,0
12117,RM-1126,5/17/2015,0,0,0,0,0,0,0
12118,RM-1126,5/18/2015,0,0,0,0,0,0,0
12119,RM-1126,5/19/2015,0,0,0,0,0,0,0
12120,RM-1126,5/20/2015,0,0,0,0,0,0,0
12121,RM-1126,5/21/2015,0,0,0,0,0,0,0
12122,RM-1126,5/22/2015,0,0,0,0,0,0,0
12123,RM-1126,5/23/2015,0,0,0,0,0,0,0
12124,RM-1126,5/24/2015,0,0,0,0,0,0,0
12125,RM-1126,5/25/2015,0,0,0,0,0,0,0
12126,RM-1126,5/26/2015,0,0,0,0,0,0,0
12127,RM-1126,5/27/2015,0,0,0,0,0,0,0
12128,RM-1126,5/28/2015,0,0,0,0,0,0,0
12129,RM-1126,5/29/2015,0,0,0,0,0,0,0
12130,RM-1126,5/30/2015,0,0,0,0,0,0,0
12131,RM-1126,5/31/2015,0,0,0,0,0,0,0
12298,RM-1130,12/27/2013,0,0,0,0,0,0,0
12299,RM-1130,12/28/2013,0,0,0,0,0,0,0
12300,RM-1130,12/29/2013,0,0,0,0,0,0,0
12301,RM-1130,12/30/2013,0,0,0,0,0,0,0
12302,RM-1130,12/31/2013,0,0,0,0,0,0,0
12303,RM-1130,1/1/2014,0,0,0,0,0,0,0
12304,RM-1130,1/2/2014,0,0,0,0,0,0,0
12305,RM-1130,1/3/2014,0,0,0,0,0,0,0
12306,RM-1130,1/4/2014,0,0,0,0,0,0,0
12307,RM-1130,1/5/2014,0,0,0,0,0,0,0
12308,RM-1130,1/6/2014,0,0,0,0,0,0,0
12309,RM-1130,1/7/2014,0,0,0,0,0,0,0
12310,RM-1130,1/8/2014,0,0,0,0,0,0,0
12311,RM-1130,1/9/2014,0,0,0,0,0,0,0
12312,RM-1130,1/10/2014,0,0,0,0,0,0,0
12313,RM-1130,1/11/2014,0,0,0,0,0,0,0
12314,RM-1130,1/12/2014,0,0,0,0,0,0,0
12315,RM-1130,1/13/2014,0,0,0,0,0,0,0
12316,RM-1130,1/14/2014,0,0,0,0,0,0,0
12317,RM-1130,1/15/2014,0,0,0,0,0,0,0
12318,RM-1130,1/16/2014,0,0,0,0,0,0,0
12319,RM-1130,1/17/2014,0,0,0,0,0,0,0
12320,RM-1130,1/18/2014,0,0,0,0,0,0,0
12321,RM-1130,1/19/2014,0,0,0,0,0,0,0
12322,RM-1130,1/20/2014,0,0,0,0,0,0,0
12323,RM-1130,1/21/2014,0,0,0,0,0,0,0
12324,RM-1130,1/22/2014,0,0,0,0,0,0,0
12325,RM-1130,1/23/2014,0,0,0,0,0,0,0
12326,RM-1130,1/24/2014,0,0,0,0,0,0,0
12327,RM-1130,1/25/2014,0,0,0,0,0,0,0
12328,RM-1130,1/26/2014,0,0,0,0,0,0,0
12329,RM-1130,1/27/2014,0,0,0,0,0,0,0
12330,RM-1130,1/28/2014,0,0,0,0,0,0,0
12331,RM-1130,1/29/2014,0,0,0,0,0,0,0
12332,RM-1130,1/30/2014,0,0,0,0,0,0,0
12333,RM-1130,1/31/2014,0,0,0,0,0,0,0
12334,RM-1130,2/1/2014,0,0,0,0,0,0,0
12335,RM-1130,2/2/2014,0,0,0,0,0,0,0
12336,RM-1130,2/3/2014,0,0,0,0,0,0,0
12337,RM-1130,2/4/2014,0,0,0,0,0,0,0
12338,RM-1130,2/5/2014,0,0,0,0,0,0,0
12339,RM-1130,2/6/2014,0,0,0,0,0,0,0
12340,RM-1130,2/7/2014,0,0,0,0,0,0,0
12341,RM-1130,2/8/2014,0,0,0,0,0,0,0
12342,RM-1130,2/9/2014,0,0,0,0,0,0,0
12343,RM-1130,2/10/2014,0,0,0,0,0,0,0
12344,RM-1130,2/11/2014,0,0,0,0,0,0,0
12345,RM-1130,2/12/2014,0,0,0,0,0,0,0
12346,RM-1130,2/13/2014,0,0,0,0,0,0,0
12347,RM-1130,2/14/2014,0,0,0,0,0,0,0
12348,RM-1130,2/15/2014,0,0,0,0,0,0,0
12349,RM-1130,2/16/2014,0,0,0,0,0,0,0
12350,RM-1130,2/17/2014,0,0,0,0,0,0,0
12351,RM-1130,2/18/2014,0,0,0,0,0,0,0
12352,RM-1130,2/19/2014,0,0,0,0,0,0,0
12353,RM-1130,2/20/2014,0,0,0,0,0,0,0
12354,RM-1130,2/21/2014,0,0,0,0,0,0,0
12355,RM-1130,2/22/2014,0,0,0,0,0,0,0
12356,RM-1130,2/23/2014,0,0,0,0,0,0,0
12357,RM-1130,2/24/2014,0,0,0,0,0,0,0
12358,RM-1130,2/25/2014,0,0,0,0,0,0,0
12359,RM-1130,2/26/2014,0,0,0,0,0,0,0
12360,RM-1130,2/27/2014,0,0,0,0,0,0,0
12361,RM-1130,2/28/2014,0,0,0,0,0,0,0
12362,RM-1130,3/1/2014,0,0,0,0,0,0,0
12363,RM-1130,3/2/2014,0,0,0,0,0,0,0
12364,RM-1130,3/3/2014,0,0,0,0,0,0,0
12365,RM-1130,3/4/2014,0,0,0,0,0,0,0
12366,RM-1130,3/5/2014,0,0,0,0,0,0,0
12367,RM-1130,3/6/2014,0,0,0,0,0,0,0
12368,RM-1130,3/7/2014,0,0,0,0,0,0,0
12369,RM-1130,3/8/2014,0,0,0,0,0,0,0
12370,RM-1130,3/9/2014,0,0,0,0,0,0,0
12371,RM-1130,3/10/2014,0,0,0,0,0,0,0
12372,RM-1130,3/11/2014,0,0,0,0,0,0,0
12373,RM-1130,3/12/2014,0,0,0,0,0,0,0
12374,RM-1130,3/13/2014,0,0,0,0,0,0,0
12375,RM-1130,3/14/2014,0,0,0,0,0,0,0
12376,RM-1130,3/15/2014,0,0,0,0,0,0,0
12377,RM-1130,3/16/2014,0,0,0,0,0,0,0
12378,RM-1130,3/17/2014,0,0,0,0,0,0,0
12379,RM-1130,3/18/2014,0,0,0,0,0,0,0
12380,RM-1130,3/19/2014,0,0,0,0,0,0,0
12381,RM-1130,3/20/2014,0,0,0,0,0,0,0
12382,RM-1130,3/21/2014,0,0,0,0,0,0,0
12383,RM-1130,3/22/2014,0,0,0,0,0,0,0
12384,RM-1130,3/23/2014,0,0,0,0,0,0,0
12385,RM-1130,3/24/2014,0,0,0,0,0,0,0
12386,RM-1130,3/25/2014,0,0,0,0,0,0,0
12387,RM-1130,3/26/2014,0,0,0,0,0,0,0
12388,RM-1130,3/27/2014,0,0,0,0,0,0,0
12389,RM-1130,3/28/2014,0,0,0,0,0,0,0
12390,RM-1130,3/29/2014,0,0,0,0,0,0,0
12391,RM-1130,3/30/2014,0,0,0,0,0,0,0
12392,RM-1130,3/31/2014,0,0,0,0,0,0,0
12393,RM-1130,4/1/2014,0,0,0,0,0,0,0
12394,RM-1130,4/2/2014,0,0,0,0,0,0,0
12395,RM-1130,4/3/2014,0,0,0,0,0,0,0
12396,RM-1130,4/4/2014,0,0,0,0,0,0,0
12397,RM-1130,4/5/2014,0,0,0,0,0,0,0
12398,RM-1130,4/6/2014,0,0,0,0,0,0,0
12399,RM-1130,4/7/2014,0,0,0,0,0,0,0
12400,RM-1130,4/8/2014,0,0,0,0,0,0,0
12401,RM-1130,4/9/2014,0,0,0,0,0,0,0
12402,RM-1130,4/10/2014,0,0,0,0,0,0,0
12403,RM-1130,4/11/2014,0,0,0,0,0,0,0
12404,RM-1130,4/12/2014,0,0,0,0,0,0,0
12405,RM-1130,4/13/2014,0,0,0,0,0,0,0
12406,RM-1130,4/14/2014,0,0,0,0,0,0,0
12407,RM-1130,4/15/2014,0,0,0,0,0,0,0
12408,RM-1130,4/16/2014,0,0,0,0,0,0,0
12409,RM-1130,4/17/2014,0,0,0,0,0,0,0
12410,RM-1130,4/18/2014,0,0,0,0,0,0,0
12411,RM-1130,4/19/2014,0,0,0,0,0,0,0
12412,RM-1130,4/20/2014,0,0,0,0,0,0,0
12413,RM-1130,4/21/2014,0,0,0,0,0,0,0
12414,RM-1130,4/22/2014,0,0,0,0,0,0,0
12415,RM-1130,4/23/2014,0,0,0,0,0,0,0
12416,RM-1130,4/24/2014,0,0,0,0,0,0,0
12417,RM-1130,4/25/2014,0,0,0,0,0,0,0
12418,RM-1130,4/26/2014,0,0,0,0,0,0,0
12419,RM-1130,4/27/2014,0,0,0,0,0,0,0
12420,RM-1130,4/28/2014,0,0,0,0,0,0,0
12421,RM-1130,4/29/2014,0,0,0,0,0,0,0
12422,RM-1130,4/30/2014,0,0,0,0,0,0,0
12423,RM-1130,5/1/2014,0,0,0,0,0,0,0
12424,RM-1130,5/2/2014,0,0,0,0,0,0,0
12425,RM-1130,5/3/2014,0,0,0,0,0,0,0
12426,RM-1130,5/4/2014,0,0,0,0,0,0,0
12427,RM-1130,5/5/2014,0,0,0,0,0,0,0
12428,RM-1130,5/7/2014,0,0,0,0,0,0,0
12429,RM-1130,5/8/2014,0,0,0,0,0,0,0
12430,RM-1130,5/9/2014,0,0,0,0,0,0,0
12431,RM-1130,5/10/2014,0,0,0,0,0,0,0
12432,RM-1130,5/11/2014,0,0,0,0,0,0,0
12433,RM-1130,5/12/2014,0,0,0,0,0,0,0
12434,RM-1130,5/13/2014,0,0,0,0,0,0,0
12435,RM-1130,5/14/2014,0,0,0,0,0,0,0
12436,RM-1130,5/15/2014,0,0,0,0,0,0,0
12437,RM-1130,5/16/2014,0,0,0,0,0,0,0
12438,RM-1130,5/17/2014,0,0,0,0,0,0,0
12439,RM-1130,5/18/2014,0,0,0,0,0,0,0
12440,RM-1130,5/19/2014,0,0,0,0,0,0,0
12441,RM-1130,5/20/2014,0,0,0,0,0,0,0
12442,RM-1130,5/21/2014,0,0,0,0,0,0,0
12443,RM-1130,5/22/2014,0,0,0,0,0,0,0
12444,RM-1130,5/23/2014,0,0,0,0,0,0,0
12445,RM-1130,5/24/2014,0,0,0,0,0,0,0
12446,RM-1130,5/25/2014,0,0,0,0,0,0,0
12447,RM-1130,5/26/2014,0,0,0,0,0,0,0
12448,RM-1130,5/27/2014,0,0,0,0,0,0,0
12449,RM-1130,5/28/2014,0,0,0,0,0,0,0
12450,RM-1130,5/29/2014,0,0,0,0,0,0,0
12451,RM-1130,5/30/2014,0,0,0,0,0,0,0
12452,RM-1130,5/31/2014,0,0,0,0,0,0,0
12453,RM-1130,6/1/2014,0,0,0,0,0,0,0
12454,RM-1130,6/2/2014,0,0,0,0,0,0,0
12455,RM-1130,6/3/2014,0,0,0,0,0,0,0
12456,RM-1130,6/4/2014,0,0,0,0,0,0,0
12457,RM-1130,6/5/2014,0,0,0,0,0,0,0
12458,RM-1130,6/6/2014,0,0,0,0,0,0,0
12459,RM-1130,6/7/2014,0,0,0,0,0,0,0
12460,RM-1130,6/8/2014,0,0,0,0,0,0,0
12461,RM-1130,6/9/2014,0,0,0,0,0,0,0
12462,RM-1130,6/10/2014,0,0,0,0,0,0,0
12463,RM-1130,6/11/2014,0,0,0,0,0,0,0
12464,RM-1130,6/12/2014,0,0,0,0,0,0,0
12465,RM-1130,6/13/2014,0,0,0,0,0,0,0
12466,RM-1130,6/14/2014,0,0,0,0,0,0,0
12467,RM-1130,6/15/2014,0,0,0,0,0,0,0
12468,RM-1130,6/16/2014,0,0,0,0,0,0,0
12469,RM-1130,6/17/2014,0,0,0,0,0,0,0
12470,RM-1130,6/18/2014,0,0,0,0,0,0,0
12471,RM-1130,6/19/2014,0,0,0,0,0,0,0
12472,RM-1130,6/20/2014,0,0,0,0,0,0,0
12473,RM-1130,6/21/2014,0,0,0,0,0,0,0
12474,RM-1130,6/22/2014,0,0,0,0,0,0,0
12475,RM-1130,6/23/2014,0,0,0,0,0,0,0
12476,RM-1130,6/24/2014,0,0,0,0,0,0,0
12477,RM-1130,6/25/2014,0,0,0,0,0,0,0
12478,RM-1130,6/26/2014,0,0,0,0,0,0,0
12479,RM-1130,6/27/2014,0,0,0,0,0,0,0
12480,RM-1130,6/28/2014,0,0,0,0,0,0,0
12481,RM-1130,6/29/2014,0,0,0,0,0,0,0
12482,RM-1130,6/30/2014,0,0,0,0,0,0,0
12483,RM-1130,7/1/2014,0,0,0,0,0,0,0
12484,RM-1130,7/2/2014,0,0,0,0,0,0,0
12485,RM-1130,7/3/2014,0,0,0,0,0,0,0
12486,RM-1130,7/4/2014,0,0,0,0,0,0,0
12487,RM-1130,7/5/2014,0,0,0,0,0,0,0
12488,RM-1130,7/6/2014,0,0,0,0,0,0,0
12489,RM-1130,7/7/2014,0,0,0,0,0,0,0
12490,RM-1130,7/8/2014,0,0,0,0,0,0,0
12491,RM-1130,7/9/2014,0,0,0,0,0,0,0
12492,RM-1130,7/10/2014,0,0,0,0,0,0,0
12493,RM-1130,7/11/2014,0,0,0,0,0,0,0
12494,RM-1130,7/12/2014,0,0,0,0,0,0,0
12495,RM-1130,7/13/2014,0,0,0,0,0,0,0
12496,RM-1130,7/14/2014,0,0,0,0,0,0,0
12497,RM-1130,7/15/2014,0,0,0,0,0,0,0
12498,RM-1130,7/16/2014,0,0,0,0,0,0,0
12499,RM-1130,7/17/2014,0,0,0,0,0,0,0
12500,RM-1130,7/18/2014,0,0,0,0,0,0,0
12501,RM-1130,7/19/2014,0,0,0,0,0,0,0
12502,RM-1130,7/20/2014,0,0,0,0,0,0,0
12503,RM-1130,7/21/2014,0,0,0,0,0,0,0
12504,RM-1130,7/22/2014,0,0,0,0,0,0,0
12505,RM-1130,7/23/2014,0,0,0,0,0,0,0
12506,RM-1130,7/24/2014,0,0,0,0,0,0,0
12507,RM-1130,7/25/2014,0,0,0,0,0,0,0
12508,RM-1130,7/26/2014,0,0,0,0,0,0,0
12509,RM-1130,7/27/2014,0,0,0,0,0,0,0
12510,RM-1130,7/28/2014,0,0,0,0,0,0,0
12511,RM-1130,7/29/2014,0,0,0,0,0,0,0
12512,RM-1130,7/30/2014,0,0,0,0,0,0,0
12513,RM-1130,7/31/2014,0,0,0,0,0,0,0
12514,RM-1130,8/1/2014,0,0,0,0,0,0,0
12515,RM-1130,8/2/2014,0,0,0,0,0,0,0
12516,RM-1130,8/3/2014,0,0,0,0,0,0,0
12517,RM-1130,8/4/2014,0,0,0,0,0,0,0
12518,RM-1130,8/5/2014,0,0,0,0,0,0,0
12519,RM-1130,8/6/2014,0,0,0,0,0,0,0
12520,RM-1130,8/7/2014,0,0,0,0,0,0,0
12521,RM-1130,8/8/2014,0,0,0,0,0,0,0
12522,RM-1130,8/9/2014,0,0,0,0,0,0,0
12523,RM-1130,8/10/2014,0,0,0,0,0,0,0
12524,RM-1130,8/11/2014,0,0,0,0,0,0,0
12525,RM-1130,8/12/2014,0,0,0,0,0,0,0
12526,RM-1130,8/13/2014,0,0,0,0,0,0,0
12527,RM-1130,8/14/2014,0,0,0,0,0,0,0
12528,RM-1130,8/15/2014,0,0,0,0,0,0,0
12529,RM-1130,8/16/2014,0,0,0,0,0,0,0
12530,RM-1130,8/17/2014,0,0,0,0,0,0,0
12531,RM-1130,8/18/2014,0,0,0,0,0,0,0
12532,RM-1130,8/19/2014,0,0,0,0,0,0,0
12533,RM-1130,8/20/2014,0,0,0,0,0,0,0
12534,RM-1130,8/21/2014,0,0,0,0,0,0,0
12535,RM-1130,8/22/2014,0,0,0,0,0,0,0
12536,RM-1130,8/23/2014,0,0,0,0,0,0,0
12537,RM-1130,8/24/2014,0,0,0,0,0,0,0
12538,RM-1130,8/25/2014,0,0,0,0,0,0,0
12539,RM-1130,8/26/2014,0,0,0,0,0,0,0
12540,RM-1130,8/27/2014,0,0,0,0,0,0,0
12541,RM-1130,8/28/2014,0,0,0,0,0,0,0
12542,RM-1130,8/29/2014,0,0,0,0,0,0,0
12543,RM-1130,8/30/2014,0,0,0,0,0,0,0
12544,RM-1130,8/31/2014,0,0,0,0,0,0,0
12545,RM-1130,9/1/2014,0,0,0,0,0,0,0
12546,RM-1130,9/2/2014,0,0,0,0,0,0,0
12547,RM-1130,9/3/2014,0,0,0,0,0,0,0
12548,RM-1130,9/4/2014,0,0,0,0,0,0,0
12549,RM-1130,9/5/2014,0,0,0,0,0,0,0
12550,RM-1130,9/6/2014,0,0,0,0,0,0,0
12551,RM-1130,9/7/2014,0,0,0,0,0,0,0
12552,RM-1130,9/8/2014,0,0,0,0,0,0,0
12553,RM-1130,9/9/2014,0,0,0,0,0,0,0
12554,RM-1130,9/10/2014,0,0,0,0,0,0,0
12735,RM-1130,3/12/2015,0,0,0,0,0,0,0
12736,RM-1130,3/13/2015,0,0,0,0,0,0,0
12737,RM-1130,3/14/2015,0,0,0,0,0,0,0
12738,RM-1130,3/15/2015,0,0,0,0,0,0,0
12739,RM-1130,3/16/2015,0,0,0,0,0,0,0
12740,RM-1130,3/17/2015,0,0,0,0,0,0,0
12741,RM-1130,3/18/2015,0,0,0,0,0,0,0
12742,RM-1130,3/19/2015,0,0,0,0,0,0,0
12743,RM-1130,3/20/2015,0,0,0,0,0,0,0
12744,RM-1130,3/21/2015,0,0,0,0,0,0,0
12745,RM-1130,3/22/2015,0,0,0,0,0,0,0
12746,RM-1130,3/23/2015,0,0,0,0,0,0,0
12747,RM-1130,3/24/2015,0,0,0,0,0,0,0
12748,RM-1130,3/25/2015,0,0,0,0,0,0,0
12749,RM-1130,3/26/2015,0,0,0,0,0,0,0
12750,RM-1130,3/27/2015,0,0,0,0,0,0,0
12751,RM-1130,3/28/2015,0,0,0,0,0,0,0
12752,RM-1130,3/29/2015,0,0,0,0,0,0,0
12753,RM-1130,3/30/2015,0,0,0,0,0,0,0
12754,RM-1130,3/31/2015,0,0,0,0,0,0,0
12755,RM-1130,4/1/2015,0,0,0,0,0,0,0
12756,RM-1130,4/2/2015,0,0,0,0,0,0,0
12757,RM-1130,4/3/2015,0,0,0,0,0,0,0
12758,RM-1130,4/4/2015,0,0,0,0,0,0,0
12759,RM-1130,4/5/2015,0,0,0,0,0,0,0
12760,RM-1130,4/6/2015,0,0,0,0,0,0,0
12761,RM-1130,4/7/2015,0,0,0,0,0,0,0
12762,RM-1130,4/8/2015,0,0,0,0,0,0,0
12763,RM-1130,4/9/2015,0,0,0,0,0,0,0
12764,RM-1130,4/10/2015,0,0,0,0,0,0,0
12765,RM-1130,4/11/2015,0,0,0,0,0,0,0
12766,RM-1130,4/12/2015,0,0,0,0,0,0,0
12767,RM-1130,4/13/2015,0,0,0,0,0,0,0
12768,RM-1130,4/14/2015,0,0,0,0,0,0,0
12769,RM-1130,4/15/2015,0,0,0,0,0,0,0
12770,RM-1130,4/16/2015,0,0,0,0,0,0,0
12771,RM-1130,4/17/2015,0,0,0,0,0,0,0
12772,RM-1130,4/18/2015,0,0,0,0,0,0,0
12773,RM-1130,4/19/2015,0,0,0,0,0,0,0
12774,RM-1130,4/20/2015,0,0,0,0,0,0,0
12775,RM-1130,4/21/2015,0,0,0,0,0,0,0
12776,RM-1130,4/22/2015,0,0,0,0,0,0,0
12777,RM-1130,4/23/2015,0,0,0,0,0,0,0
12778,RM-1130,4/24/2015,0,0,0,0,0,0,0
12779,RM-1130,4/25/2015,0,0,0,0,0,0,0
12780,RM-1130,4/26/2015,0,0,0,0,0,0,0
12781,RM-1130,4/27/2015,0,0,0,0,0,0,0
12782,RM-1130,4/28/2015,0,0,0,0,0,0,0
12783,RM-1130,4/29/2015,0,0,0,0,0,0,0
12784,RM-1130,4/30/2015,0,0,0,0,0,0,0
12785,RM-1130,5/1/2015,0,0,0,0,0,0,0
12786,RM-1130,5/2/2015,0,0,0,0,0,0,0
12787,RM-1130,5/3/2015,0,0,0,0,0,0,0
12788,RM-1130,5/4/2015,0,0,0,0,0,0,0
12789,RM-1130,5/5/2015,0,0,0,0,0,0,0
12790,RM-1130,5/6/2015,0,0,0,0,0,0,0
12791,RM-1130,5/7/2015,0,0,0,0,0,0,0
12792,RM-1130,5/8/2015,0,0,0,0,0,0,0
12793,RM-1130,5/9/2015,0,0,0,0,0,0,0
12794,RM-1130,5/10/2015,0,0,0,0,0,0,0
12795,RM-1130,5/11/2015,0,0,0,0,0,0,0
12796,RM-1130,5/12/2015,0,0,0,0,0,0,0
12797,RM-1130,5/13/2015,0,0,0,0,0,0,0
12798,RM-1130,5/14/2015,0,0,0,0,0,0,0
12799,RM-1130,5/15/2015,0,0,0,0,0,0,0
12800,RM-1130,5/16/2015,0,0,0,0,0,0,0
12801,RM-1130,5/17/2015,0,0,0,0,0,0,0
12802,RM-1130,5/18/2015,0,0,0,0,0,0,0
12803,RM-1130,5/19/2015,0,0,0,0,0,0,0
12804,RM-1130,5/20/2015,0,0,0,0,0,0,0
12805,RM-1130,5/21/2015,0,0,0,0,0,0,0
12806,RM-1130,5/22/2015,0,0,0,0,0,0,0
12807,RM-1130,5/23/2015,0,0,0,0,0,0,0
12808,RM-1130,5/24/2015,0,0,0,0,0,0,0
12809,RM-1130,5/25/2015,0,0,0,0,0,0,0
12810,RM-1130,5/26/2015,0,0,0,0,0,0,0
12811,RM-1130,5/27/2015,0,0,0,0,0,0,0
12812,RM-1130,5/28/2015,0,0,0,0,0,0,0
12813,RM-1130,5/29/2015,0,0,0,0,0,0,0
12814,RM-1130,5/30/2015,0,0,0,0,0,0,0
12815,RM-1130,5/31/2015,0,0,0,0,0,0,0
12848,RM-1132,7/31/2013,0,0,0,0,0,0,0
12849,RM-1132,8/1/2013,0,0,0,0,0,0,0
12850,RM-1132,8/2/2013,0,0,0,0,0,0,0
12851,RM-1132,8/3/2013,0,0,0,0,0,0,0
12852,RM-1132,8/4/2013,0,0,0,0,0,0,0
12853,RM-1132,8/5/2013,0,0,0,0,0,0,0
12854,RM-1132,8/6/2013,0,0,0,0,0,0,0
12855,RM-1132,8/7/2013,0,0,0,0,0,0,0
12856,RM-1132,8/8/2013,0,0,0,0,0,0,0
12857,RM-1132,8/9/2013,0,0,0,0,0,0,0
12858,RM-1132,8/10/2013,0,0,0,0,0,0,0
12859,RM-1132,8/11/2013,0,0,0,0,0,0,0
12860,RM-1132,8/12/2013,0,0,0,0,0,0,0
12861,RM-1132,8/13/2013,0,0,0,0,0,0,0
12862,RM-1132,8/14/2013,0,0,0,0,0,0,0
12863,RM-1132,8/15/2013,0,0,0,0,0,0,0
12864,RM-1132,8/16/2013,0,0,0,0,0,0,0
12865,RM-1132,8/17/2013,0,0,0,0,0,0,0
12866,RM-1132,8/18/2013,0,0,0,0,0,0,0
12867,RM-1132,8/19/2013,0,0,0,0,0,0,0
12868,RM-1132,8/20/2013,0,0,0,0,0,0,0
12869,RM-1132,8/21/2013,0,0,0,0,0,0,0
12870,RM-1132,8/22/2013,0,0,0,0,0,0,0
12871,RM-1132,8/27/2013,0,0,0,0,0,0,0
12872,RM-1132,8/28/2013,0,0,0,0,0,0,0
12873,RM-1132,8/29/2013,0,0,0,0,0,0,0
12874,RM-1132,8/30/2013,0,0,0,0,0,0,0
12875,RM-1132,9/4/2013,0,0,0,0,0,0,0
12876,RM-1132,9/5/2013,0,0,0,0,0,0,0
12877,RM-1132,9/6/2013,0,0,0,0,0,0,0
12878,RM-1132,9/7/2013,0,0,0,0,0,0,0
12879,RM-1132,9/9/2013,0,0,0,0,0,0,0
12880,RM-1132,9/10/2013,0,0,0,0,0,0,0
12881,RM-1132,9/11/2013,0,0,0,0,0,0,0
12882,RM-1132,9/12/2013,0,0,0,0,0,0,0
12883,RM-1132,9/13/2013,0,0,0,0,0,0,0
12884,RM-1132,9/14/2013,0,0,0,0,0,0,0
12885,RM-1132,9/15/2013,0,0,0,0,0,0,0
12886,RM-1132,9/16/2013,0,0,0,0,0,0,0
12887,RM-1132,9/17/2013,0,0,0,0,0,0,0
13789,RM-1133,4/25/2014,0,0,0,0,0,0,0
13790,RM-1133,4/26/2014,0,0,0,0,0,0,0
13791,RM-1133,4/27/2014,0,0,0,0,0,0,0
13792,RM-1133,4/28/2014,0,0,0,0,0,0,0
13793,RM-1133,4/29/2014,0,0,0,0,0,0,0
13794,RM-1133,4/30/2014,0,0,0,0,0,0,0
13795,RM-1133,5/1/2014,0,0,0,0,0,0,0
13796,RM-1133,5/2/2014,0,0,0,0,0,0,0
13797,RM-1133,5/3/2014,0,0,0,0,0,0,0
13798,RM-1133,5/4/2014,0,0,0,0,0,0,0
13799,RM-1133,5/5/2014,0,0,0,0,0,0,0
13800,RM-1133,5/6/2014,0,0,0,0,0,0,0
13801,RM-1133,5/7/2014,0,0,0,0,0,0,0
13802,RM-1133,5/8/2014,0,0,0,0,0,0,0
13803,RM-1133,5/9/2014,0,0,0,0,0,0,0
13804,RM-1133,5/10/2014,0,0,0,0,0,0,0
13805,RM-1133,5/11/2014,0,0,0,0,0,0,0
13806,RM-1133,5/12/2014,0,0,0,0,0,0,0
13807,RM-1133,5/13/2014,0,0,0,0,0,0,0
13808,RM-1133,5/14/2014,0,0,0,0,0,0,0
13809,RM-1133,5/15/2014,0,0,0,0,0,0,0
13810,RM-1133,5/16/2014,0,0,0,0,0,0,0
13811,RM-1133,5/17/2014,0,0,0,0,0,0,0
13812,RM-1133,5/18/2014,0,0,0,0,0,0,0
13813,RM-1133,5/19/2014,0,0,0,0,0,0,0
13814,RM-1133,5/20/2014,0,0,0,0,0,0,0
13815,RM-1133,5/21/2014,0,0,0,0,0,0,0
13816,RM-1133,5/22/2014,0,0,0,0,0,0,0
13817,RM-1133,5/23/2014,0,0,0,0,0,0,0
13818,RM-1133,5/24/2014,0,0,0,0,0,0,0
13819,RM-1133,5/25/2014,0,0,0,0,0,0,0
13820,RM-1133,5/26/2014,0,0,0,0,0,0,0
13821,RM-1133,5/27/2014,0,0,0,0,0,0,0
13822,RM-1133,5/28/2014,0,0,0,0,0,0,0
13823,RM-1133,5/29/2014,0,0,0,0,0,0,0
13824,RM-1133,5/30/2014,0,0,0,0,0,0,0
13825,RM-1133,5/31/2014,0,0,0,0,0,0,0
13826,RM-1133,6/1/2014,0,0,0,0,0,0,0
13827,RM-1133,6/2/2014,0,0,0,0,0,0,0
13828,RM-1133,6/3/2014,0,0,0,0,0,0,0
13829,RM-1133,6/4/2014,0,0,0,0,0,0,0
13830,RM-1133,6/5/2014,0,0,0,0,0,0,0
13831,RM-1133,6/6/2014,0,0,0,0,0,0,0
13832,RM-1133,6/7/2014,0,0,0,0,0,0,0
13833,RM-1133,6/8/2014,0,0,0,0,0,0,0
13834,RM-1133,6/9/2014,0,0,0,0,0,0,0
13835,RM-1133,6/10/2014,0,0,0,0,0,0,0
13836,RM-1133,6/11/2014,0,0,0,0,0,0,0
13837,RM-1133,6/12/2014,0,0,0,0,0,0,0
13838,RM-1133,6/13/2014,0,0,0,0,0,0,0
13839,RM-1133,6/14/2014,0,0,0,0,0,0,0
13840,RM-1133,6/15/2014,0,0,0,0,0,0,0
13841,RM-1133,6/16/2014,0,0,0,0,0,0,0
13842,RM-1133,6/17/2014,0,0,0,0,0,0,0
13843,RM-1133,6/18/2014,0,0,0,0,0,0,0
13844,RM-1133,6/19/2014,0,0,0,0,0,0,0
13845,RM-1133,6/20/2014,0,0,0,0,0,0,0
13846,RM-1133,6/21/2014,0,0,0,0,0,0,0
13847,RM-1133,6/22/2014,0,0,0,0,0,0,0
13848,RM-1133,6/23/2014,0,0,0,0,0,0,0
13849,RM-1133,6/24/2014,0,0,0,0,0,0,0
13850,RM-1133,6/25/2014,0,0,0,0,0,0,0
13858,RM-1133,7/3/2014,0,0,0,0,0,0,0
13859,RM-1133,7/4/2014,0,0,0,0,0,0,0
13860,RM-1133,7/5/2014,0,0,0,0,0,0,0
13861,RM-1133,7/6/2014,0,0,0,0,0,0,0
13862,RM-1133,7/7/2014,0,0,0,0,0,0,0
13863,RM-1133,7/8/2014,0,0,0,0,0,0,0
13864,RM-1133,7/9/2014,0,0,0,0,0,0,0
13865,RM-1133,7/10/2014,0,0,0,0,0,0,0
13866,RM-1133,7/11/2014,0,0,0,0,0,0,0
13867,RM-1133,7/12/2014,0,0,0,0,0,0,0
13868,RM-1133,7/13/2014,0,0,0,0,0,0,0
13869,RM-1133,7/14/2014,0,0,0,0,0,0,0
13870,RM-1133,7/15/2014,0,0,0,0,0,0,0
13871,RM-1133,7/16/2014,0,0,0,0,0,0,0
13872,RM-1133,7/17/2014,0,0,0,0,0,0,0
13873,RM-1133,7/18/2014,0,0,0,0,0,0,0
13874,RM-1133,7/19/2014,0,0,0,0,0,0,0
13875,RM-1133,7/20/2014,0,0,0,0,0,0,0
13876,RM-1133,7/21/2014,0,0,0,0,0,0,0
13877,RM-1133,7/22/2014,0,0,0,0,0,0,0
13878,RM-1133,7/23/2014,0,0,0,0,0,0,0
13879,RM-1133,7/24/2014,0,0,0,0,0,0,0
13880,RM-1133,7/25/2014,0,0,0,0,0,0,0
13881,RM-1133,7/26/2014,0,0,0,0,0,0,0
13882,RM-1133,7/27/2014,0,0,0,0,0,0,0
13883,RM-1133,7/28/2014,0,0,0,0,0,0,0
13884,RM-1133,7/29/2014,0,0,0,0,0,0,0
13885,RM-1133,7/30/2014,0,0,0,0,0,0,0
13886,RM-1133,7/31/2014,0,0,0,0,0,0,0
13887,RM-1133,8/1/2014,0,0,0,0,0,0,0
13888,RM-1133,8/2/2014,0,0,0,0,0,0,0
13889,RM-1133,8/3/2014,0,0,0,0,0,0,0
13890,RM-1133,8/4/2014,0,0,0,0,0,0,0
13891,RM-1133,8/5/2014,0,0,0,0,0,0,0
13892,RM-1133,8/6/2014,0,0,0,0,0,0,0
13893,RM-1133,8/7/2014,0,0,0,0,0,0,0
13894,RM-1133,8/8/2014,0,0,0,0,0,0,0
13895,RM-1133,8/9/2014,0,0,0,0,0,0,0
13896,RM-1133,8/10/2014,0,0,0,0,0,0,0
13897,RM-1133,8/11/2014,0,0,0,0,0,0,0
13898,RM-1133,8/12/2014,0,0,0,0,0,0,0
13899,RM-1133,8/13/2014,0,0,0,0,0,0,0
13900,RM-1133,8/14/2014,0,0,0,0,0,0,0
13901,RM-1133,8/15/2014,0,0,0,0,0,0,0
13902,RM-1133,8/16/2014,0,0,0,0,0,0,0
13903,RM-1133,8/17/2014,0,0,0,0,0,0,0
13904,RM-1133,8/18/2014,0,0,0,0,0,0,0
13905,RM-1133,8/19/2014,0,0,0,0,0,0,0
13906,RM-1133,8/20/2014,0,0,0,0,0,0,0
13907,RM-1133,8/21/2014,0,0,0,0,0,0,0
13908,RM-1133,8/22/2014,0,0,0,0,0,0,0
13909,RM-1133,8/23/2014,0,0,0,0,0,0,0
13910,RM-1133,8/24/2014,0,0,0,0,0,0,0
13911,RM-1133,8/25/2014,0,0,0,0,0,0,0
13912,RM-1133,8/26/2014,0,0,0,0,0,0,0
13913,RM-1133,8/27/2014,0,0,0,0,0,0,0
13914,RM-1133,8/28/2014,0,0,0,0,0,0,0
13915,RM-1133,8/29/2014,0,0,0,0,0,0,0
13916,RM-1133,8/30/2014,0,0,0,0,0,0,0
13917,RM-1133,8/31/2014,0,0,0,0,0,0,0
13918,RM-1133,9/1/2014,0,0,0,0,0,0,0
13919,RM-1133,9/2/2014,0,0,0,0,0,0,0
13920,RM-1133,9/3/2014,0,0,0,0,0,0,0
13921,RM-1133,9/4/2014,0,0,0,0,0,0,0
13922,RM-1133,9/5/2014,0,0,0,0,0,0,0
13923,RM-1133,9/6/2014,0,0,0,0,0,0,0
13924,RM-1133,9/7/2014,0,0,0,0,0,0,0
13925,RM-1133,9/8/2014,0,0,0,0,0,0,0
13926,RM-1133,9/9/2014,0,0,0,0,0,0,0
13927,RM-1133,9/10/2014,0,0,0,0,0,0,0
13928,RM-1133,9/11/2014,0,0,0,0,0,0,0
13929,RM-1133,9/12/2014,0,0,0,0,0,0,0
13930,RM-1133,9/13/2014,0,0,0,0,0,0,0
13931,RM-1133,9/14/2014,0,0,0,0,0,0,0
13932,RM-1133,9/15/2014,0,0,0,0,0,0,0
13933,RM-1133,9/16/2014,0,0,0,0,0,0,0
13934,RM-1133,9/17/2014,0,0,0,0,0,0,0
13935,RM-1133,9/18/2014,0,0,0,0,0,0,0
13936,RM-1133,9/19/2014,0,0,0,0,0,0,0
13937,RM-1133,9/20/2014,0,0,0,0,0,0,0
13938,RM-1133,9/21/2014,0,0,0,0,0,0,0
13939,RM-1133,9/22/2014,0,0,0,0,0,0,0
13940,RM-1133,9/23/2014,0,0,0,0,0,0,0
13941,RM-1133,9/24/2014,0,0,0,0,0,0,0
13942,RM-1133,9/25/2014,0,0,0,0,0,0,0
13943,RM-1133,9/28/2014,0,0,0,0,0,0,0
13944,RM-1133,9/29/2014,0,0,0,0,0,0,0
13945,RM-1133,9/30/2014,0,0,0,0,0,0,0
13946,RM-1133,10/1/2014,0,0,0,0,0,0,0
13947,RM-1133,10/2/2014,0,0,0,0,0,0,0
13948,RM-1133,10/3/2014,0,0,0,0,0,0,0
13949,RM-1133,10/4/2014,0,0,0,0,0,0,0
13950,RM-1133,10/5/2014,0,0,0,0,0,0,0
13951,RM-1133,10/6/2014,0,0,0,0,0,0,0
13952,RM-1133,10/7/2014,0,0,0,0,0,0,0
13953,RM-1133,10/8/2014,0,0,0,0,0,0,0
13954,RM-1133,10/9/2014,0,0,0,0,0,0,0
13955,RM-1133,10/10/2014,0,0,0,0,0,0,0
13956,RM-1133,10/11/2014,0,0,0,0,0,0,0
13957,RM-1133,10/12/2014,0,0,0,0,0,0,0
13958,RM-1133,10/13/2014,0,0,0,0,0,0,0
13959,RM-1133,10/14/2014,0,0,0,0,0,0,0
13960,RM-1133,10/15/2014,0,0,0,0,0,0,0
13961,RM-1133,10/16/2014,0,0,0,0,0,0,0
13962,RM-1133,10/17/2014,0,0,0,0,0,0,0
13963,RM-1133,10/18/2014,0,0,0,0,0,0,0
13964,RM-1133,10/19/2014,0,0,0,0,0,0,0
13965,RM-1133,10/20/2014,0,0,0,0,0,0,0
13966,RM-1133,10/21/2014,0,0,0,0,0,0,0
13967,RM-1133,10/22/2014,0,0,0,0,0,0,0
13968,RM-1133,10/23/2014,0,0,0,0,0,0,0
13969,RM-1133,10/24/2014,0,0,0,0,0,0,0
13970,RM-1133,10/25/2014,0,0,0,0,0,0,0
13971,RM-1133,10/26/2014,0,0,0,0,0,0,0
13972,RM-1133,10/27/2014,0,0,0,0,0,0,0
13973,RM-1133,10/28/2014,0,0,0,0,0,0,0
13974,RM-1133,10/29/2014,0,0,0,0,0,0,0
13975,RM-1133,10/30/2014,0,0,0,0,0,0,0
13976,RM-1133,10/31/2014,0,0,0,0,0,0,0
13977,RM-1133,11/1/2014,0,0,0,0,0,0,0
13978,RM-1133,11/2/2014,0,0,0,0,0,0,0
13979,RM-1133,11/3/2014,0,0,0,0,0,0,0
13980,RM-1133,11/4/2014,0,0,0,0,0,0,0
13981,RM-1133,11/5/2014,0,0,0,0,0,0,0
13982,RM-1133,11/6/2014,0,0,0,0,0,0,0
13983,RM-1133,11/7/2014,0,0,0,0,0,0,0
13984,RM-1133,11/8/2014,0,0,0,0,0,0,0
13985,RM-1133,11/9/2014,0,0,0,0,0,0,0
13986,RM-1133,11/10/2014,0,0,0,0,0,0,0
13987,RM-1133,11/11/2014,0,0,0,0,0,0,0
13988,RM-1133,11/12/2014,0,0,0,0,0,0,0
13989,RM-1133,11/13/2014,0,0,0,0,0,0,0
13990,RM-1133,11/14/2014,0,0,0,0,0,0,0
13991,RM-1133,11/15/2014,0,0,0,0,0,0,0
13992,RM-1133,11/16/2014,0,0,0,0,0,0,0
13993,RM-1133,11/17/2014,0,0,0,0,0,0,0
13994,RM-1133,11/18/2014,0,0,0,0,0,0,0
13995,RM-1133,11/19/2014,0,0,0,0,0,0,0
13996,RM-1133,11/20/2014,0,0,0,0,0,0,0
13997,RM-1133,11/21/2014,0,0,0,0,0,0,0
13998,RM-1133,11/22/2014,0,0,0,0,0,0,0
13999,RM-1133,11/23/2014,0,0,0,0,0,0,0
14000,RM-1133,11/24/2014,0,0,0,0,0,0,0
14001,RM-1133,11/25/2014,0,0,0,0,0,0,0
14002,RM-1133,11/26/2014,0,0,0,0,0,0,0
14003,RM-1133,11/27/2014,0,0,0,0,0,0,0
14004,RM-1133,11/28/2014,0,0,0,0,0,0,0
14005,RM-1133,11/29/2014,0,0,0,0,0,0,0
14006,RM-1133,11/30/2014,0,0,0,0,0,0,0
14007,RM-1133,12/1/2014,0,0,0,0,0,0,0
14008,RM-1133,12/2/2014,0,0,0,0,0,0,0
14009,RM-1133,12/3/2014,0,0,0,0,0,0,0
14010,RM-1133,12/4/2014,0,0,0,0,0,0,0
14011,RM-1133,12/5/2014,0,0,0,0,0,0,0
14012,RM-1133,12/6/2014,0,0,0,0,0,0,0
14013,RM-1133,12/7/2014,0,0,0,0,0,0,0
14014,RM-1133,12/8/2014,0,0,0,0,0,0,0
14015,RM-1133,12/9/2014,0,0,0,0,0,0,0
14016,RM-1133,12/10/2014,0,0,0,0,0,0,0
14017,RM-1133,12/11/2014,0,0,0,0,0,0,0
14018,RM-1133,12/12/2014,0,0,0,0,0,0,0
14019,RM-1133,12/13/2014,0,0,0,0,0,0,0
14020,RM-1133,12/14/2014,0,0,0,0,0,0,0
14021,RM-1133,12/15/2014,0,0,0,0,0,0,0
14022,RM-1133,12/16/2014,0,0,0,0,0,0,0
14023,RM-1133,12/17/2014,0,0,0,0,0,0,0
14024,RM-1133,12/18/2014,0,0,0,0,0,0,0
14025,RM-1133,12/19/2014,0,0,0,0,0,0,0
14026,RM-1133,12/20/2014,0,0,0,0,0,0,0
14027,RM-1133,12/21/2014,0,0,0,0,0,0,0
14028,RM-1133,12/22/2014,0,0,0,0,0,0,0
14029,RM-1133,12/23/2014,0,0,0,0,0,0,0
14030,RM-1133,12/24/2014,0,0,0,0,0,0,0
14031,RM-1133,12/25/2014,0,0,0,0,0,0,0
14032,RM-1133,12/26/2014,0,0,0,0,0,0,0
14033,RM-1133,12/27/2014,0,0,0,0,0,0,0
14034,RM-1133,12/28/2014,0,0,0,0,0,0,0
14035,RM-1133,12/29/2014,0,0,0,0,0,0,0
14036,RM-1133,12/30/2014,0,0,0,0,0,0,0
14037,RM-1133,12/31/2014,0,0,0,0,0,0,0
14038,RM-1133,1/1/2015,0,0,0,0,0,0,0
14039,RM-1133,1/2/2015,0,0,0,0,0,0,0
14040,RM-1133,1/3/2015,0,0,0,0,0,0,0
14041,RM-1133,1/4/2015,0,0,0,0,0,0,0
14042,RM-1133,1/5/2015,0,0,0,0,0,0,0
14043,RM-1133,1/6/2015,0,0,0,0,0,0,0
14044,RM-1133,1/7/2015,0,0,0,0,0,0,0
14045,RM-1133,1/8/2015,0,0,0,0,0,0,0
14046,RM-1133,1/9/2015,0,0,0,0,0,0,0
14047,RM-1133,1/10/2015,0,0,0,0,0,0,0
14048,RM-1133,1/11/2015,0,0,0,0,0,0,0
14049,RM-1133,1/12/2015,0,0,0,0,0,0,0
14050,RM-1133,1/13/2015,0,0,0,0,0,0,0
14051,RM-1133,1/14/2015,0,0,0,0,0,0,0
14052,RM-1133,1/15/2015,0,0,0,0,0,0,0
14053,RM-1133,1/16/2015,0,0,0,0,0,0,0
14054,RM-1133,1/17/2015,0,0,0,0,0,0,0
14055,RM-1133,1/18/2015,0,0,0,0,0,0,0
14056,RM-1133,1/19/2015,0,0,0,0,0,0,0
14057,RM-1133,1/20/2015,0,0,0,0,0,0,0
14058,RM-1133,1/21/2015,0,0,0,0,0,0,0
14059,RM-1133,1/22/2015,0,0,0,0,0,0,0
14060,RM-1133,1/23/2015,0,0,0,0,0,0,0
14061,RM-1133,1/24/2015,0,0,0,0,0,0,0
14062,RM-1133,1/25/2015,0,0,0,0,0,0,0
14063,RM-1133,1/26/2015,0,0,0,0,0,0,0
14064,RM-1133,1/27/2015,0,0,0,0,0,0,0
14065,RM-1133,1/28/2015,0,0,0,0,0,0,0
14066,RM-1133,1/29/2015,0,0,0,0,0,0,0
14067,RM-1133,1/30/2015,0,0,0,0,0,0,0
14068,RM-1133,1/31/2015,0,0,0,0,0,0,0
14069,RM-1133,2/1/2015,0,0,0,0,0,0,0
14070,RM-1133,2/2/2015,0,0,0,0,0,0,0
14071,RM-1133,2/3/2015,0,0,0,0,0,0,0
14072,RM-1133,2/4/2015,0,0,0,0,0,0,0
14073,RM-1133,2/5/2015,0,0,0,0,0,0,0
14074,RM-1133,2/6/2015,0,0,0,0,0,0,0
14075,RM-1133,2/7/2015,0,0,0,0,0,0,0
14076,RM-1133,2/8/2015,0,0,0,0,0,0,0
14077,RM-1133,2/9/2015,0,0,0,0,0,0,0
14078,RM-1133,2/10/2015,0,0,0,0,0,0,0
14079,RM-1133,2/11/2015,0,0,0,0,0,0,0
14080,RM-1133,2/12/2015,0,0,0,0,0,0,0
14081,RM-1133,2/13/2015,0,0,0,0,0,0,0
14082,RM-1133,2/14/2015,0,0,0,0,0,0,0
14083,RM-1133,2/15/2015,0,0,0,0,0,0,0
14084,RM-1133,2/16/2015,0,0,0,0,0,0,0
14085,RM-1133,2/17/2015,0,0,0,0,0,0,0
14086,RM-1133,2/18/2015,0,0,0,0,0,0,0
14087,RM-1133,2/19/2015,0,0,0,0,0,0,0
14088,RM-1133,2/20/2015,0,0,0,0,0,0,0
14089,RM-1133,2/21/2015,0,0,0,0,0,0,0
14090,RM-1133,2/22/2015,0,0,0,0,0,0,0
14091,RM-1133,2/23/2015,0,0,0,0,0,0,0
14092,RM-1133,2/24/2015,0,0,0,0,0,0,0
14093,RM-1133,2/25/2015,0,0,0,0,0,0,0
14094,RM-1133,2/26/2015,0,0,0,0,0,0,0
14095,RM-1133,2/27/2015,0,0,0,0,0,0,0
14096,RM-1133,2/28/2015,0,0,0,0,0,0,0
14097,RM-1133,3/1/2015,0,0,0,0,0,0,0
14098,RM-1133,3/2/2015,0,0,0,0,0,0,0
14099,RM-1133,3/3/2015,0,0,0,0,0,0,0
14100,RM-1133,3/4/2015,0,0,0,0,0,0,0
14101,RM-1133,3/5/2015,0,0,0,0,0,0,0
14102,RM-1133,3/6/2015,0,0,0,0,0,0,0
14103,RM-1133,3/7/2015,0,0,0,0,0,0,0
14104,RM-1133,3/8/2015,0,0,0,0,0,0,0
14105,RM-1133,3/9/2015,0,0,0,0,0,0,0
14106,RM-1133,3/10/2015,0,0,0,0,0,0,0
14107,RM-1133,3/11/2015,0,0,0,0,0,0,0
14108,RM-1133,3/12/2015,0,0,0,0,0,0,0
14109,RM-1133,3/13/2015,0,0,0,0,0,0,0
14110,RM-1133,3/14/2015,0,0,0,0,0,0,0
14111,RM-1133,3/15/2015,0,0,0,0,0,0,0
14112,RM-1133,3/16/2015,0,0,0,0,0,0,0
14113,RM-1133,3/17/2015,0,0,0,0,0,0,0
14114,RM-1133,3/18/2015,0,0,0,0,0,0,0
14115,RM-1133,3/19/2015,0,0,0,0,0,0,0
14116,RM-1133,3/20/2015,0,0,0,0,0,0,0
14117,RM-1133,3/21/2015,0,0,0,0,0,0,0
14118,RM-1133,3/22/2015,0,0,0,0,0,0,0
14119,RM-1133,3/23/2015,0,0,0,0,0,0,0
14120,RM-1133,3/24/2015,0,0,0,0,0,0,0
14121,RM-1133,3/25/2015,0,0,0,0,0,0,0
14122,RM-1133,3/26/2015,0,0,0,0,0,0,0
14123,RM-1133,3/27/2015,0,0,0,0,0,0,0
14124,RM-1133,3/28/2015,0,0,0,0,0,0,0
14125,RM-1133,3/29/2015,0,0,0,0,0,0,0
14126,RM-1133,3/30/2015,0,0,0,0,0,0,0
14127,RM-1133,3/31/2015,0,0,0,0,0,0,0
14128,RM-1133,4/1/2015,0,0,0,0,0,0,0
14129,RM-1133,4/2/2015,0,0,0,0,0,0,0
14130,RM-1133,4/3/2015,0,0,0,0,0,0,0
14131,RM-1133,4/4/2015,0,0,0,0,0,0,0
14132,RM-1133,4/5/2015,0,0,0,0,0,0,0
14133,RM-1133,4/6/2015,0,0,0,0,0,0,0
14134,RM-1133,4/7/2015,0,0,0,0,0,0,0
14135,RM-1133,4/8/2015,0,0,0,0,0,0,0
14136,RM-1133,4/9/2015,0,0,0,0,0,0,0
14137,RM-1133,4/10/2015,0,0,0,0,0,0,0
14138,RM-1133,4/11/2015,0,0,0,0,0,0,0
14139,RM-1133,4/12/2015,0,0,0,0,0,0,0
14140,RM-1133,4/13/2015,0,0,0,0,0,0,0
14141,RM-1133,4/14/2015,0,0,0,0,0,0,0
14142,RM-1133,4/15/2015,0,0,0,0,0,0,0
14143,RM-1133,4/16/2015,0,0,0,0,0,0,0
14144,RM-1133,4/17/2015,0,0,0,0,0,0,0
14145,RM-1133,4/18/2015,0,0,0,0,0,0,0
14146,RM-1133,4/19/2015,0,0,0,0,0,0,0
14147,RM-1133,4/20/2015,0,0,0,0,0,0,0
14148,RM-1133,4/21/2015,0,0,0,0,0,0,0
14149,RM-1133,4/22/2015,0,0,0,0,0,0,0
14150,RM-1133,4/23/2015,0,0,0,0,0,0,0
14151,RM-1133,4/24/2015,0,0,0,0,0,0,0
14152,RM-1133,4/25/2015,0,0,0,0,0,0,0
14153,RM-1133,4/26/2015,0,0,0,0,0,0,0
14154,RM-1133,4/27/2015,0,0,0,0,0,0,0
14155,RM-1133,4/28/2015,0,0,0,0,0,0,0
14156,RM-1133,4/29/2015,0,0,0,0,0,0,0
14157,RM-1133,4/30/2015,0,0,0,0,0,0,0
14158,RM-1133,5/1/2015,0,0,0,0,0,0,0
14159,RM-1133,5/2/2015,0,0,0,0,0,0,0
14160,RM-1133,5/3/2015,0,0,0,0,0,0,0
14161,RM-1133,5/4/2015,0,0,0,0,0,0,0
14162,RM-1133,5/5/2015,0,0,0,0,0,0,0
14163,RM-1133,5/6/2015,0,0,0,0,0,0,0
14164,RM-1133,5/7/2015,0,0,0,0,0,0,0
14165,RM-1133,5/8/2015,0,0,0,0,0,0,0
14166,RM-1133,5/9/2015,0,0,0,0,0,0,0
14167,RM-1133,5/10/2015,0,0,0,0,0,0,0
14168,RM-1133,5/11/2015,0,0,0,0,0,0,0
14169,RM-1133,5/12/2015,0,0,0,0,0,0,0
14170,RM-1133,5/13/2015,0,0,0,0,0,0,0
14171,RM-1133,5/14/2015,0,0,0,0,0,0,0
14172,RM-1133,5/15/2015,0,0,0,0,0,0,0
14173,RM-1133,5/16/2015,0,0,0,0,0,0,0
14174,RM-1133,5/17/2015,0,0,0,0,0,0,0
14175,RM-1133,5/18/2015,0,0,0,0,0,0,0
14176,RM-1133,5/19/2015,0,0,0,0,0,0,0
14177,RM-1133,5/20/2015,0,0,0,0,0,0,0
14178,RM-1133,5/21/2015,0,0,0,0,0,0,0
14179,RM-1133,5/22/2015,0,0,0,0,0,0,0
14180,RM-1133,5/23/2015,0,0,0,0,0,0,0
14181,RM-1133,5/24/2015,0,0,0,0,0,0,0
14182,RM-1133,5/25/2015,0,0,0,0,0,0,0
14183,RM-1133,5/26/2015,0,0,0,0,0,0,0
14184,RM-1133,5/27/2015,0,0,0,0,0,0,0
14185,RM-1133,5/28/2015,0,0,0,0,0,0,0
14186,RM-1133,5/29/2015,0,0,0,0,0,0,0
14187,RM-1133,5/30/2015,0,0,0,0,0,0,0
14188,RM-1133,5/31/2015,0,0,0,0,0,0,0
14189,RM-1134,7/1/2013,0,0,0,0,0,0,0
14190,RM-1134,7/2/2013,0,0,0,0,0,0,0
14191,RM-1134,7/3/2013,0,0,0,0,0,0,0
14192,RM-1134,7/4/2013,0,0,0,0,0,0,0
14193,RM-1134,7/5/2013,0,0,0,0,0,0,0
14194,RM-1134,7/6/2013,0,0,0,0,0,0,0
14195,RM-1134,7/7/2013,0,0,0,0,0,0,0
14196,RM-1134,7/8/2013,0,0,0,0,0,0,0
14197,RM-1134,7/9/2013,0,0,0,0,0,0,0
14198,RM-1134,7/10/2013,0,0,0,0,0,0,0
14199,RM-1134,7/11/2013,0,0,0,0,0,0,0
14200,RM-1134,7/12/2013,0,0,0,0,0,0,0
14201,RM-1134,1/4/2014,0,0,0,0,0,0,0
14202,RM-1134,1/5/2014,0,0,0,0,0,0,0
14203,RM-1134,1/6/2014,0,0,0,0,0,0,0
14204,RM-1134,1/7/2014,0,0,0,0,0,0,0
14205,RM-1134,1/8/2014,0,0,0,0,0,0,0
14206,RM-1134,1/9/2014,0,0,0,0,0,0,0
14207,RM-1134,1/10/2014,0,0,0,0,0,0,0
14208,RM-1134,1/11/2014,0,0,0,0,0,0,0
14209,RM-1134,1/12/2014,0,0,0,0,0,0,0
14210,RM-1134,1/13/2014,0,0,0,0,0,0,0
14211,RM-1134,1/14/2014,0,0,0,0,0,0,0
14212,RM-1134,1/15/2014,0,0,0,0,0,0,0
14213,RM-1134,1/16/2014,0,0,0,0,0,0,0
14214,RM-1134,1/17/2014,0,0,0,0,0,0,0
14215,RM-1134,1/18/2014,0,0,0,0,0,0,0
14216,RM-1134,1/19/2014,0,0,0,0,0,0,0
14217,RM-1134,1/20/2014,0,0,0,0,0,0,0
14218,RM-1134,1/21/2014,0,0,0,0,0,0,0
14219,RM-1134,1/22/2014,0,0,0,0,0,0,0
14220,RM-1134,1/23/2014,0,0,0,0,0,0,0
14221,RM-1134,1/24/2014,0,0,0,0,0,0,0
14222,RM-1134,1/25/2014,0,0,0,0,0,0,0
14223,RM-1134,1/26/2014,0,0,0,0,0,0,0
14224,RM-1134,1/27/2014,0,0,0,0,0,0,0
14225,RM-1134,1/28/2014,0,0,0,0,0,0,0
14226,RM-1134,1/29/2014,0,0,0,0,0,0,0
14227,RM-1134,1/30/2014,0,0,0,0,0,0,0
14228,RM-1134,1/31/2014,0,0,0,0,0,0,0
14229,RM-1134,2/1/2014,0,0,0,0,0,0,0
14230,RM-1134,2/2/2014,0,0,0,0,0,0,0
14231,RM-1134,2/3/2014,0,0,0,0,0,0,0
14232,RM-1134,2/4/2014,0,0,0,0,0,0,0
14233,RM-1134,2/5/2014,0,0,0,0,0,0,0
14234,RM-1134,2/6/2014,0,0,0,0,0,0,0
14235,RM-1134,2/7/2014,0,0,0,0,0,0,0
14236,RM-1134,2/8/2014,0,0,0,0,0,0,0
14237,RM-1134,2/9/2014,0,0,0,0,0,0,0
14238,RM-1134,2/10/2014,0,0,0,0,0,0,0
14239,RM-1134,2/11/2014,0,0,0,0,0,0,0
14240,RM-1134,2/12/2014,0,0,0,0,0,0,0
14241,RM-1134,2/13/2014,0,0,0,0,0,0,0
14242,RM-1134,2/14/2014,0,0,0,0,0,0,0
14243,RM-1134,2/15/2014,0,0,0,0,0,0,0
14244,RM-1134,2/16/2014,0,0,0,0,0,0,0
14245,RM-1134,2/17/2014,0,0,0,0,0,0,0
14246,RM-1134,2/18/2014,0,0,0,0,0,0,0
14247,RM-1134,2/19/2014,0,0,0,0,0,0,0
14248,RM-1134,2/20/2014,0,0,0,0,0,0,0
14249,RM-1134,2/21/2014,0,0,0,0,0,0,0
14250,RM-1134,2/22/2014,0,0,0,0,0,0,0
14251,RM-1134,2/23/2014,0,0,0,0,0,0,0
14252,RM-1134,2/24/2014,0,0,0,0,0,0,0
14253,RM-1134,2/25/2014,0,0,0,0,0,0,0
14254,RM-1134,2/26/2014,0,0,0,0,0,0,0
14255,RM-1134,2/27/2014,0,0,0,0,0,0,0
14256,RM-1134,2/28/2014,0,0,0,0,0,0,0
14257,RM-1134,3/1/2014,0,0,0,0,0,0,0
14258,RM-1134,3/2/2014,0,0,0,0,0,0,0
14259,RM-1134,3/3/2014,0,0,0,0,0,0,0
14260,RM-1134,3/4/2014,0,0,0,0,0,0,0
14261,RM-1134,3/5/2014,0,0,0,0,0,0,0
14262,RM-1134,3/6/2014,0,0,0,0,0,0,0
14263,RM-1134,3/7/2014,0,0,0,0,0,0,0
14264,RM-1134,3/8/2014,0,0,0,0,0,0,0
14265,RM-1134,3/9/2014,0,0,0,0,0,0,0
14266,RM-1134,3/10/2014,0,0,0,0,0,0,0
14267,RM-1134,3/11/2014,0,0,0,0,0,0,0
14268,RM-1134,3/12/2014,0,0,0,0,0,0,0
14269,RM-1134,3/13/2014,0,0,0,0,0,0,0
14270,RM-1134,3/14/2014,0,0,0,0,0,0,0
14568,RM-1134,1/9/2015,0,0,0,0,0,0,0
14569,RM-1134,1/10/2015,0,0,0,0,0,0,0
14570,RM-1134,1/11/2015,0,0,0,0,0,0,0
14571,RM-1134,1/12/2015,0,0,0,0,0,0,0
14572,RM-1134,1/13/2015,0,0,0,0,0,0,0
14573,RM-1134,1/14/2015,0,0,0,0,0,0,0
14574,RM-1134,1/15/2015,0,0,0,0,0,0,0
14575,RM-1134,1/16/2015,0,0,0,0,0,0,0
14576,RM-1134,1/17/2015,0,0,0,0,0,0,0
14577,RM-1134,1/18/2015,0,0,0,0,0,0,0
14578,RM-1134,1/19/2015,0,0,0,0,0,0,0
14579,RM-1134,1/20/2015,0,0,0,0,0,0,0
14580,RM-1134,1/21/2015,0,0,0,0,0,0,0
14581,RM-1134,1/22/2015,0,0,0,0,0,0,0
14582,RM-1134,1/23/2015,0,0,0,0,0,0,0
14583,RM-1134,1/24/2015,0,0,0,0,0,0,0
14584,RM-1134,1/25/2015,0,0,0,0,0,0,0
14585,RM-1134,1/26/2015,0,0,0,0,0,0,0
14586,RM-1134,1/27/2015,0,0,0,0,0,0,0
14587,RM-1134,1/28/2015,0,0,0,0,0,0,0
14588,RM-1134,1/29/2015,0,0,0,0,0,0,0
14589,RM-1134,1/30/2015,0,0,0,0,0,0,0
14590,RM-1134,1/31/2015,0,0,0,0,0,0,0
14591,RM-1134,2/1/2015,0,0,0,0,0,0,0
14592,RM-1134,2/2/2015,0,0,0,0,0,0,0
14593,RM-1134,2/3/2015,0,0,0,0,0,0,0
14594,RM-1134,2/4/2015,0,0,0,0,0,0,0
14595,RM-1134,2/5/2015,0,0,0,0,0,0,0
14596,RM-1134,2/6/2015,0,0,0,0,0,0,0
14597,RM-1134,2/7/2015,0,0,0,0,0,0,0
14598,RM-1134,2/8/2015,0,0,0,0,0,0,0
14599,RM-1134,2/9/2015,0,0,0,0,0,0,0
14600,RM-1134,2/10/2015,0,0,0,0,0,0,0
14601,RM-1134,2/11/2015,0,0,0,0,0,0,0
14602,RM-1134,2/12/2015,0,0,0,0,0,0,0
14603,RM-1134,2/13/2015,0,0,0,0,0,0,0
14604,RM-1134,2/14/2015,0,0,0,0,0,0,0
14605,RM-1134,2/15/2015,0,0,0,0,0,0,0
14606,RM-1134,2/16/2015,0,0,0,0,0,0,0
14607,RM-1134,2/17/2015,0,0,0,0,0,0,0
14608,RM-1134,2/18/2015,0,0,0,0,0,0,0
14609,RM-1134,2/19/2015,0,0,0,0,0,0,0
14610,RM-1134,2/20/2015,0,0,0,0,0,0,0
14611,RM-1134,2/21/2015,0,0,0,0,0,0,0
14612,RM-1134,2/22/2015,0,0,0,0,0,0,0
14613,RM-1134,2/23/2015,0,0,0,0,0,0,0
14614,RM-1134,2/24/2015,0,0,0,0,0,0,0
14615,RM-1134,2/25/2015,0,0,0,0,0,0,0
14616,RM-1134,2/26/2015,0,0,0,0,0,0,0
14617,RM-1134,2/27/2015,0,0,0,0,0,0,0
14618,RM-1134,2/28/2015,0,0,0,0,0,0,0
14619,RM-1134,3/1/2015,0,0,0,0,0,0,0
14620,RM-1134,3/2/2015,0,0,0,0,0,0,0
14621,RM-1134,3/3/2015,0,0,0,0,0,0,0
14622,RM-1134,3/4/2015,0,0,0,0,0,0,0
14623,RM-1134,3/5/2015,0,0,0,0,0,0,0
14624,RM-1134,3/6/2015,0,0,0,0,0,0,0
14625,RM-1134,3/7/2015,0,0,0,0,0,0,0
14626,RM-1134,3/8/2015,0,0,0,0,0,0,0
14627,RM-1134,3/9/2015,0,0,0,0,0,0,0
14628,RM-1134,3/10/2015,0,0,0,0,0,0,0
14629,RM-1134,3/11/2015,0,0,0,0,0,0,0
14630,RM-1134,3/12/2015,0,0,0,0,0,0,0
14631,RM-1134,3/13/2015,0,0,0,0,0,0,0
14632,RM-1134,3/14/2015,0,0,0,0,0,0,0
14633,RM-1134,3/15/2015,0,0,0,0,0,0,0
14634,RM-1134,3/16/2015,0,0,0,0,0,0,0
14635,RM-1134,3/17/2015,0,0,0,0,0,0,0
14636,RM-1134,3/18/2015,0,0,0,0,0,0,0
14637,RM-1134,3/19/2015,0,0,0,0,0,0,0
14638,RM-1134,3/20/2015,0,0,0,0,0,0,0
14639,RM-1134,3/21/2015,0,0,0,0,0,0,0
14640,RM-1134,3/22/2015,0,0,0,0,0,0,0
14641,RM-1134,3/23/2015,0,0,0,0,0,0,0
14642,RM-1134,3/24/2015,0,0,0,0,0,0,0
14643,RM-1134,3/25/2015,0,0,0,0,0,0,0
14644,RM-1134,3/26/2015,0,0,0,0,0,0,0
14645,RM-1134,3/27/2015,0,0,0,0,0,0,0
14646,RM-1134,3/28/2015,0,0,0,0,0,0,0
14647,RM-1134,3/29/2015,0,0,0,0,0,0,0
14648,RM-1134,3/30/2015,0,0,0,0,0,0,0
14649,RM-1134,3/31/2015,0,0,0,0,0,0,0
14650,RM-1134,4/1/2015,0,0,0,0,0,0,0
14651,RM-1134,4/2/2015,0,0,0,0,0,0,0
14652,RM-1134,4/3/2015,0,0,0,0,0,0,0
14653,RM-1134,4/4/2015,0,0,0,0,0,0,0
14654,RM-1134,4/5/2015,0,0,0,0,0,0,0
14655,RM-1134,4/6/2015,0,0,0,0,0,0,0
14656,RM-1134,4/7/2015,0,0,0,0,0,0,0
14657,RM-1134,4/8/2015,0,0,0,0,0,0,0
14658,RM-1134,4/9/2015,0,0,0,0,0,0,0
14659,RM-1134,4/10/2015,0,0,0,0,0,0,0
14660,RM-1134,4/11/2015,0,0,0,0,0,0,0
14661,RM-1134,4/12/2015,0,0,0,0,0,0,0
14662,RM-1134,4/13/2015,0,0,0,0,0,0,0
14663,RM-1134,4/14/2015,0,0,0,0,0,0,0
14664,RM-1134,4/15/2015,0,0,0,0,0,0,0
14665,RM-1134,4/16/2015,0,0,0,0,0,0,0
14666,RM-1134,4/17/2015,0,0,0,0,0,0,0
14667,RM-1134,4/18/2015,0,0,0,0,0,0,0
14668,RM-1134,4/19/2015,0,0,0,0,0,0,0
14669,RM-1134,4/20/2015,0,0,0,0,0,0,0
14670,RM-1134,4/21/2015,0,0,0,0,0,0,0
14671,RM-1134,4/22/2015,0,0,0,0,0,0,0
14672,RM-1134,4/23/2015,0,0,0,0,0,0,0
14673,RM-1134,4/24/2015,0,0,0,0,0,0,0
14674,RM-1134,4/25/2015,0,0,0,0,0,0,0
14675,RM-1134,4/26/2015,0,0,0,0,0,0,0
14676,RM-1134,4/27/2015,0,0,0,0,0,0,0
14677,RM-1134,4/28/2015,0,0,0,0,0,0,0
14678,RM-1134,4/29/2015,0,0,0,0,0,0,0
14679,RM-1134,4/30/2015,0,0,0,0,0,0,0
14680,RM-1134,5/1/2015,0,0,0,0,0,0,0
14681,RM-1134,5/2/2015,0,0,0,0,0,0,0
14682,RM-1134,5/3/2015,0,0,0,0,0,0,0
14683,RM-1134,5/4/2015,0,0,0,0,0,0,0
14684,RM-1134,5/5/2015,0,0,0,0,0,0,0
14685,RM-1134,5/6/2015,0,0,0,0,0,0,0
14686,RM-1134,5/7/2015,0,0,0,0,0,0,0
14687,RM-1134,5/8/2015,0,0,0,0,0,0,0
14688,RM-1134,5/9/2015,0,0,0,0,0,0,0
14689,RM-1134,5/10/2015,0,0,0,0,0,0,0
14690,RM-1134,5/11/2015,0,0,0,0,0,0,0
14691,RM-1134,5/12/2015,0,0,0,0,0,0,0
14692,RM-1134,5/13/2015,0,0,0,0,0,0,0
14693,RM-1134,5/14/2015,0,0,0,0,0,0,0
14694,RM-1134,5/15/2015,0,0,0,0,0,0,0
14695,RM-1134,5/16/2015,0,0,0,0,0,0,0
14696,RM-1134,5/17/2015,0,0,0,0,0,0,0
14697,RM-1134,5/18/2015,0,0,0,0,0,0,0
14698,RM-1134,5/19/2015,0,0,0,0,0,0,0
14699,RM-1134,5/20/2015,0,0,0,0,0,0,0
14700,RM-1134,5/21/2015,0,0,0,0,0,0,0
14701,RM-1134,5/22/2015,0,0,0,0,0,0,0
14702,RM-1134,5/23/2015,0,0,0,0,0,0,0
14703,RM-1134,5/24/2015,0,0,0,0,0,0,0
14704,RM-1134,5/25/2015,0,0,0,0,0,0,0
14705,RM-1134,5/26/2015,0,0,0,0,0,0,0
14706,RM-1134,5/27/2015,0,0,0,0,0,0,0
14707,RM-1134,5/28/2015,0,0,0,0,0,0,0
14708,RM-1134,5/29/2015,0,0,0,0,0,0,0
14709,RM-1134,5/30/2015,0,0,0,0,0,0,0
14710,RM-1134,5/31/2015,0,0,0,0,0,0,0
14711,RM-1139,6/28/2013,0,0,0,0,0,0,0
14712,RM-1139,6/29/2013,0,0,0,0,0,0,0
14713,RM-1139,6/30/2013,0,0,0,0,0,0,0
14714,RM-1139,7/1/2013,0,0,0,0,0,0,0
14715,RM-1139,7/2/2013,0,0,0,0,0,0,0
14716,RM-1139,7/3/2013,0,0,0,0,0,0,0
14717,RM-1139,7/4/2013,0,0,0,0,0,0,0
14718,RM-1139,7/5/2013,0,0,0,0,0,0,0
14719,RM-1139,7/6/2013,0,0,0,0,0,0,0
14720,RM-1139,7/7/2013,0,0,0,0,0,0,0
14721,RM-1139,7/8/2013,0,0,0,0,0,0,0
14722,RM-1139,7/9/2013,0,0,0,0,0,0,0
14723,RM-1139,7/10/2013,0,0,0,0,0,0,0
14724,RM-1139,7/11/2013,0,0,0,0,0,0,0
14725,RM-1139,7/12/2013,0,0,0,0,0,0,0
14726,RM-1139,7/13/2013,0,0,0,0,0,0,0
14727,RM-1139,7/14/2013,0,0,0,0,0,0,0
14728,RM-1139,7/15/2013,0,0,0,0,0,0,0
14729,RM-1139,7/17/2013,0,0,0,0,0,0,0
14730,RM-1139,7/18/2013,0,0,0,0,0,0,0
14731,RM-1139,7/19/2013,0,0,0,0,0,0,0
14732,RM-1139,7/20/2013,0,0,0,0,0,0,0
14733,RM-1139,7/21/2013,0,0,0,0,0,0,0
14734,RM-1139,7/22/2013,0,0,0,0,0,0,0
14735,RM-1139,7/23/2013,0,0,0,0,0,0,0
14736,RM-1139,7/24/2013,0,0,0,0,0,0,0
14737,RM-1139,7/25/2013,0,0,0,0,0,0,0
14738,RM-1139,7/26/2013,0,0,0,0,0,0,0
14739,RM-1139,7/27/2013,0,0,0,0,0,0,0
14740,RM-1139,7/28/2013,0,0,0,0,0,0,0
14741,RM-1139,7/29/2013,0,0,0,0,0,0,0
14742,RM-1139,7/30/2013,0,0,0,0,0,0,0
14743,RM-1139,7/31/2013,0,0,0,0,0,0,0
14744,RM-1139,8/1/2013,0,0,0,0,0,0,0
14745,RM-1139,8/2/2013,0,0,0,0,0,0,0
14746,RM-1139,8/3/2013,0,0,0,0,0,0,0
14747,RM-1139,8/4/2013,0,0,0,0,0,0,0
14748,RM-1139,8/5/2013,0,0,0,0,0,0,0
14749,RM-1139,8/6/2013,0,0,0,0,0,0,0
14750,RM-1139,8/7/2013,0,0,0,0,0,0,0
14751,RM-1139,8/8/2013,0,0,0,0,0,0,0
14752,RM-1139,8/9/2013,0,0,0,0,0,0,0
14753,RM-1139,8/10/2013,0,0,0,0,0,0,0
14754,RM-1139,8/11/2013,0,0,0,0,0,0,0
14755,RM-1139,8/12/2013,0,0,0,0,0,0,0
14756,RM-1139,8/13/2013,0,0,0,0,0,0,0
14757,RM-1139,8/14/2013,0,0,0,0,0,0,0
14758,RM-1139,8/15/2013,0,0,0,0,0,0,0
14759,RM-1139,8/16/2013,0,0,0,0,0,0,0
14760,RM-1139,8/17/2013,0,0,0,0,0,0,0
14761,RM-1139,8/18/2013,0,0,0,0,0,0,0
14762,RM-1139,8/19/2013,0,0,0,0,0,0,0
14763,RM-1139,8/20/2013,0,0,0,0,0,0,0
14764,RM-1139,8/21/2013,0,0,0,0,0,0,0
14765,RM-1139,8/22/2013,0,0,0,0,0,0,0
14766,RM-1139,8/27/2013,0,0,0,0,0,0,0
14767,RM-1139,8/28/2013,0,0,0,0,0,0,0
14768,RM-1139,8/29/2013,0,0,0,0,0,0,0
14769,RM-1139,8/30/2013,0,0,0,0,0,0,0
14770,RM-1139,9/4/2013,0,0,0,0,0,0,0
14771,RM-1139,9/5/2013,0,0,0,0,0,0,0
14772,RM-1139,9/6/2013,0,0,0,0,0,0,0
14773,RM-1139,9/7/2013,0,0,0,0,0,0,0
14774,RM-1139,9/9/2013,0,0,0,0,0,0,0
14775,RM-1139,9/10/2013,0,0,0,0,0,0,0
14776,RM-1139,9/11/2013,0,0,0,0,0,0,0
14777,RM-1139,9/12/2013,0,0,0,0,0,0,0
14778,RM-1139,9/13/2013,0,0,0,0,0,0,0
14779,RM-1139,9/14/2013,0,0,0,0,0,0,0
14780,RM-1139,9/15/2013,0,0,0,0,0,0,0
14781,RM-1139,9/16/2013,0,0,0,0,0,0,0
14782,RM-1139,9/17/2013,0,0,0,0,0,0,0
14783,RM-1139,9/18/2013,0,0,0,0,0,0,0
14784,RM-1139,9/19/2013,0,0,0,0,0,0,0
14785,RM-1139,9/20/2013,0,0,0,0,0,0,0
14786,RM-1139,9/21/2013,0,0,0,0,0,0,0
14787,RM-1139,9/22/2013,0,0,0,0,0,0,0
14788,RM-1139,9/23/2013,0,0,0,0,0,0,0
14789,RM-1139,9/24/2013,0,0,0,0,0,0,0
14790,RM-1139,9/25/2013,0,0,0,0,0,0,0
14791,RM-1139,9/26/2013,0,0,0,0,0,0,0
14792,RM-1139,9/27/2013,0,0,0,0,0,0,0
14793,RM-1139,9/28/2013,0,0,0,0,0,0,0
14794,RM-1139,9/29/2013,0,0,0,0,0,0,0
14795,RM-1139,9/30/2013,0,0,0,0,0,0,0
14796,RM-1139,10/1/2013,0,0,0,0,0,0,0
14797,RM-1139,10/2/2013,0,0,0,0,0,0,0
14798,RM-1139,10/3/2013,0,0,0,0,0,0,0
14799,RM-1139,10/4/2013,0,0,0,0,0,0,0
14800,RM-1139,10/5/2013,0,0,0,0,0,0,0
14801,RM-1139,10/6/2013,0,0,0,0,0,0,0
14802,RM-1139,10/7/2013,0,0,0,0,0,0,0
14803,RM-1139,10/8/2013,0,0,0,0,0,0,0
14804,RM-1139,10/9/2013,0,0,0,0,0,0,0
14805,RM-1139,10/10/2013,0,0,0,0,0,0,0
14806,RM-1139,10/11/2013,0,0,0,0,0,0,0
14807,RM-1139,10/12/2013,0,0,0,0,0,0,0
14808,RM-1139,10/13/2013,0,0,0,0,0,0,0
14809,RM-1139,10/14/2013,0,0,0,0,0,0,0
14810,RM-1139,10/15/2013,0,0,0,0,0,0,0
14811,RM-1139,10/16/2013,0,0,0,0,0,0,0
14812,RM-1139,10/17/2013,0,0,0,0,0,0,0
14813,RM-1139,10/18/2013,0,0,0,0,0,0,0
14814,RM-1139,10/19/2013,0,0,0,0,0,0,0
14815,RM-1139,10/20/2013,0,0,0,0,0,0,0
14816,RM-1139,10/21/2013,0,0,0,0,0,0,0
14817,RM-1139,10/22/2013,0,0,0,0,0,0,0
14818,RM-1139,10/23/2013,0,0,0,0,0,0,0
14819,RM-1139,10/24/2013,0,0,0,0,0,0,0
14820,RM-1139,10/25/2013,0,0,0,0,0,0,0
14821,RM-1139,10/26/2013,0,0,0,0,0,0,0
14822,RM-1139,10/27/2013,0,0,0,0,0,0,0
14823,RM-1139,10/28/2013,0,0,0,0,0,0,0
14824,RM-1139,10/29/2013,0,0,0,0,0,0,0
14825,RM-1139,10/30/2013,0,0,0,0,0,0,0
14826,RM-1139,10/31/2013,0,0,0,0,0,0,0
14827,RM-1139,11/1/2013,0,0,0,0,0,0,0
14828,RM-1139,11/2/2013,0,0,0,0,0,0,0
14829,RM-1139,11/3/2013,0,0,0,0,0,0,0
14830,RM-1139,11/4/2013,0,0,0,0,0,0,0
14831,RM-1139,11/5/2013,0,0,0,0,0,0,0
14832,RM-1139,11/6/2013,0,0,0,0,0,0,0
14833,RM-1139,11/7/2013,0,0,0,0,0,0,0
14834,RM-1139,11/8/2013,0,0,0,0,0,0,0
14835,RM-1139,11/9/2013,0,0,0,0,0,0,0
14836,RM-1139,11/10/2013,0,0,0,0,0,0,0
14837,RM-1139,11/11/2013,0,0,0,0,0,0,0
14838,RM-1139,11/12/2013,0,0,0,0,0,0,0
14839,RM-1139,11/13/2013,0,0,0,0,0,0,0
14840,RM-1139,11/14/2013,0,0,0,0,0,0,0
14841,RM-1139,11/15/2013,0,0,0,0,0,0,0
14842,RM-1139,11/19/2013,0,0,0,0,0,0,0
14843,RM-1139,11/20/2013,0,0,0,0,0,0,0
14844,RM-1139,11/21/2013,0,0,0,0,0,0,0
14845,RM-1139,11/22/2013,0,0,0,0,0,0,0
14846,RM-1139,11/23/2013,0,0,0,0,0,0,0
14847,RM-1139,11/24/2013,0,0,0,0,0,0,0
14848,RM-1139,11/25/2013,0,0,0,0,0,0,0
14849,RM-1139,11/26/2013,0,0,0,0,0,0,0
14850,RM-1139,11/27/2013,0,0,0,0,0,0,0
14851,RM-1139,11/28/2013,0,0,0,0,0,0,0
14852,RM-1139,11/29/2013,0,0,0,0,0,0,0
14853,RM-1139,11/30/2013,0,0,0,0,0,0,0
14854,RM-1139,12/1/2013,0,0,0,0,0,0,0
14855,RM-1139,12/2/2013,0,0,0,0,0,0,0
14856,RM-1139,12/3/2013,0,0,0,0,0,0,0
14857,RM-1139,12/4/2013,0,0,0,0,0,0,0
14858,RM-1139,12/5/2013,0,0,0,0,0,0,0
14859,RM-1139,12/6/2013,0,0,0,0,0,0,0
14860,RM-1139,12/7/2013,0,0,0,0,0,0,0
14861,RM-1139,12/8/2013,0,0,0,0,0,0,0
14862,RM-1139,12/9/2013,0,0,0,0,0,0,0
14863,RM-1139,12/10/2013,0,0,0,0,0,0,0
14864,RM-1139,12/11/2013,0,0,0,0,0,0,0
14865,RM-1139,12/12/2013,0,0,0,0,0,0,0
14866,RM-1139,12/13/2013,0,0,0,0,0,0,0
14867,RM-1139,12/14/2013,0,0,0,0,0,0,0
14868,RM-1139,12/15/2013,0,0,0,0,0,0,0
14869,RM-1139,12/16/2013,0,0,0,0,0,0,0
14870,RM-1139,12/17/2013,0,0,0,0,0,0,0
14871,RM-1139,12/18/2013,0,0,0,0,0,0,0
14872,RM-1139,12/19/2013,0,0,0,0,0,0,0
14873,RM-1139,12/20/2013,0,0,0,0,0,0,0
14874,RM-1139,12/21/2013,0,0,0,0,0,0,0
14875,RM-1139,12/22/2013,0,0,0,0,0,0,0
14876,RM-1139,12/23/2013,0,0,0,0,0,0,0
14877,RM-1139,12/24/2013,0,0,0,0,0,0,0
14878,RM-1139,12/25/2013,0,0,0,0,0,0,0
14879,RM-1139,12/26/2013,0,0,0,0,0,0,0
14880,RM-1139,12/27/2013,0,0,0,0,0,0,0
14881,RM-1139,12/28/2013,0,0,0,0,0,0,0
14882,RM-1139,12/29/2013,0,0,0,0,0,0,0
14883,RM-1139,12/30/2013,0,0,0,0,0,0,0
14884,RM-1139,12/31/2013,0,0,0,0,0,0,0
14885,RM-1139,1/1/2014,0,0,0,0,0,0,0
14886,RM-1139,1/2/2014,0,0,0,0,0,0,0
14887,RM-1139,1/3/2014,0,0,0,0,0,0,0
14888,RM-1139,1/4/2014,0,0,0,0,0,0,0
14889,RM-1139,1/5/2014,0,0,0,0,0,0,0
14890,RM-1139,1/6/2014,0,0,0,0,0,0,0
14891,RM-1139,1/7/2014,0,0,0,0,0,0,0
14892,RM-1139,1/8/2014,0,0,0,0,0,0,0
14893,RM-1139,1/9/2014,0,0,0,0,0,0,0
14894,RM-1139,1/10/2014,0,0,0,0,0,0,0
14895,RM-1139,1/11/2014,0,0,0,0,0,0,0
14896,RM-1139,1/12/2014,0,0,0,0,0,0,0
14897,RM-1139,1/13/2014,0,0,0,0,0,0,0
14898,RM-1139,1/14/2014,0,0,0,0,0,0,0
14899,RM-1139,1/15/2014,0,0,0,0,0,0,0
14900,RM-1139,1/16/2014,0,0,0,0,0,0,0
14901,RM-1139,1/17/2014,0,0,0,0,0,0,0
14902,RM-1139,1/18/2014,0,0,0,0,0,0,0
14903,RM-1139,1/19/2014,0,0,0,0,0,0,0
14904,RM-1139,1/20/2014,0,0,0,0,0,0,0
14905,RM-1139,1/21/2014,0,0,0,0,0,0,0
14906,RM-1139,1/22/2014,0,0,0,0,0,0,0
14907,RM-1139,1/23/2014,0,0,0,0,0,0,0
14908,RM-1139,1/24/2014,0,0,0,0,0,0,0
14909,RM-1139,1/25/2014,0,0,0,0,0,0,0
14910,RM-1139,1/26/2014,0,0,0,0,0,0,0
14911,RM-1139,1/27/2014,0,0,0,0,0,0,0
14912,RM-1139,1/28/2014,0,0,0,0,0,0,0
14913,RM-1139,1/29/2014,0,0,0,0,0,0,0
14914,RM-1139,1/30/2014,0,0,0,0,0,0,0
14915,RM-1139,1/31/2014,0,0,0,0,0,0,0
14916,RM-1139,2/1/2014,0,0,0,0,0,0,0
14917,RM-1139,2/2/2014,0,0,0,0,0,0,0
14918,RM-1139,2/3/2014,0,0,0,0,0,0,0
14919,RM-1139,2/4/2014,0,0,0,0,0,0,0
14920,RM-1139,2/5/2014,0,0,0,0,0,0,0
14921,RM-1139,2/6/2014,0,0,0,0,0,0,0
14922,RM-1139,2/7/2014,0,0,0,0,0,0,0
14923,RM-1139,2/8/2014,0,0,0,0,0,0,0
14924,RM-1139,2/9/2014,0,0,0,0,0,0,0
14925,RM-1139,2/10/2014,0,0,0,0,0,0,0
14926,RM-1139,2/11/2014,0,0,0,0,0,0,0
14927,RM-1139,2/12/2014,0,0,0,0,0,0,0
14928,RM-1139,2/13/2014,0,0,0,0,0,0,0
14929,RM-1139,2/14/2014,0,0,0,0,0,0,0
14930,RM-1139,2/15/2014,0,0,0,0,0,0,0
14931,RM-1139,2/16/2014,0,0,0,0,0,0,0
14932,RM-1139,2/17/2014,0,0,0,0,0,0,0
14933,RM-1139,2/18/2014,0,0,0,0,0,0,0
14934,RM-1139,2/19/2014,0,0,0,0,0,0,0
14935,RM-1139,2/20/2014,0,0,0,0,0,0,0
14936,RM-1139,2/21/2014,0,0,0,0,0,0,0
14937,RM-1139,2/22/2014,0,0,0,0,0,0,0
14938,RM-1139,2/23/2014,0,0,0,0,0,0,0
14939,RM-1139,2/24/2014,0,0,0,0,0,0,0
14940,RM-1139,2/25/2014,0,0,0,0,0,0,0
14941,RM-1139,2/26/2014,0,0,0,0,0,0,0
14942,RM-1139,2/27/2014,0,0,0,0,0,0,0
14943,RM-1139,2/28/2014,0,0,0,0,0,0,0
14944,RM-1139,3/1/2014,0,0,0,0,0,0,0
14945,RM-1139,3/2/2014,0,0,0,0,0,0,0
14946,RM-1139,3/3/2014,0,0,0,0,0,0,0
14947,RM-1139,3/4/2014,0,0,0,0,0,0,0
14948,RM-1139,3/5/2014,0,0,0,0,0,0,0
14949,RM-1139,3/6/2014,0,0,0,0,0,0,0
14950,RM-1139,3/7/2014,0,0,0,0,0,0,0
14951,RM-1139,3/8/2014,0,0,0,0,0,0,0
14952,RM-1139,3/9/2014,0,0,0,0,0,0,0
14953,RM-1139,3/10/2014,0,0,0,0,0,0,0
14954,RM-1139,3/11/2014,0,0,0,0,0,0,0
14955,RM-1139,3/12/2014,0,0,0,0,0,0,0
14956,RM-1139,3/13/2014,0,0,0,0,0,0,0
14957,RM-1139,3/14/2014,0,0,0,0,0,0,0
14958,RM-1139,3/15/2014,0,0,0,0,0,0,0
14959,RM-1139,3/16/2014,0,0,0,0,0,0,0
14960,RM-1139,3/17/2014,0,0,0,0,0,0,0
14961,RM-1139,3/18/2014,0,0,0,0,0,0,0
14962,RM-1139,3/19/2014,0,0,0,0,0,0,0
14963,RM-1139,3/20/2014,0,0,0,0,0,0,0
14964,RM-1139,3/21/2014,0,0,0,0,0,0,0
14965,RM-1139,3/22/2014,0,0,0,0,0,0,0
14966,RM-1139,3/23/2014,0,0,0,0,0,0,0
14967,RM-1139,3/24/2014,0,0,0,0,0,0,0
14968,RM-1139,3/25/2014,0,0,0,0,0,0,0
14969,RM-1139,3/26/2014,0,0,0,0,0,0,0
14970,RM-1139,3/27/2014,0,0,0,0,0,0,0
14971,RM-1139,3/28/2014,0,0,0,0,0,0,0
14972,RM-1139,3/29/2014,0,0,0,0,0,0,0
14973,RM-1139,3/30/2014,0,0,0,0,0,0,0
14974,RM-1139,3/31/2014,0,0,0,0,0,0,0
14975,RM-1139,4/1/2014,0,0,0,0,0,0,0
14976,RM-1139,4/2/2014,0,0,0,0,0,0,0
14977,RM-1139,4/3/2014,0,0,0,0,0,0,0
14978,RM-1139,4/4/2014,0,0,0,0,0,0,0
14979,RM-1139,4/5/2014,0,0,0,0,0,0,0
14980,RM-1139,4/6/2014,0,0,0,0,0,0,0
14981,RM-1139,4/7/2014,0,0,0,0,0,0,0
14982,RM-1139,4/8/2014,0,0,0,0,0,0,0
14983,RM-1139,4/9/2014,0,0,0,0,0,0,0
14984,RM-1139,4/10/2014,0,0,0,0,0,0,0
14985,RM-1139,4/11/2014,0,0,0,0,0,0,0
14986,RM-1139,4/12/2014,0,0,0,0,0,0,0
14987,RM-1139,4/13/2014,0,0,0,0,0,0,0
14988,RM-1139,4/14/2014,0,0,0,0,0,0,0
14989,RM-1139,4/15/2014,0,0,0,0,0,0,0
14990,RM-1139,4/16/2014,0,0,0,0,0,0,0
14991,RM-1139,4/17/2014,0,0,0,0,0,0,0
14992,RM-1139,4/18/2014,0,0,0,0,0,0,0
14993,RM-1139,4/19/2014,0,0,0,0,0,0,0
14994,RM-1139,4/20/2014,0,0,0,0,0,0,0
14995,RM-1139,4/21/2014,0,0,0,0,0,0,0
14996,RM-1139,4/22/2014,0,0,0,0,0,0,0
14997,RM-1139,4/23/2014,0,0,0,0,0,0,0
14998,RM-1139,4/24/2014,0,0,0,0,0,0,0
14999,RM-1139,4/25/2014,0,0,0,0,0,0,0
15000,RM-1139,4/26/2014,0,0,0,0,0,0,0
15001,RM-1139,4/27/2014,0,0,0,0,0,0,0
15002,RM-1139,4/28/2014,0,0,0,0,0,0,0
15003,RM-1139,4/29/2014,0,0,0,0,0,0,0
15004,RM-1139,4/30/2014,0,0,0,0,0,0,0
15005,RM-1139,5/1/2014,0,0,0,0,0,0,0
15006,RM-1139,5/2/2014,0,0,0,0,0,0,0
15007,RM-1139,5/3/2014,0,0,0,0,0,0,0
15008,RM-1139,5/4/2014,0,0,0,0,0,0,0
15009,RM-1139,5/5/2014,0,0,0,0,0,0,0
15010,RM-1139,5/7/2014,0,0,0,0,0,0,0
15011,RM-1139,5/8/2014,0,0,0,0,0,0,0
15012,RM-1139,5/9/2014,0,0,0,0,0,0,0
15013,RM-1139,5/10/2014,0,0,0,0,0,0,0
15014,RM-1139,5/11/2014,0,0,0,0,0,0,0
15015,RM-1139,5/12/2014,0,0,0,0,0,0,0
15016,RM-1139,5/13/2014,0,0,0,0,0,0,0
15017,RM-1139,5/14/2014,0,0,0,0,0,0,0
15018,RM-1139,5/15/2014,0,0,0,0,0,0,0
15019,RM-1139,5/16/2014,0,0,0,0,0,0,0
15020,RM-1139,5/17/2014,0,0,0,0,0,0,0
15021,RM-1139,5/18/2014,0,0,0,0,0,0,0
15022,RM-1139,5/19/2014,0,0,0,0,0,0,0
15023,RM-1139,5/20/2014,0,0,0,0,0,0,0
15024,RM-1139,5/21/2014,0,0,0,0,0,0,0
15025,RM-1139,5/22/2014,0,0,0,0,0,0,0
15026,RM-1139,5/23/2014,0,0,0,0,0,0,0
15027,RM-1139,9/3/2014,0,0,0,0,0,0,0
15028,RM-1139,9/4/2014,0,0,0,0,0,0,0
15029,RM-1139,9/5/2014,0,0,0,0,0,0,0
15030,RM-1139,9/6/2014,0,0,0,0,0,0,0
15031,RM-1139,9/7/2014,0,0,0,0,0,0,0
15032,RM-1139,9/8/2014,0,0,0,0,0,0,0
15033,RM-1139,9/9/2014,0,0,0,0,0,0,0
15034,RM-1139,9/10/2014,0,0,0,0,0,0,0
15035,RM-1139,9/11/2014,0,0,0,0,0,0,0
15036,RM-1139,9/12/2014,0,0,0,0,0,0,0
15037,RM-1139,9/13/2014,0,0,0,0,0,0,0
15038,RM-1139,9/14/2014,0,0,0,0,0,0,0
15039,RM-1139,9/15/2014,0,0,0,0,0,0,0
15040,RM-1139,9/16/2014,0,0,0,0,0,0,0
15041,RM-1139,9/17/2014,0,0,0,0,0,0,0
15042,RM-1139,9/18/2014,0,0,0,0,0,0,0
15043,RM-1139,9/19/2014,0,0,0,0,0,0,0
15044,RM-1139,9/20/2014,0,0,0,0,0,0,0
15045,RM-1139,9/21/2014,0,0,0,0,0,0,0
15046,RM-1139,9/22/2014,0,0,0,0,0,0,0
15047,RM-1139,9/23/2014,0,0,0,0,0,0,0
15048,RM-1139,9/24/2014,0,0,0,0,0,0,0
15049,RM-1139,9/25/2014,0,0,0,0,0,0,0
15050,RM-1139,9/28/2014,0,0,0,0,0,0,0
15051,RM-1139,9/29/2014,0,0,0,0,0,0,0
15052,RM-1139,9/30/2014,0,0,0,0,0,0,0
15053,RM-1139,10/1/2014,0,0,0,0,0,0,0
15054,RM-1139,10/2/2014,0,0,0,0,0,0,0
15055,RM-1139,10/3/2014,0,0,0,0,0,0,0
15056,RM-1139,10/4/2014,0,0,0,0,0,0,0
15057,RM-1139,10/5/2014,0,0,0,0,0,0,0
15058,RM-1139,10/6/2014,0,0,0,0,0,0,0
15059,RM-1139,10/7/2014,0,0,0,0,0,0,0
15060,RM-1139,10/8/2014,0,0,0,0,0,0,0
15061,RM-1139,10/9/2014,0,0,0,0,0,0,0
15062,RM-1139,10/10/2014,0,0,0,0,0,0,0
15063,RM-1139,10/11/2014,0,0,0,0,0,0,0
15064,RM-1139,10/12/2014,0,0,0,0,0,0,0
15065,RM-1139,10/13/2014,0,0,0,0,0,0,0
15066,RM-1139,10/14/2014,0,0,0,0,0,0,0
15067,RM-1139,10/15/2014,0,0,0,0,0,0,0
15068,RM-1139,10/16/2014,0,0,0,0,0,0,0
15069,RM-1139,10/17/2014,0,0,0,0,0,0,0
15070,RM-1139,10/18/2014,0,0,0,0,0,0,0
15071,RM-1139,10/19/2014,0,0,0,0,0,0,0
15072,RM-1139,10/20/2014,0,0,0,0,0,0,0
15073,RM-1139,10/21/2014,0,0,0,0,0,0,0
15074,RM-1139,10/22/2014,0,0,0,0,0,0,0
15075,RM-1139,10/23/2014,0,0,0,0,0,0,0
15076,RM-1139,10/24/2014,0,0,0,0,0,0,0
15077,RM-1139,10/25/2014,0,0,0,0,0,0,0
15078,RM-1139,10/26/2014,0,0,0,0,0,0,0
15079,RM-1139,10/27/2014,0,0,0,0,0,0,0
15080,RM-1139,10/28/2014,0,0,0,0,0,0,0
15081,RM-1139,10/29/2014,0,0,0,0,0,0,0
15082,RM-1139,10/30/2014,0,0,0,0,0,0,0
15083,RM-1139,10/31/2014,0,0,0,0,0,0,0
15084,RM-1139,11/1/2014,0,0,0,0,0,0,0
15085,RM-1139,11/2/2014,0,0,0,0,0,0,0
15086,RM-1139,11/3/2014,0,0,0,0,0,0,0
15087,RM-1139,11/4/2014,0,0,0,0,0,0,0
15088,RM-1139,11/5/2014,0,0,0,0,0,0,0
15089,RM-1139,11/6/2014,0,0,0,0,0,0,0
15090,RM-1139,11/7/2014,0,0,0,0,0,0,0
15091,RM-1139,11/8/2014,0,0,0,0,0,0,0
15092,RM-1139,11/9/2014,0,0,0,0,0,0,0
15093,RM-1139,11/10/2014,0,0,0,0,0,0,0
15094,RM-1139,11/11/2014,0,0,0,0,0,0,0
15095,RM-1139,11/12/2014,0,0,0,0,0,0,0
15096,RM-1139,11/13/2014,0,0,0,0,0,0,0
15097,RM-1139,11/14/2014,0,0,0,0,0,0,0
15098,RM-1139,11/15/2014,0,0,0,0,0,0,0
15099,RM-1139,11/16/2014,0,0,0,0,0,0,0
15100,RM-1139,11/17/2014,0,0,0,0,0,0,0
15101,RM-1139,11/18/2014,0,0,0,0,0,0,0
15102,RM-1139,11/19/2014,0,0,0,0,0,0,0
15103,RM-1139,11/20/2014,0,0,0,0,0,0,0
15104,RM-1139,11/21/2014,0,0,0,0,0,0,0
15105,RM-1139,11/22/2014,0,0,0,0,0,0,0
15106,RM-1139,11/23/2014,0,0,0,0,0,0,0
15107,RM-1139,11/24/2014,0,0,0,0,0,0,0
15108,RM-1139,11/25/2014,0,0,0,0,0,0,0
15109,RM-1139,11/26/2014,0,0,0,0,0,0,0
15110,RM-1139,11/27/2014,0,0,0,0,0,0,0
15111,RM-1139,11/28/2014,0,0,0,0,0,0,0
15112,RM-1139,11/29/2014,0,0,0,0,0,0,0
15113,RM-1139,11/30/2014,0,0,0,0,0,0,0
15114,RM-1139,12/1/2014,0,0,0,0,0,0,0
15115,RM-1139,12/2/2014,0,0,0,0,0,0,0
15116,RM-1139,12/3/2014,0,0,0,0,0,0,0
15117,RM-1139,12/4/2014,0,0,0,0,0,0,0
15118,RM-1139,12/5/2014,0,0,0,0,0,0,0
15119,RM-1139,12/6/2014,0,0,0,0,0,0,0
15120,RM-1139,12/7/2014,0,0,0,0,0,0,0
15121,RM-1139,12/8/2014,0,0,0,0,0,0,0
15122,RM-1139,12/9/2014,0,0,0,0,0,0,0
15123,RM-1139,12/10/2014,0,0,0,0,0,0,0
15124,RM-1139,12/11/2014,0,0,0,0,0,0,0
15125,RM-1139,12/12/2014,0,0,0,0,0,0,0
15126,RM-1139,12/13/2014,0,0,0,0,0,0,0
15127,RM-1139,12/14/2014,0,0,0,0,0,0,0
15128,RM-1139,12/15/2014,0,0,0,0,0,0,0
15129,RM-1139,12/16/2014,0,0,0,0,0,0,0
15130,RM-1139,12/17/2014,0,0,0,0,0,0,0
15131,RM-1139,12/18/2014,0,0,0,0,0,0,0
15132,RM-1139,12/19/2014,0,0,0,0,0,0,0
15133,RM-1139,12/20/2014,0,0,0,0,0,0,0
15134,RM-1139,12/21/2014,0,0,0,0,0,0,0
15135,RM-1139,12/22/2014,0,0,0,0,0,0,0
15136,RM-1139,12/23/2014,0,0,0,0,0,0,0
15137,RM-1139,12/24/2014,0,0,0,0,0,0,0
15138,RM-1139,12/25/2014,0,0,0,0,0,0,0
15139,RM-1139,12/26/2014,0,0,0,0,0,0,0
15140,RM-1139,12/27/2014,0,0,0,0,0,0,0
15141,RM-1139,12/28/2014,0,0,0,0,0,0,0
15142,RM-1139,12/29/2014,0,0,0,0,0,0,0
15143,RM-1139,12/30/2014,0,0,0,0,0,0,0
15144,RM-1139,12/31/2014,0,0,0,0,0,0,0
15145,RM-1139,1/1/2015,0,0,0,0,0,0,0
15146,RM-1139,1/2/2015,0,0,0,0,0,0,0
15147,RM-1139,1/3/2015,0,0,0,0,0,0,0
15148,RM-1139,1/4/2015,0,0,0,0,0,0,0
15149,RM-1139,1/5/2015,0,0,0,0,0,0,0
15150,RM-1139,1/6/2015,0,0,0,0,0,0,0
15151,RM-1139,1/7/2015,0,0,0,0,0,0,0
15152,RM-1139,1/8/2015,0,0,0,0,0,0,0
15153,RM-1139,1/9/2015,0,0,0,0,0,0,0
15154,RM-1139,1/10/2015,0,0,0,0,0,0,0
15155,RM-1139,1/11/2015,0,0,0,0,0,0,0
15156,RM-1139,1/12/2015,0,0,0,0,0,0,0
15157,RM-1139,1/13/2015,0,0,0,0,0,0,0
15158,RM-1139,1/14/2015,0,0,0,0,0,0,0
15159,RM-1139,1/15/2015,0,0,0,0,0,0,0
15160,RM-1139,1/16/2015,0,0,0,0,0,0,0
15161,RM-1139,1/17/2015,0,0,0,0,0,0,0
15162,RM-1139,1/18/2015,0,0,0,0,0,0,0
15163,RM-1139,1/19/2015,0,0,0,0,0,0,0
15164,RM-1139,1/20/2015,0,0,0,0,0,0,0
15165,RM-1139,1/21/2015,0,0,0,0,0,0,0
15166,RM-1139,1/22/2015,0,0,0,0,0,0,0
15167,RM-1139,1/23/2015,0,0,0,0,0,0,0
15168,RM-1139,1/24/2015,0,0,0,0,0,0,0
15169,RM-1139,1/25/2015,0,0,0,0,0,0,0
15170,RM-1139,1/26/2015,0,0,0,0,0,0,0
15171,RM-1139,1/27/2015,0,0,0,0,0,0,0
15172,RM-1139,1/28/2015,0,0,0,0,0,0,0
15173,RM-1139,1/29/2015,0,0,0,0,0,0,0
15174,RM-1139,1/30/2015,0,0,0,0,0,0,0
15175,RM-1139,1/31/2015,0,0,0,0,0,0,0
15176,RM-1139,2/1/2015,0,0,0,0,0,0,0
15177,RM-1139,2/2/2015,0,0,0,0,0,0,0
15178,RM-1139,2/3/2015,0,0,0,0,0,0,0
15179,RM-1139,2/4/2015,0,0,0,0,0,0,0
15180,RM-1139,2/5/2015,0,0,0,0,0,0,0
15181,RM-1139,2/6/2015,0,0,0,0,0,0,0
15182,RM-1139,2/7/2015,0,0,0,0,0,0,0
15183,RM-1139,2/8/2015,0,0,0,0,0,0,0
15184,RM-1139,2/9/2015,0,0,0,0,0,0,0
15185,RM-1139,2/10/2015,0,0,0,0,0,0,0
15186,RM-1139,2/11/2015,0,0,0,0,0,0,0
15187,RM-1139,2/12/2015,0,0,0,0,0,0,0
15188,RM-1139,2/13/2015,0,0,0,0,0,0,0
15189,RM-1139,2/14/2015,0,0,0,0,0,0,0
15190,RM-1139,2/15/2015,0,0,0,0,0,0,0
15191,RM-1139,2/16/2015,0,0,0,0,0,0,0
15192,RM-1139,2/17/2015,0,0,0,0,0,0,0
15193,RM-1139,2/18/2015,0,0,0,0,0,0,0
15194,RM-1139,2/19/2015,0,0,0,0,0,0,0
15195,RM-1139,2/20/2015,0,0,0,0,0,0,0
15196,RM-1139,2/21/2015,0,0,0,0,0,0,0
15197,RM-1139,2/22/2015,0,0,0,0,0,0,0
15198,RM-1139,2/23/2015,0,0,0,0,0,0,0
15199,RM-1139,2/24/2015,0,0,0,0,0,0,0
15200,RM-1139,2/25/2015,0,0,0,0,0,0,0
15201,RM-1139,2/26/2015,0,0,0,0,0,0,0
15202,RM-1139,2/27/2015,0,0,0,0,0,0,0
15203,RM-1139,2/28/2015,0,0,0,0,0,0,0
15204,RM-1139,3/1/2015,0,0,0,0,0,0,0
15205,RM-1139,3/2/2015,0,0,0,0,0,0,0
15206,RM-1139,3/3/2015,0,0,0,0,0,0,0
15207,RM-1139,3/4/2015,0,0,0,0,0,0,0
15208,RM-1139,3/5/2015,0,0,0,0,0,0,0
15209,RM-1139,3/6/2015,0,0,0,0,0,0,0
15210,RM-1139,3/7/2015,0,0,0,0,0,0,0
15211,RM-1139,3/8/2015,0,0,0,0,0,0,0
15212,RM-1139,3/9/2015,0,0,0,0,0,0,0
15213,RM-1139,3/10/2015,0,0,0,0,0,0,0
15214,RM-1139,3/11/2015,0,0,0,0,0,0,0
15215,RM-1139,3/12/2015,0,0,0,0,0,0,0
15216,RM-1139,3/13/2015,0,0,0,0,0,0,0
15217,RM-1139,3/14/2015,0,0,0,0,0,0,0
15218,RM-1139,3/15/2015,0,0,0,0,0,0,0
15219,RM-1139,3/16/2015,0,0,0,0,0,0,0
15220,RM-1139,3/17/2015,0,0,0,0,0,0,0
15221,RM-1139,3/18/2015,0,0,0,0,0,0,0
15222,RM-1139,3/19/2015,0,0,0,0,0,0,0
15223,RM-1139,3/20/2015,0,0,0,0,0,0,0
15224,RM-1139,3/21/2015,0,0,0,0,0,0,0
15225,RM-1139,3/22/2015,0,0,0,0,0,0,0
15226,RM-1139,3/23/2015,0,0,0,0,0,0,0
15227,RM-1139,3/24/2015,0,0,0,0,0,0,0
15228,RM-1139,3/25/2015,0,0,0,0,0,0,0
15229,RM-1139,3/26/2015,0,0,0,0,0,0,0
15230,RM-1139,3/27/2015,0,0,0,0,0,0,0
15231,RM-1139,3/28/2015,0,0,0,0,0,0,0
15232,RM-1139,3/29/2015,0,0,0,0,0,0,0
15233,RM-1139,3/30/2015,0,0,0,0,0,0,0
15234,RM-1139,3/31/2015,0,0,0,0,0,0,0
15235,RM-1139,4/1/2015,0,0,0,0,0,0,0
15236,RM-1139,4/2/2015,0,0,0,0,0,0,0
15237,RM-1139,4/3/2015,0,0,0,0,0,0,0
15238,RM-1139,4/4/2015,0,0,0,0,0,0,0
15239,RM-1139,4/5/2015,0,0,0,0,0,0,0
15240,RM-1139,4/6/2015,0,0,0,0,0,0,0
15241,RM-1139,4/7/2015,0,0,0,0,0,0,0
15242,RM-1139,4/8/2015,0,0,0,0,0,0,0
15243,RM-1139,4/9/2015,0,0,0,0,0,0,0
15244,RM-1139,4/10/2015,0,0,0,0,0,0,0
15245,RM-1139,4/11/2015,0,0,0,0,0,0,0
15246,RM-1139,4/12/2015,0,0,0,0,0,0,0
15247,RM-1139,4/13/2015,0,0,0,0,0,0,0
15248,RM-1139,4/14/2015,0,0,0,0,0,0,0
15249,RM-1139,4/15/2015,0,0,0,0,0,0,0
15250,RM-1139,4/16/2015,0,0,0,0,0,0,0
15251,RM-1139,4/17/2015,0,0,0,0,0,0,0
15252,RM-1139,4/18/2015,0,0,0,0,0,0,0
15253,RM-1139,4/19/2015,0,0,0,0,0,0,0
15254,RM-1139,4/20/2015,0,0,0,0,0,0,0
15255,RM-1139,4/21/2015,0,0,0,0,0,0,0
15256,RM-1139,4/22/2015,0,0,0,0,0,0,0
15257,RM-1139,4/23/2015,0,0,0,0,0,0,0
15258,RM-1139,4/24/2015,0,0,0,0,0,0,0
15259,RM-1139,4/25/2015,0,0,0,0,0,0,0
15260,RM-1139,4/26/2015,0,0,0,0,0,0,0
15261,RM-1139,4/27/2015,0,0,0,0,0,0,0
15262,RM-1139,4/28/2015,0,0,0,0,0,0,0
15263,RM-1139,4/29/2015,0,0,0,0,0,0,0
15264,RM-1139,4/30/2015,0,0,0,0,0,0,0
15265,RM-1139,5/1/2015,0,0,0,0,0,0,0
15266,RM-1139,5/2/2015,0,0,0,0,0,0,0
15267,RM-1139,5/3/2015,0,0,0,0,0,0,0
15268,RM-1139,5/4/2015,0,0,0,0,0,0,0
15269,RM-1139,5/5/2015,0,0,0,0,0,0,0
15270,RM-1139,5/6/2015,0,0,0,0,0,0,0
15271,RM-1139,5/7/2015,0,0,0,0,0,0,0
15272,RM-1139,5/8/2015,0,0,0,0,0,0,0
15273,RM-1139,5/9/2015,0,0,0,0,0,0,0
15274,RM-1139,5/10/2015,0,0,0,0,0,0,0
15275,RM-1139,5/11/2015,0,0,0,0,0,0,0
15276,RM-1139,5/12/2015,0,0,0,0,0,0,0
15277,RM-1139,5/13/2015,0,0,0,0,0,0,0
15278,RM-1139,5/14/2015,0,0,0,0,0,0,0
15279,RM-1139,5/15/2015,0,0,0,0,0,0,0
15280,RM-1139,5/16/2015,0,0,0,0,0,0,0
15281,RM-1139,5/17/2015,0,0,0,0,0,0,0
15282,RM-1139,5/18/2015,0,0,0,0,0,0,0
15283,RM-1139,5/19/2015,0,0,0,0,0,0,0
15284,RM-1139,5/20/2015,0,0,0,0,0,0,0
15285,RM-1139,5/21/2015,0,0,0,0,0,0,0
15286,RM-1139,5/22/2015,0,0,0,0,0,0,0
15287,RM-1139,5/23/2015,0,0,0,0,0,0,0
15288,RM-1139,5/24/2015,0,0,0,0,0,0,0
15289,RM-1139,5/25/2015,0,0,0,0,0,0,0
15290,RM-1139,5/26/2015,0,0,0,0,0,0,0
15291,RM-1139,5/27/2015,0,0,0,0,0,0,0
15292,RM-1139,5/28/2015,0,0,0,0,0,0,0
15293,RM-1139,5/29/2015,0,0,0,0,0,0,0
15294,RM-1139,5/30/2015,0,0,0,0,0,0,0
15295,RM-1139,5/31/2015,0,0,0,0,0,0,0
15296,RM-1144,7/1/2013,0,0,0,0,0,0,0
15297,RM-1144,7/2/2013,0,0,0,0,0,0,0
15298,RM-1144,7/3/2013,0,0,0,0,0,0,0
15299,RM-1144,7/4/2013,0,0,0,0,0,0,0
15300,RM-1144,7/5/2013,0,0,0,0,0,0,0
15301,RM-1144,7/6/2013,0,0,0,0,0,0,0
15302,RM-1144,7/7/2013,0,0,0,0,0,0,0
15303,RM-1144,7/8/2013,0,0,0,0,0,0,0
15304,RM-1144,7/9/2013,0,0,0,0,0,0,0
15305,RM-1144,7/10/2013,0,0,0,0,0,0,0
15306,RM-1144,7/11/2013,0,0,0,0,0,0,0
15307,RM-1144,7/12/2013,0,0,0,0,0,0,0
15308,RM-1144,7/13/2013,0,0,0,0,0,0,0
15309,RM-1144,7/14/2013,0,0,0,0,0,0,0
15310,RM-1144,7/15/2013,0,0,0,0,0,0,0
15311,RM-1144,7/17/2013,0,0,0,0,0,0,0
15312,RM-1144,7/18/2013,0,0,0,0,0,0,0
15313,RM-1144,7/19/2013,0,0,0,0,0,0,0
15314,RM-1144,7/20/2013,0,0,0,0,0,0,0
15315,RM-1144,7/21/2013,0,0,0,0,0,0,0
15316,RM-1144,7/22/2013,0,0,0,0,0,0,0
15317,RM-1144,7/23/2013,0,0,0,0,0,0,0
15318,RM-1144,7/24/2013,0,0,0,0,0,0,0
15319,RM-1144,7/25/2013,0,0,0,0,0,0,0
15320,RM-1144,7/26/2013,0,0,0,0,0,0,0
15321,RM-1144,7/27/2013,0,0,0,0,0,0,0
15322,RM-1144,7/28/2013,0,0,0,0,0,0,0
15323,RM-1144,7/29/2013,0,0,0,0,0,0,0
15426,RM-1144,11/21/2013,0,0,0,0,0,0,0
15427,RM-1144,11/22/2013,0,0,0,0,0,0,0
15428,RM-1144,11/23/2013,0,0,0,0,0,0,0
15429,RM-1144,11/24/2013,0,0,0,0,0,0,0
15430,RM-1144,11/25/2013,0,0,0,0,0,0,0
15431,RM-1144,11/26/2013,0,0,0,0,0,0,0
15432,RM-1144,11/27/2013,0,0,0,0,0,0,0
15433,RM-1144,11/28/2013,0,0,0,0,0,0,0
15434,RM-1144,11/29/2013,0,0,0,0,0,0,0
15435,RM-1144,11/30/2013,0,0,0,0,0,0,0
15436,RM-1144,12/1/2013,0,0,0,0,0,0,0
15437,RM-1144,12/2/2013,0,0,0,0,0,0,0
15438,RM-1144,12/3/2013,0,0,0,0,0,0,0
15439,RM-1144,12/4/2013,0,0,0,0,0,0,0
15440,RM-1144,12/5/2013,0,0,0,0,0,0,0
15441,RM-1144,12/6/2013,0,0,0,0,0,0,0
15442,RM-1144,12/7/2013,0,0,0,0,0,0,0
15443,RM-1144,12/8/2013,0,0,0,0,0,0,0
15444,RM-1144,12/9/2013,0,0,0,0,0,0,0
15445,RM-1144,12/10/2013,0,0,0,0,0,0,0
15446,RM-1144,12/11/2013,0,0,0,0,0,0,0
15447,RM-1144,12/12/2013,0,0,0,0,0,0,0
15448,RM-1144,12/13/2013,0,0,0,0,0,0,0
15449,RM-1144,12/14/2013,0,0,0,0,0,0,0
15450,RM-1144,12/15/2013,0,0,0,0,0,0,0
15451,RM-1144,12/16/2013,0,0,0,0,0,0,0
15452,RM-1144,12/17/2013,0,0,0,0,0,0,0
15453,RM-1144,12/18/2013,0,0,0,0,0,0,0
15454,RM-1144,12/19/2013,0,0,0,0,0,0,0
15455,RM-1144,12/20/2013,0,0,0,0,0,0,0
15456,RM-1144,12/21/2013,0,0,0,0,0,0,0
15457,RM-1144,12/22/2013,0,0,0,0,0,0,0
15458,RM-1144,12/23/2013,0,0,0,0,0,0,0
15459,RM-1144,12/24/2013,0,0,0,0,0,0,0
15460,RM-1144,12/25/2013,0,0,0,0,0,0,0
15461,RM-1144,12/26/2013,0,0,0,0,0,0,0
15462,RM-1144,12/27/2013,0,0,0,0,0,0,0
15463,RM-1144,12/28/2013,0,0,0,0,0,0,0
15464,RM-1144,12/29/2013,0,0,0,0,0,0,0
15465,RM-1144,12/30/2013,0,0,0,0,0,0,0
15466,RM-1144,12/31/2013,0,0,0,0,0,0,0
15467,RM-1144,1/1/2014,0,0,0,0,0,0,0
15468,RM-1144,1/2/2014,0,0,0,0,0,0,0
15469,RM-1144,1/3/2014,0,0,0,0,0,0,0
15470,RM-1144,1/4/2014,0,0,0,0,0,0,0
15830,RM-1144,1/1/2015,0,0,0,0,0,0,0
15831,RM-1144,1/2/2015,0,0,0,0,0,0,0
15832,RM-1144,1/3/2015,0,0,0,0,0,0,0
15833,RM-1144,1/4/2015,0,0,0,0,0,0,0
15834,RM-1144,1/5/2015,0,0,0,0,0,0,0
15835,RM-1144,1/6/2015,0,0,0,0,0,0,0
15836,RM-1144,1/7/2015,0,0,0,0,0,0,0
15837,RM-1144,1/8/2015,0,0,0,0,0,0,0
15838,RM-1144,1/9/2015,0,0,0,0,0,0,0
15839,RM-1144,1/10/2015,0,0,0,0,0,0,0
15840,RM-1144,1/11/2015,0,0,0,0,0,0,0
15841,RM-1144,1/12/2015,0,0,0,0,0,0,0
15842,RM-1144,1/13/2015,0,0,0,0,0,0,0
15843,RM-1144,1/14/2015,0,0,0,0,0,0,0
15844,RM-1144,1/15/2015,0,0,0,0,0,0,0
15845,RM-1144,1/16/2015,0,0,0,0,0,0,0
15846,RM-1144,1/17/2015,0,0,0,0,0,0,0
15847,RM-1144,1/18/2015,0,0,0,0,0,0,0
15848,RM-1144,1/19/2015,0,0,0,0,0,0,0
15849,RM-1144,1/20/2015,0,0,0,0,0,0,0
15850,RM-1144,1/21/2015,0,0,0,0,0,0,0
15851,RM-1144,1/22/2015,0,0,0,0,0,0,0
15852,RM-1144,1/23/2015,0,0,0,0,0,0,0
15853,RM-1144,1/24/2015,0,0,0,0,0,0,0
15854,RM-1144,1/25/2015,0,0,0,0,0,0,0
15855,RM-1144,1/26/2015,0,0,0,0,0,0,0
15856,RM-1144,1/27/2015,0,0,0,0,0,0,0
15857,RM-1144,1/28/2015,0,0,0,0,0,0,0
15858,RM-1144,1/29/2015,0,0,0,0,0,0,0
15859,RM-1144,1/30/2015,0,0,0,0,0,0,0
15860,RM-1144,1/31/2015,0,0,0,0,0,0,0
15861,RM-1144,2/1/2015,0,0,0,0,0,0,0
15862,RM-1144,2/2/2015,0,0,0,0,0,0,0
15863,RM-1144,2/3/2015,0,0,0,0,0,0,0
15864,RM-1144,2/4/2015,0,0,0,0,0,0,0
15865,RM-1144,2/5/2015,0,0,0,0,0,0,0
15866,RM-1144,2/6/2015,0,0,0,0,0,0,0
15867,RM-1144,2/7/2015,0,0,0,0,0,0,0
15868,RM-1144,2/8/2015,0,0,0,0,0,0,0
15869,RM-1144,2/9/2015,0,0,0,0,0,0,0
15870,RM-1144,2/10/2015,0,0,0,0,0,0,0
15871,RM-1144,2/11/2015,0,0,0,0,0,0,0
15872,RM-1144,2/12/2015,0,0,0,0,0,0,0
15873,RM-1144,2/13/2015,0,0,0,0,0,0,0
15874,RM-1144,2/14/2015,0,0,0,0,0,0,0
15875,RM-1144,2/15/2015,0,0,0,0,0,0,0
15876,RM-1144,2/16/2015,0,0,0,0,0,0,0
15877,RM-1144,2/17/2015,0,0,0,0,0,0,0
15878,RM-1144,2/18/2015,0,0,0,0,0,0,0
15879,RM-1144,2/19/2015,0,0,0,0,0,0,0
15880,RM-1144,2/20/2015,0,0,0,0,0,0,0
15881,RM-1144,2/21/2015,0,0,0,0,0,0,0
15882,RM-1144,2/22/2015,0,0,0,0,0,0,0
15883,RM-1144,2/23/2015,0,0,0,0,0,0,0
15884,RM-1144,2/24/2015,0,0,0,0,0,0,0
15885,RM-1144,2/25/2015,0,0,0,0,0,0,0
15886,RM-1144,2/26/2015,0,0,0,0,0,0,0
15887,RM-1144,2/27/2015,0,0,0,0,0,0,0
15888,RM-1144,2/28/2015,0,0,0,0,0,0,0
15889,RM-1144,3/1/2015,0,0,0,0,0,0,0
15890,RM-1144,3/2/2015,0,0,0,0,0,0,0
15891,RM-1144,3/3/2015,0,0,0,0,0,0,0
15892,RM-1144,3/4/2015,0,0,0,0,0,0,0
15893,RM-1144,3/5/2015,0,0,0,0,0,0,0
15894,RM-1144,3/6/2015,0,0,0,0,0,0,0
15895,RM-1144,3/7/2015,0,0,0,0,0,0,0
15896,RM-1144,3/8/2015,0,0,0,0,0,0,0
15897,RM-1144,3/9/2015,0,0,0,0,0,0,0
15898,RM-1144,3/10/2015,0,0,0,0,0,0,0
15899,RM-1144,3/11/2015,0,0,0,0,0,0,0
15900,RM-1144,3/12/2015,0,0,0,0,0,0,0
15901,RM-1144,3/13/2015,0,0,0,0,0,0,0
15902,RM-1144,3/14/2015,0,0,0,0,0,0,0
15903,RM-1144,3/15/2015,0,0,0,0,0,0,0
15904,RM-1144,3/16/2015,0,0,0,0,0,0,0
15905,RM-1144,3/17/2015,0,0,0,0,0,0,0
15906,RM-1144,3/18/2015,0,0,0,0,0,0,0
15907,RM-1144,3/19/2015,0,0,0,0,0,0,0
15908,RM-1144,3/20/2015,0,0,0,0,0,0,0
15909,RM-1144,3/21/2015,0,0,0,0,0,0,0
15910,RM-1144,3/22/2015,0,0,0,0,0,0,0
15911,RM-1144,3/23/2015,0,0,0,0,0,0,0
15912,RM-1144,3/24/2015,0,0,0,0,0,0,0
15913,RM-1144,3/25/2015,0,0,0,0,0,0,0
15914,RM-1144,3/26/2015,0,0,0,0,0,0,0
15915,RM-1144,3/27/2015,0,0,0,0,0,0,0
15916,RM-1144,3/28/2015,0,0,0,0,0,0,0
15917,RM-1144,3/29/2015,0,0,0,0,0,0,0
15918,RM-1144,3/30/2015,0,0,0,0,0,0,0
15919,RM-1144,3/31/2015,0,0,0,0,0,0,0
15920,RM-1144,4/1/2015,0,0,0,0,0,0,0
15921,RM-1144,4/2/2015,0,0,0,0,0,0,0
15922,RM-1144,4/3/2015,0,0,0,0,0,0,0
15923,RM-1144,4/4/2015,0,0,0,0,0,0,0
15924,RM-1144,4/5/2015,0,0,0,0,0,0,0
15925,RM-1144,4/6/2015,0,0,0,0,0,0,0
15926,RM-1144,4/7/2015,0,0,0,0,0,0,0
15927,RM-1144,4/8/2015,0,0,0,0,0,0,0
15928,RM-1144,4/9/2015,0,0,0,0,0,0,0
15929,RM-1144,4/10/2015,0,0,0,0,0,0,0
15930,RM-1144,4/11/2015,0,0,0,0,0,0,0
15931,RM-1144,4/12/2015,0,0,0,0,0,0,0
15932,RM-1144,4/13/2015,0,0,0,0,0,0,0
15933,RM-1144,4/14/2015,0,0,0,0,0,0,0
15934,RM-1144,4/15/2015,0,0,0,0,0,0,0
15935,RM-1144,4/16/2015,0,0,0,0,0,0,0
15936,RM-1144,4/17/2015,0,0,0,0,0,0,0
15937,RM-1144,4/18/2015,0,0,0,0,0,0,0
15938,RM-1144,4/19/2015,0,0,0,0,0,0,0
15939,RM-1144,4/20/2015,0,0,0,0,0,0,0
15940,RM-1144,4/21/2015,0,0,0,0,0,0,0
15941,RM-1144,4/22/2015,0,0,0,0,0,0,0
15942,RM-1144,4/23/2015,0,0,0,0,0,0,0
15943,RM-1144,4/24/2015,0,0,0,0,0,0,0
15944,RM-1144,4/25/2015,0,0,0,0,0,0,0
15945,RM-1144,4/26/2015,0,0,0,0,0,0,0
15946,RM-1144,4/27/2015,0,0,0,0,0,0,0
15947,RM-1144,4/28/2015,0,0,0,0,0,0,0
15948,RM-1144,4/29/2015,0,0,0,0,0,0,0
15949,RM-1144,4/30/2015,0,0,0,0,0,0,0
15950,RM-1144,5/1/2015,0,0,0,0,0,0,0
15951,RM-1144,5/2/2015,0,0,0,0,0,0,0
15952,RM-1144,5/3/2015,0,0,0,0,0,0,0
15953,RM-1144,5/4/2015,0,0,0,0,0,0,0
15954,RM-1144,5/5/2015,0,0,0,0,0,0,0
15955,RM-1144,5/6/2015,0,0,0,0,0,0,0
15956,RM-1144,5/7/2015,0,0,0,0,0,0,0
15957,RM-1144,5/8/2015,0,0,0,0,0,0,0
15958,RM-1144,5/9/2015,0,0,0,0,0,0,0
15959,RM-1144,5/10/2015,0,0,0,0,0,0,0
15960,RM-1144,5/11/2015,0,0,0,0,0,0,0
15961,RM-1144,5/12/2015,0,0,0,0,0,0,0
15962,RM-1144,5/13/2015,0,0,0,0,0,0,0
15963,RM-1144,5/14/2015,0,0,0,0,0,0,0
15964,RM-1144,5/15/2015,0,0,0,0,0,0,0
15965,RM-1144,5/16/2015,0,0,0,0,0,0,0
15966,RM-1144,5/17/2015,0,0,0,0,0,0,0
15967,RM-1144,5/18/2015,0,0,0,0,0,0,0
15968,RM-1144,5/19/2015,0,0,0,0,0,0,0
15969,RM-1144,5/20/2015,0,0,0,0,0,0,0
15970,RM-1144,5/21/2015,0,0,0,0,0,0,0
15971,RM-1144,5/22/2015,0,0,0,0,0,0,0
15972,RM-1144,5/23/2015,0,0,0,0,0,0,0
15973,RM-1144,5/24/2015,0,0,0,0,0,0,0
15974,RM-1144,5/25/2015,0,0,0,0,0,0,0
15975,RM-1144,5/26/2015,0,0,0,0,0,0,0
15976,RM-1144,5/27/2015,0,0,0,0,0,0,0
15977,RM-1144,5/28/2015,0,0,0,0,0,0,0
15978,RM-1144,5/29/2015,0,0,0,0,0,0,0
15979,RM-1144,5/30/2015,0,0,0,0,0,0,0
15980,RM-1144,5/31/2015,0,0,0,0,0,0,0
15981,RM-1145,7/1/2013,0,0,0,0,0,0,0
15982,RM-1145,7/2/2013,0,0,0,0,0,0,0
15983,RM-1145,7/3/2013,0,0,0,0,0,0,0
15984,RM-1145,7/4/2013,0,0,0,0,0,0,0
15985,RM-1145,7/5/2013,0,0,0,0,0,0,0
15986,RM-1145,7/6/2013,0,0,0,0,0,0,0
15987,RM-1145,7/7/2013,0,0,0,0,0,0,0
15988,RM-1145,7/8/2013,0,0,0,0,0,0,0
15989,RM-1145,7/9/2013,0,0,0,0,0,0,0
15990,RM-1145,7/10/2013,0,0,0,0,0,0,0
15991,RM-1145,7/11/2013,0,0,0,0,0,0,0
15992,RM-1145,7/12/2013,0,0,0,0,0,0,0
15993,RM-1145,7/13/2013,0,0,0,0,0,0,0
15994,RM-1145,7/14/2013,0,0,0,0,0,0,0
15995,RM-1145,7/15/2013,0,0,0,0,0,0,0
15996,RM-1145,7/17/2013,0,0,0,0,0,0,0
15997,RM-1145,7/18/2013,0,0,0,0,0,0,0
15998,RM-1145,7/19/2013,0,0,0,0,0,0,0
15999,RM-1145,7/20/2013,0,0,0,0,0,0,0
16000,RM-1145,7/21/2013,0,0,0,0,0,0,0
16001,RM-1145,7/22/2013,0,0,0,0,0,0,0
16002,RM-1145,7/23/2013,0,0,0,0,0,0,0
16003,RM-1145,7/24/2013,0,0,0,0,0,0,0
16004,RM-1145,7/25/2013,0,0,0,0,0,0,0
16005,RM-1145,7/26/2013,0,0,0,0,0,0,0
16006,RM-1145,7/27/2013,0,0,0,0,0,0,0
16007,RM-1145,7/28/2013,0,0,0,0,0,0,0
16008,RM-1145,7/29/2013,0,0,0,0,0,0,0
16009,RM-1145,7/30/2013,0,0,0,0,0,0,0
16010,RM-1145,7/31/2013,0,0,0,0,0,0,0
16011,RM-1145,8/1/2013,0,0,0,0,0,0,0
16012,RM-1145,8/2/2013,0,0,0,0,0,0,0
16013,RM-1145,8/3/2013,0,0,0,0,0,0,0
16014,RM-1145,8/4/2013,0,0,0,0,0,0,0
16015,RM-1145,8/5/2013,0,0,0,0,0,0,0
16016,RM-1145,8/6/2013,0,0,0,0,0,0,0
16017,RM-1145,8/7/2013,0,0,0,0,0,0,0
16018,RM-1145,8/8/2013,0,0,0,0,0,0,0
16019,RM-1145,8/9/2013,0,0,0,0,0,0,0
16020,RM-1145,8/10/2013,0,0,0,0,0,0,0
16021,RM-1145,8/11/2013,0,0,0,0,0,0,0
16022,RM-1145,8/12/2013,0,0,0,0,0,0,0
16023,RM-1145,8/13/2013,0,0,0,0,0,0,0
16024,RM-1145,8/14/2013,0,0,0,0,0,0,0
16025,RM-1145,8/15/2013,0,0,0,0,0,0,0
16026,RM-1145,8/16/2013,0,0,0,0,0,0,0
16027,RM-1145,8/17/2013,0,0,0,0,0,0,0
16028,RM-1145,8/18/2013,0,0,0,0,0,0,0
16029,RM-1145,8/19/2013,0,0,0,0,0,0,0
16030,RM-1145,8/20/2013,0,0,0,0,0,0,0
16031,RM-1145,8/21/2013,0,0,0,0,0,0,0
16032,RM-1145,8/22/2013,0,0,0,0,0,0,0
16033,RM-1145,8/27/2013,0,0,0,0,0,0,0
16034,RM-1145,8/28/2013,0,0,0,0,0,0,0
16035,RM-1145,8/29/2013,0,0,0,0,0,0,0
16036,RM-1145,8/30/2013,0,0,0,0,0,0,0
16037,RM-1145,9/4/2013,0,0,0,0,0,0,0
16038,RM-1145,9/5/2013,0,0,0,0,0,0,0
16039,RM-1145,9/6/2013,0,0,0,0,0,0,0
16040,RM-1145,9/7/2013,0,0,0,0,0,0,0
16041,RM-1145,9/9/2013,0,0,0,0,0,0,0
16042,RM-1145,9/10/2013,0,0,0,0,0,0,0
16043,RM-1145,9/11/2013,0,0,0,0,0,0,0
16044,RM-1145,9/12/2013,0,0,0,0,0,0,0
16045,RM-1145,9/13/2013,0,0,0,0,0,0,0
16046,RM-1145,9/14/2013,0,0,0,0,0,0,0
16047,RM-1145,9/15/2013,0,0,0,0,0,0,0
16048,RM-1145,9/16/2013,0,0,0,0,0,0,0
16049,RM-1145,9/17/2013,0,0,0,0,0,0,0
16050,RM-1145,9/18/2013,0,0,0,0,0,0,0
16051,RM-1145,9/19/2013,0,0,0,0,0,0,0
16052,RM-1145,9/20/2013,0,0,0,0,0,0,0
16053,RM-1145,9/21/2013,0,0,0,0,0,0,0
16054,RM-1145,9/22/2013,0,0,0,0,0,0,0
16055,RM-1145,9/23/2013,0,0,0,0,0,0,0
16056,RM-1145,9/24/2013,0,0,0,0,0,0,0
16057,RM-1145,9/25/2013,0,0,0,0,0,0,0
16058,RM-1145,9/26/2013,0,0,0,0,0,0,0
16059,RM-1145,9/27/2013,0,0,0,0,0,0,0
16060,RM-1145,9/28/2013,0,0,0,0,0,0,0
16061,RM-1145,9/29/2013,0,0,0,0,0,0,0
16062,RM-1145,9/30/2013,0,0,0,0,0,0,0
16063,RM-1145,10/1/2013,0,0,0,0,0,0,0
16064,RM-1145,10/2/2013,0,0,0,0,0,0,0
16065,RM-1145,10/3/2013,0,0,0,0,0,0,0
16066,RM-1145,10/4/2013,0,0,0,0,0,0,0
16067,RM-1145,10/5/2013,0,0,0,0,0,0,0
16068,RM-1145,10/6/2013,0,0,0,0,0,0,0
16069,RM-1145,10/7/2013,0,0,0,0,0,0,0
16070,RM-1145,10/8/2013,0,0,0,0,0,0,0
16071,RM-1145,10/9/2013,0,0,0,0,0,0,0
16072,RM-1145,10/10/2013,0,0,0,0,0,0,0
16073,RM-1145,10/11/2013,0,0,0,0,0,0,0
16074,RM-1145,10/12/2013,0,0,0,0,0,0,0
16562,RM-1145,3/16/2015,0,0,0,0,0,0,0
16563,RM-1145,3/17/2015,0,0,0,0,0,0,0
16564,RM-1145,3/18/2015,0,0,0,0,0,0,0
16565,RM-1145,3/19/2015,0,0,0,0,0,0,0
16566,RM-1145,3/20/2015,0,0,0,0,0,0,0
16567,RM-1145,3/21/2015,0,0,0,0,0,0,0
16568,RM-1145,3/22/2015,0,0,0,0,0,0,0
16569,RM-1145,3/23/2015,0,0,0,0,0,0,0
16570,RM-1145,3/24/2015,0,0,0,0,0,0,0
16571,RM-1145,3/25/2015,0,0,0,0,0,0,0
16572,RM-1145,3/26/2015,0,0,0,0,0,0,0
16573,RM-1145,3/27/2015,0,0,0,0,0,0,0
16574,RM-1145,3/28/2015,0,0,0,0,0,0,0
16575,RM-1145,3/29/2015,0,0,0,0,0,0,0
16576,RM-1145,3/30/2015,0,0,0,0,0,0,0
16577,RM-1145,3/31/2015,0,0,0,0,0,0,0
16578,RM-1145,4/1/2015,0,0,0,0,0,0,0
16579,RM-1145,4/2/2015,0,0,0,0,0,0,0
16580,RM-1145,4/3/2015,0,0,0,0,0,0,0
16581,RM-1145,4/4/2015,0,0,0,0,0,0,0
16582,RM-1145,4/5/2015,0,0,0,0,0,0,0
16583,RM-1145,4/6/2015,0,0,0,0,0,0,0
16584,RM-1145,4/7/2015,0,0,0,0,0,0,0
16585,RM-1145,4/8/2015,0,0,0,0,0,0,0
16586,RM-1145,4/9/2015,0,0,0,0,0,0,0
16587,RM-1145,4/10/2015,0,0,0,0,0,0,0
16588,RM-1145,4/11/2015,0,0,0,0,0,0,0
16589,RM-1145,4/12/2015,0,0,0,0,0,0,0
16590,RM-1145,4/13/2015,0,0,0,0,0,0,0
16591,RM-1145,4/14/2015,0,0,0,0,0,0,0
16592,RM-1145,4/15/2015,0,0,0,0,0,0,0
16593,RM-1145,4/16/2015,0,0,0,0,0,0,0
16594,RM-1145,4/17/2015,0,0,0,0,0,0,0
16595,RM-1145,4/18/2015,0,0,0,0,0,0,0
16596,RM-1145,4/19/2015,0,0,0,0,0,0,0
16597,RM-1145,4/20/2015,0,0,0,0,0,0,0
16598,RM-1145,4/21/2015,0,0,0,0,0,0,0
16599,RM-1145,4/22/2015,0,0,0,0,0,0,0
16600,RM-1145,4/23/2015,0,0,0,0,0,0,0
16601,RM-1145,4/24/2015,0,0,0,0,0,0,0
16602,RM-1145,4/25/2015,0,0,0,0,0,0,0
16603,RM-1145,4/26/2015,0,0,0,0,0,0,0
16604,RM-1145,4/27/2015,0,0,0,0,0,0,0
16605,RM-1145,4/28/2015,0,0,0,0,0,0,0
16606,RM-1145,4/29/2015,0,0,0,0,0,0,0
16607,RM-1145,4/30/2015,0,0,0,0,0,0,0
16608,RM-1145,5/1/2015,0,0,0,0,0,0,0
16609,RM-1145,5/2/2015,0,0,0,0,0,0,0
16610,RM-1145,5/3/2015,0,0,0,0,0,0,0
16611,RM-1145,5/4/2015,0,0,0,0,0,0,0
16612,RM-1145,5/5/2015,0,0,0,0,0,0,0
16613,RM-1145,5/6/2015,0,0,0,0,0,0,0
16614,RM-1145,5/7/2015,0,0,0,0,0,0,0
16615,RM-1145,5/8/2015,0,0,0,0,0,0,0
16616,RM-1145,5/9/2015,0,0,0,0,0,0,0
16617,RM-1145,5/10/2015,0,0,0,0,0,0,0
16618,RM-1145,5/11/2015,0,0,0,0,0,0,0
16619,RM-1145,5/12/2015,0,0,0,0,0,0,0
16620,RM-1145,5/13/2015,0,0,0,0,0,0,0
16621,RM-1145,5/14/2015,0,0,0,0,0,0,0
16622,RM-1145,5/15/2015,0,0,0,0,0,0,0
16623,RM-1145,5/16/2015,0,0,0,0,0,0,0
16624,RM-1145,5/17/2015,0,0,0,0,0,0,0
16625,RM-1145,5/18/2015,0,0,0,0,0,0,0
16626,RM-1145,5/19/2015,0,0,0,0,0,0,0
16627,RM-1145,5/20/2015,0,0,0,0,0,0,0
16628,RM-1145,5/21/2015,0,0,0,0,0,0,0
16629,RM-1145,5/22/2015,0,0,0,0,0,0,0
16630,RM-1145,5/23/2015,0,0,0,0,0,0,0
16631,RM-1145,5/24/2015,0,0,0,0,0,0,0
16632,RM-1145,5/25/2015,0,0,0,0,0,0,0
16633,RM-1145,5/26/2015,0,0,0,0,0,0,0
16634,RM-1145,5/27/2015,0,0,0,0,0,0,0
16635,RM-1145,5/28/2015,0,0,0,0,0,0,0
16636,RM-1145,5/29/2015,0,0,0,0,0,0,0
16637,RM-1145,5/30/2015,0,0,0,0,0,0,0
16638,RM-1145,5/31/2015,0,0,0,0,0,0,0
16639,RM-1150,7/1/2013,0,0,0,0,0,0,0
16640,RM-1150,7/2/2013,0,0,0,0,0,0,0
16641,RM-1150,7/3/2013,0,0,0,0,0,0,0
16642,RM-1150,7/4/2013,0,0,0,0,0,0,0
16643,RM-1150,7/5/2013,0,0,0,0,0,0,0
16644,RM-1150,7/6/2013,0,0,0,0,0,0,0
16645,RM-1150,7/7/2013,0,0,0,0,0,0,0
16646,RM-1150,7/8/2013,0,0,0,0,0,0,0
16647,RM-1150,7/9/2013,0,0,0,0,0,0,0
16648,RM-1150,7/10/2013,0,0,0,0,0,0,0
16649,RM-1150,7/11/2013,0,0,0,0,0,0,0
16650,RM-1150,7/12/2013,0,0,0,0,0,0,0
16651,RM-1150,7/13/2013,0,0,0,0,0,0,0
16652,RM-1150,7/14/2013,0,0,0,0,0,0,0
16653,RM-1150,7/15/2013,0,0,0,0,0,0,0
16654,RM-1150,7/17/2013,0,0,0,0,0,0,0
16655,RM-1150,7/18/2013,0,0,0,0,0,0,0
16656,RM-1150,7/19/2013,0,0,0,0,0,0,0
16657,RM-1150,7/20/2013,0,0,0,0,0,0,0
16658,RM-1150,7/21/2013,0,0,0,0,0,0,0
16659,RM-1150,7/22/2013,0,0,0,0,0,0,0
16660,RM-1150,7/23/2013,0,0,0,0,0,0,0
16661,RM-1150,7/24/2013,0,0,0,0,0,0,0
16662,RM-1150,7/25/2013,0,0,0,0,0,0,0
16663,RM-1150,7/26/2013,0,0,0,0,0,0,0
16664,RM-1150,7/27/2013,0,0,0,0,0,0,0
16665,RM-1150,7/28/2013,0,0,0,0,0,0,0
16666,RM-1150,7/29/2013,0,0,0,0,0,0,0
16667,RM-1150,7/30/2013,0,0,0,0,0,0,0
16668,RM-1150,7/31/2013,0,0,0,0,0,0,0
16669,RM-1150,8/1/2013,0,0,0,0,0,0,0
16670,RM-1150,8/2/2013,0,0,0,0,0,0,0
16671,RM-1150,8/3/2013,0,0,0,0,0,0,0
16672,RM-1150,8/4/2013,0,0,0,0,0,0,0
16673,RM-1150,8/5/2013,0,0,0,0,0,0,0
16674,RM-1150,8/6/2013,0,0,0,0,0,0,0
16675,RM-1150,8/7/2013,0,0,0,0,0,0,0
16676,RM-1150,8/8/2013,0,0,0,0,0,0,0
16677,RM-1150,8/9/2013,0,0,0,0,0,0,0
16678,RM-1150,8/10/2013,0,0,0,0,0,0,0
16679,RM-1150,8/11/2013,0,0,0,0,0,0,0
16680,RM-1150,8/12/2013,0,0,0,0,0,0,0
16681,RM-1150,8/13/2013,0,0,0,0,0,0,0
16682,RM-1150,8/14/2013,0,0,0,0,0,0,0
16683,RM-1150,8/15/2013,0,0,0,0,0,0,0
16684,RM-1150,8/16/2013,0,0,0,0,0,0,0
16685,RM-1150,8/17/2013,0,0,0,0,0,0,0
16686,RM-1150,8/18/2013,0,0,0,0,0,0,0
16687,RM-1150,8/19/2013,0,0,0,0,0,0,0
16688,RM-1150,8/20/2013,0,0,0,0,0,0,0
16689,RM-1150,8/21/2013,0,0,0,0,0,0,0
16690,RM-1150,8/22/2013,0,0,0,0,0,0,0
16691,RM-1150,8/27/2013,0,0,0,0,0,0,0
16692,RM-1150,8/28/2013,0,0,0,0,0,0,0
16693,RM-1150,8/29/2013,0,0,0,0,0,0,0
16694,RM-1150,8/30/2013,0,0,0,0,0,0,0
16695,RM-1150,9/4/2013,0,0,0,0,0,0,0
16696,RM-1150,9/5/2013,0,0,0,0,0,0,0
16697,RM-1150,9/6/2013,0,0,0,0,0,0,0
16698,RM-1150,9/7/2013,0,0,0,0,0,0,0
16699,RM-1150,9/9/2013,0,0,0,0,0,0,0
16700,RM-1150,9/10/2013,0,0,0,0,0,0,0
16701,RM-1150,9/11/2013,0,0,0,0,0,0,0
16702,RM-1150,9/12/2013,0,0,0,0,0,0,0
16703,RM-1150,9/13/2013,0,0,0,0,0,0,0
16704,RM-1150,9/14/2013,0,0,0,0,0,0,0
16705,RM-1150,9/15/2013,0,0,0,0,0,0,0
16706,RM-1150,9/16/2013,0,0,0,0,0,0,0
16707,RM-1150,9/17/2013,0,0,0,0,0,0,0
16708,RM-1150,9/18/2013,0,0,0,0,0,0,0
16709,RM-1150,9/19/2013,0,0,0,0,0,0,0
16710,RM-1150,9/20/2013,0,0,0,0,0,0,0
16711,RM-1150,9/21/2013,0,0,0,0,0,0,0
16712,RM-1150,9/22/2013,0,0,0,0,0,0,0
16713,RM-1150,9/23/2013,0,0,0,0,0,0,0
16714,RM-1150,9/24/2013,0,0,0,0,0,0,0
16715,RM-1150,9/25/2013,0,0,0,0,0,0,0
16716,RM-1150,9/26/2013,0,0,0,0,0,0,0
16717,RM-1150,9/27/2013,0,0,0,0,0,0,0
16718,RM-1150,9/28/2013,0,0,0,0,0,0,0
16719,RM-1150,9/29/2013,0,0,0,0,0,0,0
16720,RM-1150,9/30/2013,0,0,0,0,0,0,0
16721,RM-1150,10/1/2013,0,0,0,0,0,0,0
16722,RM-1150,10/2/2013,0,0,0,0,0,0,0
16723,RM-1150,10/3/2013,0,0,0,0,0,0,0
16724,RM-1150,10/4/2013,0,0,0,0,0,0,0
16725,RM-1150,10/5/2013,0,0,0,0,0,0,0
16726,RM-1150,10/6/2013,0,0,0,0,0,0,0
16727,RM-1150,10/7/2013,0,0,0,0,0,0,0
16728,RM-1150,10/8/2013,0,0,0,0,0,0,0
16729,RM-1150,10/9/2013,0,0,0,0,0,0,0
16730,RM-1150,10/10/2013,0,0,0,0,0,0,0
16731,RM-1150,10/11/2013,0,0,0,0,0,0,0
16732,RM-1150,10/12/2013,0,0,0,0,0,0,0
16733,RM-1150,10/13/2013,0,0,0,0,0,0,0
16734,RM-1150,10/14/2013,0,0,0,0,0,0,0
16735,RM-1150,10/15/2013,0,0,0,0,0,0,0
16736,RM-1150,10/16/2013,0,0,0,0,0,0,0
16737,RM-1150,10/17/2013,0,0,0,0,0,0,0
16738,RM-1150,10/18/2013,0,0,0,0,0,0,0
16739,RM-1150,10/19/2013,0,0,0,0,0,0,0
16740,RM-1150,10/20/2013,0,0,0,0,0,0,0
16741,RM-1150,10/21/2013,0,0,0,0,0,0,0
16742,RM-1150,10/22/2013,0,0,0,0,0,0,0
16743,RM-1150,10/23/2013,0,0,0,0,0,0,0
16744,RM-1150,10/24/2013,0,0,0,0,0,0,0
16745,RM-1150,10/25/2013,0,0,0,0,0,0,0
16746,RM-1150,10/26/2013,0,0,0,0,0,0,0
16747,RM-1150,10/27/2013,0,0,0,0,0,0,0
16748,RM-1150,10/28/2013,0,0,0,0,0,0,0
16749,RM-1150,10/29/2013,0,0,0,0,0,0,0
16750,RM-1150,10/30/2013,0,0,0,0,0,0,0
16751,RM-1150,11/1/2013,0,0,0,0,0,0,0
16752,RM-1150,11/2/2013,0,0,0,0,0,0,0
16753,RM-1150,11/3/2013,0,0,0,0,0,0,0
16754,RM-1150,11/4/2013,0,0,0,0,0,0,0
16755,RM-1150,11/5/2013,0,0,0,0,0,0,0
16756,RM-1150,11/6/2013,0,0,0,0,0,0,0
16757,RM-1150,11/7/2013,0,0,0,0,0,0,0
16758,RM-1150,11/8/2013,0,0,0,0,0,0,0
16759,RM-1150,11/9/2013,0,0,0,0,0,0,0
16760,RM-1150,11/10/2013,0,0,0,0,0,0,0
16761,RM-1150,11/11/2013,0,0,0,0,0,0,0
16762,RM-1150,11/12/2013,0,0,0,0,0,0,0
16763,RM-1150,11/13/2013,0,0,0,0,0,0,0
16764,RM-1150,11/14/2013,0,0,0,0,0,0,0
16765,RM-1150,11/15/2013,0,0,0,0,0,0,0
16766,RM-1150,11/19/2013,0,0,0,0,0,0,0
16767,RM-1150,11/20/2013,0,0,0,0,0,0,0
16768,RM-1150,11/21/2013,0,0,0,0,0,0,0
16769,RM-1150,11/22/2013,0,0,0,0,0,0,0
16770,RM-1150,11/23/2013,0,0,0,0,0,0,0
16771,RM-1150,11/24/2013,0,0,0,0,0,0,0
16772,RM-1150,11/25/2013,0,0,0,0,0,0,0
16773,RM-1150,11/26/2013,0,0,0,0,0,0,0
16774,RM-1150,11/27/2013,0,0,0,0,0,0,0
16775,RM-1150,11/28/2013,0,0,0,0,0,0,0
16776,RM-1150,11/29/2013,0,0,0,0,0,0,0
16777,RM-1150,11/30/2013,0,0,0,0,0,0,0
16778,RM-1150,12/1/2013,0,0,0,0,0,0,0
16779,RM-1150,12/2/2013,0,0,0,0,0,0,0
16780,RM-1150,12/3/2013,0,0,0,0,0,0,0
16781,RM-1150,12/4/2013,0,0,0,0,0,0,0
16782,RM-1150,12/5/2013,0,0,0,0,0,0,0
16783,RM-1150,12/6/2013,0,0,0,0,0,0,0
16784,RM-1150,12/7/2013,0,0,0,0,0,0,0
16785,RM-1150,12/8/2013,0,0,0,0,0,0,0
16786,RM-1150,12/9/2013,0,0,0,0,0,0,0
16787,RM-1150,12/10/2013,0,0,0,0,0,0,0
16788,RM-1150,12/11/2013,0,0,0,0,0,0,0
16789,RM-1150,12/12/2013,0,0,0,0,0,0,0
16790,RM-1150,12/13/2013,0,0,0,0,0,0,0
16791,RM-1150,12/14/2013,0,0,0,0,0,0,0
16792,RM-1150,12/15/2013,0,0,0,0,0,0,0
16793,RM-1150,12/16/2013,0,0,0,0,0,0,0
16794,RM-1150,12/17/2013,0,0,0,0,0,0,0
16795,RM-1150,12/18/2013,0,0,0,0,0,0,0
16796,RM-1150,12/19/2013,0,0,0,0,0,0,0
16797,RM-1150,12/20/2013,0,0,0,0,0,0,0
16798,RM-1150,12/21/2013,0,0,0,0,0,0,0
16799,RM-1150,12/22/2013,0,0,0,0,0,0,0
16800,RM-1150,12/23/2013,0,0,0,0,0,0,0
16801,RM-1150,12/24/2013,0,0,0,0,0,0,0
16802,RM-1150,12/25/2013,0,0,0,0,0,0,0
16803,RM-1150,12/26/2013,0,0,0,0,0,0,0
16804,RM-1150,12/27/2013,0,0,0,0,0,0,0
16805,RM-1150,12/28/2013,0,0,0,0,0,0,0
16806,RM-1150,12/29/2013,0,0,0,0,0,0,0
16807,RM-1150,12/30/2013,0,0,0,0,0,0,0
16808,RM-1150,12/31/2013,0,0,0,0,0,0,0
16809,RM-1150,1/1/2014,0,0,0,0,0,0,0
16810,RM-1150,1/2/2014,0,0,0,0,0,0,0
16811,RM-1150,1/3/2014,0,0,0,0,0,0,0
16812,RM-1150,1/4/2014,0,0,0,0,0,0,0
16813,RM-1150,1/5/2014,0,0,0,0,0,0,0
16814,RM-1150,1/6/2014,0,0,0,0,0,0,0
16815,RM-1150,1/7/2014,0,0,0,0,0,0,0
16816,RM-1150,1/8/2014,0,0,0,0,0,0,0
16817,RM-1150,1/9/2014,0,0,0,0,0,0,0
16818,RM-1150,1/10/2014,0,0,0,0,0,0,0
16819,RM-1150,1/11/2014,0,0,0,0,0,0,0
16820,RM-1150,1/12/2014,0,0,0,0,0,0,0
16821,RM-1150,1/13/2014,0,0,0,0,0,0,0
16822,RM-1150,1/14/2014,0,0,0,0,0,0,0
16823,RM-1150,1/15/2014,0,0,0,0,0,0,0
16844,RM-1150,2/5/2014,0,0,0,0,0,0,0
16845,RM-1150,2/6/2014,0,0,0,0,0,0,0
16846,RM-1150,2/7/2014,0,0,0,0,0,0,0
16847,RM-1150,2/8/2014,0,0,0,0,0,0,0
16848,RM-1150,2/9/2014,0,0,0,0,0,0,0
16849,RM-1150,2/10/2014,0,0,0,0,0,0,0
16850,RM-1150,2/11/2014,0,0,0,0,0,0,0
16851,RM-1150,2/12/2014,0,0,0,0,0,0,0
16852,RM-1150,2/13/2014,0,0,0,0,0,0,0
16853,RM-1150,2/14/2014,0,0,0,0,0,0,0
16854,RM-1150,2/15/2014,0,0,0,0,0,0,0
16855,RM-1150,2/16/2014,0,0,0,0,0,0,0
16856,RM-1150,2/17/2014,0,0,0,0,0,0,0
16857,RM-1150,2/18/2014,0,0,0,0,0,0,0
16858,RM-1150,2/19/2014,0,0,0,0,0,0,0
16859,RM-1150,2/20/2014,0,0,0,0,0,0,0
16860,RM-1150,2/21/2014,0,0,0,0,0,0,0
16861,RM-1150,2/22/2014,0,0,0,0,0,0,0
16862,RM-1150,2/23/2014,0,0,0,0,0,0,0
16863,RM-1150,2/24/2014,0,0,0,0,0,0,0
16992,RM-1150,7/3/2014,0,0,0,0,0,0,0
16993,RM-1150,7/4/2014,0,0,0,0,0,0,0
16994,RM-1150,7/5/2014,0,0,0,0,0,0,0
16995,RM-1150,7/6/2014,0,0,0,0,0,0,0
16996,RM-1150,7/7/2014,0,0,0,0,0,0,0
16997,RM-1150,7/8/2014,0,0,0,0,0,0,0
16998,RM-1150,7/9/2014,0,0,0,0,0,0,0
16999,RM-1150,7/10/2014,0,0,0,0,0,0,0
17000,RM-1150,7/11/2014,0,0,0,0,0,0,0
17001,RM-1150,7/12/2014,0,0,0,0,0,0,0
17002,RM-1150,7/13/2014,0,0,0,0,0,0,0
17003,RM-1150,7/14/2014,0,0,0,0,0,0,0
17004,RM-1150,7/15/2014,0,0,0,0,0,0,0
17005,RM-1150,7/16/2014,0,0,0,0,0,0,0
17006,RM-1150,7/17/2014,0,0,0,0,0,0,0
17007,RM-1150,7/18/2014,0,0,0,0,0,0,0
17008,RM-1150,7/19/2014,0,0,0,0,0,0,0
17009,RM-1150,7/20/2014,0,0,0,0,0,0,0
17010,RM-1150,7/21/2014,0,0,0,0,0,0,0
17011,RM-1150,7/22/2014,0,0,0,0,0,0,0
17012,RM-1150,7/23/2014,0,0,0,0,0,0,0
17013,RM-1150,7/24/2014,0,0,0,0,0,0,0
17014,RM-1150,7/25/2014,0,0,0,0,0,0,0
17015,RM-1150,7/26/2014,0,0,0,0,0,0,0
17016,RM-1150,7/27/2014,0,0,0,0,0,0,0
17017,RM-1150,7/28/2014,0,0,0,0,0,0,0
17018,RM-1150,7/29/2014,0,0,0,0,0,0,0
17019,RM-1150,7/30/2014,0,0,0,0,0,0,0
17020,RM-1150,7/31/2014,0,0,0,0,0,0,0
17021,RM-1150,8/1/2014,0,0,0,0,0,0,0
17022,RM-1150,8/2/2014,0,0,0,0,0,0,0
17023,RM-1150,8/3/2014,0,0,0,0,0,0,0
17024,RM-1150,8/4/2014,0,0,0,0,0,0,0
17025,RM-1150,8/5/2014,0,0,0,0,0,0,0
17026,RM-1150,8/6/2014,0,0,0,0,0,0,0
17027,RM-1150,8/7/2014,0,0,0,0,0,0,0
17028,RM-1150,8/8/2014,0,0,0,0,0,0,0
17029,RM-1150,8/9/2014,0,0,0,0,0,0,0
17030,RM-1150,8/10/2014,0,0,0,0,0,0,0
17031,RM-1150,8/11/2014,0,0,0,0,0,0,0
17032,RM-1150,8/12/2014,0,0,0,0,0,0,0
17033,RM-1150,8/13/2014,0,0,0,0,0,0,0
17034,RM-1150,8/14/2014,0,0,0,0,0,0,0
17035,RM-1150,8/15/2014,0,0,0,0,0,0,0
17036,RM-1150,8/16/2014,0,0,0,0,0,0,0
17037,RM-1150,8/17/2014,0,0,0,0,0,0,0
17038,RM-1150,8/18/2014,0,0,0,0,0,0,0
17039,RM-1150,8/19/2014,0,0,0,0,0,0,0
17040,RM-1150,8/20/2014,0,0,0,0,0,0,0
17041,RM-1150,8/21/2014,0,0,0,0,0,0,0
17042,RM-1150,8/22/2014,0,0,0,0,0,0,0
17043,RM-1150,8/23/2014,0,0,0,0,0,0,0
17044,RM-1150,8/24/2014,0,0,0,0,0,0,0
17045,RM-1150,8/25/2014,0,0,0,0,0,0,0
17046,RM-1150,8/26/2014,0,0,0,0,0,0,0
17047,RM-1150,8/27/2014,0,0,0,0,0,0,0
17048,RM-1150,8/28/2014,0,0,0,0,0,0,0
17049,RM-1150,8/29/2014,0,0,0,0,0,0,0
17050,RM-1150,8/30/2014,0,0,0,0,0,0,0
17051,RM-1150,8/31/2014,0,0,0,0,0,0,0
17052,RM-1150,9/1/2014,0,0,0,0,0,0,0
17053,RM-1150,9/2/2014,0,0,0,0,0,0,0
17054,RM-1150,9/3/2014,0,0,0,0,0,0,0
17055,RM-1150,9/4/2014,0,0,0,0,0,0,0
17056,RM-1150,9/5/2014,0,0,0,0,0,0,0
17057,RM-1150,9/6/2014,0,0,0,0,0,0,0
17058,RM-1150,9/7/2014,0,0,0,0,0,0,0
17059,RM-1150,9/8/2014,0,0,0,0,0,0,0
17060,RM-1150,9/9/2014,0,0,0,0,0,0,0
17061,RM-1150,9/10/2014,0,0,0,0,0,0,0
17062,RM-1150,9/11/2014,0,0,0,0,0,0,0
17063,RM-1150,9/12/2014,0,0,0,0,0,0,0
17064,RM-1150,9/13/2014,0,0,0,0,0,0,0
17065,RM-1150,9/14/2014,0,0,0,0,0,0,0
17066,RM-1150,9/15/2014,0,0,0,0,0,0,0
17067,RM-1150,9/16/2014,0,0,0,0,0,0,0
17068,RM-1150,9/17/2014,0,0,0,0,0,0,0
17069,RM-1150,9/18/2014,0,0,0,0,0,0,0
17070,RM-1150,9/19/2014,0,0,0,0,0,0,0
17071,RM-1150,9/20/2014,0,0,0,0,0,0,0
17072,RM-1150,9/21/2014,0,0,0,0,0,0,0
17073,RM-1150,9/22/2014,0,0,0,0,0,0,0
17074,RM-1150,9/23/2014,0,0,0,0,0,0,0
17075,RM-1150,9/24/2014,0,0,0,0,0,0,0
17076,RM-1150,9/25/2014,0,0,0,0,0,0,0
17077,RM-1150,9/28/2014,0,0,0,0,0,0,0
17078,RM-1150,9/29/2014,0,0,0,0,0,0,0
17079,RM-1150,9/30/2014,0,0,0,0,0,0,0
17080,RM-1150,10/1/2014,0,0,0,0,0,0,0
17081,RM-1150,10/2/2014,0,0,0,0,0,0,0
17082,RM-1150,10/3/2014,0,0,0,0,0,0,0
17083,RM-1150,10/4/2014,0,0,0,0,0,0,0
17084,RM-1150,10/5/2014,0,0,0,0,0,0,0
17085,RM-1150,10/6/2014,0,0,0,0,0,0,0
17086,RM-1150,10/7/2014,0,0,0,0,0,0,0
17087,RM-1150,10/8/2014,0,0,0,0,0,0,0
17088,RM-1150,10/9/2014,0,0,0,0,0,0,0
17089,RM-1150,10/10/2014,0,0,0,0,0,0,0
17090,RM-1150,10/11/2014,0,0,0,0,0,0,0
17091,RM-1150,10/12/2014,0,0,0,0,0,0,0
17092,RM-1150,10/13/2014,0,0,0,0,0,0,0
17093,RM-1150,10/14/2014,0,0,0,0,0,0,0
17094,RM-1150,10/15/2014,0,0,0,0,0,0,0
17095,RM-1150,10/16/2014,0,0,0,0,0,0,0
17096,RM-1150,10/17/2014,0,0,0,0,0,0,0
17097,RM-1150,10/18/2014,0,0,0,0,0,0,0
17098,RM-1150,10/19/2014,0,0,0,0,0,0,0
17099,RM-1150,10/20/2014,0,0,0,0,0,0,0
17100,RM-1150,10/21/2014,0,0,0,0,0,0,0
17101,RM-1150,10/22/2014,0,0,0,0,0,0,0
17102,RM-1150,10/23/2014,0,0,0,0,0,0,0
17103,RM-1150,10/24/2014,0,0,0,0,0,0,0
17104,RM-1150,10/25/2014,0,0,0,0,0,0,0
17105,RM-1150,10/26/2014,0,0,0,0,0,0,0
17106,RM-1150,10/27/2014,0,0,0,0,0,0,0
17107,RM-1150,10/28/2014,0,0,0,0,0,0,0
17108,RM-1150,10/29/2014,0,0,0,0,0,0,0
17109,RM-1150,10/30/2014,0,0,0,0,0,0,0
17110,RM-1150,10/31/2014,0,0,0,0,0,0,0
17111,RM-1150,11/1/2014,0,0,0,0,0,0,0
17112,RM-1150,11/2/2014,0,0,0,0,0,0,0
17113,RM-1150,11/3/2014,0,0,0,0,0,0,0
17114,RM-1150,11/4/2014,0,0,0,0,0,0,0
17115,RM-1150,11/5/2014,0,0,0,0,0,0,0
17116,RM-1150,11/6/2014,0,0,0,0,0,0,0
17117,RM-1150,11/7/2014,0,0,0,0,0,0,0
17118,RM-1150,11/8/2014,0,0,0,0,0,0,0
17119,RM-1150,11/9/2014,0,0,0,0,0,0,0
17120,RM-1150,11/10/2014,0,0,0,0,0,0,0
17121,RM-1150,11/11/2014,0,0,0,0,0,0,0
17122,RM-1150,11/12/2014,0,0,0,0,0,0,0
17123,RM-1150,11/13/2014,0,0,0,0,0,0,0
17124,RM-1150,11/14/2014,0,0,0,0,0,0,0
17125,RM-1150,11/15/2014,0,0,0,0,0,0,0
17126,RM-1150,11/16/2014,0,0,0,0,0,0,0
17127,RM-1150,11/17/2014,0,0,0,0,0,0,0
17128,RM-1150,11/18/2014,0,0,0,0,0,0,0
17129,RM-1150,11/19/2014,0,0,0,0,0,0,0
17130,RM-1150,11/20/2014,0,0,0,0,0,0,0
17131,RM-1150,11/21/2014,0,0,0,0,0,0,0
17132,RM-1150,11/22/2014,0,0,0,0,0,0,0
17133,RM-1150,11/23/2014,0,0,0,0,0,0,0
17134,RM-1150,11/24/2014,0,0,0,0,0,0,0
17135,RM-1150,11/25/2014,0,0,0,0,0,0,0
17136,RM-1150,11/26/2014,0,0,0,0,0,0,0
17137,RM-1150,11/27/2014,0,0,0,0,0,0,0
17138,RM-1150,11/28/2014,0,0,0,0,0,0,0
17139,RM-1150,11/29/2014,0,0,0,0,0,0,0
17140,RM-1150,11/30/2014,0,0,0,0,0,0,0
17141,RM-1150,12/1/2014,0,0,0,0,0,0,0
17142,RM-1150,12/2/2014,0,0,0,0,0,0,0
17143,RM-1150,12/3/2014,0,0,0,0,0,0,0
17144,RM-1150,12/4/2014,0,0,0,0,0,0,0
17145,RM-1150,12/5/2014,0,0,0,0,0,0,0
17146,RM-1150,12/6/2014,0,0,0,0,0,0,0
17147,RM-1150,12/7/2014,0,0,0,0,0,0,0
17148,RM-1150,12/8/2014,0,0,0,0,0,0,0
17149,RM-1150,12/9/2014,0,0,0,0,0,0,0
17150,RM-1150,12/10/2014,0,0,0,0,0,0,0
17151,RM-1150,12/11/2014,0,0,0,0,0,0,0
17152,RM-1150,12/12/2014,0,0,0,0,0,0,0
17153,RM-1150,12/13/2014,0,0,0,0,0,0,0
17154,RM-1150,12/14/2014,0,0,0,0,0,0,0
17155,RM-1150,12/15/2014,0,0,0,0,0,0,0
17156,RM-1150,12/16/2014,0,0,0,0,0,0,0
17157,RM-1150,12/17/2014,0,0,0,0,0,0,0
17158,RM-1150,12/18/2014,0,0,0,0,0,0,0
17159,RM-1150,12/19/2014,0,0,0,0,0,0,0
17160,RM-1150,12/20/2014,0,0,0,0,0,0,0
17161,RM-1150,12/21/2014,0,0,0,0,0,0,0
17162,RM-1150,12/22/2014,0,0,0,0,0,0,0
17163,RM-1150,12/23/2014,0,0,0,0,0,0,0
17164,RM-1150,12/24/2014,0,0,0,0,0,0,0
17165,RM-1150,12/25/2014,0,0,0,0,0,0,0
17166,RM-1150,12/26/2014,0,0,0,0,0,0,0
17167,RM-1150,12/27/2014,0,0,0,0,0,0,0
17168,RM-1150,12/28/2014,0,0,0,0,0,0,0
17169,RM-1150,12/29/2014,0,0,0,0,0,0,0
17170,RM-1150,12/30/2014,0,0,0,0,0,0,0
17171,RM-1150,12/31/2014,0,0,0,0,0,0,0
17172,RM-1150,1/1/2015,0,0,0,0,0,0,0
17173,RM-1150,1/2/2015,0,0,0,0,0,0,0
17174,RM-1150,1/3/2015,0,0,0,0,0,0,0
17175,RM-1150,1/4/2015,0,0,0,0,0,0,0
17176,RM-1150,1/5/2015,0,0,0,0,0,0,0
17177,RM-1150,1/6/2015,0,0,0,0,0,0,0
17178,RM-1150,1/7/2015,0,0,0,0,0,0,0
17179,RM-1150,1/8/2015,0,0,0,0,0,0,0
17180,RM-1150,1/9/2015,0,0,0,0,0,0,0
17181,RM-1150,1/10/2015,0,0,0,0,0,0,0
17182,RM-1150,1/11/2015,0,0,0,0,0,0,0
17183,RM-1150,1/12/2015,0,0,0,0,0,0,0
17184,RM-1150,1/13/2015,0,0,0,0,0,0,0
17185,RM-1150,1/14/2015,0,0,0,0,0,0,0
17186,RM-1150,1/15/2015,0,0,0,0,0,0,0
17187,RM-1150,1/16/2015,0,0,0,0,0,0,0
17188,RM-1150,1/17/2015,0,0,0,0,0,0,0
17189,RM-1150,1/18/2015,0,0,0,0,0,0,0
17190,RM-1150,1/19/2015,0,0,0,0,0,0,0
17191,RM-1150,1/20/2015,0,0,0,0,0,0,0
17192,RM-1150,1/21/2015,0,0,0,0,0,0,0
17193,RM-1150,1/22/2015,0,0,0,0,0,0,0
17194,RM-1150,1/23/2015,0,0,0,0,0,0,0
17195,RM-1150,1/24/2015,0,0,0,0,0,0,0
17196,RM-1150,1/25/2015,0,0,0,0,0,0,0
17197,RM-1150,1/26/2015,0,0,0,0,0,0,0
17198,RM-1150,1/27/2015,0,0,0,0,0,0,0
17199,RM-1150,1/28/2015,0,0,0,0,0,0,0
17200,RM-1150,1/29/2015,0,0,0,0,0,0,0
17201,RM-1150,1/30/2015,0,0,0,0,0,0,0
17202,RM-1150,1/31/2015,0,0,0,0,0,0,0
17203,RM-1150,2/1/2015,0,0,0,0,0,0,0
17204,RM-1150,2/2/2015,0,0,0,0,0,0,0
17205,RM-1150,2/3/2015,0,0,0,0,0,0,0
17206,RM-1150,2/4/2015,0,0,0,0,0,0,0
17207,RM-1150,2/5/2015,0,0,0,0,0,0,0
17208,RM-1150,2/6/2015,0,0,0,0,0,0,0
17209,RM-1150,2/7/2015,0,0,0,0,0,0,0
17210,RM-1150,2/8/2015,0,0,0,0,0,0,0
17211,RM-1150,2/9/2015,0,0,0,0,0,0,0
17212,RM-1150,2/10/2015,0,0,0,0,0,0,0
17213,RM-1150,2/11/2015,0,0,0,0,0,0,0
17214,RM-1150,2/12/2015,0,0,0,0,0,0,0
17215,RM-1150,2/13/2015,0,0,0,0,0,0,0
17216,RM-1150,2/14/2015,0,0,0,0,0,0,0
17217,RM-1150,2/15/2015,0,0,0,0,0,0,0
17218,RM-1150,2/16/2015,0,0,0,0,0,0,0
17219,RM-1150,2/17/2015,0,0,0,0,0,0,0
17220,RM-1150,2/18/2015,0,0,0,0,0,0,0
17221,RM-1150,2/19/2015,0,0,0,0,0,0,0
17222,RM-1150,2/20/2015,0,0,0,0,0,0,0
17223,RM-1150,2/21/2015,0,0,0,0,0,0,0
17224,RM-1150,2/22/2015,0,0,0,0,0,0,0
17225,RM-1150,2/23/2015,0,0,0,0,0,0,0
17226,RM-1150,2/24/2015,0,0,0,0,0,0,0
17227,RM-1150,2/25/2015,0,0,0,0,0,0,0
17228,RM-1150,2/26/2015,0,0,0,0,0,0,0
17229,RM-1150,2/27/2015,0,0,0,0,0,0,0
17230,RM-1150,2/28/2015,0,0,0,0,0,0,0
17231,RM-1150,3/1/2015,0,0,0,0,0,0,0
17232,RM-1150,3/2/2015,0,0,0,0,0,0,0
17233,RM-1150,3/3/2015,0,0,0,0,0,0,0
17234,RM-1150,3/4/2015,0,0,0,0,0,0,0
17235,RM-1150,3/5/2015,0,0,0,0,0,0,0
17236,RM-1150,3/6/2015,0,0,0,0,0,0,0
17237,RM-1150,3/7/2015,0,0,0,0,0,0,0
17238,RM-1150,3/8/2015,0,0,0,0,0,0,0
17239,RM-1150,3/9/2015,0,0,0,0,0,0,0
17240,RM-1150,3/10/2015,0,0,0,0,0,0,0
17241,RM-1150,3/11/2015,0,0,0,0,0,0,0
17242,RM-1150,3/12/2015,0,0,0,0,0,0,0
17243,RM-1150,3/13/2015,0,0,0,0,0,0,0
17244,RM-1150,3/14/2015,0,0,0,0,0,0,0
17245,RM-1150,3/15/2015,0,0,0,0,0,0,0
17246,RM-1150,3/16/2015,0,0,0,0,0,0,0
17247,RM-1150,3/17/2015,0,0,0,0,0,0,0
17248,RM-1150,3/18/2015,0,0,0,0,0,0,0
17249,RM-1150,3/19/2015,0,0,0,0,0,0,0
17250,RM-1150,3/20/2015,0,0,0,0,0,0,0
17251,RM-1150,3/21/2015,0,0,0,0,0,0,0
17252,RM-1150,3/22/2015,0,0,0,0,0,0,0
17253,RM-1150,3/23/2015,0,0,0,0,0,0,0
17254,RM-1150,3/24/2015,0,0,0,0,0,0,0
17255,RM-1150,3/25/2015,0,0,0,0,0,0,0
17256,RM-1150,3/26/2015,0,0,0,0,0,0,0
17257,RM-1150,3/27/2015,0,0,0,0,0,0,0
17258,RM-1150,3/28/2015,0,0,0,0,0,0,0
17259,RM-1150,3/29/2015,0,0,0,0,0,0,0
17260,RM-1150,3/30/2015,0,0,0,0,0,0,0
17261,RM-1150,3/31/2015,0,0,0,0,0,0,0
17262,RM-1150,4/1/2015,0,0,0,0,0,0,0
17263,RM-1150,4/2/2015,0,0,0,0,0,0,0
17264,RM-1150,4/3/2015,0,0,0,0,0,0,0
17265,RM-1150,4/4/2015,0,0,0,0,0,0,0
17266,RM-1150,4/5/2015,0,0,0,0,0,0,0
17267,RM-1150,4/6/2015,0,0,0,0,0,0,0
17268,RM-1150,4/7/2015,0,0,0,0,0,0,0
17269,RM-1150,4/8/2015,0,0,0,0,0,0,0
17270,RM-1150,4/9/2015,0,0,0,0,0,0,0
17271,RM-1150,4/10/2015,0,0,0,0,0,0,0
17272,RM-1150,4/11/2015,0,0,0,0,0,0,0
17273,RM-1150,4/12/2015,0,0,0,0,0,0,0
17274,RM-1150,4/13/2015,0,0,0,0,0,0,0
17275,RM-1150,4/14/2015,0,0,0,0,0,0,0
17276,RM-1150,4/15/2015,0,0,0,0,0,0,0
17277,RM-1150,4/16/2015,0,0,0,0,0,0,0
17278,RM-1150,4/17/2015,0,0,0,0,0,0,0
17279,RM-1150,4/18/2015,0,0,0,0,0,0,0
17280,RM-1150,4/19/2015,0,0,0,0,0,0,0
17281,RM-1150,4/20/2015,0,0,0,0,0,0,0
17282,RM-1150,4/21/2015,0,0,0,0,0,0,0
17283,RM-1150,4/22/2015,0,0,0,0,0,0,0
17284,RM-1150,4/23/2015,0,0,0,0,0,0,0
17285,RM-1150,4/24/2015,0,0,0,0,0,0,0
17286,RM-1150,4/25/2015,0,0,0,0,0,0,0
17287,RM-1150,4/26/2015,0,0,0,0,0,0,0
17288,RM-1150,4/27/2015,0,0,0,0,0,0,0
17289,RM-1150,4/28/2015,0,0,0,0,0,0,0
17290,RM-1150,4/29/2015,0,0,0,0,0,0,0
17291,RM-1150,4/30/2015,0,0,0,0,0,0,0
17292,RM-1150,5/1/2015,0,0,0,0,0,0,0
17293,RM-1150,5/2/2015,0,0,0,0,0,0,0
17294,RM-1150,5/3/2015,0,0,0,0,0,0,0
17295,RM-1150,5/4/2015,0,0,0,0,0,0,0
17296,RM-1150,5/5/2015,0,0,0,0,0,0,0
17297,RM-1150,5/6/2015,0,0,0,0,0,0,0
17298,RM-1150,5/7/2015,0,0,0,0,0,0,0
17299,RM-1150,5/8/2015,0,0,0,0,0,0,0
17300,RM-1150,5/9/2015,0,0,0,0,0,0,0
17301,RM-1150,5/10/2015,0,0,0,0,0,0,0
17302,RM-1150,5/11/2015,0,0,0,0,0,0,0
17303,RM-1150,5/12/2015,0,0,0,0,0,0,0
17304,RM-1150,5/13/2015,0,0,0,0,0,0,0
17305,RM-1150,5/14/2015,0,0,0,0,0,0,0
17306,RM-1150,5/15/2015,0,0,0,0,0,0,0
17307,RM-1150,5/16/2015,0,0,0,0,0,0,0
17308,RM-1150,5/17/2015,0,0,0,0,0,0,0
17309,RM-1150,5/18/2015,0,0,0,0,0,0,0
17310,RM-1150,5/19/2015,0,0,0,0,0,0,0
17311,RM-1150,5/20/2015,0,0,0,0,0,0,0
17312,RM-1150,5/21/2015,0,0,0,0,0,0,0
17313,RM-1150,5/22/2015,0,0,0,0,0,0,0
17314,RM-1150,5/23/2015,0,0,0,0,0,0,0
17315,RM-1150,5/24/2015,0,0,0,0,0,0,0
17316,RM-1150,5/25/2015,0,0,0,0,0,0,0
17317,RM-1150,5/26/2015,0,0,0,0,0,0,0
17318,RM-1150,5/27/2015,0,0,0,0,0,0,0
17319,RM-1150,5/28/2015,0,0,0,0,0,0,0
17320,RM-1150,5/29/2015,0,0,0,0,0,0,0
17321,RM-1150,5/30/2015,0,0,0,0,0,0,0
17322,RM-1150,5/31/2015,0,0,0,0,0,0,0
17323,RM-1151,7/1/2013,0,0,0,0,0,0,0
17324,RM-1151,7/2/2013,0,0,0,0,0,0,0
17325,RM-1151,7/3/2013,0,0,0,0,0,0,0
17326,RM-1151,7/4/2013,0,0,0,0,0,0,0
17327,RM-1151,7/5/2013,0,0,0,0,0,0,0
17328,RM-1151,7/6/2013,0,0,0,0,0,0,0
17329,RM-1151,7/7/2013,0,0,0,0,0,0,0
17330,RM-1151,7/8/2013,0,0,0,0,0,0,0
17331,RM-1151,7/9/2013,0,0,0,0,0,0,0
17332,RM-1151,7/10/2013,0,0,0,0,0,0,0
17333,RM-1151,7/11/2013,0,0,0,0,0,0,0
17334,RM-1151,7/12/2013,0,0,0,0,0,0,0
17335,RM-1151,7/13/2013,0,0,0,0,0,0,0
17336,RM-1151,7/14/2013,0,0,0,0,0,0,0
17337,RM-1151,7/15/2013,0,0,0,0,0,0,0
17338,RM-1151,7/17/2013,0,0,0,0,0,0,0
17339,RM-1151,7/18/2013,0,0,0,0,0,0,0
17340,RM-1151,7/19/2013,0,0,0,0,0,0,0
17341,RM-1151,7/20/2013,0,0,0,0,0,0,0
17342,RM-1151,7/21/2013,0,0,0,0,0,0,0
17343,RM-1151,7/22/2013,0,0,0,0,0,0,0
17344,RM-1151,7/23/2013,0,0,0,0,0,0,0
17345,RM-1151,7/24/2013,0,0,0,0,0,0,0
17346,RM-1151,7/25/2013,0,0,0,0,0,0,0
17347,RM-1151,7/26/2013,0,0,0,0,0,0,0
17348,RM-1151,7/27/2013,0,0,0,0,0,0,0
17349,RM-1151,7/28/2013,0,0,0,0,0,0,0
17350,RM-1151,7/29/2013,0,0,0,0,0,0,0
17351,RM-1151,7/30/2013,0,0,0,0,0,0,0
17352,RM-1151,7/31/2013,0,0,0,0,0,0,0
17353,RM-1151,8/1/2013,0,0,0,0,0,0,0
17354,RM-1151,8/2/2013,0,0,0,0,0,0,0
17355,RM-1151,8/3/2013,0,0,0,0,0,0,0
17356,RM-1151,8/4/2013,0,0,0,0,0,0,0
17357,RM-1151,8/5/2013,0,0,0,0,0,0,0
17358,RM-1151,8/6/2013,0,0,0,0,0,0,0
17359,RM-1151,8/7/2013,0,0,0,0,0,0,0
17360,RM-1151,8/8/2013,0,0,0,0,0,0,0
17361,RM-1151,8/9/2013,0,0,0,0,0,0,0
17362,RM-1151,8/10/2013,0,0,0,0,0,0,0
17363,RM-1151,8/11/2013,0,0,0,0,0,0,0
17364,RM-1151,8/12/2013,0,0,0,0,0,0,0
17365,RM-1151,8/13/2013,0,0,0,0,0,0,0
17366,RM-1151,8/14/2013,0,0,0,0,0,0,0
17367,RM-1151,8/15/2013,0,0,0,0,0,0,0
17368,RM-1151,8/16/2013,0,0,0,0,0,0,0
17369,RM-1151,8/17/2013,0,0,0,0,0,0,0
17370,RM-1151,8/18/2013,0,0,0,0,0,0,0
17371,RM-1151,8/19/2013,0,0,0,0,0,0,0
17372,RM-1151,8/20/2013,0,0,0,0,0,0,0
17373,RM-1151,8/21/2013,0,0,0,0,0,0,0
17374,RM-1151,8/22/2013,0,0,0,0,0,0,0
17375,RM-1151,8/27/2013,0,0,0,0,0,0,0
17376,RM-1151,8/28/2013,0,0,0,0,0,0,0
17377,RM-1151,8/29/2013,0,0,0,0,0,0,0
17378,RM-1151,8/30/2013,0,0,0,0,0,0,0
17379,RM-1151,9/4/2013,0,0,0,0,0,0,0
17380,RM-1151,9/5/2013,0,0,0,0,0,0,0
17381,RM-1151,9/6/2013,0,0,0,0,0,0,0
17382,RM-1151,9/7/2013,0,0,0,0,0,0,0
17383,RM-1151,9/9/2013,0,0,0,0,0,0,0
17384,RM-1151,9/10/2013,0,0,0,0,0,0,0
17385,RM-1151,9/11/2013,0,0,0,0,0,0,0
17386,RM-1151,9/12/2013,0,0,0,0,0,0,0
17387,RM-1151,9/13/2013,0,0,0,0,0,0,0
17388,RM-1151,9/14/2013,0,0,0,0,0,0,0
17389,RM-1151,9/15/2013,0,0,0,0,0,0,0
17390,RM-1151,9/16/2013,0,0,0,0,0,0,0
17391,RM-1151,9/17/2013,0,0,0,0,0,0,0
17392,RM-1151,9/18/2013,0,0,0,0,0,0,0
17393,RM-1151,9/19/2013,0,0,0,0,0,0,0
17394,RM-1151,9/20/2013,0,0,0,0,0,0,0
17395,RM-1151,9/21/2013,0,0,0,0,0,0,0
17396,RM-1151,9/22/2013,0,0,0,0,0,0,0
17397,RM-1151,9/23/2013,0,0,0,0,0,0,0
17398,RM-1151,9/24/2013,0,0,0,0,0,0,0
17399,RM-1151,9/25/2013,0,0,0,0,0,0,0
17400,RM-1151,9/26/2013,0,0,0,0,0,0,0
17401,RM-1151,9/27/2013,0,0,0,0,0,0,0
17402,RM-1151,9/28/2013,0,0,0,0,0,0,0
17403,RM-1151,9/29/2013,0,0,0,0,0,0,0
17404,RM-1151,9/30/2013,0,0,0,0,0,0,0
17405,RM-1151,10/1/2013,0,0,0,0,0,0,0
17406,RM-1151,10/2/2013,0,0,0,0,0,0,0
17407,RM-1151,10/3/2013,0,0,0,0,0,0,0
17408,RM-1151,10/4/2013,0,0,0,0,0,0,0
17409,RM-1151,10/5/2013,0,0,0,0,0,0,0
17410,RM-1151,10/6/2013,0,0,0,0,0,0,0
17411,RM-1151,10/7/2013,0,0,0,0,0,0,0
17412,RM-1151,10/8/2013,0,0,0,0,0,0,0
17413,RM-1151,10/9/2013,0,0,0,0,0,0,0
17414,RM-1151,10/10/2013,0,0,0,0,0,0,0
17415,RM-1151,10/11/2013,0,0,0,0,0,0,0
17416,RM-1151,10/12/2013,0,0,0,0,0,0,0
17417,RM-1151,10/13/2013,0,0,0,0,0,0,0
17418,RM-1151,10/14/2013,0,0,0,0,0,0,0
17419,RM-1151,10/15/2013,0,0,0,0,0,0,0
17420,RM-1151,10/16/2013,0,0,0,0,0,0,0
17421,RM-1151,10/17/2013,0,0,0,0,0,0,0
17422,RM-1151,10/18/2013,0,0,0,0,0,0,0
17423,RM-1151,10/19/2013,0,0,0,0,0,0,0
17424,RM-1151,10/20/2013,0,0,0,0,0,0,0
17425,RM-1151,10/21/2013,0,0,0,0,0,0,0
17426,RM-1151,10/22/2013,0,0,0,0,0,0,0
17427,RM-1151,10/23/2013,0,0,0,0,0,0,0
17428,RM-1151,10/24/2013,0,0,0,0,0,0,0
17429,RM-1151,10/25/2013,0,0,0,0,0,0,0
17430,RM-1151,10/26/2013,0,0,0,0,0,0,0
17431,RM-1151,10/27/2013,0,0,0,0,0,0,0
17432,RM-1151,10/28/2013,0,0,0,0,0,0,0
17433,RM-1151,10/29/2013,0,0,0,0,0,0,0
17434,RM-1151,10/30/2013,0,0,0,0,0,0,0
17435,RM-1151,10/31/2013,0,0,0,0,0,0,0
17436,RM-1151,11/1/2013,0,0,0,0,0,0,0
17437,RM-1151,11/2/2013,0,0,0,0,0,0,0
17438,RM-1151,11/3/2013,0,0,0,0,0,0,0
17439,RM-1151,11/4/2013,0,0,0,0,0,0,0
17440,RM-1151,11/5/2013,0,0,0,0,0,0,0
17441,RM-1151,11/6/2013,0,0,0,0,0,0,0
17442,RM-1151,11/7/2013,0,0,0,0,0,0,0
17443,RM-1151,11/8/2013,0,0,0,0,0,0,0
17444,RM-1151,11/9/2013,0,0,0,0,0,0,0
17445,RM-1151,11/10/2013,0,0,0,0,0,0,0
17446,RM-1151,11/11/2013,0,0,0,0,0,0,0
17447,RM-1151,11/12/2013,0,0,0,0,0,0,0
17448,RM-1151,11/13/2013,0,0,0,0,0,0,0
17449,RM-1151,11/14/2013,0,0,0,0,0,0,0
17450,RM-1151,11/15/2013,0,0,0,0,0,0,0
17451,RM-1151,11/19/2013,0,0,0,0,0,0,0
17452,RM-1151,11/20/2013,0,0,0,0,0,0,0
17453,RM-1151,11/21/2013,0,0,0,0,0,0,0
17454,RM-1151,11/22/2013,0,0,0,0,0,0,0
17455,RM-1151,11/23/2013,0,0,0,0,0,0,0
17456,RM-1151,11/24/2013,0,0,0,0,0,0,0
17457,RM-1151,11/25/2013,0,0,0,0,0,0,0
17458,RM-1151,11/26/2013,0,0,0,0,0,0,0
17459,RM-1151,11/27/2013,0,0,0,0,0,0,0
17460,RM-1151,11/28/2013,0,0,0,0,0,0,0
17461,RM-1151,11/29/2013,0,0,0,0,0,0,0
17462,RM-1151,11/30/2013,0,0,0,0,0,0,0
17463,RM-1151,12/1/2013,0,0,0,0,0,0,0
17464,RM-1151,12/2/2013,0,0,0,0,0,0,0
17465,RM-1151,12/3/2013,0,0,0,0,0,0,0
17466,RM-1151,12/4/2013,0,0,0,0,0,0,0
17467,RM-1151,12/5/2013,0,0,0,0,0,0,0
17468,RM-1151,12/6/2013,0,0,0,0,0,0,0
17469,RM-1151,12/7/2013,0,0,0,0,0,0,0
17470,RM-1151,12/8/2013,0,0,0,0,0,0,0
17471,RM-1151,12/9/2013,0,0,0,0,0,0,0
17472,RM-1151,12/10/2013,0,0,0,0,0,0,0
17473,RM-1151,12/11/2013,0,0,0,0,0,0,0
17474,RM-1151,12/12/2013,0,0,0,0,0,0,0
17475,RM-1151,12/13/2013,0,0,0,0,0,0,0
17476,RM-1151,12/14/2013,0,0,0,0,0,0,0
17477,RM-1151,12/15/2013,0,0,0,0,0,0,0
17478,RM-1151,12/16/2013,0,0,0,0,0,0,0
17479,RM-1151,12/17/2013,0,0,0,0,0,0,0
17480,RM-1151,12/18/2013,0,0,0,0,0,0,0
17481,RM-1151,12/19/2013,0,0,0,0,0,0,0
17482,RM-1151,12/20/2013,0,0,0,0,0,0,0
17483,RM-1151,12/21/2013,0,0,0,0,0,0,0
17484,RM-1151,12/22/2013,0,0,0,0,0,0,0
17485,RM-1151,12/23/2013,0,0,0,0,0,0,0
17486,RM-1151,12/24/2013,0,0,0,0,0,0,0
17487,RM-1151,12/25/2013,0,0,0,0,0,0,0
17488,RM-1151,12/26/2013,0,0,0,0,0,0,0
17489,RM-1151,12/27/2013,0,0,0,0,0,0,0
17490,RM-1151,12/28/2013,0,0,0,0,0,0,0
17491,RM-1151,12/29/2013,0,0,0,0,0,0,0
17492,RM-1151,12/30/2013,0,0,0,0,0,0,0
17493,RM-1151,12/31/2013,0,0,0,0,0,0,0
17494,RM-1151,1/1/2014,0,0,0,0,0,0,0
17495,RM-1151,1/2/2014,0,0,0,0,0,0,0
17496,RM-1151,1/3/2014,0,0,0,0,0,0,0
17497,RM-1151,1/4/2014,0,0,0,0,0,0,0
17498,RM-1151,1/5/2014,0,0,0,0,0,0,0
17499,RM-1151,1/6/2014,0,0,0,0,0,0,0
17500,RM-1151,1/7/2014,0,0,0,0,0,0,0
17501,RM-1151,1/8/2014,0,0,0,0,0,0,0
17502,RM-1151,1/9/2014,0,0,0,0,0,0,0
17503,RM-1151,1/10/2014,0,0,0,0,0,0,0
17504,RM-1151,1/11/2014,0,0,0,0,0,0,0
17505,RM-1151,1/12/2014,0,0,0,0,0,0,0
17506,RM-1151,1/13/2014,0,0,0,0,0,0,0
17507,RM-1151,1/14/2014,0,0,0,0,0,0,0
17508,RM-1151,1/15/2014,0,0,0,0,0,0,0
17800,RM-1151,11/5/2014,0,0,0,0,0,0,0
17801,RM-1151,11/6/2014,0,0,0,0,0,0,0
17802,RM-1151,11/7/2014,0,0,0,0,0,0,0
17803,RM-1151,11/8/2014,0,0,0,0,0,0,0
17804,RM-1151,11/9/2014,0,0,0,0,0,0,0
17805,RM-1151,11/10/2014,0,0,0,0,0,0,0
17806,RM-1151,11/11/2014,0,0,0,0,0,0,0
17807,RM-1151,11/12/2014,0,0,0,0,0,0,0
17808,RM-1151,11/13/2014,0,0,0,0,0,0,0
17809,RM-1151,11/14/2014,0,0,0,0,0,0,0
17810,RM-1151,11/15/2014,0,0,0,0,0,0,0
17811,RM-1151,11/16/2014,0,0,0,0,0,0,0
17812,RM-1151,11/17/2014,0,0,0,0,0,0,0
17813,RM-1151,11/18/2014,0,0,0,0,0,0,0
17814,RM-1151,11/19/2014,0,0,0,0,0,0,0
17815,RM-1151,11/20/2014,0,0,0,0,0,0,0
17816,RM-1151,11/21/2014,0,0,0,0,0,0,0
17817,RM-1151,11/22/2014,0,0,0,0,0,0,0
17818,RM-1151,11/23/2014,0,0,0,0,0,0,0
17819,RM-1151,11/24/2014,0,0,0,0,0,0,0
17820,RM-1151,11/25/2014,0,0,0,0,0,0,0
17821,RM-1151,11/26/2014,0,0,0,0,0,0,0
17822,RM-1151,11/27/2014,0,0,0,0,0,0,0
17823,RM-1151,11/28/2014,0,0,0,0,0,0,0
17824,RM-1151,11/29/2014,0,0,0,0,0,0,0
17825,RM-1151,11/30/2014,0,0,0,0,0,0,0
17826,RM-1151,12/1/2014,0,0,0,0,0,0,0
17827,RM-1151,12/2/2014,0,0,0,0,0,0,0
17828,RM-1151,12/3/2014,0,0,0,0,0,0,0
17829,RM-1151,12/4/2014,0,0,0,0,0,0,0
17830,RM-1151,12/5/2014,0,0,0,0,0,0,0
17831,RM-1151,12/6/2014,0,0,0,0,0,0,0
17832,RM-1151,12/7/2014,0,0,0,0,0,0,0
17833,RM-1151,12/8/2014,0,0,0,0,0,0,0
17834,RM-1151,12/9/2014,0,0,0,0,0,0,0
17835,RM-1151,12/10/2014,0,0,0,0,0,0,0
17836,RM-1151,12/11/2014,0,0,0,0,0,0,0
17837,RM-1151,12/12/2014,0,0,0,0,0,0,0
17838,RM-1151,12/13/2014,0,0,0,0,0,0,0
17839,RM-1151,12/14/2014,0,0,0,0,0,0,0
17840,RM-1151,12/15/2014,0,0,0,0,0,0,0
17841,RM-1151,12/16/2014,0,0,0,0,0,0,0
17842,RM-1151,12/17/2014,0,0,0,0,0,0,0
17843,RM-1151,12/18/2014,0,0,0,0,0,0,0
17844,RM-1151,12/19/2014,0,0,0,0,0,0,0
17845,RM-1151,12/20/2014,0,0,0,0,0,0,0
17846,RM-1151,12/21/2014,0,0,0,0,0,0,0
17847,RM-1151,12/22/2014,0,0,0,0,0,0,0
17848,RM-1151,12/23/2014,0,0,0,0,0,0,0
17849,RM-1151,12/24/2014,0,0,0,0,0,0,0
17850,RM-1151,12/25/2014,0,0,0,0,0,0,0
17851,RM-1151,12/26/2014,0,0,0,0,0,0,0
17852,RM-1151,12/27/2014,0,0,0,0,0,0,0
17853,RM-1151,12/28/2014,0,0,0,0,0,0,0
17854,RM-1151,12/29/2014,0,0,0,0,0,0,0
17855,RM-1151,12/30/2014,0,0,0,0,0,0,0
17856,RM-1151,12/31/2014,0,0,0,0,0,0,0
17857,RM-1151,1/1/2015,0,0,0,0,0,0,0
17858,RM-1151,1/2/2015,0,0,0,0,0,0,0
17859,RM-1151,1/3/2015,0,0,0,0,0,0,0
17860,RM-1151,1/4/2015,0,0,0,0,0,0,0
17861,RM-1151,1/5/2015,0,0,0,0,0,0,0
17862,RM-1151,1/6/2015,0,0,0,0,0,0,0
17863,RM-1151,1/7/2015,0,0,0,0,0,0,0
17864,RM-1151,1/8/2015,0,0,0,0,0,0,0
17865,RM-1151,1/9/2015,0,0,0,0,0,0,0
17866,RM-1151,1/10/2015,0,0,0,0,0,0,0
17867,RM-1151,1/11/2015,0,0,0,0,0,0,0
17868,RM-1151,1/12/2015,0,0,0,0,0,0,0
17869,RM-1151,1/13/2015,0,0,0,0,0,0,0
17870,RM-1151,1/14/2015,0,0,0,0,0,0,0
17871,RM-1151,1/15/2015,0,0,0,0,0,0,0
17872,RM-1151,1/16/2015,0,0,0,0,0,0,0
17873,RM-1151,1/17/2015,0,0,0,0,0,0,0
17874,RM-1151,1/18/2015,0,0,0,0,0,0,0
17875,RM-1151,1/19/2015,0,0,0,0,0,0,0
17876,RM-1151,1/20/2015,0,0,0,0,0,0,0
17877,RM-1151,1/21/2015,0,0,0,0,0,0,0
17878,RM-1151,1/22/2015,0,0,0,0,0,0,0
17879,RM-1151,1/23/2015,0,0,0,0,0,0,0
17880,RM-1151,1/24/2015,0,0,0,0,0,0,0
17881,RM-1151,1/25/2015,0,0,0,0,0,0,0
17882,RM-1151,1/26/2015,0,0,0,0,0,0,0
17883,RM-1151,1/27/2015,0,0,0,0,0,0,0
17884,RM-1151,1/28/2015,0,0,0,0,0,0,0
17885,RM-1151,1/29/2015,0,0,0,0,0,0,0
17886,RM-1151,1/30/2015,0,0,0,0,0,0,0
17887,RM-1151,1/31/2015,0,0,0,0,0,0,0
17888,RM-1151,2/1/2015,0,0,0,0,0,0,0
17889,RM-1151,2/2/2015,0,0,0,0,0,0,0
17890,RM-1151,2/3/2015,0,0,0,0,0,0,0
17891,RM-1151,2/4/2015,0,0,0,0,0,0,0
17892,RM-1151,2/5/2015,0,0,0,0,0,0,0
17893,RM-1151,2/6/2015,0,0,0,0,0,0,0
17894,RM-1151,2/7/2015,0,0,0,0,0,0,0
17895,RM-1151,2/8/2015,0,0,0,0,0,0,0
17896,RM-1151,2/9/2015,0,0,0,0,0,0,0
17897,RM-1151,2/10/2015,0,0,0,0,0,0,0
17898,RM-1151,2/11/2015,0,0,0,0,0,0,0
17899,RM-1151,2/12/2015,0,0,0,0,0,0,0
17900,RM-1151,2/13/2015,0,0,0,0,0,0,0
17901,RM-1151,2/14/2015,0,0,0,0,0,0,0
17902,RM-1151,2/15/2015,0,0,0,0,0,0,0
17903,RM-1151,2/16/2015,0,0,0,0,0,0,0
17904,RM-1151,2/17/2015,0,0,0,0,0,0,0
17905,RM-1151,2/18/2015,0,0,0,0,0,0,0
17906,RM-1151,2/19/2015,0,0,0,0,0,0,0
17907,RM-1151,2/20/2015,0,0,0,0,0,0,0
17908,RM-1151,2/21/2015,0,0,0,0,0,0,0
17909,RM-1151,2/22/2015,0,0,0,0,0,0,0
17910,RM-1151,2/23/2015,0,0,0,0,0,0,0
17911,RM-1151,2/24/2015,0,0,0,0,0,0,0
17912,RM-1151,2/25/2015,0,0,0,0,0,0,0
17913,RM-1151,2/26/2015,0,0,0,0,0,0,0
17914,RM-1151,2/27/2015,0,0,0,0,0,0,0
17915,RM-1151,2/28/2015,0,0,0,0,0,0,0
17916,RM-1151,3/1/2015,0,0,0,0,0,0,0
17917,RM-1151,3/2/2015,0,0,0,0,0,0,0
17918,RM-1151,3/3/2015,0,0,0,0,0,0,0
17919,RM-1151,3/4/2015,0,0,0,0,0,0,0
17920,RM-1151,3/5/2015,0,0,0,0,0,0,0
17921,RM-1151,3/6/2015,0,0,0,0,0,0,0
17922,RM-1151,3/7/2015,0,0,0,0,0,0,0
17923,RM-1151,3/8/2015,0,0,0,0,0,0,0
17924,RM-1151,3/9/2015,0,0,0,0,0,0,0
17925,RM-1151,3/10/2015,0,0,0,0,0,0,0
17926,RM-1151,3/11/2015,0,0,0,0,0,0,0
17927,RM-1151,3/12/2015,0,0,0,0,0,0,0
17928,RM-1151,3/13/2015,0,0,0,0,0,0,0
17929,RM-1151,3/14/2015,0,0,0,0,0,0,0
17930,RM-1151,3/15/2015,0,0,0,0,0,0,0
17931,RM-1151,3/16/2015,0,0,0,0,0,0,0
17932,RM-1151,3/17/2015,0,0,0,0,0,0,0
17933,RM-1151,3/18/2015,0,0,0,0,0,0,0
17934,RM-1151,3/19/2015,0,0,0,0,0,0,0
17935,RM-1151,3/20/2015,0,0,0,0,0,0,0
17936,RM-1151,3/21/2015,0,0,0,0,0,0,0
17937,RM-1151,3/22/2015,0,0,0,0,0,0,0
17938,RM-1151,3/23/2015,0,0,0,0,0,0,0
17939,RM-1151,3/24/2015,0,0,0,0,0,0,0
17940,RM-1151,3/25/2015,0,0,0,0,0,0,0
17941,RM-1151,3/26/2015,0,0,0,0,0,0,0
17942,RM-1151,3/27/2015,0,0,0,0,0,0,0
17943,RM-1151,3/28/2015,0,0,0,0,0,0,0
17944,RM-1151,3/29/2015,0,0,0,0,0,0,0
17945,RM-1151,3/30/2015,0,0,0,0,0,0,0
17946,RM-1151,3/31/2015,0,0,0,0,0,0,0
17947,RM-1151,4/1/2015,0,0,0,0,0,0,0
17948,RM-1151,4/2/2015,0,0,0,0,0,0,0
17949,RM-1151,4/3/2015,0,0,0,0,0,0,0
17950,RM-1151,4/4/2015,0,0,0,0,0,0,0
17951,RM-1151,4/5/2015,0,0,0,0,0,0,0
17952,RM-1151,4/6/2015,0,0,0,0,0,0,0
17953,RM-1151,4/7/2015,0,0,0,0,0,0,0
17954,RM-1151,4/8/2015,0,0,0,0,0,0,0
17955,RM-1151,4/9/2015,0,0,0,0,0,0,0
17956,RM-1151,4/10/2015,0,0,0,0,0,0,0
17957,RM-1151,4/11/2015,0,0,0,0,0,0,0
17958,RM-1151,4/12/2015,0,0,0,0,0,0,0
17959,RM-1151,4/13/2015,0,0,0,0,0,0,0
17960,RM-1151,4/14/2015,0,0,0,0,0,0,0
17961,RM-1151,4/15/2015,0,0,0,0,0,0,0
17962,RM-1151,4/16/2015,0,0,0,0,0,0,0
17963,RM-1151,4/17/2015,0,0,0,0,0,0,0
17964,RM-1151,4/18/2015,0,0,0,0,0,0,0
17965,RM-1151,4/19/2015,0,0,0,0,0,0,0
17966,RM-1151,4/20/2015,0,0,0,0,0,0,0
17967,RM-1151,4/21/2015,0,0,0,0,0,0,0
17968,RM-1151,4/22/2015,0,0,0,0,0,0,0
17969,RM-1151,4/23/2015,0,0,0,0,0,0,0
17970,RM-1151,4/24/2015,0,0,0,0,0,0,0
17971,RM-1151,4/25/2015,0,0,0,0,0,0,0
17972,RM-1151,4/26/2015,0,0,0,0,0,0,0
17973,RM-1151,4/27/2015,0,0,0,0,0,0,0
17974,RM-1151,4/28/2015,0,0,0,0,0,0,0
17975,RM-1151,4/29/2015,0,0,0,0,0,0,0
17976,RM-1151,4/30/2015,0,0,0,0,0,0,0
17977,RM-1151,5/1/2015,0,0,0,0,0,0,0
17978,RM-1151,5/2/2015,0,0,0,0,0,0,0
17979,RM-1151,5/3/2015,0,0,0,0,0,0,0
17980,RM-1151,5/4/2015,0,0,0,0,0,0,0
17981,RM-1151,5/5/2015,0,0,0,0,0,0,0
17982,RM-1151,5/6/2015,0,0,0,0,0,0,0
17983,RM-1151,5/7/2015,0,0,0,0,0,0,0
17984,RM-1151,5/8/2015,0,0,0,0,0,0,0
17985,RM-1151,5/9/2015,0,0,0,0,0,0,0
17986,RM-1151,5/10/2015,0,0,0,0,0,0,0
17987,RM-1151,5/11/2015,0,0,0,0,0,0,0
17988,RM-1151,5/12/2015,0,0,0,0,0,0,0
17989,RM-1151,5/13/2015,0,0,0,0,0,0,0
17990,RM-1151,5/14/2015,0,0,0,0,0,0,0
17991,RM-1151,5/15/2015,0,0,0,0,0,0,0
17992,RM-1151,5/16/2015,0,0,0,0,0,0,0
17993,RM-1151,5/17/2015,0,0,0,0,0,0,0
17994,RM-1151,5/18/2015,0,0,0,0,0,0,0
17995,RM-1151,5/19/2015,0,0,0,0,0,0,0
17996,RM-1151,5/20/2015,0,0,0,0,0,0,0
17997,RM-1151,5/21/2015,0,0,0,0,0,0,0
17998,RM-1151,5/22/2015,0,0,0,0,0,0,0
17999,RM-1151,5/23/2015,0,0,0,0,0,0,0
18000,RM-1151,5/24/2015,0,0,0,0,0,0,0
18001,RM-1151,5/25/2015,0,0,0,0,0,0,0
18002,RM-1151,5/26/2015,0,0,0,0,0,0,0
18003,RM-1151,5/27/2015,0,0,0,0,0,0,0
18004,RM-1151,5/28/2015,0,0,0,0,0,0,0
18005,RM-1151,5/29/2015,0,0,0,0,0,0,0
18006,RM-1151,5/30/2015,0,0,0,0,0,0,0
18007,RM-1151,5/31/2015,0,0,0,0,0,0,0
18027,RM-1154,7/21/2013,0,0,0,0,0,0,0
18028,RM-1154,7/22/2013,0,0,0,0,0,0,0
18072,RM-1154,9/13/2013,0,0,0,0,0,0,0
18073,RM-1154,9/14/2013,0,0,0,0,0,0,0
18074,RM-1154,9/15/2013,0,0,0,0,0,0,0
18075,RM-1154,9/16/2013,0,0,0,0,0,0,0
18076,RM-1154,9/17/2013,0,0,0,0,0,0,0
18077,RM-1154,9/18/2013,0,0,0,0,0,0,0
18078,RM-1154,9/19/2013,0,0,0,0,0,0,0
18079,RM-1154,9/20/2013,0,0,0,0,0,0,0
18080,RM-1154,9/21/2013,0,0,0,0,0,0,0
18081,RM-1154,9/22/2013,0,0,0,0,0,0,0
18082,RM-1154,9/23/2013,0,0,0,0,0,0,0
18083,RM-1154,9/24/2013,0,0,0,0,0,0,0
18084,RM-1154,9/25/2013,0,0,0,0,0,0,0
18085,RM-1154,9/26/2013,0,0,0,0,0,0,0
18086,RM-1154,9/27/2013,0,0,0,0,0,0,0
18087,RM-1154,9/28/2013,0,0,0,0,0,0,0
18088,RM-1154,9/29/2013,0,0,0,0,0,0,0
18089,RM-1154,9/30/2013,0,0,0,0,0,0,0
18090,RM-1154,10/1/2013,0,0,0,0,0,0,0
18091,RM-1154,10/2/2013,0,0,0,0,0,0,0
18092,RM-1154,10/3/2013,0,0,0,0,0,0,0
18093,RM-1154,10/4/2013,0,0,0,0,0,0,0
18094,RM-1154,10/5/2013,0,0,0,0,0,0,0
18095,RM-1154,10/6/2013,0,0,0,0,0,0,0
18096,RM-1154,10/7/2013,0,0,0,0,0,0,0
18097,RM-1154,10/8/2013,0,0,0,0,0,0,0
18098,RM-1154,10/9/2013,0,0,0,0,0,0,0
18099,RM-1154,10/10/2013,0,0,0,0,0,0,0
18100,RM-1154,10/11/2013,0,0,0,0,0,0,0
18101,RM-1154,10/12/2013,0,0,0,0,0,0,0
18102,RM-1154,10/13/2013,0,0,0,0,0,0,0
18103,RM-1154,10/14/2013,0,0,0,0,0,0,0
18104,RM-1154,10/15/2013,0,0,0,0,0,0,0
18105,RM-1154,10/16/2013,0,0,0,0,0,0,0
18106,RM-1154,10/17/2013,0,0,0,0,0,0,0
18107,RM-1154,10/18/2013,0,0,0,0,0,0,0
18108,RM-1154,10/19/2013,0,0,0,0,0,0,0
18109,RM-1154,10/20/2013,0,0,0,0,0,0,0
18110,RM-1154,10/21/2013,0,0,0,0,0,0,0
18111,RM-1154,10/22/2013,0,0,0,0,0,0,0
18112,RM-1154,10/23/2013,0,0,0,0,0,0,0
18113,RM-1154,10/24/2013,0,0,0,0,0,0,0
18114,RM-1154,10/25/2013,0,0,0,0,0,0,0
18115,RM-1154,10/26/2013,0,0,0,0,0,0,0
18116,RM-1154,10/27/2013,0,0,0,0,0,0,0
18117,RM-1154,10/28/2013,0,0,0,0,0,0,0
18118,RM-1154,10/29/2013,0,0,0,0,0,0,0
18119,RM-1154,10/30/2013,0,0,0,0,0,0,0
18120,RM-1154,10/31/2013,0,0,0,0,0,0,0
18121,RM-1154,11/1/2013,0,0,0,0,0,0,0
18122,RM-1154,11/2/2013,0,0,0,0,0,0,0
18123,RM-1154,11/3/2013,0,0,0,0,0,0,0
18124,RM-1154,11/4/2013,0,0,0,0,0,0,0
18125,RM-1154,11/5/2013,0,0,0,0,0,0,0
18126,RM-1154,11/6/2013,0,0,0,0,0,0,0
18127,RM-1154,11/7/2013,0,0,0,0,0,0,0
18128,RM-1154,11/8/2013,0,0,0,0,0,0,0
18129,RM-1154,11/9/2013,0,0,0,0,0,0,0
18130,RM-1154,11/10/2013,0,0,0,0,0,0,0
18131,RM-1154,11/11/2013,0,0,0,0,0,0,0
18132,RM-1154,11/12/2013,0,0,0,0,0,0,0
18133,RM-1154,11/13/2013,0,0,0,0,0,0,0
18134,RM-1154,11/14/2013,0,0,0,0,0,0,0
18135,RM-1154,11/15/2013,0,0,0,0,0,0,0
18136,RM-1154,11/19/2013,0,0,0,0,0,0,0
18137,RM-1154,11/20/2013,0,0,0,0,0,0,0
18138,RM-1154,11/21/2013,0,0,0,0,0,0,0
18139,RM-1154,11/22/2013,0,0,0,0,0,0,0
18140,RM-1154,11/23/2013,0,0,0,0,0,0,0
18141,RM-1154,11/24/2013,0,0,0,0,0,0,0
18142,RM-1154,11/25/2013,0,0,0,0,0,0,0
18143,RM-1154,11/26/2013,0,0,0,0,0,0,0
18144,RM-1154,11/27/2013,0,0,0,0,0,0,0
18145,RM-1154,11/28/2013,0,0,0,0,0,0,0
18146,RM-1154,11/29/2013,0,0,0,0,0,0,0
18147,RM-1154,11/30/2013,0,0,0,0,0,0,0
18148,RM-1154,12/1/2013,0,0,0,0,0,0,0
18149,RM-1154,12/2/2013,0,0,0,0,0,0,0
18150,RM-1154,12/3/2013,0,0,0,0,0,0,0
18151,RM-1154,12/4/2013,0,0,0,0,0,0,0
18152,RM-1154,12/5/2013,0,0,0,0,0,0,0
18153,RM-1154,12/6/2013,0,0,0,0,0,0,0
18154,RM-1154,12/7/2013,0,0,0,0,0,0,0
18155,RM-1154,12/8/2013,0,0,0,0,0,0,0
18156,RM-1154,12/9/2013,0,0,0,0,0,0,0
18157,RM-1154,12/10/2013,0,0,0,0,0,0,0
18158,RM-1154,12/11/2013,0,0,0,0,0,0,0
18159,RM-1154,12/12/2013,0,0,0,0,0,0,0
18160,RM-1154,12/13/2013,0,0,0,0,0,0,0
18161,RM-1154,12/14/2013,0,0,0,0,0,0,0
18162,RM-1154,12/15/2013,0,0,0,0,0,0,0
18163,RM-1154,12/16/2013,0,0,0,0,0,0,0
18164,RM-1154,12/17/2013,0,0,0,0,0,0,0
18165,RM-1154,12/18/2013,0,0,0,0,0,0,0
18166,RM-1154,12/19/2013,0,0,0,0,0,0,0
18167,RM-1154,12/20/2013,0,0,0,0,0,0,0
18168,RM-1154,12/21/2013,0,0,0,0,0,0,0
18169,RM-1154,12/22/2013,0,0,0,0,0,0,0
18170,RM-1154,12/23/2013,0,0,0,0,0,0,0
18171,RM-1154,12/24/2013,0,0,0,0,0,0,0
18172,RM-1154,12/25/2013,0,0,0,0,0,0,0
18173,RM-1154,12/26/2013,0,0,0,0,0,0,0
18174,RM-1154,12/27/2013,0,0,0,0,0,0,0
18175,RM-1154,12/28/2013,0,0,0,0,0,0,0
18176,RM-1154,12/29/2013,0,0,0,0,0,0,0
18177,RM-1154,12/30/2013,0,0,0,0,0,0,0
18178,RM-1154,12/31/2013,0,0,0,0,0,0,0
18179,RM-1154,1/1/2014,0,0,0,0,0,0,0
18180,RM-1154,1/2/2014,0,0,0,0,0,0,0
18181,RM-1154,1/3/2014,0,0,0,0,0,0,0
18182,RM-1154,1/4/2014,0,0,0,0,0,0,0
18183,RM-1154,1/5/2014,0,0,0,0,0,0,0
18184,RM-1154,1/6/2014,0,0,0,0,0,0,0
18185,RM-1154,1/7/2014,0,0,0,0,0,0,0
18186,RM-1154,1/8/2014,0,0,0,0,0,0,0
18187,RM-1154,1/9/2014,0,0,0,0,0,0,0
18188,RM-1154,1/10/2014,0,0,0,0,0,0,0
18189,RM-1154,1/11/2014,0,0,0,0,0,0,0
18190,RM-1154,1/12/2014,0,0,0,0,0,0,0
18191,RM-1154,1/13/2014,0,0,0,0,0,0,0
18192,RM-1154,1/14/2014,0,0,0,0,0,0,0
18193,RM-1154,1/15/2014,0,0,0,0,0,0,0
18194,RM-1154,1/16/2014,0,0,0,0,0,0,0
18195,RM-1154,1/17/2014,0,0,0,0,0,0,0
18196,RM-1154,1/18/2014,0,0,0,0,0,0,0
18197,RM-1154,1/19/2014,0,0,0,0,0,0,0
18198,RM-1154,1/20/2014,0,0,0,0,0,0,0
18199,RM-1154,1/21/2014,0,0,0,0,0,0,0
18200,RM-1154,1/22/2014,0,0,0,0,0,0,0
18201,RM-1154,1/23/2014,0,0,0,0,0,0,0
18202,RM-1154,1/24/2014,0,0,0,0,0,0,0
18203,RM-1154,1/25/2014,0,0,0,0,0,0,0
18204,RM-1154,1/26/2014,0,0,0,0,0,0,0
18205,RM-1154,1/27/2014,0,0,0,0,0,0,0
18206,RM-1154,1/28/2014,0,0,0,0,0,0,0
18207,RM-1154,1/29/2014,0,0,0,0,0,0,0
18208,RM-1154,1/30/2014,0,0,0,0,0,0,0
18209,RM-1154,1/31/2014,0,0,0,0,0,0,0
18210,RM-1154,2/1/2014,0,0,0,0,0,0,0
18211,RM-1154,2/2/2014,0,0,0,0,0,0,0
18212,RM-1154,2/3/2014,0,0,0,0,0,0,0
18213,RM-1154,2/4/2014,0,0,0,0,0,0,0
18214,RM-1154,2/5/2014,0,0,0,0,0,0,0
18215,RM-1154,2/6/2014,0,0,0,0,0,0,0
18216,RM-1154,2/7/2014,0,0,0,0,0,0,0
18217,RM-1154,2/8/2014,0,0,0,0,0,0,0
18218,RM-1154,2/9/2014,0,0,0,0,0,0,0
18219,RM-1154,2/10/2014,0,0,0,0,0,0,0
18220,RM-1154,2/11/2014,0,0,0,0,0,0,0
18221,RM-1154,2/12/2014,0,0,0,0,0,0,0
18222,RM-1154,2/13/2014,0,0,0,0,0,0,0
18223,RM-1154,2/14/2014,0,0,0,0,0,0,0
18224,RM-1154,2/15/2014,0,0,0,0,0,0,0
18225,RM-1154,2/16/2014,0,0,0,0,0,0,0
18226,RM-1154,2/17/2014,0,0,0,0,0,0,0
18227,RM-1154,2/18/2014,0,0,0,0,0,0,0
18228,RM-1154,2/19/2014,0,0,0,0,0,0,0
18229,RM-1154,2/20/2014,0,0,0,0,0,0,0
18230,RM-1154,2/21/2014,0,0,0,0,0,0,0
18231,RM-1154,2/22/2014,0,0,0,0,0,0,0
18232,RM-1154,2/23/2014,0,0,0,0,0,0,0
18233,RM-1154,2/24/2014,0,0,0,0,0,0,0
18234,RM-1154,2/25/2014,0,0,0,0,0,0,0
18235,RM-1154,2/26/2014,0,0,0,0,0,0,0
18236,RM-1154,2/27/2014,0,0,0,0,0,0,0
18237,RM-1154,2/28/2014,0,0,0,0,0,0,0
18238,RM-1154,3/1/2014,0,0,0,0,0,0,0
18239,RM-1154,3/2/2014,0,0,0,0,0,0,0
18240,RM-1154,3/3/2014,0,0,0,0,0,0,0
18241,RM-1154,3/4/2014,0,0,0,0,0,0,0
18242,RM-1154,3/5/2014,0,0,0,0,0,0,0
18243,RM-1154,3/6/2014,0,0,0,0,0,0,0
18244,RM-1154,3/7/2014,0,0,0,0,0,0,0
18245,RM-1154,3/8/2014,0,0,0,0,0,0,0
18246,RM-1154,3/9/2014,0,0,0,0,0,0,0
18247,RM-1154,3/10/2014,0,0,0,0,0,0,0
18248,RM-1154,3/11/2014,0,0,0,0,0,0,0
18249,RM-1154,3/12/2014,0,0,0,0,0,0,0
18250,RM-1154,3/13/2014,0,0,0,0,0,0,0
18251,RM-1154,3/14/2014,0,0,0,0,0,0,0
18252,RM-1154,3/15/2014,0,0,0,0,0,0,0
18253,RM-1154,3/16/2014,0,0,0,0,0,0,0
18254,RM-1154,3/17/2014,0,0,0,0,0,0,0
18255,RM-1154,3/18/2014,0,0,0,0,0,0,0
18256,RM-1154,3/19/2014,0,0,0,0,0,0,0
18257,RM-1154,3/20/2014,0,0,0,0,0,0,0
18258,RM-1154,3/21/2014,0,0,0,0,0,0,0
18259,RM-1154,3/22/2014,0,0,0,0,0,0,0
18260,RM-1154,3/23/2014,0,0,0,0,0,0,0
18261,RM-1154,3/24/2014,0,0,0,0,0,0,0
18262,RM-1154,3/25/2014,0,0,0,0,0,0,0
18263,RM-1154,3/26/2014,0,0,0,0,0,0,0
18264,RM-1154,3/27/2014,0,0,0,0,0,0,0
18265,RM-1154,3/28/2014,0,0,0,0,0,0,0
18266,RM-1154,3/29/2014,0,0,0,0,0,0,0
18267,RM-1154,3/30/2014,0,0,0,0,0,0,0
18268,RM-1154,3/31/2014,0,0,0,0,0,0,0
18269,RM-1154,4/1/2014,0,0,0,0,0,0,0
18270,RM-1154,4/2/2014,0,0,0,0,0,0,0
18271,RM-1154,4/3/2014,0,0,0,0,0,0,0
18272,RM-1154,4/4/2014,0,0,0,0,0,0,0
18273,RM-1154,4/5/2014,0,0,0,0,0,0,0
18274,RM-1154,4/6/2014,0,0,0,0,0,0,0
18275,RM-1154,4/7/2014,0,0,0,0,0,0,0
18276,RM-1154,4/8/2014,0,0,0,0,0,0,0
18277,RM-1154,4/9/2014,0,0,0,0,0,0,0
18278,RM-1154,4/10/2014,0,0,0,0,0,0,0
18279,RM-1154,4/11/2014,0,0,0,0,0,0,0
18280,RM-1154,4/12/2014,0,0,0,0,0,0,0
18281,RM-1154,4/13/2014,0,0,0,0,0,0,0
18282,RM-1154,4/14/2014,0,0,0,0,0,0,0
18283,RM-1154,4/15/2014,0,0,0,0,0,0,0
18284,RM-1154,4/16/2014,0,0,0,0,0,0,0
18285,RM-1154,4/17/2014,0,0,0,0,0,0,0
18286,RM-1154,4/18/2014,0,0,0,0,0,0,0
18287,RM-1154,4/19/2014,0,0,0,0,0,0,0
18288,RM-1154,4/20/2014,0,0,0,0,0,0,0
18289,RM-1154,4/21/2014,0,0,0,0,0,0,0
18290,RM-1154,4/22/2014,0,0,0,0,0,0,0
18291,RM-1154,4/23/2014,0,0,0,0,0,0,0
18292,RM-1154,4/24/2014,0,0,0,0,0,0,0
18293,RM-1154,4/25/2014,0,0,0,0,0,0,0
18294,RM-1154,4/26/2014,0,0,0,0,0,0,0
18295,RM-1154,4/27/2014,0,0,0,0,0,0,0
18296,RM-1154,4/28/2014,0,0,0,0,0,0,0
18297,RM-1154,4/29/2014,0,0,0,0,0,0,0
18298,RM-1154,4/30/2014,0,0,0,0,0,0,0
18299,RM-1154,5/1/2014,0,0,0,0,0,0,0
18300,RM-1154,5/2/2014,0,0,0,0,0,0,0
18301,RM-1154,5/3/2014,0,0,0,0,0,0,0
18302,RM-1154,5/4/2014,0,0,0,0,0,0,0
18303,RM-1154,5/5/2014,0,0,0,0,0,0,0
18304,RM-1154,5/6/2014,0,0,0,0,0,0,0
18305,RM-1154,5/7/2014,0,0,0,0,0,0,0
18306,RM-1154,5/8/2014,0,0,0,0,0,0,0
18307,RM-1154,5/9/2014,0,0,0,0,0,0,0
18308,RM-1154,5/10/2014,0,0,0,0,0,0,0
18309,RM-1154,5/11/2014,0,0,0,0,0,0,0
18310,RM-1154,5/12/2014,0,0,0,0,0,0,0
18311,RM-1154,5/13/2014,0,0,0,0,0,0,0
18312,RM-1154,5/14/2014,0,0,0,0,0,0,0
18313,RM-1154,5/15/2014,0,0,0,0,0,0,0
18314,RM-1154,5/16/2014,0,0,0,0,0,0,0
18315,RM-1154,5/17/2014,0,0,0,0,0,0,0
18316,RM-1154,5/18/2014,0,0,0,0,0,0,0
18317,RM-1154,5/19/2014,0,0,0,0,0,0,0
18318,RM-1154,5/20/2014,0,0,0,0,0,0,0
18319,RM-1154,5/21/2014,0,0,0,0,0,0,0
18320,RM-1154,5/22/2014,0,0,0,0,0,0,0
18321,RM-1154,5/23/2014,0,0,0,0,0,0,0
18322,RM-1154,5/24/2014,0,0,0,0,0,0,0
18323,RM-1154,5/25/2014,0,0,0,0,0,0,0
18324,RM-1154,5/26/2014,0,0,0,0,0,0,0
18325,RM-1154,5/27/2014,0,0,0,0,0,0,0
18326,RM-1154,5/28/2014,0,0,0,0,0,0,0
18327,RM-1154,5/29/2014,0,0,0,0,0,0,0
18328,RM-1154,5/30/2014,0,0,0,0,0,0,0
18329,RM-1154,5/31/2014,0,0,0,0,0,0,0
18330,RM-1154,6/1/2014,0,0,0,0,0,0,0
18331,RM-1154,6/2/2014,0,0,0,0,0,0,0
18332,RM-1154,6/3/2014,0,0,0,0,0,0,0
18333,RM-1154,6/4/2014,0,0,0,0,0,0,0
18334,RM-1154,6/5/2014,0,0,0,0,0,0,0
18335,RM-1154,6/6/2014,0,0,0,0,0,0,0
18336,RM-1154,6/7/2014,0,0,0,0,0,0,0
18337,RM-1154,6/8/2014,0,0,0,0,0,0,0
18338,RM-1154,6/9/2014,0,0,0,0,0,0,0
18339,RM-1154,6/10/2014,0,0,0,0,0,0,0
18340,RM-1154,6/11/2014,0,0,0,0,0,0,0
18341,RM-1154,6/12/2014,0,0,0,0,0,0,0
18342,RM-1154,6/13/2014,0,0,0,0,0,0,0
18343,RM-1154,6/14/2014,0,0,0,0,0,0,0
18344,RM-1154,6/15/2014,0,0,0,0,0,0,0
18345,RM-1154,6/16/2014,0,0,0,0,0,0,0
18346,RM-1154,6/17/2014,0,0,0,0,0,0,0
18347,RM-1154,6/18/2014,0,0,0,0,0,0,0
18348,RM-1154,6/19/2014,0,0,0,0,0,0,0
18349,RM-1154,6/20/2014,0,0,0,0,0,0,0
18350,RM-1154,6/21/2014,0,0,0,0,0,0,0
18351,RM-1154,6/22/2014,0,0,0,0,0,0,0
18352,RM-1154,6/23/2014,0,0,0,0,0,0,0
18353,RM-1154,6/24/2014,0,0,0,0,0,0,0
18354,RM-1154,6/25/2014,0,0,0,0,0,0,0
18355,RM-1154,6/26/2014,0,0,0,0,0,0,0
18356,RM-1154,6/27/2014,0,0,0,0,0,0,0
18357,RM-1154,6/28/2014,0,0,0,0,0,0,0
18358,RM-1154,6/29/2014,0,0,0,0,0,0,0
18359,RM-1154,6/30/2014,0,0,0,0,0,0,0
18360,RM-1154,7/1/2014,0,0,0,0,0,0,0
18361,RM-1154,7/2/2014,0,0,0,0,0,0,0
18362,RM-1154,7/3/2014,0,0,0,0,0,0,0
18363,RM-1154,7/4/2014,0,0,0,0,0,0,0
18364,RM-1154,7/5/2014,0,0,0,0,0,0,0
18365,RM-1154,7/6/2014,0,0,0,0,0,0,0
18366,RM-1154,7/7/2014,0,0,0,0,0,0,0
18367,RM-1154,7/8/2014,0,0,0,0,0,0,0
18368,RM-1154,7/9/2014,0,0,0,0,0,0,0
18369,RM-1154,7/10/2014,0,0,0,0,0,0,0
18370,RM-1154,7/11/2014,0,0,0,0,0,0,0
18371,RM-1154,7/12/2014,0,0,0,0,0,0,0
18372,RM-1154,7/13/2014,0,0,0,0,0,0,0
18373,RM-1154,7/14/2014,0,0,0,0,0,0,0
18374,RM-1154,7/15/2014,0,0,0,0,0,0,0
18375,RM-1154,7/16/2014,0,0,0,0,0,0,0
18376,RM-1154,7/17/2014,0,0,0,0,0,0,0
18377,RM-1154,7/18/2014,0,0,0,0,0,0,0
18378,RM-1154,7/19/2014,0,0,0,0,0,0,0
18379,RM-1154,7/20/2014,0,0,0,0,0,0,0
18380,RM-1154,7/21/2014,0,0,0,0,0,0,0
18381,RM-1154,7/22/2014,0,0,0,0,0,0,0
18382,RM-1154,7/23/2014,0,0,0,0,0,0,0
18383,RM-1154,7/24/2014,0,0,0,0,0,0,0
18384,RM-1154,7/25/2014,0,0,0,0,0,0,0
18385,RM-1154,7/26/2014,0,0,0,0,0,0,0
18386,RM-1154,7/27/2014,0,0,0,0,0,0,0
18387,RM-1154,7/28/2014,0,0,0,0,0,0,0
18388,RM-1154,7/29/2014,0,0,0,0,0,0,0
18389,RM-1154,7/30/2014,0,0,0,0,0,0,0
18390,RM-1154,7/31/2014,0,0,0,0,0,0,0
18391,RM-1154,8/1/2014,0,0,0,0,0,0,0
18392,RM-1154,8/2/2014,0,0,0,0,0,0,0
18393,RM-1154,8/3/2014,0,0,0,0,0,0,0
18394,RM-1154,8/4/2014,0,0,0,0,0,0,0
18395,RM-1154,8/5/2014,0,0,0,0,0,0,0
18396,RM-1154,8/6/2014,0,0,0,0,0,0,0
18397,RM-1154,8/7/2014,0,0,0,0,0,0,0
18398,RM-1154,8/8/2014,0,0,0,0,0,0,0
18399,RM-1154,8/9/2014,0,0,0,0,0,0,0
18400,RM-1154,8/10/2014,0,0,0,0,0,0,0
18401,RM-1154,8/11/2014,0,0,0,0,0,0,0
18402,RM-1154,8/12/2014,0,0,0,0,0,0,0
18403,RM-1154,8/13/2014,0,0,0,0,0,0,0
18404,RM-1154,8/14/2014,0,0,0,0,0,0,0
18405,RM-1154,8/15/2014,0,0,0,0,0,0,0
18406,RM-1154,8/16/2014,0,0,0,0,0,0,0
18407,RM-1154,8/17/2014,0,0,0,0,0,0,0
18408,RM-1154,8/18/2014,0,0,0,0,0,0,0
18409,RM-1154,8/19/2014,0,0,0,0,0,0,0
18410,RM-1154,8/20/2014,0,0,0,0,0,0,0
18411,RM-1154,8/21/2014,0,0,0,0,0,0,0
18412,RM-1154,8/22/2014,0,0,0,0,0,0,0
18413,RM-1154,8/23/2014,0,0,0,0,0,0,0
18414,RM-1154,8/24/2014,0,0,0,0,0,0,0
18415,RM-1154,8/25/2014,0,0,0,0,0,0,0
18416,RM-1154,8/26/2014,0,0,0,0,0,0,0
18417,RM-1154,8/27/2014,0,0,0,0,0,0,0
18418,RM-1154,8/28/2014,0,0,0,0,0,0,0
18419,RM-1154,8/29/2014,0,0,0,0,0,0,0
18420,RM-1154,8/30/2014,0,0,0,0,0,0,0
18421,RM-1154,8/31/2014,0,0,0,0,0,0,0
18422,RM-1154,9/1/2014,0,0,0,0,0,0,0
18423,RM-1154,9/2/2014,0,0,0,0,0,0,0
18424,RM-1154,9/3/2014,0,0,0,0,0,0,0
18425,RM-1154,9/4/2014,0,0,0,0,0,0,0
18426,RM-1154,9/5/2014,0,0,0,0,0,0,0
18427,RM-1154,9/6/2014,0,0,0,0,0,0,0
18428,RM-1154,9/7/2014,0,0,0,0,0,0,0
18429,RM-1154,9/8/2014,0,0,0,0,0,0,0
18430,RM-1154,9/9/2014,0,0,0,0,0,0,0
18431,RM-1154,9/10/2014,0,0,0,0,0,0,0
18432,RM-1154,9/11/2014,0,0,0,0,0,0,0
18433,RM-1154,9/12/2014,0,0,0,0,0,0,0
18434,RM-1154,9/13/2014,0,0,0,0,0,0,0
18435,RM-1154,9/14/2014,0,0,0,0,0,0,0
18436,RM-1154,9/15/2014,0,0,0,0,0,0,0
18437,RM-1154,9/16/2014,0,0,0,0,0,0,0
18438,RM-1154,9/17/2014,0,0,0,0,0,0,0
18439,RM-1154,9/18/2014,0,0,0,0,0,0,0
18440,RM-1154,9/19/2014,0,0,0,0,0,0,0
18441,RM-1154,9/20/2014,0,0,0,0,0,0,0
18442,RM-1154,9/21/2014,0,0,0,0,0,0,0
18443,RM-1154,9/22/2014,0,0,0,0,0,0,0
18444,RM-1154,9/23/2014,0,0,0,0,0,0,0
18445,RM-1154,9/24/2014,0,0,0,0,0,0,0
18446,RM-1154,9/25/2014,0,0,0,0,0,0,0
18447,RM-1154,9/28/2014,0,0,0,0,0,0,0
18448,RM-1154,9/29/2014,0,0,0,0,0,0,0
18449,RM-1154,9/30/2014,0,0,0,0,0,0,0
18450,RM-1154,10/1/2014,0,0,0,0,0,0,0
18451,RM-1154,10/2/2014,0,0,0,0,0,0,0
18452,RM-1154,10/3/2014,0,0,0,0,0,0,0
18453,RM-1154,10/4/2014,0,0,0,0,0,0,0
18454,RM-1154,10/5/2014,0,0,0,0,0,0,0
18455,RM-1154,10/6/2014,0,0,0,0,0,0,0
18456,RM-1154,10/7/2014,0,0,0,0,0,0,0
18457,RM-1154,10/8/2014,0,0,0,0,0,0,0
18458,RM-1154,10/9/2014,0,0,0,0,0,0,0
18459,RM-1154,10/10/2014,0,0,0,0,0,0,0
18460,RM-1154,10/11/2014,0,0,0,0,0,0,0
18461,RM-1154,10/12/2014,0,0,0,0,0,0,0
18462,RM-1154,10/13/2014,0,0,0,0,0,0,0
18463,RM-1154,10/14/2014,0,0,0,0,0,0,0
18464,RM-1154,10/15/2014,0,0,0,0,0,0,0
18465,RM-1154,10/16/2014,0,0,0,0,0,0,0
18466,RM-1154,10/17/2014,0,0,0,0,0,0,0
18467,RM-1154,10/18/2014,0,0,0,0,0,0,0
18468,RM-1154,10/19/2014,0,0,0,0,0,0,0
18469,RM-1154,10/20/2014,0,0,0,0,0,0,0
18470,RM-1154,10/21/2014,0,0,0,0,0,0,0
18471,RM-1154,10/22/2014,0,0,0,0,0,0,0
18472,RM-1154,10/23/2014,0,0,0,0,0,0,0
18473,RM-1154,10/24/2014,0,0,0,0,0,0,0
18474,RM-1154,10/25/2014,0,0,0,0,0,0,0
18475,RM-1154,10/26/2014,0,0,0,0,0,0,0
18476,RM-1154,10/27/2014,0,0,0,0,0,0,0
18477,RM-1154,10/28/2014,0,0,0,0,0,0,0
18478,RM-1154,10/29/2014,0,0,0,0,0,0,0
18479,RM-1154,10/30/2014,0,0,0,0,0,0,0
18480,RM-1154,10/31/2014,0,0,0,0,0,0,0
18481,RM-1154,11/1/2014,0,0,0,0,0,0,0
18482,RM-1154,11/2/2014,0,0,0,0,0,0,0
18483,RM-1154,11/3/2014,0,0,0,0,0,0,0
18484,RM-1154,11/4/2014,0,0,0,0,0,0,0
18485,RM-1154,11/5/2014,0,0,0,0,0,0,0
18486,RM-1154,11/6/2014,0,0,0,0,0,0,0
18487,RM-1154,11/7/2014,0,0,0,0,0,0,0
18488,RM-1154,11/8/2014,0,0,0,0,0,0,0
18489,RM-1154,11/9/2014,0,0,0,0,0,0,0
18490,RM-1154,11/10/2014,0,0,0,0,0,0,0
18491,RM-1154,11/11/2014,0,0,0,0,0,0,0
18492,RM-1154,11/12/2014,0,0,0,0,0,0,0
18493,RM-1154,11/13/2014,0,0,0,0,0,0,0
18494,RM-1154,11/14/2014,0,0,0,0,0,0,0
18495,RM-1154,11/15/2014,0,0,0,0,0,0,0
18496,RM-1154,11/16/2014,0,0,0,0,0,0,0
18497,RM-1154,11/17/2014,0,0,0,0,0,0,0
18498,RM-1154,11/18/2014,0,0,0,0,0,0,0
18499,RM-1154,11/19/2014,0,0,0,0,0,0,0
18500,RM-1154,11/20/2014,0,0,0,0,0,0,0
18501,RM-1154,11/21/2014,0,0,0,0,0,0,0
18502,RM-1154,11/22/2014,0,0,0,0,0,0,0
18503,RM-1154,11/23/2014,0,0,0,0,0,0,0
18504,RM-1154,11/24/2014,0,0,0,0,0,0,0
18505,RM-1154,11/25/2014,0,0,0,0,0,0,0
18506,RM-1154,11/26/2014,0,0,0,0,0,0,0
18507,RM-1154,11/27/2014,0,0,0,0,0,0,0
18508,RM-1154,11/28/2014,0,0,0,0,0,0,0
18509,RM-1154,11/29/2014,0,0,0,0,0,0,0
18510,RM-1154,11/30/2014,0,0,0,0,0,0,0
18511,RM-1154,12/1/2014,0,0,0,0,0,0,0
18512,RM-1154,12/2/2014,0,0,0,0,0,0,0
18513,RM-1154,12/3/2014,0,0,0,0,0,0,0
18514,RM-1154,12/4/2014,0,0,0,0,0,0,0
18515,RM-1154,12/5/2014,0,0,0,0,0,0,0
18516,RM-1154,12/6/2014,0,0,0,0,0,0,0
18517,RM-1154,12/7/2014,0,0,0,0,0,0,0
18518,RM-1154,12/8/2014,0,0,0,0,0,0,0
18519,RM-1154,12/9/2014,0,0,0,0,0,0,0
18520,RM-1154,12/10/2014,0,0,0,0,0,0,0
18521,RM-1154,12/11/2014,0,0,0,0,0,0,0
18522,RM-1154,12/12/2014,0,0,0,0,0,0,0
18523,RM-1154,12/13/2014,0,0,0,0,0,0,0
18524,RM-1154,12/14/2014,0,0,0,0,0,0,0
18525,RM-1154,12/15/2014,0,0,0,0,0,0,0
18526,RM-1154,12/16/2014,0,0,0,0,0,0,0
18527,RM-1154,12/17/2014,0,0,0,0,0,0,0
18528,RM-1154,12/18/2014,0,0,0,0,0,0,0
18529,RM-1154,12/19/2014,0,0,0,0,0,0,0
18530,RM-1154,12/20/2014,0,0,0,0,0,0,0
18531,RM-1154,12/21/2014,0,0,0,0,0,0,0
18532,RM-1154,12/22/2014,0,0,0,0,0,0,0
18533,RM-1154,12/23/2014,0,0,0,0,0,0,0
18534,RM-1154,12/24/2014,0,0,0,0,0,0,0
18535,RM-1154,12/25/2014,0,0,0,0,0,0,0
18536,RM-1154,12/26/2014,0,0,0,0,0,0,0
18537,RM-1154,12/27/2014,0,0,0,0,0,0,0
18538,RM-1154,12/28/2014,0,0,0,0,0,0,0
18539,RM-1154,12/29/2014,0,0,0,0,0,0,0
18540,RM-1154,12/30/2014,0,0,0,0,0,0,0
18541,RM-1154,12/31/2014,0,0,0,0,0,0,0
18542,RM-1154,1/1/2015,0,0,0,0,0,0,0
18543,RM-1154,1/2/2015,0,0,0,0,0,0,0
18544,RM-1154,1/3/2015,0,0,0,0,0,0,0
18545,RM-1154,1/4/2015,0,0,0,0,0,0,0
18546,RM-1154,1/5/2015,0,0,0,0,0,0,0
18547,RM-1154,1/6/2015,0,0,0,0,0,0,0
18548,RM-1154,1/7/2015,0,0,0,0,0,0,0
18549,RM-1154,1/8/2015,0,0,0,0,0,0,0
18550,RM-1154,1/9/2015,0,0,0,0,0,0,0
18551,RM-1154,1/10/2015,0,0,0,0,0,0,0
18552,RM-1154,1/11/2015,0,0,0,0,0,0,0
18553,RM-1154,1/12/2015,0,0,0,0,0,0,0
18554,RM-1154,1/13/2015,0,0,0,0,0,0,0
18555,RM-1154,1/14/2015,0,0,0,0,0,0,0
18556,RM-1154,1/15/2015,0,0,0,0,0,0,0
18557,RM-1154,1/16/2015,0,0,0,0,0,0,0
18558,RM-1154,1/17/2015,0,0,0,0,0,0,0
18559,RM-1154,1/18/2015,0,0,0,0,0,0,0
18560,RM-1154,1/19/2015,0,0,0,0,0,0,0
18561,RM-1154,1/20/2015,0,0,0,0,0,0,0
18562,RM-1154,1/21/2015,0,0,0,0,0,0,0
18563,RM-1154,1/22/2015,0,0,0,0,0,0,0
18564,RM-1154,1/23/2015,0,0,0,0,0,0,0
18565,RM-1154,1/24/2015,0,0,0,0,0,0,0
18566,RM-1154,1/25/2015,0,0,0,0,0,0,0
18567,RM-1154,1/26/2015,0,0,0,0,0,0,0
18568,RM-1154,1/27/2015,0,0,0,0,0,0,0
18569,RM-1154,1/28/2015,0,0,0,0,0,0,0
18570,RM-1154,1/29/2015,0,0,0,0,0,0,0
18571,RM-1154,1/30/2015,0,0,0,0,0,0,0
18572,RM-1154,1/31/2015,0,0,0,0,0,0,0
18573,RM-1154,2/1/2015,0,0,0,0,0,0,0
18574,RM-1154,2/2/2015,0,0,0,0,0,0,0
18575,RM-1154,2/3/2015,0,0,0,0,0,0,0
18576,RM-1154,2/4/2015,0,0,0,0,0,0,0
18577,RM-1154,2/5/2015,0,0,0,0,0,0,0
18578,RM-1154,2/6/2015,0,0,0,0,0,0,0
18579,RM-1154,2/7/2015,0,0,0,0,0,0,0
18580,RM-1154,2/8/2015,0,0,0,0,0,0,0
18581,RM-1154,2/9/2015,0,0,0,0,0,0,0
18582,RM-1154,2/10/2015,0,0,0,0,0,0,0
18583,RM-1154,2/11/2015,0,0,0,0,0,0,0
18584,RM-1154,2/12/2015,0,0,0,0,0,0,0
18585,RM-1154,2/13/2015,0,0,0,0,0,0,0
18586,RM-1154,2/14/2015,0,0,0,0,0,0,0
18587,RM-1154,2/15/2015,0,0,0,0,0,0,0
18588,RM-1154,2/16/2015,0,0,0,0,0,0,0
18589,RM-1154,2/17/2015,0,0,0,0,0,0,0
18590,RM-1154,2/18/2015,0,0,0,0,0,0,0
18591,RM-1154,2/19/2015,0,0,0,0,0,0,0
18592,RM-1154,2/20/2015,0,0,0,0,0,0,0
18593,RM-1154,2/21/2015,0,0,0,0,0,0,0
18594,RM-1154,2/22/2015,0,0,0,0,0,0,0
18595,RM-1154,2/23/2015,0,0,0,0,0,0,0
18596,RM-1154,2/24/2015,0,0,0,0,0,0,0
18597,RM-1154,2/25/2015,0,0,0,0,0,0,0
18598,RM-1154,2/26/2015,0,0,0,0,0,0,0
18599,RM-1154,2/27/2015,0,0,0,0,0,0,0
18600,RM-1154,2/28/2015,0,0,0,0,0,0,0
18601,RM-1154,3/1/2015,0,0,0,0,0,0,0
18602,RM-1154,3/2/2015,0,0,0,0,0,0,0
18603,RM-1154,3/3/2015,0,0,0,0,0,0,0
18604,RM-1154,3/4/2015,0,0,0,0,0,0,0
18605,RM-1154,3/5/2015,0,0,0,0,0,0,0
18606,RM-1154,3/6/2015,0,0,0,0,0,0,0
18607,RM-1154,3/7/2015,0,0,0,0,0,0,0
18608,RM-1154,3/8/2015,0,0,0,0,0,0,0
18609,RM-1154,3/9/2015,0,0,0,0,0,0,0
18610,RM-1154,3/10/2015,0,0,0,0,0,0,0
18611,RM-1154,3/11/2015,0,0,0,0,0,0,0
18612,RM-1154,3/12/2015,0,0,0,0,0,0,0
18613,RM-1154,3/13/2015,0,0,0,0,0,0,0
18614,RM-1154,3/14/2015,0,0,0,0,0,0,0
18615,RM-1154,3/15/2015,0,0,0,0,0,0,0
18616,RM-1154,3/16/2015,0,0,0,0,0,0,0
18617,RM-1154,3/17/2015,0,0,0,0,0,0,0
18618,RM-1154,3/18/2015,0,0,0,0,0,0,0
18619,RM-1154,3/19/2015,0,0,0,0,0,0,0
18620,RM-1154,3/20/2015,0,0,0,0,0,0,0
18621,RM-1154,3/21/2015,0,0,0,0,0,0,0
18622,RM-1154,3/22/2015,0,0,0,0,0,0,0
18623,RM-1154,3/23/2015,0,0,0,0,0,0,0
18624,RM-1154,3/24/2015,0,0,0,0,0,0,0
18625,RM-1154,3/25/2015,0,0,0,0,0,0,0
18626,RM-1154,3/26/2015,0,0,0,0,0,0,0
18627,RM-1154,3/27/2015,0,0,0,0,0,0,0
18628,RM-1154,3/28/2015,0,0,0,0,0,0,0
18629,RM-1154,3/29/2015,0,0,0,0,0,0,0
18630,RM-1154,3/30/2015,0,0,0,0,0,0,0
18631,RM-1154,3/31/2015,0,0,0,0,0,0,0
18632,RM-1154,4/1/2015,0,0,0,0,0,0,0
18633,RM-1154,4/2/2015,0,0,0,0,0,0,0
18634,RM-1154,4/3/2015,0,0,0,0,0,0,0
18635,RM-1154,4/4/2015,0,0,0,0,0,0,0
18636,RM-1154,4/5/2015,0,0,0,0,0,0,0
18637,RM-1154,4/6/2015,0,0,0,0,0,0,0
18638,RM-1154,4/7/2015,0,0,0,0,0,0,0
18639,RM-1154,4/8/2015,0,0,0,0,0,0,0
18640,RM-1154,4/9/2015,0,0,0,0,0,0,0
18641,RM-1154,4/10/2015,0,0,0,0,0,0,0
18642,RM-1154,4/11/2015,0,0,0,0,0,0,0
18643,RM-1154,4/12/2015,0,0,0,0,0,0,0
18644,RM-1154,4/13/2015,0,0,0,0,0,0,0
18645,RM-1154,4/14/2015,0,0,0,0,0,0,0
18646,RM-1154,4/15/2015,0,0,0,0,0,0,0
18647,RM-1154,4/16/2015,0,0,0,0,0,0,0
18648,RM-1154,4/17/2015,0,0,0,0,0,0,0
18649,RM-1154,4/18/2015,0,0,0,0,0,0,0
18650,RM-1154,4/19/2015,0,0,0,0,0,0,0
18651,RM-1154,4/20/2015,0,0,0,0,0,0,0
18652,RM-1154,4/21/2015,0,0,0,0,0,0,0
18653,RM-1154,4/22/2015,0,0,0,0,0,0,0
18654,RM-1154,4/23/2015,0,0,0,0,0,0,0
18655,RM-1154,4/24/2015,0,0,0,0,0,0,0
18656,RM-1154,4/25/2015,0,0,0,0,0,0,0
18657,RM-1154,4/26/2015,0,0,0,0,0,0,0
18658,RM-1154,4/27/2015,0,0,0,0,0,0,0
18659,RM-1154,4/28/2015,0,0,0,0,0,0,0
18660,RM-1154,4/29/2015,0,0,0,0,0,0,0
18661,RM-1154,4/30/2015,0,0,0,0,0,0,0
18662,RM-1154,5/1/2015,0,0,0,0,0,0,0
18663,RM-1154,5/2/2015,0,0,0,0,0,0,0
18664,RM-1154,5/3/2015,0,0,0,0,0,0,0
18665,RM-1154,5/4/2015,0,0,0,0,0,0,0
18666,RM-1154,5/5/2015,0,0,0,0,0,0,0
18667,RM-1154,5/6/2015,0,0,0,0,0,0,0
18668,RM-1154,5/7/2015,0,0,0,0,0,0,0
18669,RM-1154,5/8/2015,0,0,0,0,0,0,0
18670,RM-1154,5/9/2015,0,0,0,0,0,0,0
18671,RM-1154,5/10/2015,0,0,0,0,0,0,0
18672,RM-1154,5/11/2015,0,0,0,0,0,0,0
18673,RM-1154,5/12/2015,0,0,0,0,0,0,0
18674,RM-1154,5/13/2015,0,0,0,0,0,0,0
18675,RM-1154,5/14/2015,0,0,0,0,0,0,0
18676,RM-1154,5/15/2015,0,0,0,0,0,0,0
18677,RM-1154,5/16/2015,0,0,0,0,0,0,0
18678,RM-1154,5/17/2015,0,0,0,0,0,0,0
18679,RM-1154,5/18/2015,0,0,0,0,0,0,0
18680,RM-1154,5/19/2015,0,0,0,0,0,0,0
18681,RM-1154,5/20/2015,0,0,0,0,0,0,0
18682,RM-1154,5/21/2015,0,0,0,0,0,0,0
18683,RM-1154,5/22/2015,0,0,0,0,0,0,0
18684,RM-1154,5/23/2015,0,0,0,0,0,0,0
18685,RM-1154,5/24/2015,0,0,0,0,0,0,0
18686,RM-1154,5/25/2015,0,0,0,0,0,0,0
18687,RM-1154,5/26/2015,0,0,0,0,0,0,0
18688,RM-1154,5/27/2015,0,0,0,0,0,0,0
18689,RM-1154,5/28/2015,0,0,0,0,0,0,0
18690,RM-1154,5/29/2015,0,0,0,0,0,0,0
18691,RM-1154,5/30/2015,0,0,0,0,0,0,0
18692,RM-1154,5/31/2015,0,0,0,0,0,0,0
18992,RM-1155,5/6/2014,0,0,0,0,0,0,0
19272,RM-1155,2/12/2015,0,0,0,0,0,0,0
19273,RM-1155,2/13/2015,0,0,0,0,0,0,0
19274,RM-1155,2/14/2015,0,0,0,0,0,0,0
19275,RM-1155,2/15/2015,0,0,0,0,0,0,0
19276,RM-1155,2/16/2015,0,0,0,0,0,0,0
19277,RM-1155,2/17/2015,0,0,0,0,0,0,0
19278,RM-1155,2/18/2015,0,0,0,0,0,0,0
19279,RM-1155,2/19/2015,0,0,0,0,0,0,0
19280,RM-1155,2/20/2015,0,0,0,0,0,0,0
19281,RM-1155,2/21/2015,0,0,0,0,0,0,0
19282,RM-1155,2/22/2015,0,0,0,0,0,0,0
19283,RM-1155,2/23/2015,0,0,0,0,0,0,0
19284,RM-1155,2/24/2015,0,0,0,0,0,0,0
19285,RM-1155,2/25/2015,0,0,0,0,0,0,0
19286,RM-1155,2/26/2015,0,0,0,0,0,0,0
19287,RM-1155,2/27/2015,0,0,0,0,0,0,0
19288,RM-1155,2/28/2015,0,0,0,0,0,0,0
19289,RM-1155,3/1/2015,0,0,0,0,0,0,0
19290,RM-1155,3/2/2015,0,0,0,0,0,0,0
19291,RM-1155,3/3/2015,0,0,0,0,0,0,0
19292,RM-1155,3/4/2015,0,0,0,0,0,0,0
19293,RM-1155,3/5/2015,0,0,0,0,0,0,0
19294,RM-1155,3/6/2015,0,0,0,0,0,0,0
19295,RM-1155,3/7/2015,0,0,0,0,0,0,0
19296,RM-1155,3/8/2015,0,0,0,0,0,0,0
19297,RM-1155,3/9/2015,0,0,0,0,0,0,0
19298,RM-1155,3/10/2015,0,0,0,0,0,0,0
19299,RM-1155,3/11/2015,0,0,0,0,0,0,0
19300,RM-1155,3/12/2015,0,0,0,0,0,0,0
19301,RM-1155,3/13/2015,0,0,0,0,0,0,0
19302,RM-1155,3/14/2015,0,0,0,0,0,0,0
19303,RM-1155,3/15/2015,0,0,0,0,0,0,0
19304,RM-1155,3/16/2015,0,0,0,0,0,0,0
19305,RM-1155,3/17/2015,0,0,0,0,0,0,0
19306,RM-1155,3/18/2015,0,0,0,0,0,0,0
19307,RM-1155,3/19/2015,0,0,0,0,0,0,0
19308,RM-1155,3/20/2015,0,0,0,0,0,0,0
19309,RM-1155,3/21/2015,0,0,0,0,0,0,0
19310,RM-1155,3/22/2015,0,0,0,0,0,0,0
19311,RM-1155,3/23/2015,0,0,0,0,0,0,0
19312,RM-1155,3/24/2015,0,0,0,0,0,0,0
19313,RM-1155,3/25/2015,0,0,0,0,0,0,0
19314,RM-1155,3/26/2015,0,0,0,0,0,0,0
19315,RM-1155,3/27/2015,0,0,0,0,0,0,0
19316,RM-1155,3/28/2015,0,0,0,0,0,0,0
19317,RM-1155,3/29/2015,0,0,0,0,0,0,0
19318,RM-1155,3/30/2015,0,0,0,0,0,0,0
19319,RM-1155,3/31/2015,0,0,0,0,0,0,0
19320,RM-1155,4/1/2015,0,0,0,0,0,0,0
19321,RM-1155,4/2/2015,0,0,0,0,0,0,0
19322,RM-1155,4/3/2015,0,0,0,0,0,0,0
19323,RM-1155,4/4/2015,0,0,0,0,0,0,0
19324,RM-1155,4/5/2015,0,0,0,0,0,0,0
19325,RM-1155,4/6/2015,0,0,0,0,0,0,0
19326,RM-1155,4/7/2015,0,0,0,0,0,0,0
19327,RM-1155,4/8/2015,0,0,0,0,0,0,0
19328,RM-1155,4/9/2015,0,0,0,0,0,0,0
19329,RM-1155,4/10/2015,0,0,0,0,0,0,0
19330,RM-1155,4/11/2015,0,0,0,0,0,0,0
19331,RM-1155,4/12/2015,0,0,0,0,0,0,0
19332,RM-1155,4/13/2015,0,0,0,0,0,0,0
19333,RM-1155,4/14/2015,0,0,0,0,0,0,0
19334,RM-1155,4/15/2015,0,0,0,0,0,0,0
19335,RM-1155,4/16/2015,0,0,0,0,0,0,0
19336,RM-1155,4/17/2015,0,0,0,0,0,0,0
19337,RM-1155,4/18/2015,0,0,0,0,0,0,0
19338,RM-1155,4/19/2015,0,0,0,0,0,0,0
19339,RM-1155,4/20/2015,0,0,0,0,0,0,0
19340,RM-1155,4/21/2015,0,0,0,0,0,0,0
19341,RM-1155,4/22/2015,0,0,0,0,0,0,0
19342,RM-1155,4/23/2015,0,0,0,0,0,0,0
19343,RM-1155,4/24/2015,0,0,0,0,0,0,0
19344,RM-1155,4/25/2015,0,0,0,0,0,0,0
19345,RM-1155,4/26/2015,0,0,0,0,0,0,0
19346,RM-1155,4/27/2015,0,0,0,0,0,0,0
19347,RM-1155,4/28/2015,0,0,0,0,0,0,0
19348,RM-1155,4/29/2015,0,0,0,0,0,0,0
19349,RM-1155,4/30/2015,0,0,0,0,0,0,0
19350,RM-1155,5/1/2015,0,0,0,0,0,0,0
19351,RM-1155,5/2/2015,0,0,0,0,0,0,0
19352,RM-1155,5/3/2015,0,0,0,0,0,0,0
19353,RM-1155,5/4/2015,0,0,0,0,0,0,0
19354,RM-1155,5/5/2015,0,0,0,0,0,0,0
19355,RM-1155,5/6/2015,0,0,0,0,0,0,0
19356,RM-1155,5/7/2015,0,0,0,0,0,0,0
19357,RM-1155,5/8/2015,0,0,0,0,0,0,0
19358,RM-1155,5/9/2015,0,0,0,0,0,0,0
19359,RM-1155,5/10/2015,0,0,0,0,0,0,0
19360,RM-1155,5/11/2015,0,0,0,0,0,0,0
19361,RM-1155,5/12/2015,0,0,0,0,0,0,0
19362,RM-1155,5/13/2015,0,0,0,0,0,0,0
19363,RM-1155,5/14/2015,0,0,0,0,0,0,0
19364,RM-1155,5/15/2015,0,0,0,0,0,0,0
19365,RM-1155,5/16/2015,0,0,0,0,0,0,0
19366,RM-1155,5/17/2015,0,0,0,0,0,0,0
19367,RM-1155,5/18/2015,0,0,0,0,0,0,0
19368,RM-1155,5/19/2015,0,0,0,0,0,0,0
19369,RM-1155,5/20/2015,0,0,0,0,0,0,0
19370,RM-1155,5/21/2015,0,0,0,0,0,0,0
19371,RM-1155,5/22/2015,0,0,0,0,0,0,0
19372,RM-1156,7/1/2013,0,0,0,0,0,0,0
19373,RM-1156,7/2/2013,0,0,0,0,0,0,0
19374,RM-1156,7/3/2013,0,0,0,0,0,0,0
19375,RM-1156,7/4/2013,0,0,0,0,0,0,0
19376,RM-1156,7/5/2013,0,0,0,0,0,0,0
19377,RM-1156,7/6/2013,0,0,0,0,0,0,0
19378,RM-1156,7/7/2013,0,0,0,0,0,0,0
19379,RM-1156,7/8/2013,0,0,0,0,0,0,0
19380,RM-1156,7/9/2013,0,0,0,0,0,0,0
19381,RM-1156,7/10/2013,0,0,0,0,0,0,0
19382,RM-1156,7/11/2013,0,0,0,0,0,0,0
19383,RM-1156,7/12/2013,0,0,0,0,0,0,0
19384,RM-1156,7/13/2013,0,0,0,0,0,0,0
19385,RM-1156,7/14/2013,0,0,0,0,0,0,0
19386,RM-1156,7/15/2013,0,0,0,0,0,0,0
19387,RM-1156,7/17/2013,0,0,0,0,0,0,0
19388,RM-1156,7/18/2013,0,0,0,0,0,0,0
19389,RM-1156,7/19/2013,0,0,0,0,0,0,0
19390,RM-1156,7/20/2013,0,0,0,0,0,0,0
19391,RM-1156,7/21/2013,0,0,0,0,0,0,0
19392,RM-1156,7/22/2013,0,0,0,0,0,0,0
19393,RM-1156,7/23/2013,0,0,0,0,0,0,0
19394,RM-1156,7/24/2013,0,0,0,0,0,0,0
19395,RM-1156,7/25/2013,0,0,0,0,0,0,0
19396,RM-1156,7/26/2013,0,0,0,0,0,0,0
19397,RM-1156,7/27/2013,0,0,0,0,0,0,0
19398,RM-1156,7/28/2013,0,0,0,0,0,0,0
19399,RM-1156,7/29/2013,0,0,0,0,0,0,0
19400,RM-1156,7/30/2013,0,0,0,0,0,0,0
19401,RM-1156,7/31/2013,0,0,0,0,0,0,0
19402,RM-1156,8/1/2013,0,0,0,0,0,0,0
19403,RM-1156,8/2/2013,0,0,0,0,0,0,0
19404,RM-1156,8/3/2013,0,0,0,0,0,0,0
19405,RM-1156,8/4/2013,0,0,0,0,0,0,0
19406,RM-1156,8/5/2013,0,0,0,0,0,0,0
19407,RM-1156,8/6/2013,0,0,0,0,0,0,0
19408,RM-1156,8/7/2013,0,0,0,0,0,0,0
19409,RM-1156,8/8/2013,0,0,0,0,0,0,0
19410,RM-1156,8/9/2013,0,0,0,0,0,0,0
19411,RM-1156,8/10/2013,0,0,0,0,0,0,0
19412,RM-1156,8/11/2013,0,0,0,0,0,0,0
19413,RM-1156,8/12/2013,0,0,0,0,0,0,0
19414,RM-1156,8/13/2013,0,0,0,0,0,0,0
19415,RM-1156,8/14/2013,0,0,0,0,0,0,0
19416,RM-1156,8/15/2013,0,0,0,0,0,0,0
19417,RM-1156,8/16/2013,0,0,0,0,0,0,0
19418,RM-1156,8/17/2013,0,0,0,0,0,0,0
19419,RM-1156,8/18/2013,0,0,0,0,0,0,0
19420,RM-1156,8/19/2013,0,0,0,0,0,0,0
19421,RM-1156,8/20/2013,0,0,0,0,0,0,0
19422,RM-1156,8/21/2013,0,0,0,0,0,0,0
19423,RM-1156,8/22/2013,0,0,0,0,0,0,0
19424,RM-1156,8/27/2013,0,0,0,0,0,0,0
19425,RM-1156,8/28/2013,0,0,0,0,0,0,0
19426,RM-1156,8/29/2013,0,0,0,0,0,0,0
19427,RM-1156,8/30/2013,0,0,0,0,0,0,0
19428,RM-1156,9/4/2013,0,0,0,0,0,0,0
19429,RM-1156,9/5/2013,0,0,0,0,0,0,0
19430,RM-1156,9/6/2013,0,0,0,0,0,0,0
19431,RM-1156,9/7/2013,0,0,0,0,0,0,0
19432,RM-1156,9/9/2013,0,0,0,0,0,0,0
19433,RM-1156,9/10/2013,0,0,0,0,0,0,0
19434,RM-1156,9/11/2013,0,0,0,0,0,0,0
19435,RM-1156,9/12/2013,0,0,0,0,0,0,0
19436,RM-1156,9/13/2013,0,0,0,0,0,0,0
19437,RM-1156,9/14/2013,0,0,0,0,0,0,0
19438,RM-1156,9/15/2013,0,0,0,0,0,0,0
19439,RM-1156,9/16/2013,0,0,0,0,0,0,0
19440,RM-1156,9/17/2013,0,0,0,0,0,0,0
19441,RM-1156,9/18/2013,0,0,0,0,0,0,0
19442,RM-1156,9/19/2013,0,0,0,0,0,0,0
19443,RM-1156,9/20/2013,0,0,0,0,0,0,0
19444,RM-1156,9/21/2013,0,0,0,0,0,0,0
19445,RM-1156,9/22/2013,0,0,0,0,0,0,0
19446,RM-1156,9/23/2013,0,0,0,0,0,0,0
19447,RM-1156,9/24/2013,0,0,0,0,0,0,0
19448,RM-1156,9/25/2013,0,0,0,0,0,0,0
19449,RM-1156,9/26/2013,0,0,0,0,0,0,0
19450,RM-1156,9/27/2013,0,0,0,0,0,0,0
19451,RM-1156,9/28/2013,0,0,0,0,0,0,0
19452,RM-1156,9/29/2013,0,0,0,0,0,0,0
19453,RM-1156,9/30/2013,0,0,0,0,0,0,0
19454,RM-1156,10/1/2013,0,0,0,0,0,0,0
19455,RM-1156,10/2/2013,0,0,0,0,0,0,0
19456,RM-1156,10/3/2013,0,0,0,0,0,0,0
19457,RM-1156,10/4/2013,0,0,0,0,0,0,0
19458,RM-1156,10/5/2013,0,0,0,0,0,0,0
19459,RM-1156,10/6/2013,0,0,0,0,0,0,0
19460,RM-1156,10/7/2013,0,0,0,0,0,0,0
19461,RM-1156,10/8/2013,0,0,0,0,0,0,0
19462,RM-1156,10/9/2013,0,0,0,0,0,0,0
19463,RM-1156,10/10/2013,0,0,0,0,0,0,0
19464,RM-1156,10/11/2013,0,0,0,0,0,0,0
19465,RM-1156,10/12/2013,0,0,0,0,0,0,0
19466,RM-1156,10/13/2013,0,0,0,0,0,0,0
19467,RM-1156,10/14/2013,0,0,0,0,0,0,0
19468,RM-1156,10/15/2013,0,0,0,0,0,0,0
19469,RM-1156,10/16/2013,0,0,0,0,0,0,0
19470,RM-1156,10/17/2013,0,0,0,0,0,0,0
19471,RM-1156,10/18/2013,0,0,0,0,0,0,0
19472,RM-1156,10/19/2013,0,0,0,0,0,0,0
19473,RM-1156,10/20/2013,0,0,0,0,0,0,0
19474,RM-1156,10/21/2013,0,0,0,0,0,0,0
19475,RM-1156,10/22/2013,0,0,0,0,0,0,0
19476,RM-1156,10/23/2013,0,0,0,0,0,0,0
19477,RM-1156,10/24/2013,0,0,0,0,0,0,0
19478,RM-1156,10/25/2013,0,0,0,0,0,0,0
19479,RM-1156,10/26/2013,0,0,0,0,0,0,0
19480,RM-1156,10/27/2013,0,0,0,0,0,0,0
19481,RM-1156,10/28/2013,0,0,0,0,0,0,0
19482,RM-1156,10/29/2013,0,0,0,0,0,0,0
19483,RM-1156,10/30/2013,0,0,0,0,0,0,0
19484,RM-1156,10/31/2013,0,0,0,0,0,0,0
19485,RM-1156,11/1/2013,0,0,0,0,0,0,0
19486,RM-1156,11/2/2013,0,0,0,0,0,0,0
19487,RM-1156,11/3/2013,0,0,0,0,0,0,0
19488,RM-1156,11/4/2013,0,0,0,0,0,0,0
19489,RM-1156,11/5/2013,0,0,0,0,0,0,0
19490,RM-1156,11/6/2013,0,0,0,0,0,0,0
19491,RM-1156,11/7/2013,0,0,0,0,0,0,0
19492,RM-1156,11/8/2013,0,0,0,0,0,0,0
19493,RM-1156,11/9/2013,0,0,0,0,0,0,0
19494,RM-1156,11/10/2013,0,0,0,0,0,0,0
19495,RM-1156,11/11/2013,0,0,0,0,0,0,0
19496,RM-1156,11/12/2013,0,0,0,0,0,0,0
19497,RM-1156,11/13/2013,0,0,0,0,0,0,0
19498,RM-1156,11/14/2013,0,0,0,0,0,0,0
19499,RM-1156,11/15/2013,0,0,0,0,0,0,0
19500,RM-1156,11/19/2013,0,0,0,0,0,0,0
19501,RM-1156,11/20/2013,0,0,0,0,0,0,0
19502,RM-1156,11/21/2013,0,0,0,0,0,0,0
19503,RM-1156,11/22/2013,0,0,0,0,0,0,0
19504,RM-1156,11/23/2013,0,0,0,0,0,0,0
19505,RM-1156,11/24/2013,0,0,0,0,0,0,0
19506,RM-1156,11/25/2013,0,0,0,0,0,0,0
19507,RM-1156,11/26/2013,0,0,0,0,0,0,0
19508,RM-1156,11/27/2013,0,0,0,0,0,0,0
19509,RM-1156,11/28/2013,0,0,0,0,0,0,0
19510,RM-1156,11/29/2013,0,0,0,0,0,0,0
19511,RM-1156,11/30/2013,0,0,0,0,0,0,0
19512,RM-1156,12/1/2013,0,0,0,0,0,0,0
19513,RM-1156,12/2/2013,0,0,0,0,0,0,0
19514,RM-1156,12/3/2013,0,0,0,0,0,0,0
19515,RM-1156,12/4/2013,0,0,0,0,0,0,0
19516,RM-1156,12/5/2013,0,0,0,0,0,0,0
19517,RM-1156,12/6/2013,0,0,0,0,0,0,0
19518,RM-1156,12/7/2013,0,0,0,0,0,0,0
19519,RM-1156,12/8/2013,0,0,0,0,0,0,0
19520,RM-1156,12/9/2013,0,0,0,0,0,0,0
19521,RM-1156,12/10/2013,0,0,0,0,0,0,0
19522,RM-1156,12/11/2013,0,0,0,0,0,0,0
19523,RM-1156,12/12/2013,0,0,0,0,0,0,0
19524,RM-1156,12/13/2013,0,0,0,0,0,0,0
19525,RM-1156,12/14/2013,0,0,0,0,0,0,0
19526,RM-1156,12/15/2013,0,0,0,0,0,0,0
19527,RM-1156,12/16/2013,0,0,0,0,0,0,0
19528,RM-1156,12/17/2013,0,0,0,0,0,0,0
19529,RM-1156,12/18/2013,0,0,0,0,0,0,0
19530,RM-1156,12/19/2013,0,0,0,0,0,0,0
19531,RM-1156,12/20/2013,0,0,0,0,0,0,0
19532,RM-1156,12/21/2013,0,0,0,0,0,0,0
19533,RM-1156,12/22/2013,0,0,0,0,0,0,0
19534,RM-1156,12/23/2013,0,0,0,0,0,0,0
19535,RM-1156,12/24/2013,0,0,0,0,0,0,0
19536,RM-1156,12/25/2013,0,0,0,0,0,0,0
19537,RM-1156,12/26/2013,0,0,0,0,0,0,0
19538,RM-1156,12/27/2013,0,0,0,0,0,0,0
19539,RM-1156,12/28/2013,0,0,0,0,0,0,0
19540,RM-1156,12/29/2013,0,0,0,0,0,0,0
19541,RM-1156,12/30/2013,0,0,0,0,0,0,0
19654,RM-1156,4/22/2014,0,0,0,0,0,0,0
19655,RM-1156,4/23/2014,0,0,0,0,0,0,0
19656,RM-1156,4/24/2014,0,0,0,0,0,0,0
19657,RM-1156,4/25/2014,0,0,0,0,0,0,0
19658,RM-1156,4/26/2014,0,0,0,0,0,0,0
19659,RM-1156,4/27/2014,0,0,0,0,0,0,0
19660,RM-1156,4/28/2014,0,0,0,0,0,0,0
19661,RM-1156,4/29/2014,0,0,0,0,0,0,0
19662,RM-1156,4/30/2014,0,0,0,0,0,0,0
19663,RM-1156,5/1/2014,0,0,0,0,0,0,0
19664,RM-1156,5/2/2014,0,0,0,0,0,0,0
19665,RM-1156,5/3/2014,0,0,0,0,0,0,0
19666,RM-1156,5/4/2014,0,0,0,0,0,0,0
19667,RM-1156,5/5/2014,0,0,0,0,0,0,0
19668,RM-1156,5/6/2014,0,0,0,0,0,0,0
19669,RM-1156,5/7/2014,0,0,0,0,0,0,0
19670,RM-1156,5/8/2014,0,0,0,0,0,0,0
19671,RM-1156,5/9/2014,0,0,0,0,0,0,0
19672,RM-1156,5/10/2014,0,0,0,0,0,0,0
19673,RM-1156,5/11/2014,0,0,0,0,0,0,0
19674,RM-1156,5/12/2014,0,0,0,0,0,0,0
19675,RM-1156,5/13/2014,0,0,0,0,0,0,0
19676,RM-1156,5/14/2014,0,0,0,0,0,0,0
19677,RM-1156,5/15/2014,0,0,0,0,0,0,0
19678,RM-1156,5/16/2014,0,0,0,0,0,0,0
19679,RM-1156,5/17/2014,0,0,0,0,0,0,0
19680,RM-1156,5/18/2014,0,0,0,0,0,0,0
19681,RM-1156,5/19/2014,0,0,0,0,0,0,0
19682,RM-1156,5/20/2014,0,0,0,0,0,0,0
19683,RM-1156,5/21/2014,0,0,0,0,0,0,0
19684,RM-1156,5/22/2014,0,0,0,0,0,0,0
19685,RM-1156,5/23/2014,0,0,0,0,0,0,0
19686,RM-1156,5/24/2014,0,0,0,0,0,0,0
19687,RM-1156,5/25/2014,0,0,0,0,0,0,0
19688,RM-1156,5/26/2014,0,0,0,0,0,0,0
19689,RM-1156,5/27/2014,0,0,0,0,0,0,0
19690,RM-1156,5/28/2014,0,0,0,0,0,0,0
19691,RM-1156,5/29/2014,0,0,0,0,0,0,0
19692,RM-1156,5/30/2014,0,0,0,0,0,0,0
19693,RM-1156,5/31/2014,0,0,0,0,0,0,0
19694,RM-1156,6/1/2014,0,0,0,0,0,0,0
19695,RM-1156,6/2/2014,0,0,0,0,0,0,0
19696,RM-1156,6/3/2014,0,0,0,0,0,0,0
19697,RM-1156,6/4/2014,0,0,0,0,0,0,0
19698,RM-1156,6/5/2014,0,0,0,0,0,0,0
19699,RM-1156,6/6/2014,0,0,0,0,0,0,0
19700,RM-1156,6/7/2014,0,0,0,0,0,0,0
19701,RM-1156,6/8/2014,0,0,0,0,0,0,0
19702,RM-1156,6/9/2014,0,0,0,0,0,0,0
19703,RM-1156,6/10/2014,0,0,0,0,0,0,0
19704,RM-1156,6/11/2014,0,0,0,0,0,0,0
19705,RM-1156,6/12/2014,0,0,0,0,0,0,0
19706,RM-1156,6/13/2014,0,0,0,0,0,0,0
19707,RM-1156,6/14/2014,0,0,0,0,0,0,0
19708,RM-1156,6/15/2014,0,0,0,0,0,0,0
19709,RM-1156,6/16/2014,0,0,0,0,0,0,0
19710,RM-1156,6/17/2014,0,0,0,0,0,0,0
19711,RM-1156,6/18/2014,0,0,0,0,0,0,0
19712,RM-1156,6/19/2014,0,0,0,0,0,0,0
19713,RM-1156,6/20/2014,0,0,0,0,0,0,0
19714,RM-1156,6/21/2014,0,0,0,0,0,0,0
19715,RM-1156,6/22/2014,0,0,0,0,0,0,0
19716,RM-1156,6/23/2014,0,0,0,0,0,0,0
19717,RM-1156,6/24/2014,0,0,0,0,0,0,0
19718,RM-1156,6/25/2014,0,0,0,0,0,0,0
19719,RM-1156,6/26/2014,0,0,0,0,0,0,0
19720,RM-1156,6/27/2014,0,0,0,0,0,0,0
19721,RM-1156,6/28/2014,0,0,0,0,0,0,0
19722,RM-1156,6/29/2014,0,0,0,0,0,0,0
19723,RM-1156,6/30/2014,0,0,0,0,0,0,0
19724,RM-1156,7/1/2014,0,0,0,0,0,0,0
19725,RM-1156,7/2/2014,0,0,0,0,0,0,0
19726,RM-1156,7/3/2014,0,0,0,0,0,0,0
19727,RM-1156,7/4/2014,0,0,0,0,0,0,0
19728,RM-1156,7/5/2014,0,0,0,0,0,0,0
19729,RM-1156,7/6/2014,0,0,0,0,0,0,0
19730,RM-1156,7/7/2014,0,0,0,0,0,0,0
19731,RM-1156,7/8/2014,0,0,0,0,0,0,0
19732,RM-1156,7/9/2014,0,0,0,0,0,0,0
19733,RM-1156,7/10/2014,0,0,0,0,0,0,0
19734,RM-1156,7/11/2014,0,0,0,0,0,0,0
19735,RM-1156,7/12/2014,0,0,0,0,0,0,0
19736,RM-1156,7/13/2014,0,0,0,0,0,0,0
19737,RM-1156,7/14/2014,0,0,0,0,0,0,0
19738,RM-1156,7/15/2014,0,0,0,0,0,0,0
19739,RM-1156,7/16/2014,0,0,0,0,0,0,0
19740,RM-1156,7/17/2014,0,0,0,0,0,0,0
19741,RM-1156,7/18/2014,0,0,0,0,0,0,0
19742,RM-1156,7/19/2014,0,0,0,0,0,0,0
19743,RM-1156,7/20/2014,0,0,0,0,0,0,0
19744,RM-1156,7/21/2014,0,0,0,0,0,0,0
19745,RM-1156,7/22/2014,0,0,0,0,0,0,0
19746,RM-1156,7/23/2014,0,0,0,0,0,0,0
19747,RM-1156,7/24/2014,0,0,0,0,0,0,0
19748,RM-1156,7/25/2014,0,0,0,0,0,0,0
19749,RM-1156,7/26/2014,0,0,0,0,0,0,0
19750,RM-1156,7/27/2014,0,0,0,0,0,0,0
19751,RM-1156,7/28/2014,0,0,0,0,0,0,0
19752,RM-1156,7/29/2014,0,0,0,0,0,0,0
19753,RM-1156,7/30/2014,0,0,0,0,0,0,0
19754,RM-1156,7/31/2014,0,0,0,0,0,0,0
19755,RM-1156,8/1/2014,0,0,0,0,0,0,0
19756,RM-1156,8/2/2014,0,0,0,0,0,0,0
19757,RM-1156,8/3/2014,0,0,0,0,0,0,0
19758,RM-1156,8/4/2014,0,0,0,0,0,0,0
19759,RM-1156,8/5/2014,0,0,0,0,0,0,0
19760,RM-1156,8/6/2014,0,0,0,0,0,0,0
19761,RM-1156,8/7/2014,0,0,0,0,0,0,0
19762,RM-1156,8/8/2014,0,0,0,0,0,0,0
19763,RM-1156,8/9/2014,0,0,0,0,0,0,0
19764,RM-1156,8/10/2014,0,0,0,0,0,0,0
19765,RM-1156,8/11/2014,0,0,0,0,0,0,0
19766,RM-1156,8/12/2014,0,0,0,0,0,0,0
19767,RM-1156,8/13/2014,0,0,0,0,0,0,0
19768,RM-1156,8/14/2014,0,0,0,0,0,0,0
19769,RM-1156,8/15/2014,0,0,0,0,0,0,0
19770,RM-1156,8/16/2014,0,0,0,0,0,0,0
19771,RM-1156,8/17/2014,0,0,0,0,0,0,0
19772,RM-1156,8/18/2014,0,0,0,0,0,0,0
19773,RM-1156,8/19/2014,0,0,0,0,0,0,0
19774,RM-1156,8/20/2014,0,0,0,0,0,0,0
19775,RM-1156,8/21/2014,0,0,0,0,0,0,0
19776,RM-1156,8/22/2014,0,0,0,0,0,0,0
19777,RM-1156,8/23/2014,0,0,0,0,0,0,0
19778,RM-1156,8/24/2014,0,0,0,0,0,0,0
20057,RM-1200A,8/2/2013,0,0,0,0,0,0,0
20058,RM-1200A,8/3/2013,0,0,0,0,0,0,0
20059,RM-1200A,8/4/2013,0,0,0,0,0,0,0
20060,RM-1200A,8/5/2013,0,0,0,0,0,0,0
20061,RM-1200A,8/6/2013,0,0,0,0,0,0,0
20062,RM-1200A,8/7/2013,0,0,0,0,0,0,0
20063,RM-1200A,8/8/2013,0,0,0,0,0,0,0
20064,RM-1200A,8/9/2013,0,0,0,0,0,0,0
20065,RM-1200A,8/10/2013,0,0,0,0,0,0,0
20066,RM-1200A,8/11/2013,0,0,0,0,0,0,0
20067,RM-1200A,8/12/2013,0,0,0,0,0,0,0
20068,RM-1200A,8/13/2013,0,0,0,0,0,0,0
20069,RM-1200A,8/14/2013,0,0,0,0,0,0,0
20070,RM-1200A,8/15/2013,0,0,0,0,0,0,0
20071,RM-1200A,8/16/2013,0,0,0,0,0,0,0
20072,RM-1200A,8/17/2013,0,0,0,0,0,0,0
20073,RM-1200A,8/18/2013,0,0,0,0,0,0,0
20074,RM-1200A,8/19/2013,0,0,0,0,0,0,0
20075,RM-1200A,8/20/2013,0,0,0,0,0,0,0
20076,RM-1200A,8/21/2013,0,0,0,0,0,0,0
20077,RM-1200A,8/22/2013,0,0,0,0,0,0,0
20078,RM-1200A,8/27/2013,0,0,0,0,0,0,0
20079,RM-1200A,8/28/2013,0,0,0,0,0,0,0
20080,RM-1200A,8/29/2013,0,0,0,0,0,0,0
20081,RM-1200A,8/30/2013,0,0,0,0,0,0,0
20082,RM-1200A,9/4/2013,0,0,0,0,0,0,0
20083,RM-1200A,9/5/2013,0,0,0,0,0,0,0
20084,RM-1200A,9/6/2013,0,0,0,0,0,0,0
20085,RM-1200A,9/7/2013,0,0,0,0,0,0,0
20086,RM-1200A,9/9/2013,0,0,0,0,0,0,0
20087,RM-1200A,9/10/2013,0,0,0,0,0,0,0
20088,RM-1200A,9/11/2013,0,0,0,0,0,0,0
20089,RM-1200A,9/12/2013,0,0,0,0,0,0,0
20090,RM-1200A,9/13/2013,0,0,0,0,0,0,0
20091,RM-1200A,9/14/2013,0,0,0,0,0,0,0
20092,RM-1200A,9/15/2013,0,0,0,0,0,0,0
20093,RM-1200A,9/16/2013,0,0,0,0,0,0,0
20094,RM-1200A,9/17/2013,0,0,0,0,0,0,0
20095,RM-1200A,9/18/2013,0,0,0,0,0,0,0
20096,RM-1200A,9/19/2013,0,0,0,0,0,0,0
20097,RM-1200A,9/20/2013,0,0,0,0,0,0,0
20098,RM-1200A,9/21/2013,0,0,0,0,0,0,0
20099,RM-1200A,9/22/2013,0,0,0,0,0,0,0
20100,RM-1200A,9/23/2013,0,0,0,0,0,0,0
20101,RM-1200A,9/24/2013,0,0,0,0,0,0,0
20102,RM-1200A,9/25/2013,0,0,0,0,0,0,0
20103,RM-1200A,9/26/2013,0,0,0,0,0,0,0
20104,RM-1200A,9/27/2013,0,0,0,0,0,0,0
20105,RM-1200A,9/28/2013,0,0,0,0,0,0,0
20106,RM-1200A,9/29/2013,0,0,0,0,0,0,0
20107,RM-1200A,9/30/2013,0,0,0,0,0,0,0
20108,RM-1200A,10/1/2013,0,0,0,0,0,0,0
20109,RM-1200A,10/2/2013,0,0,0,0,0,0,0
20110,RM-1200A,10/3/2013,0,0,0,0,0,0,0
20111,RM-1200A,10/4/2013,0,0,0,0,0,0,0
20112,RM-1200A,10/5/2013,0,0,0,0,0,0,0
20113,RM-1200A,10/6/2013,0,0,0,0,0,0,0
20114,RM-1200A,10/7/2013,0,0,0,0,0,0,0
20115,RM-1200A,10/8/2013,0,0,0,0,0,0,0
20116,RM-1200A,10/9/2013,0,0,0,0,0,0,0
20117,RM-1200A,10/10/2013,0,0,0,0,0,0,0
20118,RM-1200A,10/11/2013,0,0,0,0,0,0,0
20119,RM-1200A,10/12/2013,0,0,0,0,0,0,0
20120,RM-1200A,10/13/2013,0,0,0,0,0,0,0
20121,RM-1200A,10/14/2013,0,0,0,0,0,0,0
20122,RM-1200A,10/15/2013,0,0,0,0,0,0,0
20123,RM-1200A,10/16/2013,0,0,0,0,0,0,0
20124,RM-1200A,10/17/2013,0,0,0,0,0,0,0
20125,RM-1200A,10/18/2013,0,0,0,0,0,0,0
20126,RM-1200A,10/19/2013,0,0,0,0,0,0,0
20127,RM-1200A,10/20/2013,0,0,0,0,0,0,0
20128,RM-1200A,10/21/2013,0,0,0,0,0,0,0
20129,RM-1200A,10/22/2013,0,0,0,0,0,0,0
20130,RM-1200A,10/23/2013,0,0,0,0,0,0,0
20131,RM-1200A,10/24/2013,0,0,0,0,0,0,0
20132,RM-1200A,10/25/2013,0,0,0,0,0,0,0
20133,RM-1200A,10/26/2013,0,0,0,0,0,0,0
20134,RM-1200A,10/27/2013,0,0,0,0,0,0,0
20135,RM-1200A,10/28/2013,0,0,0,0,0,0,0
20136,RM-1200A,10/29/2013,0,0,0,0,0,0,0
20137,RM-1200A,10/30/2013,0,0,0,0,0,0,0
20138,RM-1200A,10/31/2013,0,0,0,0,0,0,0
20139,RM-1200A,11/1/2013,0,0,0,0,0,0,0
20140,RM-1200A,11/2/2013,0,0,0,0,0,0,0
20141,RM-1200A,11/3/2013,0,0,0,0,0,0,0
20142,RM-1200A,11/4/2013,0,0,0,0,0,0,0
20143,RM-1200A,11/5/2013,0,0,0,0,0,0,0
20144,RM-1200A,11/6/2013,0,0,0,0,0,0,0
20145,RM-1200A,11/7/2013,0,0,0,0,0,0,0
20146,RM-1200A,11/8/2013,0,0,0,0,0,0,0
20147,RM-1200A,11/9/2013,0,0,0,0,0,0,0
20148,RM-1200A,11/10/2013,0,0,0,0,0,0,0
20149,RM-1200A,11/11/2013,0,0,0,0,0,0,0
20150,RM-1200A,11/12/2013,0,0,0,0,0,0,0
20151,RM-1200A,11/13/2013,0,0,0,0,0,0,0
20152,RM-1200A,11/14/2013,0,0,0,0,0,0,0
20153,RM-1200A,11/15/2013,0,0,0,0,0,0,0
20154,RM-1200A,11/19/2013,0,0,0,0,0,0,0
20155,RM-1200A,11/20/2013,0,0,0,0,0,0,0
20156,RM-1200A,11/21/2013,0,0,0,0,0,0,0
20157,RM-1200A,11/22/2013,0,0,0,0,0,0,0
20158,RM-1200A,11/23/2013,0,0,0,0,0,0,0
20159,RM-1200A,11/24/2013,0,0,0,0,0,0,0
20160,RM-1200A,11/25/2013,0,0,0,0,0,0,0
20161,RM-1200A,11/26/2013,0,0,0,0,0,0,0
20162,RM-1200A,11/27/2013,0,0,0,0,0,0,0
20163,RM-1200A,11/28/2013,0,0,0,0,0,0,0
20164,RM-1200A,11/29/2013,0,0,0,0,0,0,0
20165,RM-1200A,11/30/2013,0,0,0,0,0,0,0
20166,RM-1200A,12/1/2013,0,0,0,0,0,0,0
20167,RM-1200A,12/2/2013,0,0,0,0,0,0,0
20168,RM-1200A,12/3/2013,0,0,0,0,0,0,0
20169,RM-1200A,12/4/2013,0,0,0,0,0,0,0
20170,RM-1200A,12/5/2013,0,0,0,0,0,0,0
20171,RM-1200A,12/6/2013,0,0,0,0,0,0,0
20172,RM-1200A,12/7/2013,0,0,0,0,0,0,0
20173,RM-1200A,12/8/2013,0,0,0,0,0,0,0
20174,RM-1200A,12/9/2013,0,0,0,0,0,0,0
20175,RM-1200A,12/10/2013,0,0,0,0,0,0,0
20176,RM-1200A,12/11/2013,0,0,0,0,0,0,0
20177,RM-1200A,12/12/2013,0,0,0,0,0,0,0
20178,RM-1200A,12/13/2013,0,0,0,0,0,0,0
20179,RM-1200A,12/14/2013,0,0,0,0,0,0,0
20180,RM-1200A,12/15/2013,0,0,0,0,0,0,0
20181,RM-1200A,12/16/2013,0,0,0,0,0,0,0
20182,RM-1200A,12/17/2013,0,0,0,0,0,0,0
20183,RM-1200A,12/18/2013,0,0,0,0,0,0,0
20184,RM-1200A,12/19/2013,0,0,0,0,0,0,0
20185,RM-1200A,12/20/2013,0,0,0,0,0,0,0
20186,RM-1200A,12/21/2013,0,0,0,0,0,0,0
20187,RM-1200A,12/22/2013,0,0,0,0,0,0,0
20188,RM-1200A,12/23/2013,0,0,0,0,0,0,0
20189,RM-1200A,12/24/2013,0,0,0,0,0,0,0
20190,RM-1200A,12/25/2013,0,0,0,0,0,0,0
20191,RM-1200A,12/26/2013,0,0,0,0,0,0,0
20192,RM-1200A,12/27/2013,0,0,0,0,0,0,0
20193,RM-1200A,12/28/2013,0,0,0,0,0,0,0
20194,RM-1200A,12/29/2013,0,0,0,0,0,0,0
20195,RM-1200A,12/30/2013,0,0,0,0,0,0,0
20196,RM-1200A,12/31/2013,0,0,0,0,0,0,0
20197,RM-1200A,1/1/2014,0,0,0,0,0,0,0
20198,RM-1200A,1/2/2014,0,0,0,0,0,0,0
20199,RM-1200A,1/3/2014,0,0,0,0,0,0,0
20200,RM-1200A,1/4/2014,0,0,0,0,0,0,0
20201,RM-1200A,1/5/2014,0,0,0,0,0,0,0
20202,RM-1200A,1/6/2014,0,0,0,0,0,0,0
20203,RM-1200A,1/7/2014,0,0,0,0,0,0,0
20204,RM-1200A,1/8/2014,0,0,0,0,0,0,0
20205,RM-1200A,1/9/2014,0,0,0,0,0,0,0
20206,RM-1200A,1/10/2014,0,0,0,0,0,0,0
20207,RM-1200A,1/11/2014,0,0,0,0,0,0,0
20208,RM-1200A,1/12/2014,0,0,0,0,0,0,0
20209,RM-1200A,1/13/2014,0,0,0,0,0,0,0
20210,RM-1200A,1/14/2014,0,0,0,0,0,0,0
20211,RM-1200A,1/15/2014,0,0,0,0,0,0,0
20380,RM-1200A,7/3/2014,0,0,0,0,0,0,0
20381,RM-1200A,7/4/2014,0,0,0,0,0,0,0
20382,RM-1200A,7/5/2014,0,0,0,0,0,0,0
20383,RM-1200A,7/6/2014,0,0,0,0,0,0,0
20384,RM-1200A,7/7/2014,0,0,0,0,0,0,0
20385,RM-1200A,7/8/2014,0,0,0,0,0,0,0
20386,RM-1200A,7/9/2014,0,0,0,0,0,0,0
20387,RM-1200A,7/10/2014,0,0,0,0,0,0,0
20388,RM-1200A,7/11/2014,0,0,0,0,0,0,0
20389,RM-1200A,7/12/2014,0,0,0,0,0,0,0
20390,RM-1200A,7/13/2014,0,0,0,0,0,0,0
20391,RM-1200A,7/14/2014,0,0,0,0,0,0,0
20392,RM-1200A,7/15/2014,0,0,0,0,0,0,0
20393,RM-1200A,7/16/2014,0,0,0,0,0,0,0
20394,RM-1200A,7/17/2014,0,0,0,0,0,0,0
20395,RM-1200A,7/18/2014,0,0,0,0,0,0,0
20396,RM-1200A,7/19/2014,0,0,0,0,0,0,0
20397,RM-1200A,7/20/2014,0,0,0,0,0,0,0
20398,RM-1200A,7/21/2014,0,0,0,0,0,0,0
20399,RM-1200A,7/22/2014,0,0,0,0,0,0,0
20400,RM-1200A,7/23/2014,0,0,0,0,0,0,0
20401,RM-1200A,7/24/2014,0,0,0,0,0,0,0
20402,RM-1200A,7/25/2014,0,0,0,0,0,0,0
20403,RM-1200A,7/26/2014,0,0,0,0,0,0,0
20404,RM-1200A,7/27/2014,0,0,0,0,0,0,0
20405,RM-1200A,7/28/2014,0,0,0,0,0,0,0
20406,RM-1200A,7/29/2014,0,0,0,0,0,0,0
20407,RM-1200A,7/30/2014,0,0,0,0,0,0,0
20408,RM-1200A,7/31/2014,0,0,0,0,0,0,0
20409,RM-1200A,8/1/2014,0,0,0,0,0,0,0
20410,RM-1200A,8/2/2014,0,0,0,0,0,0,0
20411,RM-1200A,8/3/2014,0,0,0,0,0,0,0
20412,RM-1200A,8/4/2014,0,0,0,0,0,0,0
20413,RM-1200A,8/5/2014,0,0,0,0,0,0,0
20414,RM-1200A,8/6/2014,0,0,0,0,0,0,0
20415,RM-1200A,8/7/2014,0,0,0,0,0,0,0
20416,RM-1200A,8/8/2014,0,0,0,0,0,0,0
20417,RM-1200A,8/9/2014,0,0,0,0,0,0,0
20418,RM-1200A,8/10/2014,0,0,0,0,0,0,0
20419,RM-1200A,8/11/2014,0,0,0,0,0,0,0
20420,RM-1200A,8/12/2014,0,0,0,0,0,0,0
20421,RM-1200A,8/13/2014,0,0,0,0,0,0,0
20422,RM-1200A,8/14/2014,0,0,0,0,0,0,0
20423,RM-1200A,8/15/2014,0,0,0,0,0,0,0
20424,RM-1200A,8/16/2014,0,0,0,0,0,0,0
20425,RM-1200A,8/17/2014,0,0,0,0,0,0,0
20426,RM-1200A,8/18/2014,0,0,0,0,0,0,0
20427,RM-1200A,8/19/2014,0,0,0,0,0,0,0
20428,RM-1200A,8/20/2014,0,0,0,0,0,0,0
20429,RM-1200A,8/21/2014,0,0,0,0,0,0,0
20430,RM-1200A,8/22/2014,0,0,0,0,0,0,0
20431,RM-1200A,8/23/2014,0,0,0,0,0,0,0
20432,RM-1200A,8/24/2014,0,0,0,0,0,0,0
20433,RM-1200A,8/25/2014,0,0,0,0,0,0,0
20434,RM-1200A,8/26/2014,0,0,0,0,0,0,0
20435,RM-1200A,8/27/2014,0,0,0,0,0,0,0
20436,RM-1200A,8/28/2014,0,0,0,0,0,0,0
20437,RM-1200A,8/29/2014,0,0,0,0,0,0,0
20438,RM-1200A,8/30/2014,0,0,0,0,0,0,0
20439,RM-1200A,8/31/2014,0,0,0,0,0,0,0
20440,RM-1200A,9/1/2014,0,0,0,0,0,0,0
20441,RM-1200A,9/2/2014,0,0,0,0,0,0,0
20442,RM-1200A,9/3/2014,0,0,0,0,0,0,0
20443,RM-1200A,9/4/2014,0,0,0,0,0,0,0
20444,RM-1200A,9/5/2014,0,0,0,0,0,0,0
20445,RM-1200A,9/6/2014,0,0,0,0,0,0,0
20446,RM-1200A,9/7/2014,0,0,0,0,0,0,0
20447,RM-1200A,9/8/2014,0,0,0,0,0,0,0
20448,RM-1200A,9/9/2014,0,0,0,0,0,0,0
20449,RM-1200A,9/10/2014,0,0,0,0,0,0,0
20450,RM-1200A,9/11/2014,0,0,0,0,0,0,0
20451,RM-1200A,9/12/2014,0,0,0,0,0,0,0
20452,RM-1200A,9/13/2014,0,0,0,0,0,0,0
20453,RM-1200A,9/14/2014,0,0,0,0,0,0,0
20454,RM-1200A,9/15/2014,0,0,0,0,0,0,0
20455,RM-1200A,9/16/2014,0,0,0,0,0,0,0
20456,RM-1200A,9/17/2014,0,0,0,0,0,0,0
20457,RM-1200A,9/18/2014,0,0,0,0,0,0,0
20458,RM-1200A,9/19/2014,0,0,0,0,0,0,0
20459,RM-1200A,9/20/2014,0,0,0,0,0,0,0
20460,RM-1200A,9/21/2014,0,0,0,0,0,0,0
20461,RM-1200A,9/22/2014,0,0,0,0,0,0,0
20462,RM-1200A,9/23/2014,0,0,0,0,0,0,0
20463,RM-1200A,9/24/2014,0,0,0,0,0,0,0
20464,RM-1200A,9/25/2014,0,0,0,0,0,0,0
20465,RM-1200A,9/28/2014,0,0,0,0,0,0,0
20466,RM-1200A,9/29/2014,0,0,0,0,0,0,0
20467,RM-1200A,9/30/2014,0,0,0,0,0,0,0
20468,RM-1200A,10/1/2014,0,0,0,0,0,0,0
20469,RM-1200A,10/2/2014,0,0,0,0,0,0,0
20470,RM-1200A,10/3/2014,0,0,0,0,0,0,0
20471,RM-1200A,10/4/2014,0,0,0,0,0,0,0
20472,RM-1200A,10/5/2014,0,0,0,0,0,0,0
20473,RM-1200A,10/6/2014,0,0,0,0,0,0,0
20474,RM-1200A,10/7/2014,0,0,0,0,0,0,0
20475,RM-1200A,10/8/2014,0,0,0,0,0,0,0
20476,RM-1200A,10/9/2014,0,0,0,0,0,0,0
20477,RM-1200A,10/10/2014,0,0,0,0,0,0,0
20478,RM-1200A,10/11/2014,0,0,0,0,0,0,0
20479,RM-1200A,10/12/2014,0,0,0,0,0,0,0
20480,RM-1200A,10/13/2014,0,0,0,0,0,0,0
20481,RM-1200A,10/14/2014,0,0,0,0,0,0,0
20482,RM-1200A,10/15/2014,0,0,0,0,0,0,0
20483,RM-1200A,10/16/2014,0,0,0,0,0,0,0
20484,RM-1200A,10/17/2014,0,0,0,0,0,0,0
20485,RM-1200A,10/18/2014,0,0,0,0,0,0,0
20486,RM-1200A,10/19/2014,0,0,0,0,0,0,0
20487,RM-1200A,10/20/2014,0,0,0,0,0,0,0
20488,RM-1200A,10/21/2014,0,0,0,0,0,0,0
20489,RM-1200A,10/22/2014,0,0,0,0,0,0,0
20490,RM-1200A,10/23/2014,0,0,0,0,0,0,0
20491,RM-1200A,10/24/2014,0,0,0,0,0,0,0
20492,RM-1200A,10/25/2014,0,0,0,0,0,0,0
20493,RM-1200A,10/26/2014,0,0,0,0,0,0,0
20494,RM-1200A,10/27/2014,0,0,0,0,0,0,0
20495,RM-1200A,10/28/2014,0,0,0,0,0,0,0
20496,RM-1200A,10/29/2014,0,0,0,0,0,0,0
20497,RM-1200A,10/30/2014,0,0,0,0,0,0,0
20498,RM-1200A,10/31/2014,0,0,0,0,0,0,0
20499,RM-1200A,11/1/2014,0,0,0,0,0,0,0
20500,RM-1200A,11/2/2014,0,0,0,0,0,0,0
20501,RM-1200A,11/3/2014,0,0,0,0,0,0,0
20502,RM-1200A,11/4/2014,0,0,0,0,0,0,0
20503,RM-1200A,11/5/2014,0,0,0,0,0,0,0
20504,RM-1200A,11/6/2014,0,0,0,0,0,0,0
20505,RM-1200A,11/7/2014,0,0,0,0,0,0,0
20506,RM-1200A,11/8/2014,0,0,0,0,0,0,0
20507,RM-1200A,11/9/2014,0,0,0,0,0,0,0
20508,RM-1200A,11/10/2014,0,0,0,0,0,0,0
20509,RM-1200A,11/11/2014,0,0,0,0,0,0,0
20510,RM-1200A,11/12/2014,0,0,0,0,0,0,0
20511,RM-1200A,11/13/2014,0,0,0,0,0,0,0
20512,RM-1200A,11/14/2014,0,0,0,0,0,0,0
20513,RM-1200A,11/15/2014,0,0,0,0,0,0,0
20514,RM-1200A,11/16/2014,0,0,0,0,0,0,0
20515,RM-1200A,11/17/2014,0,0,0,0,0,0,0
20516,RM-1200A,11/18/2014,0,0,0,0,0,0,0
20517,RM-1200A,11/19/2014,0,0,0,0,0,0,0
20518,RM-1200A,11/20/2014,0,0,0,0,0,0,0
20519,RM-1200A,11/21/2014,0,0,0,0,0,0,0
20520,RM-1200A,11/22/2014,0,0,0,0,0,0,0
20521,RM-1200A,11/23/2014,0,0,0,0,0,0,0
20522,RM-1200A,11/24/2014,0,0,0,0,0,0,0
20523,RM-1200A,11/25/2014,0,0,0,0,0,0,0
20524,RM-1200A,11/26/2014,0,0,0,0,0,0,0
20525,RM-1200A,11/27/2014,0,0,0,0,0,0,0
20526,RM-1200A,11/28/2014,0,0,0,0,0,0,0
20527,RM-1200A,11/29/2014,0,0,0,0,0,0,0
20528,RM-1200A,11/30/2014,0,0,0,0,0,0,0
20529,RM-1200A,12/1/2014,0,0,0,0,0,0,0
20530,RM-1200A,12/2/2014,0,0,0,0,0,0,0
20531,RM-1200A,12/3/2014,0,0,0,0,0,0,0
20532,RM-1200A,12/4/2014,0,0,0,0,0,0,0
20533,RM-1200A,12/5/2014,0,0,0,0,0,0,0
20534,RM-1200A,12/6/2014,0,0,0,0,0,0,0
20535,RM-1200A,12/7/2014,0,0,0,0,0,0,0
20536,RM-1200A,12/8/2014,0,0,0,0,0,0,0
20537,RM-1200A,12/9/2014,0,0,0,0,0,0,0
20538,RM-1200A,12/10/2014,0,0,0,0,0,0,0
20539,RM-1200A,12/11/2014,0,0,0,0,0,0,0
20540,RM-1200A,12/12/2014,0,0,0,0,0,0,0
20541,RM-1200A,12/13/2014,0,0,0,0,0,0,0
20542,RM-1200A,12/14/2014,0,0,0,0,0,0,0
20543,RM-1200A,12/15/2014,0,0,0,0,0,0,0
20544,RM-1200A,12/16/2014,0,0,0,0,0,0,0
20545,RM-1200A,12/17/2014,0,0,0,0,0,0,0
20546,RM-1200A,12/18/2014,0,0,0,0,0,0,0
20547,RM-1200A,12/19/2014,0,0,0,0,0,0,0
20548,RM-1200A,12/20/2014,0,0,0,0,0,0,0
20549,RM-1200A,12/21/2014,0,0,0,0,0,0,0
20550,RM-1200A,12/22/2014,0,0,0,0,0,0,0
20551,RM-1200A,12/23/2014,0,0,0,0,0,0,0
20552,RM-1200A,12/24/2014,0,0,0,0,0,0,0
20553,RM-1200A,12/25/2014,0,0,0,0,0,0,0
20554,RM-1200A,12/26/2014,0,0,0,0,0,0,0
20555,RM-1200A,12/27/2014,0,0,0,0,0,0,0
20556,RM-1200A,12/28/2014,0,0,0,0,0,0,0
20557,RM-1200A,12/29/2014,0,0,0,0,0,0,0
20558,RM-1200A,12/30/2014,0,0,0,0,0,0,0
20559,RM-1200A,12/31/2014,0,0,0,0,0,0,0
20560,RM-1200A,1/1/2015,0,0,0,0,0,0,0
20561,RM-1200A,1/2/2015,0,0,0,0,0,0,0
20562,RM-1200A,1/3/2015,0,0,0,0,0,0,0
20563,RM-1200A,1/4/2015,0,0,0,0,0,0,0
20564,RM-1200A,1/5/2015,0,0,0,0,0,0,0
20565,RM-1200A,1/6/2015,0,0,0,0,0,0,0
20566,RM-1200A,1/7/2015,0,0,0,0,0,0,0
20567,RM-1200A,1/8/2015,0,0,0,0,0,0,0
20568,RM-1200A,1/9/2015,0,0,0,0,0,0,0
20569,RM-1200A,1/10/2015,0,0,0,0,0,0,0
20570,RM-1200A,1/11/2015,0,0,0,0,0,0,0
20571,RM-1200A,1/12/2015,0,0,0,0,0,0,0
20572,RM-1200A,1/13/2015,0,0,0,0,0,0,0
20573,RM-1200A,1/14/2015,0,0,0,0,0,0,0
20574,RM-1200A,1/15/2015,0,0,0,0,0,0,0
20575,RM-1200A,1/16/2015,0,0,0,0,0,0,0
20576,RM-1200A,1/17/2015,0,0,0,0,0,0,0
20577,RM-1200A,1/18/2015,0,0,0,0,0,0,0
20578,RM-1200A,1/19/2015,0,0,0,0,0,0,0
20579,RM-1200A,1/20/2015,0,0,0,0,0,0,0
20580,RM-1200A,1/21/2015,0,0,0,0,0,0,0
20581,RM-1200A,1/22/2015,0,0,0,0,0,0,0
20582,RM-1200A,1/23/2015,0,0,0,0,0,0,0
20583,RM-1200A,1/24/2015,0,0,0,0,0,0,0
20584,RM-1200A,1/25/2015,0,0,0,0,0,0,0
20585,RM-1200A,1/26/2015,0,0,0,0,0,0,0
20586,RM-1200A,1/27/2015,0,0,0,0,0,0,0
20587,RM-1200A,1/28/2015,0,0,0,0,0,0,0
20588,RM-1200A,1/29/2015,0,0,0,0,0,0,0
20589,RM-1200A,1/30/2015,0,0,0,0,0,0,0
20590,RM-1200A,1/31/2015,0,0,0,0,0,0,0
20591,RM-1200A,2/1/2015,0,0,0,0,0,0,0
20592,RM-1200A,2/2/2015,0,0,0,0,0,0,0
20593,RM-1200A,2/3/2015,0,0,0,0,0,0,0
20594,RM-1200A,2/4/2015,0,0,0,0,0,0,0
20595,RM-1200A,2/5/2015,0,0,0,0,0,0,0
20596,RM-1200A,2/6/2015,0,0,0,0,0,0,0
20597,RM-1200A,2/7/2015,0,0,0,0,0,0,0
20598,RM-1200A,2/8/2015,0,0,0,0,0,0,0
20599,RM-1200A,2/9/2015,0,0,0,0,0,0,0
20600,RM-1200A,2/10/2015,0,0,0,0,0,0,0
20601,RM-1200A,2/11/2015,0,0,0,0,0,0,0
20602,RM-1200A,2/12/2015,0,0,0,0,0,0,0
20603,RM-1200A,2/13/2015,0,0,0,0,0,0,0
20604,RM-1200A,2/14/2015,0,0,0,0,0,0,0
20605,RM-1200A,2/15/2015,0,0,0,0,0,0,0
20606,RM-1200A,2/16/2015,0,0,0,0,0,0,0
20607,RM-1200A,2/17/2015,0,0,0,0,0,0,0
20608,RM-1200A,2/18/2015,0,0,0,0,0,0,0
20609,RM-1200A,2/19/2015,0,0,0,0,0,0,0
20610,RM-1200A,2/20/2015,0,0,0,0,0,0,0
20611,RM-1200A,2/21/2015,0,0,0,0,0,0,0
20612,RM-1200A,2/22/2015,0,0,0,0,0,0,0
20613,RM-1200A,2/23/2015,0,0,0,0,0,0,0
20614,RM-1200A,2/24/2015,0,0,0,0,0,0,0
20615,RM-1200A,2/25/2015,0,0,0,0,0,0,0
20616,RM-1200A,2/26/2015,0,0,0,0,0,0,0
20617,RM-1200A,2/27/2015,0,0,0,0,0,0,0
20618,RM-1200A,2/28/2015,0,0,0,0,0,0,0
20619,RM-1200A,3/1/2015,0,0,0,0,0,0,0
20620,RM-1200A,3/2/2015,0,0,0,0,0,0,0
20621,RM-1200A,3/3/2015,0,0,0,0,0,0,0
20622,RM-1200A,3/4/2015,0,0,0,0,0,0,0
20623,RM-1200A,3/5/2015,0,0,0,0,0,0,0
20624,RM-1200A,3/6/2015,0,0,0,0,0,0,0
20625,RM-1200A,3/7/2015,0,0,0,0,0,0,0
20626,RM-1200A,3/8/2015,0,0,0,0,0,0,0
20627,RM-1200A,3/9/2015,0,0,0,0,0,0,0
20628,RM-1200A,3/10/2015,0,0,0,0,0,0,0
20629,RM-1200A,3/11/2015,0,0,0,0,0,0,0
20630,RM-1200A,3/12/2015,0,0,0,0,0,0,0
20631,RM-1200A,3/13/2015,0,0,0,0,0,0,0
20632,RM-1200A,3/14/2015,0,0,0,0,0,0,0
20633,RM-1200A,3/15/2015,0,0,0,0,0,0,0
20634,RM-1200A,3/16/2015,0,0,0,0,0,0,0
20635,RM-1200A,3/17/2015,0,0,0,0,0,0,0
20636,RM-1200A,3/18/2015,0,0,0,0,0,0,0
20637,RM-1200A,3/19/2015,0,0,0,0,0,0,0
20638,RM-1200A,3/20/2015,0,0,0,0,0,0,0
20639,RM-1200A,3/21/2015,0,0,0,0,0,0,0
20640,RM-1200A,3/22/2015,0,0,0,0,0,0,0
20641,RM-1200A,3/23/2015,0,0,0,0,0,0,0
20642,RM-1200A,3/24/2015,0,0,0,0,0,0,0
20643,RM-1200A,3/25/2015,0,0,0,0,0,0,0
20644,RM-1200A,3/26/2015,0,0,0,0,0,0,0
20645,RM-1200A,3/27/2015,0,0,0,0,0,0,0
20646,RM-1200A,3/28/2015,0,0,0,0,0,0,0
20647,RM-1200A,3/29/2015,0,0,0,0,0,0,0
20648,RM-1200A,3/30/2015,0,0,0,0,0,0,0
20649,RM-1200A,3/31/2015,0,0,0,0,0,0,0
20650,RM-1200A,4/1/2015,0,0,0,0,0,0,0
20651,RM-1200A,4/2/2015,0,0,0,0,0,0,0
20652,RM-1200A,4/3/2015,0,0,0,0,0,0,0
20653,RM-1200A,4/4/2015,0,0,0,0,0,0,0
20654,RM-1200A,4/5/2015,0,0,0,0,0,0,0
20655,RM-1200A,4/6/2015,0,0,0,0,0,0,0
20656,RM-1200A,4/7/2015,0,0,0,0,0,0,0
20657,RM-1200A,4/8/2015,0,0,0,0,0,0,0
20658,RM-1200A,4/9/2015,0,0,0,0,0,0,0
20659,RM-1200A,4/10/2015,0,0,0,0,0,0,0
20660,RM-1200A,4/11/2015,0,0,0,0,0,0,0
20661,RM-1200A,4/12/2015,0,0,0,0,0,0,0
20662,RM-1200A,4/13/2015,0,0,0,0,0,0,0
20663,RM-1200A,4/14/2015,0,0,0,0,0,0,0
20664,RM-1200A,4/15/2015,0,0,0,0,0,0,0
20665,RM-1200A,4/16/2015,0,0,0,0,0,0,0
20666,RM-1200A,4/17/2015,0,0,0,0,0,0,0
20667,RM-1200A,4/18/2015,0,0,0,0,0,0,0
20668,RM-1200A,4/19/2015,0,0,0,0,0,0,0
20669,RM-1200A,4/20/2015,0,0,0,0,0,0,0
20670,RM-1200A,4/21/2015,0,0,0,0,0,0,0
20671,RM-1200A,4/22/2015,0,0,0,0,0,0,0
20672,RM-1200A,4/23/2015,0,0,0,0,0,0,0
20673,RM-1200A,4/24/2015,0,0,0,0,0,0,0
20674,RM-1200A,4/25/2015,0,0,0,0,0,0,0
20675,RM-1200A,4/26/2015,0,0,0,0,0,0,0
20676,RM-1200A,4/27/2015,0,0,0,0,0,0,0
20677,RM-1200A,4/28/2015,0,0,0,0,0,0,0
20678,RM-1200A,4/29/2015,0,0,0,0,0,0,0
20679,RM-1200A,4/30/2015,0,0,0,0,0,0,0
20812,RM-1200B,11/11/2013,0,0,0,0,0,0,0
20813,RM-1200B,11/12/2013,0,0,0,0,0,0,0
20814,RM-1200B,11/13/2013,0,0,0,0,0,0,0
20815,RM-1200B,11/14/2013,0,0,0,0,0,0,0
20816,RM-1200B,11/15/2013,0,0,0,0,0,0,0
20817,RM-1200B,11/19/2013,0,0,0,0,0,0,0
20818,RM-1200B,11/20/2013,0,0,0,0,0,0,0
20819,RM-1200B,11/21/2013,0,0,0,0,0,0,0
20820,RM-1200B,11/22/2013,0,0,0,0,0,0,0
20821,RM-1200B,11/23/2013,0,0,0,0,0,0,0
20822,RM-1200B,11/24/2013,0,0,0,0,0,0,0
20823,RM-1200B,11/25/2013,0,0,0,0,0,0,0
20824,RM-1200B,11/26/2013,0,0,0,0,0,0,0
20825,RM-1200B,11/27/2013,0,0,0,0,0,0,0
20826,RM-1200B,11/28/2013,0,0,0,0,0,0,0
20827,RM-1200B,11/29/2013,0,0,0,0,0,0,0
20828,RM-1200B,11/30/2013,0,0,0,0,0,0,0
20829,RM-1200B,12/1/2013,0,0,0,0,0,0,0
20830,RM-1200B,12/2/2013,0,0,0,0,0,0,0
20831,RM-1200B,12/3/2013,0,0,0,0,0,0,0
20832,RM-1200B,12/4/2013,0,0,0,0,0,0,0
20833,RM-1200B,12/5/2013,0,0,0,0,0,0,0
20834,RM-1200B,12/6/2013,0,0,0,0,0,0,0
20835,RM-1200B,12/7/2013,0,0,0,0,0,0,0
20836,RM-1200B,12/8/2013,0,0,0,0,0,0,0
20837,RM-1200B,12/9/2013,0,0,0,0,0,0,0
20838,RM-1200B,12/10/2013,0,0,0,0,0,0,0
20839,RM-1200B,12/11/2013,0,0,0,0,0,0,0
20840,RM-1200B,12/12/2013,0,0,0,0,0,0,0
20841,RM-1200B,12/13/2013,0,0,0,0,0,0,0
20842,RM-1200B,12/14/2013,0,0,0,0,0,0,0
20843,RM-1200B,12/15/2013,0,0,0,0,0,0,0
20844,RM-1200B,12/16/2013,0,0,0,0,0,0,0
20845,RM-1200B,12/17/2013,0,0,0,0,0,0,0
20846,RM-1200B,12/18/2013,0,0,0,0,0,0,0
20847,RM-1200B,12/19/2013,0,0,0,0,0,0,0
20848,RM-1200B,12/20/2013,0,0,0,0,0,0,0
20849,RM-1200B,12/21/2013,0,0,0,0,0,0,0
20850,RM-1200B,12/22/2013,0,0,0,0,0,0,0
20851,RM-1200B,12/23/2013,0,0,0,0,0,0,0
20852,RM-1200B,12/24/2013,0,0,0,0,0,0,0
20853,RM-1200B,12/25/2013,0,0,0,0,0,0,0
20854,RM-1200B,12/26/2013,0,0,0,0,0,0,0
20855,RM-1200B,12/27/2013,0,0,0,0,0,0,0
20856,RM-1200B,12/28/2013,0,0,0,0,0,0,0
20857,RM-1200B,12/29/2013,0,0,0,0,0,0,0
20858,RM-1200B,12/30/2013,0,0,0,0,0,0,0
20859,RM-1200B,12/31/2013,0,0,0,0,0,0,0
20860,RM-1200B,1/1/2014,0,0,0,0,0,0,0
20861,RM-1200B,1/2/2014,0,0,0,0,0,0,0
20862,RM-1200B,1/3/2014,0,0,0,0,0,0,0
20863,RM-1200B,1/4/2014,0,0,0,0,0,0,0
20864,RM-1200B,1/5/2014,0,0,0,0,0,0,0
20865,RM-1200B,1/6/2014,0,0,0,0,0,0,0
20866,RM-1200B,1/7/2014,0,0,0,0,0,0,0
20868,RM-1200B,1/9/2014,0,0,0,0,0,0,0
20872,RM-1200B,1/13/2014,0,0,0,0,0,0,0
20873,RM-1200B,1/14/2014,0,0,0,0,0,0,0
21001,RM-1200B,5/22/2014,0,0,0,0,0,0,0
21002,RM-1200B,5/23/2014,0,0,0,0,0,0,0
21003,RM-1200B,5/24/2014,0,0,0,0,0,0,0
21004,RM-1200B,5/25/2014,0,0,0,0,0,0,0
21005,RM-1200B,5/26/2014,0,0,0,0,0,0,0
21006,RM-1200B,5/27/2014,0,0,0,0,0,0,0
21007,RM-1200B,5/28/2014,0,0,0,0,0,0,0
21008,RM-1200B,5/29/2014,0,0,0,0,0,0,0
21009,RM-1200B,5/30/2014,0,0,0,0,0,0,0
21010,RM-1200B,5/31/2014,0,0,0,0,0,0,0
21011,RM-1200B,6/1/2014,0,0,0,0,0,0,0
21012,RM-1200B,6/2/2014,0,0,0,0,0,0,0
21013,RM-1200B,6/3/2014,0,0,0,0,0,0,0
21014,RM-1200B,6/4/2014,0,0,0,0,0,0,0
21015,RM-1200B,6/5/2014,0,0,0,0,0,0,0
21016,RM-1200B,6/6/2014,0,0,0,0,0,0,0
21017,RM-1200B,6/7/2014,0,0,0,0,0,0,0
21018,RM-1200B,6/8/2014,0,0,0,0,0,0,0
21019,RM-1200B,6/9/2014,0,0,0,0,0,0,0
21020,RM-1200B,6/10/2014,0,0,0,0,0,0,0
21021,RM-1200B,6/11/2014,0,0,0,0,0,0,0
21022,RM-1200B,6/12/2014,0,0,0,0,0,0,0
21023,RM-1200B,6/13/2014,0,0,0,0,0,0,0
21024,RM-1200B,6/14/2014,0,0,0,0,0,0,0
21025,RM-1200B,6/15/2014,0,0,0,0,0,0,0
21026,RM-1200B,6/16/2014,0,0,0,0,0,0,0
21027,RM-1200B,6/17/2014,0,0,0,0,0,0,0
21028,RM-1200B,6/18/2014,0,0,0,0,0,0,0
21029,RM-1200B,6/19/2014,0,0,0,0,0,0,0
21030,RM-1200B,6/20/2014,0,0,0,0,0,0,0
21031,RM-1200B,6/21/2014,0,0,0,0,0,0,0
21032,RM-1200B,6/22/2014,0,0,0,0,0,0,0
21033,RM-1200B,6/23/2014,0,0,0,0,0,0,0
21034,RM-1200B,6/24/2014,0,0,0,0,0,0,0
21035,RM-1200B,6/25/2014,0,0,0,0,0,0,0
21036,RM-1200B,6/26/2014,0,0,0,0,0,0,0
21037,RM-1200B,6/27/2014,0,0,0,0,0,0,0
21038,RM-1200B,6/28/2014,0,0,0,0,0,0,0
21039,RM-1200B,6/29/2014,0,0,0,0,0,0,0
21040,RM-1200B,6/30/2014,0,0,0,0,0,0,0
21041,RM-1200B,7/1/2014,0,0,0,0,0,0,0
21042,RM-1200B,7/2/2014,0,0,0,0,0,0,0
21043,RM-1200B,7/3/2014,0,0,0,0,0,0,0
21044,RM-1200B,7/4/2014,0,0,0,0,0,0,0
21045,RM-1200B,7/5/2014,0,0,0,0,0,0,0
21046,RM-1200B,7/6/2014,0,0,0,0,0,0,0
21047,RM-1200B,7/7/2014,0,0,0,0,0,0,0
21048,RM-1200B,7/8/2014,0,0,0,0,0,0,0
21049,RM-1200B,7/9/2014,0,0,0,0,0,0,0
21050,RM-1200B,7/10/2014,0,0,0,0,0,0,0
21051,RM-1200B,7/11/2014,0,0,0,0,0,0,0
21052,RM-1200B,7/12/2014,0,0,0,0,0,0,0
21053,RM-1200B,7/13/2014,0,0,0,0,0,0,0
21054,RM-1200B,7/14/2014,0,0,0,0,0,0,0
21055,RM-1200B,7/15/2014,0,0,0,0,0,0,0
21056,RM-1200B,7/16/2014,0,0,0,0,0,0,0
21057,RM-1200B,7/17/2014,0,0,0,0,0,0,0
21058,RM-1200B,7/18/2014,0,0,0,0,0,0,0
21059,RM-1200B,7/19/2014,0,0,0,0,0,0,0
21060,RM-1200B,7/20/2014,0,0,0,0,0,0,0
21061,RM-1200B,7/21/2014,0,0,0,0,0,0,0
21062,RM-1200B,7/22/2014,0,0,0,0,0,0,0
21063,RM-1200B,7/23/2014,0,0,0,0,0,0,0
21064,RM-1200B,7/24/2014,0,0,0,0,0,0,0
21065,RM-1200B,7/25/2014,0,0,0,0,0,0,0
21066,RM-1200B,7/26/2014,0,0,0,0,0,0,0
21067,RM-1200B,7/27/2014,0,0,0,0,0,0,0
21068,RM-1200B,7/28/2014,0,0,0,0,0,0,0
21069,RM-1200B,7/29/2014,0,0,0,0,0,0,0
21070,RM-1200B,7/30/2014,0,0,0,0,0,0,0
21071,RM-1200B,7/31/2014,0,0,0,0,0,0,0
21072,RM-1200B,8/1/2014,0,0,0,0,0,0,0
21073,RM-1200B,8/2/2014,0,0,0,0,0,0,0
21074,RM-1200B,8/3/2014,0,0,0,0,0,0,0
21075,RM-1200B,8/4/2014,0,0,0,0,0,0,0
21076,RM-1200B,8/5/2014,0,0,0,0,0,0,0
21077,RM-1200B,8/6/2014,0,0,0,0,0,0,0
21078,RM-1200B,8/7/2014,0,0,0,0,0,0,0
21079,RM-1200B,8/8/2014,0,0,0,0,0,0,0
21080,RM-1200B,8/9/2014,0,0,0,0,0,0,0
21081,RM-1200B,8/10/2014,0,0,0,0,0,0,0
21082,RM-1200B,8/11/2014,0,0,0,0,0,0,0
21083,RM-1200B,8/12/2014,0,0,0,0,0,0,0
21084,RM-1200B,8/13/2014,0,0,0,0,0,0,0
21085,RM-1200B,8/14/2014,0,0,0,0,0,0,0
21086,RM-1200B,8/15/2014,0,0,0,0,0,0,0
21087,RM-1200B,8/16/2014,0,0,0,0,0,0,0
21088,RM-1200B,8/17/2014,0,0,0,0,0,0,0
21089,RM-1200B,8/18/2014,0,0,0,0,0,0,0
21090,RM-1200B,8/19/2014,0,0,0,0,0,0,0
21091,RM-1200B,8/20/2014,0,0,0,0,0,0,0
21092,RM-1200B,8/21/2014,0,0,0,0,0,0,0
21093,RM-1200B,8/22/2014,0,0,0,0,0,0,0
21094,RM-1200B,8/23/2014,0,0,0,0,0,0,0
21095,RM-1200B,8/24/2014,0,0,0,0,0,0,0
21096,RM-1200B,8/25/2014,0,0,0,0,0,0,0
21097,RM-1200B,8/26/2014,0,0,0,0,0,0,0
21098,RM-1200B,8/27/2014,0,0,0,0,0,0,0
21099,RM-1200B,8/28/2014,0,0,0,0,0,0,0
21100,RM-1200B,8/29/2014,0,0,0,0,0,0,0
21101,RM-1200B,8/30/2014,0,0,0,0,0,0,0
21102,RM-1200B,8/31/2014,0,0,0,0,0,0,0
21103,RM-1200B,9/1/2014,0,0,0,0,0,0,0
21104,RM-1200B,9/2/2014,0,0,0,0,0,0,0
21105,RM-1200B,9/3/2014,0,0,0,0,0,0,0
21106,RM-1200B,9/4/2014,0,0,0,0,0,0,0
21107,RM-1200B,9/5/2014,0,0,0,0,0,0,0
21108,RM-1200B,9/6/2014,0,0,0,0,0,0,0
21109,RM-1200B,9/7/2014,0,0,0,0,0,0,0
21110,RM-1200B,9/8/2014,0,0,0,0,0,0,0
21111,RM-1200B,9/9/2014,0,0,0,0,0,0,0
21112,RM-1200B,9/10/2014,0,0,0,0,0,0,0
21113,RM-1200B,9/11/2014,0,0,0,0,0,0,0
21114,RM-1200B,9/12/2014,0,0,0,0,0,0,0
21115,RM-1200B,9/13/2014,0,0,0,0,0,0,0
21116,RM-1200B,9/14/2014,0,0,0,0,0,0,0
21117,RM-1200B,9/15/2014,0,0,0,0,0,0,0
21118,RM-1200B,9/16/2014,0,0,0,0,0,0,0
21119,RM-1200B,9/17/2014,0,0,0,0,0,0,0
21120,RM-1200B,9/18/2014,0,0,0,0,0,0,0
21121,RM-1200B,9/19/2014,0,0,0,0,0,0,0
21122,RM-1200B,9/20/2014,0,0,0,0,0,0,0
21123,RM-1200B,9/21/2014,0,0,0,0,0,0,0
21124,RM-1200B,9/22/2014,0,0,0,0,0,0,0
21125,RM-1200B,9/23/2014,0,0,0,0,0,0,0
21126,RM-1200B,9/24/2014,0,0,0,0,0,0,0
21127,RM-1200B,9/25/2014,0,0,0,0,0,0,0
21128,RM-1200B,9/28/2014,0,0,0,0,0,0,0
21129,RM-1200B,9/29/2014,0,0,0,0,0,0,0
21130,RM-1200B,9/30/2014,0,0,0,0,0,0,0
21131,RM-1200B,10/1/2014,0,0,0,0,0,0,0
21132,RM-1200B,10/2/2014,0,0,0,0,0,0,0
21133,RM-1200B,10/3/2014,0,0,0,0,0,0,0
21134,RM-1200B,10/4/2014,0,0,0,0,0,0,0
21135,RM-1200B,10/5/2014,0,0,0,0,0,0,0
21136,RM-1200B,10/6/2014,0,0,0,0,0,0,0
21137,RM-1200B,10/7/2014,0,0,0,0,0,0,0
21138,RM-1200B,10/8/2014,0,0,0,0,0,0,0
21139,RM-1200B,10/9/2014,0,0,0,0,0,0,0
21140,RM-1200B,10/10/2014,0,0,0,0,0,0,0
21141,RM-1200B,10/11/2014,0,0,0,0,0,0,0
21142,RM-1200B,10/12/2014,0,0,0,0,0,0,0
21143,RM-1200B,10/13/2014,0,0,0,0,0,0,0
21144,RM-1200B,10/14/2014,0,0,0,0,0,0,0
21145,RM-1200B,10/15/2014,0,0,0,0,0,0,0
21146,RM-1200B,10/16/2014,0,0,0,0,0,0,0
21147,RM-1200B,10/17/2014,0,0,0,0,0,0,0
21148,RM-1200B,10/18/2014,0,0,0,0,0,0,0
21149,RM-1200B,10/19/2014,0,0,0,0,0,0,0
21150,RM-1200B,10/20/2014,0,0,0,0,0,0,0
21151,RM-1200B,10/21/2014,0,0,0,0,0,0,0
21152,RM-1200B,10/22/2014,0,0,0,0,0,0,0
21153,RM-1200B,10/23/2014,0,0,0,0,0,0,0
21154,RM-1200B,10/24/2014,0,0,0,0,0,0,0
21155,RM-1200B,10/25/2014,0,0,0,0,0,0,0
21156,RM-1200B,10/26/2014,0,0,0,0,0,0,0
21157,RM-1200B,10/27/2014,0,0,0,0,0,0,0
21158,RM-1200B,10/28/2014,0,0,0,0,0,0,0
21159,RM-1200B,10/29/2014,0,0,0,0,0,0,0
21160,RM-1200B,10/30/2014,0,0,0,0,0,0,0
21161,RM-1200B,10/31/2014,0,0,0,0,0,0,0
21162,RM-1200B,11/1/2014,0,0,0,0,0,0,0
21163,RM-1200B,11/2/2014,0,0,0,0,0,0,0
21164,RM-1200B,11/3/2014,0,0,0,0,0,0,0
21165,RM-1200B,11/4/2014,0,0,0,0,0,0,0
21166,RM-1200B,11/5/2014,0,0,0,0,0,0,0
21167,RM-1200B,11/6/2014,0,0,0,0,0,0,0
21168,RM-1200B,11/7/2014,0,0,0,0,0,0,0
21169,RM-1200B,11/8/2014,0,0,0,0,0,0,0
21170,RM-1200B,11/9/2014,0,0,0,0,0,0,0
21171,RM-1200B,11/10/2014,0,0,0,0,0,0,0
21172,RM-1200B,11/11/2014,0,0,0,0,0,0,0
21173,RM-1200B,11/12/2014,0,0,0,0,0,0,0
21174,RM-1200B,11/13/2014,0,0,0,0,0,0,0
21175,RM-1200B,11/14/2014,0,0,0,0,0,0,0
21176,RM-1200B,11/15/2014,0,0,0,0,0,0,0
21177,RM-1200B,11/16/2014,0,0,0,0,0,0,0
21178,RM-1200B,11/17/2014,0,0,0,0,0,0,0
21179,RM-1200B,11/18/2014,0,0,0,0,0,0,0
21180,RM-1200B,11/19/2014,0,0,0,0,0,0,0
21181,RM-1200B,11/20/2014,0,0,0,0,0,0,0
21182,RM-1200B,11/21/2014,0,0,0,0,0,0,0
21183,RM-1200B,11/22/2014,0,0,0,0,0,0,0
21184,RM-1200B,11/23/2014,0,0,0,0,0,0,0
21185,RM-1200B,11/24/2014,0,0,0,0,0,0,0
21186,RM-1200B,11/25/2014,0,0,0,0,0,0,0
21187,RM-1200B,11/26/2014,0,0,0,0,0,0,0
21188,RM-1200B,11/27/2014,0,0,0,0,0,0,0
21189,RM-1200B,11/28/2014,0,0,0,0,0,0,0
21190,RM-1200B,11/29/2014,0,0,0,0,0,0,0
21191,RM-1200B,11/30/2014,0,0,0,0,0,0,0
21192,RM-1200B,12/1/2014,0,0,0,0,0,0,0
21193,RM-1200B,12/2/2014,0,0,0,0,0,0,0
21194,RM-1200B,12/3/2014,0,0,0,0,0,0,0
21195,RM-1200B,12/4/2014,0,0,0,0,0,0,0
21196,RM-1200B,12/5/2014,0,0,0,0,0,0,0
21197,RM-1200B,12/6/2014,0,0,0,0,0,0,0
21198,RM-1200B,12/7/2014,0,0,0,0,0,0,0
21199,RM-1200B,12/8/2014,0,0,0,0,0,0,0
21200,RM-1200B,12/9/2014,0,0,0,0,0,0,0
21201,RM-1200B,12/10/2014,0,0,0,0,0,0,0
21202,RM-1200B,12/11/2014,0,0,0,0,0,0,0
21203,RM-1200B,12/12/2014,0,0,0,0,0,0,0
21204,RM-1200B,12/13/2014,0,0,0,0,0,0,0
21205,RM-1200B,12/14/2014,0,0,0,0,0,0,0
21206,RM-1200B,12/15/2014,0,0,0,0,0,0,0
21207,RM-1200B,12/16/2014,0,0,0,0,0,0,0
21208,RM-1200B,12/17/2014,0,0,0,0,0,0,0
21209,RM-1200B,12/18/2014,0,0,0,0,0,0,0
21210,RM-1200B,12/19/2014,0,0,0,0,0,0,0
21211,RM-1200B,12/20/2014,0,0,0,0,0,0,0
21212,RM-1200B,12/21/2014,0,0,0,0,0,0,0
21213,RM-1200B,12/22/2014,0,0,0,0,0,0,0
21214,RM-1200B,12/23/2014,0,0,0,0,0,0,0
21215,RM-1200B,12/24/2014,0,0,0,0,0,0,0
21216,RM-1200B,12/25/2014,0,0,0,0,0,0,0
21217,RM-1200B,12/26/2014,0,0,0,0,0,0,0
21218,RM-1200B,12/27/2014,0,0,0,0,0,0,0
21219,RM-1200B,12/28/2014,0,0,0,0,0,0,0
21220,RM-1200B,12/29/2014,0,0,0,0,0,0,0
21221,RM-1200B,12/30/2014,0,0,0,0,0,0,0
21222,RM-1200B,12/31/2014,0,0,0,0,0,0,0
21223,RM-1200B,1/1/2015,0,0,0,0,0,0,0
21224,RM-1200B,1/2/2015,0,0,0,0,0,0,0
21225,RM-1200B,1/3/2015,0,0,0,0,0,0,0
21226,RM-1200B,1/4/2015,0,0,0,0,0,0,0
21227,RM-1200B,1/5/2015,0,0,0,0,0,0,0
21228,RM-1200B,1/6/2015,0,0,0,0,0,0,0
21229,RM-1200B,1/7/2015,0,0,0,0,0,0,0
21230,RM-1200B,1/8/2015,0,0,0,0,0,0,0
21231,RM-1200B,1/9/2015,0,0,0,0,0,0,0
21232,RM-1200B,1/10/2015,0,0,0,0,0,0,0
21233,RM-1200B,1/11/2015,0,0,0,0,0,0,0
21234,RM-1200B,1/12/2015,0,0,0,0,0,0,0
21235,RM-1200B,1/13/2015,0,0,0,0,0,0,0
21236,RM-1200B,1/14/2015,0,0,0,0,0,0,0
21237,RM-1200B,1/15/2015,0,0,0,0,0,0,0
21238,RM-1200B,1/16/2015,0,0,0,0,0,0,0
21239,RM-1200B,1/17/2015,0,0,0,0,0,0,0
21240,RM-1200B,1/18/2015,0,0,0,0,0,0,0
21241,RM-1200B,1/19/2015,0,0,0,0,0,0,0
21242,RM-1200B,1/20/2015,0,0,0,0,0,0,0
21243,RM-1200B,1/21/2015,0,0,0,0,0,0,0
21244,RM-1200B,1/22/2015,0,0,0,0,0,0,0
21245,RM-1200B,1/23/2015,0,0,0,0,0,0,0
21246,RM-1200B,1/24/2015,0,0,0,0,0,0,0
21247,RM-1200B,1/25/2015,0,0,0,0,0,0,0
21248,RM-1200B,1/26/2015,0,0,0,0,0,0,0
21249,RM-1200B,1/27/2015,0,0,0,0,0,0,0
21250,RM-1200B,1/28/2015,0,0,0,0,0,0,0
21251,RM-1200B,1/29/2015,0,0,0,0,0,0,0
21252,RM-1200B,1/30/2015,0,0,0,0,0,0,0
21253,RM-1200B,1/31/2015,0,0,0,0,0,0,0
21254,RM-1200B,2/1/2015,0,0,0,0,0,0,0
21255,RM-1200B,2/2/2015,0,0,0,0,0,0,0
21256,RM-1200B,2/3/2015,0,0,0,0,0,0,0
21257,RM-1200B,2/4/2015,0,0,0,0,0,0,0
21258,RM-1200B,2/5/2015,0,0,0,0,0,0,0
21259,RM-1200B,2/6/2015,0,0,0,0,0,0,0
21260,RM-1200B,2/7/2015,0,0,0,0,0,0,0
21261,RM-1200B,2/8/2015,0,0,0,0,0,0,0
21262,RM-1200B,2/9/2015,0,0,0,0,0,0,0
21263,RM-1200B,2/10/2015,0,0,0,0,0,0,0
21264,RM-1200B,2/11/2015,0,0,0,0,0,0,0
21265,RM-1200B,2/12/2015,0,0,0,0,0,0,0
21266,RM-1200B,2/13/2015,0,0,0,0,0,0,0
21267,RM-1200B,2/14/2015,0,0,0,0,0,0,0
21268,RM-1200B,2/15/2015,0,0,0,0,0,0,0
21269,RM-1200B,2/16/2015,0,0,0,0,0,0,0
21270,RM-1200B,2/17/2015,0,0,0,0,0,0,0
21271,RM-1200B,2/18/2015,0,0,0,0,0,0,0
21272,RM-1200B,2/19/2015,0,0,0,0,0,0,0
21273,RM-1200B,2/20/2015,0,0,0,0,0,0,0
21274,RM-1200B,2/21/2015,0,0,0,0,0,0,0
21275,RM-1200B,2/22/2015,0,0,0,0,0,0,0
21276,RM-1200B,2/23/2015,0,0,0,0,0,0,0
21277,RM-1200B,2/24/2015,0,0,0,0,0,0,0
21278,RM-1200B,2/25/2015,0,0,0,0,0,0,0
21279,RM-1200B,2/26/2015,0,0,0,0,0,0,0
21280,RM-1200B,2/27/2015,0,0,0,0,0,0,0
21281,RM-1200B,2/28/2015,0,0,0,0,0,0,0
21282,RM-1200B,3/1/2015,0,0,0,0,0,0,0
21283,RM-1200B,3/2/2015,0,0,0,0,0,0,0
21284,RM-1200B,3/3/2015,0,0,0,0,0,0,0
21285,RM-1200B,3/4/2015,0,0,0,0,0,0,0
21286,RM-1200B,3/5/2015,0,0,0,0,0,0,0
21287,RM-1200B,3/6/2015,0,0,0,0,0,0,0
21288,RM-1200B,3/7/2015,0,0,0,0,0,0,0
21289,RM-1200B,3/8/2015,0,0,0,0,0,0,0
21290,RM-1200B,3/9/2015,0,0,0,0,0,0,0
21291,RM-1200B,3/10/2015,0,0,0,0,0,0,0
21292,RM-1200B,3/11/2015,0,0,0,0,0,0,0
21293,RM-1200B,3/12/2015,0,0,0,0,0,0,0
21294,RM-1200B,3/13/2015,0,0,0,0,0,0,0
21295,RM-1200B,3/14/2015,0,0,0,0,0,0,0
21296,RM-1200B,3/15/2015,0,0,0,0,0,0,0
21297,RM-1200B,3/16/2015,0,0,0,0,0,0,0
21298,RM-1200B,3/17/2015,0,0,0,0,0,0,0
21299,RM-1200B,3/18/2015,0,0,0,0,0,0,0
21300,RM-1200B,3/19/2015,0,0,0,0,0,0,0
21301,RM-1200B,3/20/2015,0,0,0,0,0,0,0
21302,RM-1200B,3/21/2015,0,0,0,0,0,0,0
21303,RM-1200B,3/22/2015,0,0,0,0,0,0,0
21304,RM-1200B,3/23/2015,0,0,0,0,0,0,0
21305,RM-1200B,3/24/2015,0,0,0,0,0,0,0
21306,RM-1200B,3/25/2015,0,0,0,0,0,0,0
21307,RM-1200B,3/26/2015,0,0,0,0,0,0,0
21308,RM-1200B,3/27/2015,0,0,0,0,0,0,0
21309,RM-1200B,3/28/2015,0,0,0,0,0,0,0
21310,RM-1200B,3/29/2015,0,0,0,0,0,0,0
21311,RM-1200B,3/30/2015,0,0,0,0,0,0,0
21312,RM-1200B,3/31/2015,0,0,0,0,0,0,0
21313,RM-1200B,4/1/2015,0,0,0,0,0,0,0
21314,RM-1200B,4/2/2015,0,0,0,0,0,0,0
21315,RM-1200B,4/3/2015,0,0,0,0,0,0,0
21316,RM-1200B,4/4/2015,0,0,0,0,0,0,0
21317,RM-1200B,4/5/2015,0,0,0,0,0,0,0
21318,RM-1200B,4/6/2015,0,0,0,0,0,0,0
21319,RM-1200B,4/7/2015,0,0,0,0,0,0,0
21320,RM-1200B,4/8/2015,0,0,0,0,0,0,0
21321,RM-1200B,4/9/2015,0,0,0,0,0,0,0
21322,RM-1200B,4/10/2015,0,0,0,0,0,0,0
21323,RM-1200B,4/11/2015,0,0,0,0,0,0,0
21324,RM-1200B,4/12/2015,0,0,0,0,0,0,0
21325,RM-1200B,4/13/2015,0,0,0,0,0,0,0
21326,RM-1200B,4/14/2015,0,0,0,0,0,0,0
21327,RM-1200B,4/15/2015,0,0,0,0,0,0,0
21328,RM-1200B,4/16/2015,0,0,0,0,0,0,0
21329,RM-1200B,4/17/2015,0,0,0,0,0,0,0
21330,RM-1200B,4/18/2015,0,0,0,0,0,0,0
21331,RM-1200B,4/19/2015,0,0,0,0,0,0,0
21332,RM-1200B,4/20/2015,0,0,0,0,0,0,0
21333,RM-1200B,4/21/2015,0,0,0,0,0,0,0
21334,RM-1200B,4/22/2015,0,0,0,0,0,0,0
21335,RM-1200B,4/23/2015,0,0,0,0,0,0,0
21336,RM-1200B,4/24/2015,0,0,0,0,0,0,0
21337,RM-1200B,4/25/2015,0,0,0,0,0,0,0
21338,RM-1200B,4/26/2015,0,0,0,0,0,0,0
21339,RM-1200B,4/27/2015,0,0,0,0,0,0,0
21340,RM-1200B,4/28/2015,0,0,0,0,0,0,0
21341,RM-1200B,4/29/2015,0,0,0,0,0,0,0
21342,RM-1200B,4/30/2015,0,0,0,0,0,0,0
21343,RM-1200B,5/1/2015,0,0,0,0,0,0,0
21344,RM-1200B,5/2/2015,0,0,0,0,0,0,0
21345,RM-1200B,5/3/2015,0,0,0,0,0,0,0
21346,RM-1200B,5/4/2015,0,0,0,0,0,0,0
21347,RM-1200B,5/5/2015,0,0,0,0,0,0,0
21348,RM-1200B,5/6/2015,0,0,0,0,0,0,0
21349,RM-1200B,5/7/2015,0,0,0,0,0,0,0
21350,RM-1200B,5/8/2015,0,0,0,0,0,0,0
21351,RM-1200B,5/9/2015,0,0,0,0,0,0,0
21352,RM-1200B,5/10/2015,0,0,0,0,0,0,0
21353,RM-1200B,5/11/2015,0,0,0,0,0,0,0
21354,RM-1200B,5/12/2015,0,0,0,0,0,0,0
21355,RM-1200B,5/13/2015,0,0,0,0,0,0,0
21356,RM-1200B,5/14/2015,0,0,0,0,0,0,0
21357,RM-1200B,5/15/2015,0,0,0,0,0,0,0
21358,RM-1200B,5/16/2015,0,0,0,0,0,0,0
21359,RM-1200B,5/17/2015,0,0,0,0,0,0,0
21360,RM-1200B,5/18/2015,0,0,0,0,0,0,0
21361,RM-1200B,5/19/2015,0,0,0,0,0,0,0
21362,RM-1200B,5/20/2015,0,0,0,0,0,0,0
21363,RM-1200B,5/21/2015,0,0,0,0,0,0,0
21364,RM-1200B,5/22/2015,0,0,0,0,0,0,0
21365,RM-1200B,5/23/2015,0,0,0,0,0,0,0
21366,RM-1200B,5/24/2015,0,0,0,0,0,0,0
21367,RM-1200B,5/25/2015,0,0,0,0,0,0,0
21368,RM-1200B,5/26/2015,0,0,0,0,0,0,0
21369,RM-1200B,5/27/2015,0,0,0,0,0,0,0
21370,RM-1200B,5/28/2015,0,0,0,0,0,0,0
21371,RM-1200B,5/29/2015,0,0,0,0,0,0,0
21372,RM-1200B,5/30/2015,0,0,0,0,0,0,0
21373,RM-1200B,5/31/2015,0,0,0,0,0,0,0
21374,RM-1200C,7/1/2013,0,0,0,0,0,0,0
21375,RM-1200C,7/2/2013,0,0,0,0,0,0,0
21376,RM-1200C,7/3/2013,0,0,0,0,0,0,0
21377,RM-1200C,7/4/2013,0,0,0,0,0,0,0
21378,RM-1200C,7/5/2013,0,0,0,0,0,0,0
21379,RM-1200C,7/6/2013,0,0,0,0,0,0,0
21380,RM-1200C,7/7/2013,0,0,0,0,0,0,0
21381,RM-1200C,7/8/2013,0,0,0,0,0,0,0
21382,RM-1200C,7/9/2013,0,0,0,0,0,0,0
21383,RM-1200C,7/10/2013,0,0,0,0,0,0,0
21384,RM-1200C,7/11/2013,0,0,0,0,0,0,0
21385,RM-1200C,7/12/2013,0,0,0,0,0,0,0
21386,RM-1200C,7/13/2013,0,0,0,0,0,0,0
21387,RM-1200C,7/14/2013,0,0,0,0,0,0,0
21388,RM-1200C,7/15/2013,0,0,0,0,0,0,0
21389,RM-1200C,7/17/2013,0,0,0,0,0,0,0
21390,RM-1200C,7/18/2013,0,0,0,0,0,0,0
21391,RM-1200C,7/19/2013,0,0,0,0,0,0,0
21392,RM-1200C,7/20/2013,0,0,0,0,0,0,0
21393,RM-1200C,7/21/2013,0,0,0,0,0,0,0
21394,RM-1200C,7/22/2013,0,0,0,0,0,0,0
21395,RM-1200C,7/23/2013,0,0,0,0,0,0,0
21396,RM-1200C,7/24/2013,0,0,0,0,0,0,0
21397,RM-1200C,7/25/2013,0,0,0,0,0,0,0
21398,RM-1200C,7/26/2013,0,0,0,0,0,0,0
21399,RM-1200C,7/27/2013,0,0,0,0,0,0,0
21400,RM-1200C,7/28/2013,0,0,0,0,0,0,0
21401,RM-1200C,7/29/2013,0,0,0,0,0,0,0
21402,RM-1200C,7/30/2013,0,0,0,0,0,0,0
21403,RM-1200C,7/31/2013,0,0,0,0,0,0,0
21404,RM-1200C,8/1/2013,0,0,0,0,0,0,0
21405,RM-1200C,8/2/2013,0,0,0,0,0,0,0
21406,RM-1200C,8/3/2013,0,0,0,0,0,0,0
21407,RM-1200C,8/4/2013,0,0,0,0,0,0,0
21408,RM-1200C,8/5/2013,0,0,0,0,0,0,0
21409,RM-1200C,8/6/2013,0,0,0,0,0,0,0
21410,RM-1200C,8/7/2013,0,0,0,0,0,0,0
21411,RM-1200C,8/8/2013,0,0,0,0,0,0,0
21412,RM-1200C,8/9/2013,0,0,0,0,0,0,0
21413,RM-1200C,8/10/2013,0,0,0,0,0,0,0
21414,RM-1200C,8/11/2013,0,0,0,0,0,0,0
21415,RM-1200C,8/12/2013,0,0,0,0,0,0,0
21416,RM-1200C,8/13/2013,0,0,0,0,0,0,0
21417,RM-1200C,8/14/2013,0,0,0,0,0,0,0
21418,RM-1200C,8/15/2013,0,0,0,0,0,0,0
21419,RM-1200C,8/16/2013,0,0,0,0,0,0,0
21420,RM-1200C,8/17/2013,0,0,0,0,0,0,0
21421,RM-1200C,8/18/2013,0,0,0,0,0,0,0
21422,RM-1200C,8/19/2013,0,0,0,0,0,0,0
21423,RM-1200C,8/20/2013,0,0,0,0,0,0,0
21424,RM-1200C,8/21/2013,0,0,0,0,0,0,0
21425,RM-1200C,8/22/2013,0,0,0,0,0,0,0
21426,RM-1200C,8/27/2013,0,0,0,0,0,0,0
21427,RM-1200C,8/28/2013,0,0,0,0,0,0,0
21428,RM-1200C,8/29/2013,0,0,0,0,0,0,0
21429,RM-1200C,8/30/2013,0,0,0,0,0,0,0
21430,RM-1200C,9/4/2013,0,0,0,0,0,0,0
21431,RM-1200C,9/5/2013,0,0,0,0,0,0,0
21432,RM-1200C,9/6/2013,0,0,0,0,0,0,0
21433,RM-1200C,9/7/2013,0,0,0,0,0,0,0
21434,RM-1200C,9/9/2013,0,0,0,0,0,0,0
21435,RM-1200C,9/10/2013,0,0,0,0,0,0,0
21436,RM-1200C,9/11/2013,0,0,0,0,0,0,0
21437,RM-1200C,9/12/2013,0,0,0,0,0,0,0
21438,RM-1200C,9/13/2013,0,0,0,0,0,0,0
21439,RM-1200C,9/14/2013,0,0,0,0,0,0,0
21440,RM-1200C,9/15/2013,0,0,0,0,0,0,0
21441,RM-1200C,9/16/2013,0,0,0,0,0,0,0
21442,RM-1200C,9/17/2013,0,0,0,0,0,0,0
21443,RM-1200C,9/18/2013,0,0,0,0,0,0,0
21444,RM-1200C,9/19/2013,0,0,0,0,0,0,0
21445,RM-1200C,9/20/2013,0,0,0,0,0,0,0
21446,RM-1200C,9/21/2013,0,0,0,0,0,0,0
21447,RM-1200C,9/22/2013,0,0,0,0,0,0,0
21448,RM-1200C,9/23/2013,0,0,0,0,0,0,0
21449,RM-1200C,9/24/2013,0,0,0,0,0,0,0
21450,RM-1200C,9/25/2013,0,0,0,0,0,0,0
21451,RM-1200C,9/26/2013,0,0,0,0,0,0,0
21452,RM-1200C,9/27/2013,0,0,0,0,0,0,0
21453,RM-1200C,9/28/2013,0,0,0,0,0,0,0
21454,RM-1200C,9/29/2013,0,0,0,0,0,0,0
21455,RM-1200C,9/30/2013,0,0,0,0,0,0,0
21456,RM-1200C,10/1/2013,0,0,0,0,0,0,0
21457,RM-1200C,10/2/2013,0,0,0,0,0,0,0
21458,RM-1200C,10/3/2013,0,0,0,0,0,0,0
21459,RM-1200C,10/4/2013,0,0,0,0,0,0,0
21460,RM-1200C,10/5/2013,0,0,0,0,0,0,0
21461,RM-1200C,10/6/2013,0,0,0,0,0,0,0
21462,RM-1200C,10/7/2013,0,0,0,0,0,0,0
21463,RM-1200C,10/8/2013,0,0,0,0,0,0,0
21464,RM-1200C,10/9/2013,0,0,0,0,0,0,0
21465,RM-1200C,10/10/2013,0,0,0,0,0,0,0
21466,RM-1200C,10/11/2013,0,0,0,0,0,0,0
21467,RM-1200C,10/12/2013,0,0,0,0,0,0,0
21468,RM-1200C,10/13/2013,0,0,0,0,0,0,0
21469,RM-1200C,10/14/2013,0,0,0,0,0,0,0
21470,RM-1200C,10/15/2013,0,0,0,0,0,0,0
21471,RM-1200C,10/16/2013,0,0,0,0,0,0,0
21472,RM-1200C,10/17/2013,0,0,0,0,0,0,0
21473,RM-1200C,10/18/2013,0,0,0,0,0,0,0
21474,RM-1200C,10/19/2013,0,0,0,0,0,0,0
21475,RM-1200C,10/20/2013,0,0,0,0,0,0,0
21476,RM-1200C,10/21/2013,0,0,0,0,0,0,0
21477,RM-1200C,10/22/2013,0,0,0,0,0,0,0
21478,RM-1200C,10/23/2013,0,0,0,0,0,0,0
21479,RM-1200C,10/24/2013,0,0,0,0,0,0,0
21480,RM-1200C,10/25/2013,0,0,0,0,0,0,0
21481,RM-1200C,10/26/2013,0,0,0,0,0,0,0
21482,RM-1200C,10/27/2013,0,0,0,0,0,0,0
21483,RM-1200C,10/28/2013,0,0,0,0,0,0,0
21484,RM-1200C,10/29/2013,0,0,0,0,0,0,0
21485,RM-1200C,10/30/2013,0,0,0,0,0,0,0
21486,RM-1200C,10/31/2013,0,0,0,0,0,0,0
21487,RM-1200C,11/1/2013,0,0,0,0,0,0,0
21488,RM-1200C,11/2/2013,0,0,0,0,0,0,0
21489,RM-1200C,11/3/2013,0,0,0,0,0,0,0
21490,RM-1200C,11/4/2013,0,0,0,0,0,0,0
21491,RM-1200C,11/5/2013,0,0,0,0,0,0,0
21492,RM-1200C,11/6/2013,0,0,0,0,0,0,0
21493,RM-1200C,11/7/2013,0,0,0,0,0,0,0
21494,RM-1200C,11/8/2013,0,0,0,0,0,0,0
21495,RM-1200C,11/9/2013,0,0,0,0,0,0,0
21496,RM-1200C,11/10/2013,0,0,0,0,0,0,0
21497,RM-1200C,11/11/2013,0,0,0,0,0,0,0
21498,RM-1200C,11/12/2013,0,0,0,0,0,0,0
21499,RM-1200C,11/13/2013,0,0,0,0,0,0,0
21500,RM-1200C,11/14/2013,0,0,0,0,0,0,0
21501,RM-1200C,11/15/2013,0,0,0,0,0,0,0
21502,RM-1200C,11/19/2013,0,0,0,0,0,0,0
21503,RM-1200C,11/20/2013,0,0,0,0,0,0,0
21504,RM-1200C,11/21/2013,0,0,0,0,0,0,0
21505,RM-1200C,11/22/2013,0,0,0,0,0,0,0
21506,RM-1200C,11/23/2013,0,0,0,0,0,0,0
21507,RM-1200C,11/24/2013,0,0,0,0,0,0,0
21508,RM-1200C,11/25/2013,0,0,0,0,0,0,0
21509,RM-1200C,11/26/2013,0,0,0,0,0,0,0
21510,RM-1200C,11/27/2013,0,0,0,0,0,0,0
21511,RM-1200C,11/28/2013,0,0,0,0,0,0,0
21512,RM-1200C,11/29/2013,0,0,0,0,0,0,0
21513,RM-1200C,11/30/2013,0,0,0,0,0,0,0
21514,RM-1200C,12/1/2013,0,0,0,0,0,0,0
21515,RM-1200C,12/2/2013,0,0,0,0,0,0,0
21516,RM-1200C,12/3/2013,0,0,0,0,0,0,0
21517,RM-1200C,12/4/2013,0,0,0,0,0,0,0
21518,RM-1200C,12/5/2013,0,0,0,0,0,0,0
21519,RM-1200C,12/6/2013,0,0,0,0,0,0,0
21520,RM-1200C,12/7/2013,0,0,0,0,0,0,0
21521,RM-1200C,12/8/2013,0,0,0,0,0,0,0
21522,RM-1200C,12/9/2013,0,0,0,0,0,0,0
21523,RM-1200C,12/10/2013,0,0,0,0,0,0,0
21524,RM-1200C,12/11/2013,0,0,0,0,0,0,0
21525,RM-1200C,12/12/2013,0,0,0,0,0,0,0
21526,RM-1200C,12/13/2013,0,0,0,0,0,0,0
21527,RM-1200C,12/14/2013,0,0,0,0,0,0,0
21528,RM-1200C,12/15/2013,0,0,0,0,0,0,0
21529,RM-1200C,12/16/2013,0,0,0,0,0,0,0
21530,RM-1200C,12/17/2013,0,0,0,0,0,0,0
21531,RM-1200C,12/18/2013,0,0,0,0,0,0,0
21532,RM-1200C,12/19/2013,0,0,0,0,0,0,0
21533,RM-1200C,12/20/2013,0,0,0,0,0,0,0
21534,RM-1200C,12/21/2013,0,0,0,0,0,0,0
21535,RM-1200C,12/22/2013,0,0,0,0,0,0,0
21536,RM-1200C,12/23/2013,0,0,0,0,0,0,0
21537,RM-1200C,12/24/2013,0,0,0,0,0,0,0
21538,RM-1200C,12/25/2013,0,0,0,0,0,0,0
21539,RM-1200C,12/26/2013,0,0,0,0,0,0,0
21540,RM-1200C,12/27/2013,0,0,0,0,0,0,0
21541,RM-1200C,12/28/2013,0,0,0,0,0,0,0
21542,RM-1200C,12/29/2013,0,0,0,0,0,0,0
21543,RM-1200C,12/30/2013,0,0,0,0,0,0,0
21544,RM-1200C,12/31/2013,0,0,0,0,0,0,0
21545,RM-1200C,1/1/2014,0,0,0,0,0,0,0
21546,RM-1200C,1/2/2014,0,0,0,0,0,0,0
21547,RM-1200C,1/3/2014,0,0,0,0,0,0,0
21548,RM-1200C,1/4/2014,0,0,0,0,0,0,0
21549,RM-1200C,1/5/2014,0,0,0,0,0,0,0
21550,RM-1200C,1/6/2014,0,0,0,0,0,0,0
21551,RM-1200C,1/7/2014,0,0,0,0,0,0,0
21553,RM-1200C,1/9/2014,0,0,0,0,0,0,0
21557,RM-1200C,1/13/2014,0,0,0,0,0,0,0
21558,RM-1200C,1/14/2014,0,0,0,0,0,0,0
21728,RM-1200C,7/3/2014,0,0,0,0,0,0,0
21729,RM-1200C,7/4/2014,0,0,0,0,0,0,0
21730,RM-1200C,7/5/2014,0,0,0,0,0,0,0
21731,RM-1200C,7/6/2014,0,0,0,0,0,0,0
21732,RM-1200C,7/7/2014,0,0,0,0,0,0,0
21733,RM-1200C,7/8/2014,0,0,0,0,0,0,0
21734,RM-1200C,7/9/2014,0,0,0,0,0,0,0
21735,RM-1200C,7/10/2014,0,0,0,0,0,0,0
21736,RM-1200C,7/11/2014,0,0,0,0,0,0,0
21737,RM-1200C,7/12/2014,0,0,0,0,0,0,0
21738,RM-1200C,7/13/2014,0,0,0,0,0,0,0
21739,RM-1200C,7/14/2014,0,0,0,0,0,0,0
21740,RM-1200C,7/15/2014,0,0,0,0,0,0,0
21741,RM-1200C,7/16/2014,0,0,0,0,0,0,0
21742,RM-1200C,7/17/2014,0,0,0,0,0,0,0
21743,RM-1200C,7/18/2014,0,0,0,0,0,0,0
21744,RM-1200C,7/19/2014,0,0,0,0,0,0,0
21745,RM-1200C,7/20/2014,0,0,0,0,0,0,0
21746,RM-1200C,7/21/2014,0,0,0,0,0,0,0
21747,RM-1200C,7/22/2014,0,0,0,0,0,0,0
21748,RM-1200C,7/23/2014,0,0,0,0,0,0,0
21749,RM-1200C,7/24/2014,0,0,0,0,0,0,0
21750,RM-1200C,7/25/2014,0,0,0,0,0,0,0
21751,RM-1200C,7/26/2014,0,0,0,0,0,0,0
21752,RM-1200C,7/27/2014,0,0,0,0,0,0,0
21753,RM-1200C,7/28/2014,0,0,0,0,0,0,0
21754,RM-1200C,7/29/2014,0,0,0,0,0,0,0
21755,RM-1200C,7/30/2014,0,0,0,0,0,0,0
21756,RM-1200C,7/31/2014,0,0,0,0,0,0,0
21757,RM-1200C,8/1/2014,0,0,0,0,0,0,0
21758,RM-1200C,8/2/2014,0,0,0,0,0,0,0
21759,RM-1200C,8/3/2014,0,0,0,0,0,0,0
21760,RM-1200C,8/4/2014,0,0,0,0,0,0,0
21761,RM-1200C,8/5/2014,0,0,0,0,0,0,0
21762,RM-1200C,8/6/2014,0,0,0,0,0,0,0
21763,RM-1200C,8/7/2014,0,0,0,0,0,0,0
21764,RM-1200C,8/8/2014,0,0,0,0,0,0,0
21765,RM-1200C,8/9/2014,0,0,0,0,0,0,0
21766,RM-1200C,8/10/2014,0,0,0,0,0,0,0
21767,RM-1200C,8/11/2014,0,0,0,0,0,0,0
21768,RM-1200C,8/12/2014,0,0,0,0,0,0,0
21769,RM-1200C,8/13/2014,0,0,0,0,0,0,0
21770,RM-1200C,8/14/2014,0,0,0,0,0,0,0
21771,RM-1200C,8/15/2014,0,0,0,0,0,0,0
21772,RM-1200C,8/16/2014,0,0,0,0,0,0,0
21773,RM-1200C,8/17/2014,0,0,0,0,0,0,0
21774,RM-1200C,8/18/2014,0,0,0,0,0,0,0
21775,RM-1200C,8/19/2014,0,0,0,0,0,0,0
21776,RM-1200C,8/20/2014,0,0,0,0,0,0,0
21777,RM-1200C,8/21/2014,0,0,0,0,0,0,0
21778,RM-1200C,8/22/2014,0,0,0,0,0,0,0
21779,RM-1200C,8/23/2014,0,0,0,0,0,0,0
21780,RM-1200C,8/24/2014,0,0,0,0,0,0,0
21781,RM-1200C,8/25/2014,0,0,0,0,0,0,0
21782,RM-1200C,8/26/2014,0,0,0,0,0,0,0
21783,RM-1200C,8/27/2014,0,0,0,0,0,0,0
21784,RM-1200C,8/28/2014,0,0,0,0,0,0,0
21785,RM-1200C,8/29/2014,0,0,0,0,0,0,0
21786,RM-1200C,8/30/2014,0,0,0,0,0,0,0
21787,RM-1200C,8/31/2014,0,0,0,0,0,0,0
21788,RM-1200C,9/1/2014,0,0,0,0,0,0,0
21789,RM-1200C,9/2/2014,0,0,0,0,0,0,0
21790,RM-1200C,9/3/2014,0,0,0,0,0,0,0
21791,RM-1200C,9/4/2014,0,0,0,0,0,0,0
21792,RM-1200C,9/5/2014,0,0,0,0,0,0,0
21793,RM-1200C,9/6/2014,0,0,0,0,0,0,0
21794,RM-1200C,9/7/2014,0,0,0,0,0,0,0
21795,RM-1200C,9/8/2014,0,0,0,0,0,0,0
21796,RM-1200C,9/9/2014,0,0,0,0,0,0,0
21797,RM-1200C,9/10/2014,0,0,0,0,0,0,0
21798,RM-1200C,9/11/2014,0,0,0,0,0,0,0
21799,RM-1200C,9/12/2014,0,0,0,0,0,0,0
21800,RM-1200C,9/13/2014,0,0,0,0,0,0,0
21801,RM-1200C,9/14/2014,0,0,0,0,0,0,0
21802,RM-1200C,9/15/2014,0,0,0,0,0,0,0
21803,RM-1200C,9/16/2014,0,0,0,0,0,0,0
21804,RM-1200C,9/17/2014,0,0,0,0,0,0,0
21805,RM-1200C,9/18/2014,0,0,0,0,0,0,0
21806,RM-1200C,9/19/2014,0,0,0,0,0,0,0
21807,RM-1200C,9/20/2014,0,0,0,0,0,0,0
21808,RM-1200C,9/21/2014,0,0,0,0,0,0,0
21809,RM-1200C,9/22/2014,0,0,0,0,0,0,0
21810,RM-1200C,9/23/2014,0,0,0,0,0,0,0
21811,RM-1200C,9/24/2014,0,0,0,0,0,0,0
21812,RM-1200C,9/25/2014,0,0,0,0,0,0,0
21813,RM-1200C,9/28/2014,0,0,0,0,0,0,0
21814,RM-1200C,9/29/2014,0,0,0,0,0,0,0
21815,RM-1200C,9/30/2014,0,0,0,0,0,0,0
21816,RM-1200C,10/1/2014,0,0,0,0,0,0,0
21817,RM-1200C,10/2/2014,0,0,0,0,0,0,0
21818,RM-1200C,10/3/2014,0,0,0,0,0,0,0
21819,RM-1200C,10/4/2014,0,0,0,0,0,0,0
21820,RM-1200C,10/5/2014,0,0,0,0,0,0,0
21821,RM-1200C,10/6/2014,0,0,0,0,0,0,0
21822,RM-1200C,10/7/2014,0,0,0,0,0,0,0
21823,RM-1200C,10/8/2014,0,0,0,0,0,0,0
21824,RM-1200C,10/9/2014,0,0,0,0,0,0,0
21825,RM-1200C,10/10/2014,0,0,0,0,0,0,0
21826,RM-1200C,10/11/2014,0,0,0,0,0,0,0
21827,RM-1200C,10/12/2014,0,0,0,0,0,0,0
21828,RM-1200C,10/13/2014,0,0,0,0,0,0,0
21829,RM-1200C,10/14/2014,0,0,0,0,0,0,0
21830,RM-1200C,10/15/2014,0,0,0,0,0,0,0
21831,RM-1200C,10/16/2014,0,0,0,0,0,0,0
21832,RM-1200C,10/17/2014,0,0,0,0,0,0,0
21833,RM-1200C,10/18/2014,0,0,0,0,0,0,0
21834,RM-1200C,10/19/2014,0,0,0,0,0,0,0
21835,RM-1200C,10/20/2014,0,0,0,0,0,0,0
21836,RM-1200C,10/21/2014,0,0,0,0,0,0,0
21837,RM-1200C,10/22/2014,0,0,0,0,0,0,0
21838,RM-1200C,10/23/2014,0,0,0,0,0,0,0
21839,RM-1200C,10/24/2014,0,0,0,0,0,0,0
21840,RM-1200C,10/25/2014,0,0,0,0,0,0,0
21841,RM-1200C,10/26/2014,0,0,0,0,0,0,0
21842,RM-1200C,10/27/2014,0,0,0,0,0,0,0
21843,RM-1200C,10/28/2014,0,0,0,0,0,0,0
21844,RM-1200C,10/29/2014,0,0,0,0,0,0,0
21845,RM-1200C,10/30/2014,0,0,0,0,0,0,0
21846,RM-1200C,10/31/2014,0,0,0,0,0,0,0
21847,RM-1200C,11/1/2014,0,0,0,0,0,0,0
21848,RM-1200C,11/2/2014,0,0,0,0,0,0,0
21849,RM-1200C,11/3/2014,0,0,0,0,0,0,0
21850,RM-1200C,11/4/2014,0,0,0,0,0,0,0
21851,RM-1200C,11/5/2014,0,0,0,0,0,0,0
21852,RM-1200C,11/6/2014,0,0,0,0,0,0,0
21853,RM-1200C,11/7/2014,0,0,0,0,0,0,0
21854,RM-1200C,11/8/2014,0,0,0,0,0,0,0
21855,RM-1200C,11/9/2014,0,0,0,0,0,0,0
21856,RM-1200C,11/10/2014,0,0,0,0,0,0,0
21857,RM-1200C,11/11/2014,0,0,0,0,0,0,0
21858,RM-1200C,11/12/2014,0,0,0,0,0,0,0
21859,RM-1200C,11/13/2014,0,0,0,0,0,0,0
21860,RM-1200C,11/14/2014,0,0,0,0,0,0,0
21861,RM-1200C,11/15/2014,0,0,0,0,0,0,0
21862,RM-1200C,11/16/2014,0,0,0,0,0,0,0
21863,RM-1200C,11/17/2014,0,0,0,0,0,0,0
21864,RM-1200C,11/18/2014,0,0,0,0,0,0,0
21865,RM-1200C,11/19/2014,0,0,0,0,0,0,0
21866,RM-1200C,11/20/2014,0,0,0,0,0,0,0
21867,RM-1200C,11/21/2014,0,0,0,0,0,0,0
21868,RM-1200C,11/22/2014,0,0,0,0,0,0,0
21869,RM-1200C,11/23/2014,0,0,0,0,0,0,0
21870,RM-1200C,11/24/2014,0,0,0,0,0,0,0
21871,RM-1200C,11/25/2014,0,0,0,0,0,0,0
21872,RM-1200C,11/26/2014,0,0,0,0,0,0,0
21873,RM-1200C,11/27/2014,0,0,0,0,0,0,0
21874,RM-1200C,11/28/2014,0,0,0,0,0,0,0
21875,RM-1200C,11/29/2014,0,0,0,0,0,0,0
21876,RM-1200C,11/30/2014,0,0,0,0,0,0,0
21877,RM-1200C,12/1/2014,0,0,0,0,0,0,0
21878,RM-1200C,12/2/2014,0,0,0,0,0,0,0
21879,RM-1200C,12/3/2014,0,0,0,0,0,0,0
21880,RM-1200C,12/4/2014,0,0,0,0,0,0,0
21881,RM-1200C,12/5/2014,0,0,0,0,0,0,0
21882,RM-1200C,12/6/2014,0,0,0,0,0,0,0
21883,RM-1200C,12/7/2014,0,0,0,0,0,0,0
21884,RM-1200C,12/8/2014,0,0,0,0,0,0,0
21885,RM-1200C,12/9/2014,0,0,0,0,0,0,0
21886,RM-1200C,12/10/2014,0,0,0,0,0,0,0
21887,RM-1200C,12/11/2014,0,0,0,0,0,0,0
21888,RM-1200C,12/12/2014,0,0,0,0,0,0,0
21889,RM-1200C,12/13/2014,0,0,0,0,0,0,0
21890,RM-1200C,12/14/2014,0,0,0,0,0,0,0
21891,RM-1200C,12/15/2014,0,0,0,0,0,0,0
21892,RM-1200C,12/16/2014,0,0,0,0,0,0,0
21893,RM-1200C,12/17/2014,0,0,0,0,0,0,0
21894,RM-1200C,12/18/2014,0,0,0,0,0,0,0
21895,RM-1200C,12/19/2014,0,0,0,0,0,0,0
21896,RM-1200C,12/20/2014,0,0,0,0,0,0,0
21897,RM-1200C,12/21/2014,0,0,0,0,0,0,0
21898,RM-1200C,12/22/2014,0,0,0,0,0,0,0
21899,RM-1200C,12/23/2014,0,0,0,0,0,0,0
21900,RM-1200C,12/24/2014,0,0,0,0,0,0,0
21901,RM-1200C,12/25/2014,0,0,0,0,0,0,0
21902,RM-1200C,12/26/2014,0,0,0,0,0,0,0
21903,RM-1200C,12/27/2014,0,0,0,0,0,0,0
21904,RM-1200C,12/28/2014,0,0,0,0,0,0,0
21905,RM-1200C,12/29/2014,0,0,0,0,0,0,0
21906,RM-1200C,12/30/2014,0,0,0,0,0,0,0
21907,RM-1200C,12/31/2014,0,0,0,0,0,0,0
21908,RM-1200C,1/1/2015,0,0,0,0,0,0,0
21909,RM-1200C,1/2/2015,0,0,0,0,0,0,0
21910,RM-1200C,1/3/2015,0,0,0,0,0,0,0
21911,RM-1200C,1/4/2015,0,0,0,0,0,0,0
21912,RM-1200C,1/5/2015,0,0,0,0,0,0,0
21913,RM-1200C,1/6/2015,0,0,0,0,0,0,0
21914,RM-1200C,1/7/2015,0,0,0,0,0,0,0
21915,RM-1200C,1/8/2015,0,0,0,0,0,0,0
21916,RM-1200C,1/9/2015,0,0,0,0,0,0,0
21917,RM-1200C,1/10/2015,0,0,0,0,0,0,0
21918,RM-1200C,1/11/2015,0,0,0,0,0,0,0
21919,RM-1200C,1/12/2015,0,0,0,0,0,0,0
21920,RM-1200C,1/13/2015,0,0,0,0,0,0,0
21921,RM-1200C,1/14/2015,0,0,0,0,0,0,0
21922,RM-1200C,1/15/2015,0,0,0,0,0,0,0
21923,RM-1200C,1/16/2015,0,0,0,0,0,0,0
21924,RM-1200C,1/17/2015,0,0,0,0,0,0,0
21925,RM-1200C,1/18/2015,0,0,0,0,0,0,0
21926,RM-1200C,1/19/2015,0,0,0,0,0,0,0
21927,RM-1200C,1/20/2015,0,0,0,0,0,0,0
21928,RM-1200C,1/21/2015,0,0,0,0,0,0,0
21929,RM-1200C,1/22/2015,0,0,0,0,0,0,0
21930,RM-1200C,1/23/2015,0,0,0,0,0,0,0
21931,RM-1200C,1/24/2015,0,0,0,0,0,0,0
21932,RM-1200C,1/25/2015,0,0,0,0,0,0,0
21933,RM-1200C,1/26/2015,0,0,0,0,0,0,0
21934,RM-1200C,1/27/2015,0,0,0,0,0,0,0
21935,RM-1200C,1/28/2015,0,0,0,0,0,0,0
21936,RM-1200C,1/29/2015,0,0,0,0,0,0,0
21937,RM-1200C,1/30/2015,0,0,0,0,0,0,0
21938,RM-1200C,1/31/2015,0,0,0,0,0,0,0
21939,RM-1200C,2/1/2015,0,0,0,0,0,0,0
21940,RM-1200C,2/2/2015,0,0,0,0,0,0,0
21941,RM-1200C,2/3/2015,0,0,0,0,0,0,0
21942,RM-1200C,2/4/2015,0,0,0,0,0,0,0
21943,RM-1200C,2/5/2015,0,0,0,0,0,0,0
22059,RM-1203,7/1/2013,0,0,0,0,0,0,0
22060,RM-1203,7/2/2013,0,0,0,0,0,0,0
22061,RM-1203,7/3/2013,0,0,0,0,0,0,0
22062,RM-1203,7/4/2013,0,0,0,0,0,0,0
22063,RM-1203,7/5/2013,0,0,0,0,0,0,0
22064,RM-1203,7/6/2013,0,0,0,0,0,0,0
22065,RM-1203,7/7/2013,0,0,0,0,0,0,0
22066,RM-1203,7/8/2013,0,0,0,0,0,0,0
22067,RM-1203,7/9/2013,0,0,0,0,0,0,0
22068,RM-1203,7/10/2013,0,0,0,0,0,0,0
22069,RM-1203,7/11/2013,0,0,0,0,0,0,0
22070,RM-1203,7/12/2013,0,0,0,0,0,0,0
22071,RM-1203,7/13/2013,0,0,0,0,0,0,0
22072,RM-1203,7/14/2013,0,0,0,0,0,0,0
22073,RM-1203,7/15/2013,0,0,0,0,0,0,0
22074,RM-1203,7/17/2013,0,0,0,0,0,0,0
22075,RM-1203,7/18/2013,0,0,0,0,0,0,0
22076,RM-1203,7/19/2013,0,0,0,0,0,0,0
22077,RM-1203,7/20/2013,0,0,0,0,0,0,0
22078,RM-1203,7/21/2013,0,0,0,0,0,0,0
22079,RM-1203,7/22/2013,0,0,0,0,0,0,0
22080,RM-1203,7/23/2013,0,0,0,0,0,0,0
22081,RM-1203,7/24/2013,0,0,0,0,0,0,0
22082,RM-1203,7/25/2013,0,0,0,0,0,0,0
22083,RM-1203,7/26/2013,0,0,0,0,0,0,0
22084,RM-1203,7/27/2013,0,0,0,0,0,0,0
22085,RM-1203,7/28/2013,0,0,0,0,0,0,0
22086,RM-1203,7/29/2013,0,0,0,0,0,0,0
22087,RM-1203,7/30/2013,0,0,0,0,0,0,0
22088,RM-1203,7/31/2013,0,0,0,0,0,0,0
22089,RM-1203,8/1/2013,0,0,0,0,0,0,0
22090,RM-1203,8/2/2013,0,0,0,0,0,0,0
22091,RM-1203,8/3/2013,0,0,0,0,0,0,0
22092,RM-1203,8/4/2013,0,0,0,0,0,0,0
22093,RM-1203,8/5/2013,0,0,0,0,0,0,0
22094,RM-1203,8/6/2013,0,0,0,0,0,0,0
22095,RM-1203,8/7/2013,0,0,0,0,0,0,0
22096,RM-1203,8/8/2013,0,0,0,0,0,0,0
22097,RM-1203,8/9/2013,0,0,0,0,0,0,0
22098,RM-1203,8/10/2013,0,0,0,0,0,0,0
22099,RM-1203,8/11/2013,0,0,0,0,0,0,0
22100,RM-1203,8/12/2013,0,0,0,0,0,0,0
22101,RM-1203,8/13/2013,0,0,0,0,0,0,0
22102,RM-1203,8/14/2013,0,0,0,0,0,0,0
22103,RM-1203,8/15/2013,0,0,0,0,0,0,0
22104,RM-1203,8/16/2013,0,0,0,0,0,0,0
22105,RM-1203,8/17/2013,0,0,0,0,0,0,0
22106,RM-1203,8/18/2013,0,0,0,0,0,0,0
22107,RM-1203,8/19/2013,0,0,0,0,0,0,0
22108,RM-1203,8/20/2013,0,0,0,0,0,0,0
22109,RM-1203,8/21/2013,0,0,0,0,0,0,0
22110,RM-1203,8/22/2013,0,0,0,0,0,0,0
22111,RM-1203,8/27/2013,0,0,0,0,0,0,0
22112,RM-1203,8/28/2013,0,0,0,0,0,0,0
22113,RM-1203,8/29/2013,0,0,0,0,0,0,0
22114,RM-1203,8/30/2013,0,0,0,0,0,0,0
22115,RM-1203,9/4/2013,0,0,0,0,0,0,0
22116,RM-1203,9/5/2013,0,0,0,0,0,0,0
22117,RM-1203,9/6/2013,0,0,0,0,0,0,0
22118,RM-1203,9/7/2013,0,0,0,0,0,0,0
22119,RM-1203,9/9/2013,0,0,0,0,0,0,0
22120,RM-1203,9/10/2013,0,0,0,0,0,0,0
22121,RM-1203,9/11/2013,0,0,0,0,0,0,0
22122,RM-1203,9/12/2013,0,0,0,0,0,0,0
22123,RM-1203,9/13/2013,0,0,0,0,0,0,0
22124,RM-1203,9/14/2013,0,0,0,0,0,0,0
22125,RM-1203,9/15/2013,0,0,0,0,0,0,0
22126,RM-1203,9/16/2013,0,0,0,0,0,0,0
22127,RM-1203,9/17/2013,0,0,0,0,0,0,0
22128,RM-1203,9/18/2013,0,0,0,0,0,0,0
22129,RM-1203,9/19/2013,0,0,0,0,0,0,0
22130,RM-1203,9/20/2013,0,0,0,0,0,0,0
22131,RM-1203,9/21/2013,0,0,0,0,0,0,0
22132,RM-1203,9/22/2013,0,0,0,0,0,0,0
22133,RM-1203,9/23/2013,0,0,0,0,0,0,0
22134,RM-1203,9/24/2013,0,0,0,0,0,0,0
22135,RM-1203,9/25/2013,0,0,0,0,0,0,0
22136,RM-1203,9/26/2013,0,0,0,0,0,0,0
22137,RM-1203,9/27/2013,0,0,0,0,0,0,0
22138,RM-1203,9/28/2013,0,0,0,0,0,0,0
22139,RM-1203,9/29/2013,0,0,0,0,0,0,0
22140,RM-1203,9/30/2013,0,0,0,0,0,0,0
22141,RM-1203,10/1/2013,0,0,0,0,0,0,0
22142,RM-1203,10/2/2013,0,0,0,0,0,0,0
22143,RM-1203,10/3/2013,0,0,0,0,0,0,0
22144,RM-1203,10/4/2013,0,0,0,0,0,0,0
22145,RM-1203,10/5/2013,0,0,0,0,0,0,0
22146,RM-1203,10/6/2013,0,0,0,0,0,0,0
22147,RM-1203,10/7/2013,0,0,0,0,0,0,0
22148,RM-1203,10/8/2013,0,0,0,0,0,0,0
22149,RM-1203,10/9/2013,0,0,0,0,0,0,0
22150,RM-1203,10/10/2013,0,0,0,0,0,0,0
22151,RM-1203,10/11/2013,0,0,0,0,0,0,0
22152,RM-1203,10/12/2013,0,0,0,0,0,0,0
22153,RM-1203,10/13/2013,0,0,0,0,0,0,0
22154,RM-1203,10/14/2013,0,0,0,0,0,0,0
22155,RM-1203,10/15/2013,0,0,0,0,0,0,0
22156,RM-1203,10/16/2013,0,0,0,0,0,0,0
22157,RM-1203,10/17/2013,0,0,0,0,0,0,0
22158,RM-1203,10/18/2013,0,0,0,0,0,0,0
22159,RM-1203,10/19/2013,0,0,0,0,0,0,0
22160,RM-1203,10/20/2013,0,0,0,0,0,0,0
22161,RM-1203,10/21/2013,0,0,0,0,0,0,0
22162,RM-1203,10/22/2013,0,0,0,0,0,0,0
22163,RM-1203,10/23/2013,0,0,0,0,0,0,0
22164,RM-1203,10/24/2013,0,0,0,0,0,0,0
22165,RM-1203,10/25/2013,0,0,0,0,0,0,0
22166,RM-1203,10/26/2013,0,0,0,0,0,0,0
22167,RM-1203,10/27/2013,0,0,0,0,0,0,0
22168,RM-1203,10/28/2013,0,0,0,0,0,0,0
22169,RM-1203,10/29/2013,0,0,0,0,0,0,0
22170,RM-1203,10/30/2013,0,0,0,0,0,0,0
22171,RM-1203,10/31/2013,0,0,0,0,0,0,0
22172,RM-1203,11/1/2013,0,0,0,0,0,0,0
22173,RM-1203,11/2/2013,0,0,0,0,0,0,0
22174,RM-1203,11/3/2013,0,0,0,0,0,0,0
22175,RM-1203,11/4/2013,0,0,0,0,0,0,0
22176,RM-1203,11/5/2013,0,0,0,0,0,0,0
22177,RM-1203,11/6/2013,0,0,0,0,0,0,0
22178,RM-1203,11/7/2013,0,0,0,0,0,0,0
22179,RM-1203,11/8/2013,0,0,0,0,0,0,0
22180,RM-1203,11/9/2013,0,0,0,0,0,0,0
22181,RM-1203,11/10/2013,0,0,0,0,0,0,0
22182,RM-1203,11/11/2013,0,0,0,0,0,0,0
22183,RM-1203,11/12/2013,0,0,0,0,0,0,0
22184,RM-1203,11/13/2013,0,0,0,0,0,0,0
22185,RM-1203,11/14/2013,0,0,0,0,0,0,0
22186,RM-1203,11/15/2013,0,0,0,0,0,0,0
22187,RM-1203,11/19/2013,0,0,0,0,0,0,0
22188,RM-1203,11/20/2013,0,0,0,0,0,0,0
22189,RM-1203,11/21/2013,0,0,0,0,0,0,0
22190,RM-1203,11/22/2013,0,0,0,0,0,0,0
22191,RM-1203,11/23/2013,0,0,0,0,0,0,0
22192,RM-1203,11/24/2013,0,0,0,0,0,0,0
22193,RM-1203,11/25/2013,0,0,0,0,0,0,0
22194,RM-1203,11/26/2013,0,0,0,0,0,0,0
22195,RM-1203,11/27/2013,0,0,0,0,0,0,0
22196,RM-1203,11/28/2013,0,0,0,0,0,0,0
22197,RM-1203,11/29/2013,0,0,0,0,0,0,0
22198,RM-1203,11/30/2013,0,0,0,0,0,0,0
22199,RM-1203,12/1/2013,0,0,0,0,0,0,0
22200,RM-1203,12/2/2013,0,0,0,0,0,0,0
22201,RM-1203,12/3/2013,0,0,0,0,0,0,0
22202,RM-1203,12/4/2013,0,0,0,0,0,0,0
22203,RM-1203,12/5/2013,0,0,0,0,0,0,0
22204,RM-1203,12/6/2013,0,0,0,0,0,0,0
22205,RM-1203,12/7/2013,0,0,0,0,0,0,0
22206,RM-1203,12/8/2013,0,0,0,0,0,0,0
22207,RM-1203,12/9/2013,0,0,0,0,0,0,0
22208,RM-1203,12/10/2013,0,0,0,0,0,0,0
22209,RM-1203,12/11/2013,0,0,0,0,0,0,0
22210,RM-1203,12/12/2013,0,0,0,0,0,0,0
22211,RM-1203,12/13/2013,0,0,0,0,0,0,0
22212,RM-1203,12/14/2013,0,0,0,0,0,0,0
22213,RM-1203,12/15/2013,0,0,0,0,0,0,0
22214,RM-1203,12/16/2013,0,0,0,0,0,0,0
22215,RM-1203,12/17/2013,0,0,0,0,0,0,0
22216,RM-1203,12/18/2013,0,0,0,0,0,0,0
22217,RM-1203,12/19/2013,0,0,0,0,0,0,0
22218,RM-1203,12/20/2013,0,0,0,0,0,0,0
22219,RM-1203,12/21/2013,0,0,0,0,0,0,0
22220,RM-1203,12/22/2013,0,0,0,0,0,0,0
22221,RM-1203,12/23/2013,0,0,0,0,0,0,0
22222,RM-1203,12/24/2013,0,0,0,0,0,0,0
22223,RM-1203,12/25/2013,0,0,0,0,0,0,0
22224,RM-1203,12/26/2013,0,0,0,0,0,0,0
22225,RM-1203,12/27/2013,0,0,0,0,0,0,0
22226,RM-1203,12/28/2013,0,0,0,0,0,0,0
22227,RM-1203,12/29/2013,0,0,0,0,0,0,0
22228,RM-1203,12/30/2013,0,0,0,0,0,0,0
22229,RM-1203,12/31/2013,0,0,0,0,0,0,0
22230,RM-1203,1/1/2014,0,0,0,0,0,0,0
22231,RM-1203,1/2/2014,0,0,0,0,0,0,0
22232,RM-1203,1/3/2014,0,0,0,0,0,0,0
22233,RM-1203,1/4/2014,0,0,0,0,0,0,0
22234,RM-1203,1/5/2014,0,0,0,0,0,0,0
22235,RM-1203,1/6/2014,0,0,0,0,0,0,0
22236,RM-1203,1/7/2014,0,0,0,0,0,0,0
22237,RM-1203,1/8/2014,0,0,0,0,0,0,0
22238,RM-1203,1/9/2014,0,0,0,0,0,0,0
22239,RM-1203,1/10/2014,0,0,0,0,0,0,0
22240,RM-1203,1/11/2014,0,0,0,0,0,0,0
22241,RM-1203,1/12/2014,0,0,0,0,0,0,0
22242,RM-1203,1/13/2014,0,0,0,0,0,0,0
22243,RM-1203,1/14/2014,0,0,0,0,0,0,0
22244,RM-1203,1/15/2014,0,0,0,0,0,0,0
22245,RM-1203,1/16/2014,0,0,0,0,0,0,0
22246,RM-1203,1/17/2014,0,0,0,0,0,0,0
22247,RM-1203,1/18/2014,0,0,0,0,0,0,0
22248,RM-1203,1/19/2014,0,0,0,0,0,0,0
22249,RM-1203,1/20/2014,0,0,0,0,0,0,0
22250,RM-1203,1/21/2014,0,0,0,0,0,0,0
22251,RM-1203,1/22/2014,0,0,0,0,0,0,0
22252,RM-1203,1/23/2014,0,0,0,0,0,0,0
22253,RM-1203,1/24/2014,0,0,0,0,0,0,0
22254,RM-1203,1/25/2014,0,0,0,0,0,0,0
22255,RM-1203,1/26/2014,0,0,0,0,0,0,0
22256,RM-1203,1/27/2014,0,0,0,0,0,0,0
22257,RM-1203,1/28/2014,0,0,0,0,0,0,0
22258,RM-1203,1/29/2014,0,0,0,0,0,0,0
22259,RM-1203,1/30/2014,0,0,0,0,0,0,0
22260,RM-1203,1/31/2014,0,0,0,0,0,0,0
22261,RM-1203,2/1/2014,0,0,0,0,0,0,0
22262,RM-1203,2/2/2014,0,0,0,0,0,0,0
22263,RM-1203,2/3/2014,0,0,0,0,0,0,0
22264,RM-1203,2/4/2014,0,0,0,0,0,0,0
22265,RM-1203,2/5/2014,0,0,0,0,0,0,0
22266,RM-1203,2/6/2014,0,0,0,0,0,0,0
22267,RM-1203,2/7/2014,0,0,0,0,0,0,0
22268,RM-1203,2/8/2014,0,0,0,0,0,0,0
22269,RM-1203,2/9/2014,0,0,0,0,0,0,0
22270,RM-1203,2/10/2014,0,0,0,0,0,0,0
22271,RM-1203,2/11/2014,0,0,0,0,0,0,0
22272,RM-1203,2/12/2014,0,0,0,0,0,0,0
22273,RM-1203,2/13/2014,0,0,0,0,0,0,0
22274,RM-1203,2/14/2014,0,0,0,0,0,0,0
22275,RM-1203,2/15/2014,0,0,0,0,0,0,0
22276,RM-1203,4/14/2014,0,0,0,0,0,0,0
22277,RM-1203,4/15/2014,0,0,0,0,0,0,0
22278,RM-1203,4/16/2014,0,0,0,0,0,0,0
22279,RM-1203,4/17/2014,0,0,0,0,0,0,0
22280,RM-1203,4/18/2014,0,0,0,0,0,0,0
22281,RM-1203,4/19/2014,0,0,0,0,0,0,0
22282,RM-1203,4/20/2014,0,0,0,0,0,0,0
22283,RM-1203,4/21/2014,0,0,0,0,0,0,0
22284,RM-1203,4/22/2014,0,0,0,0,0,0,0
22285,RM-1203,4/23/2014,0,0,0,0,0,0,0
22286,RM-1203,4/24/2014,0,0,0,0,0,0,0
22287,RM-1203,4/25/2014,0,0,0,0,0,0,0
22288,RM-1203,4/26/2014,0,0,0,0,0,0,0
22289,RM-1203,4/27/2014,0,0,0,0,0,0,0
22290,RM-1203,4/28/2014,0,0,0,0,0,0,0
22291,RM-1203,4/29/2014,0,0,0,0,0,0,0
22292,RM-1203,4/30/2014,0,0,0,0,0,0,0
22293,RM-1203,5/1/2014,0,0,0,0,0,0,0
22294,RM-1203,5/2/2014,0,0,0,0,0,0,0
22295,RM-1203,5/3/2014,0,0,0,0,0,0,0
22296,RM-1203,5/4/2014,0,0,0,0,0,0,0
22297,RM-1203,5/5/2014,0,0,0,0,0,0,0
22298,RM-1203,5/6/2014,0,0,0,0,0,0,0
22299,RM-1203,5/7/2014,0,0,0,0,0,0,0
22300,RM-1203,5/8/2014,0,0,0,0,0,0,0
22301,RM-1203,5/9/2014,0,0,0,0,0,0,0
22302,RM-1203,5/10/2014,0,0,0,0,0,0,0
22303,RM-1203,5/11/2014,0,0,0,0,0,0,0
22304,RM-1203,5/12/2014,0,0,0,0,0,0,0
22305,RM-1203,5/13/2014,0,0,0,0,0,0,0
22306,RM-1203,5/14/2014,0,0,0,0,0,0,0
22307,RM-1203,5/15/2014,0,0,0,0,0,0,0
22308,RM-1203,5/16/2014,0,0,0,0,0,0,0
22309,RM-1203,5/17/2014,0,0,0,0,0,0,0
22310,RM-1203,5/18/2014,0,0,0,0,0,0,0
22311,RM-1203,5/19/2014,0,0,0,0,0,0,0
22312,RM-1203,5/20/2014,0,0,0,0,0,0,0
22313,RM-1203,5/21/2014,0,0,0,0,0,0,0
22314,RM-1203,5/22/2014,0,0,0,0,0,0,0
22315,RM-1203,5/23/2014,0,0,0,0,0,0,0
22316,RM-1203,5/24/2014,0,0,0,0,0,0,0
22317,RM-1203,5/25/2014,0,0,0,0,0,0,0
22318,RM-1203,5/26/2014,0,0,0,0,0,0,0
22319,RM-1203,5/27/2014,0,0,0,0,0,0,0
22320,RM-1203,5/28/2014,0,0,0,0,0,0,0
22321,RM-1203,5/29/2014,0,0,0,0,0,0,0
22322,RM-1203,5/30/2014,0,0,0,0,0,0,0
22323,RM-1203,5/31/2014,0,0,0,0,0,0,0
22324,RM-1203,6/1/2014,0,0,0,0,0,0,0
22325,RM-1203,6/2/2014,0,0,0,0,0,0,0
22326,RM-1203,6/3/2014,0,0,0,0,0,0,0
22327,RM-1203,6/4/2014,0,0,0,0,0,0,0
22328,RM-1203,6/5/2014,0,0,0,0,0,0,0
22329,RM-1203,6/6/2014,0,0,0,0,0,0,0
22330,RM-1203,6/7/2014,0,0,0,0,0,0,0
22331,RM-1203,6/8/2014,0,0,0,0,0,0,0
22332,RM-1203,6/9/2014,0,0,0,0,0,0,0
22333,RM-1203,6/10/2014,0,0,0,0,0,0,0
22334,RM-1203,6/11/2014,0,0,0,0,0,0,0
22335,RM-1203,6/12/2014,0,0,0,0,0,0,0
22336,RM-1203,6/13/2014,0,0,0,0,0,0,0
22337,RM-1203,6/14/2014,0,0,0,0,0,0,0
22338,RM-1203,6/15/2014,0,0,0,0,0,0,0
22339,RM-1203,6/16/2014,0,0,0,0,0,0,0
22340,RM-1203,6/17/2014,0,0,0,0,0,0,0
22341,RM-1203,6/18/2014,0,0,0,0,0,0,0
22342,RM-1203,6/19/2014,0,0,0,0,0,0,0
22343,RM-1203,6/20/2014,0,0,0,0,0,0,0
22344,RM-1203,6/21/2014,0,0,0,0,0,0,0
22345,RM-1203,6/22/2014,0,0,0,0,0,0,0
22346,RM-1203,6/23/2014,0,0,0,0,0,0,0
22347,RM-1203,6/24/2014,0,0,0,0,0,0,0
22348,RM-1203,6/25/2014,0,0,0,0,0,0,0
22349,RM-1203,6/26/2014,0,0,0,0,0,0,0
22350,RM-1203,6/27/2014,0,0,0,0,0,0,0
22351,RM-1203,6/28/2014,0,0,0,0,0,0,0
22352,RM-1203,6/29/2014,0,0,0,0,0,0,0
22353,RM-1203,6/30/2014,0,0,0,0,0,0,0
22354,RM-1203,7/1/2014,0,0,0,0,0,0,0
22355,RM-1203,7/2/2014,0,0,0,0,0,0,0
22356,RM-1203,7/3/2014,0,0,0,0,0,0,0
22357,RM-1203,7/4/2014,0,0,0,0,0,0,0
22358,RM-1203,7/5/2014,0,0,0,0,0,0,0
22359,RM-1203,7/6/2014,0,0,0,0,0,0,0
22360,RM-1203,7/7/2014,0,0,0,0,0,0,0
22361,RM-1203,7/8/2014,0,0,0,0,0,0,0
22362,RM-1203,7/9/2014,0,0,0,0,0,0,0
22363,RM-1203,7/10/2014,0,0,0,0,0,0,0
22364,RM-1203,7/11/2014,0,0,0,0,0,0,0
22365,RM-1203,7/12/2014,0,0,0,0,0,0,0
22366,RM-1203,7/13/2014,0,0,0,0,0,0,0
22367,RM-1203,7/14/2014,0,0,0,0,0,0,0
22368,RM-1203,7/15/2014,0,0,0,0,0,0,0
22369,RM-1203,7/16/2014,0,0,0,0,0,0,0
22370,RM-1203,7/17/2014,0,0,0,0,0,0,0
22371,RM-1203,7/18/2014,0,0,0,0,0,0,0
22372,RM-1203,7/19/2014,0,0,0,0,0,0,0
22373,RM-1203,7/20/2014,0,0,0,0,0,0,0
22374,RM-1203,7/21/2014,0,0,0,0,0,0,0
22375,RM-1203,7/22/2014,0,0,0,0,0,0,0
22376,RM-1203,7/23/2014,0,0,0,0,0,0,0
22377,RM-1203,7/24/2014,0,0,0,0,0,0,0
22378,RM-1203,7/25/2014,0,0,0,0,0,0,0
22379,RM-1203,7/26/2014,0,0,0,0,0,0,0
22380,RM-1203,7/27/2014,0,0,0,0,0,0,0
22381,RM-1203,7/28/2014,0,0,0,0,0,0,0
22382,RM-1203,7/29/2014,0,0,0,0,0,0,0
22383,RM-1203,7/30/2014,0,0,0,0,0,0,0
22384,RM-1203,7/31/2014,0,0,0,0,0,0,0
22385,RM-1203,8/1/2014,0,0,0,0,0,0,0
22386,RM-1203,8/2/2014,0,0,0,0,0,0,0
22387,RM-1203,8/3/2014,0,0,0,0,0,0,0
22388,RM-1203,8/4/2014,0,0,0,0,0,0,0
22389,RM-1203,8/5/2014,0,0,0,0,0,0,0
22390,RM-1203,8/6/2014,0,0,0,0,0,0,0
22391,RM-1203,8/7/2014,0,0,0,0,0,0,0
22392,RM-1203,8/8/2014,0,0,0,0,0,0,0
22393,RM-1203,8/9/2014,0,0,0,0,0,0,0
22394,RM-1203,8/10/2014,0,0,0,0,0,0,0
22395,RM-1203,8/11/2014,0,0,0,0,0,0,0
22396,RM-1203,8/12/2014,0,0,0,0,0,0,0
22397,RM-1203,8/13/2014,0,0,0,0,0,0,0
22398,RM-1203,8/14/2014,0,0,0,0,0,0,0
22399,RM-1203,8/15/2014,0,0,0,0,0,0,0
22400,RM-1203,8/16/2014,0,0,0,0,0,0,0
22401,RM-1203,8/17/2014,0,0,0,0,0,0,0
22402,RM-1203,8/18/2014,0,0,0,0,0,0,0
22403,RM-1203,8/19/2014,0,0,0,0,0,0,0
22404,RM-1203,8/20/2014,0,0,0,0,0,0,0
22405,RM-1203,8/21/2014,0,0,0,0,0,0,0
22406,RM-1203,8/22/2014,0,0,0,0,0,0,0
22407,RM-1203,8/23/2014,0,0,0,0,0,0,0
22408,RM-1203,8/24/2014,0,0,0,0,0,0,0
22409,RM-1203,8/25/2014,0,0,0,0,0,0,0
22410,RM-1203,8/26/2014,0,0,0,0,0,0,0
22411,RM-1203,8/27/2014,0,0,0,0,0,0,0
22412,RM-1203,8/28/2014,0,0,0,0,0,0,0
22413,RM-1203,8/29/2014,0,0,0,0,0,0,0
22414,RM-1203,8/30/2014,0,0,0,0,0,0,0
22415,RM-1203,8/31/2014,0,0,0,0,0,0,0
22416,RM-1203,9/1/2014,0,0,0,0,0,0,0
22417,RM-1203,9/2/2014,0,0,0,0,0,0,0
22418,RM-1203,9/3/2014,0,0,0,0,0,0,0
22419,RM-1203,9/4/2014,0,0,0,0,0,0,0
22420,RM-1203,9/5/2014,0,0,0,0,0,0,0
22421,RM-1203,9/6/2014,0,0,0,0,0,0,0
22422,RM-1203,9/7/2014,0,0,0,0,0,0,0
22423,RM-1203,9/8/2014,0,0,0,0,0,0,0
22424,RM-1203,9/9/2014,0,0,0,0,0,0,0
22425,RM-1203,9/10/2014,0,0,0,0,0,0,0
22426,RM-1203,9/11/2014,0,0,0,0,0,0,0
22427,RM-1203,9/12/2014,0,0,0,0,0,0,0
22428,RM-1203,9/13/2014,0,0,0,0,0,0,0
22429,RM-1203,9/14/2014,0,0,0,0,0,0,0
22430,RM-1203,9/15/2014,0,0,0,0,0,0,0
22431,RM-1203,9/16/2014,0,0,0,0,0,0,0
22432,RM-1203,9/17/2014,0,0,0,0,0,0,0
22433,RM-1203,9/18/2014,0,0,0,0,0,0,0
22434,RM-1203,9/19/2014,0,0,0,0,0,0,0
22435,RM-1203,9/20/2014,0,0,0,0,0,0,0
22436,RM-1203,9/21/2014,0,0,0,0,0,0,0
22437,RM-1203,9/22/2014,0,0,0,0,0,0,0
22438,RM-1203,9/23/2014,0,0,0,0,0,0,0
22439,RM-1203,9/24/2014,0,0,0,0,0,0,0
22440,RM-1203,9/25/2014,0,0,0,0,0,0,0
22441,RM-1203,9/28/2014,0,0,0,0,0,0,0
22442,RM-1203,9/29/2014,0,0,0,0,0,0,0
22443,RM-1203,9/30/2014,0,0,0,0,0,0,0
22444,RM-1203,10/1/2014,0,0,0,0,0,0,0
22445,RM-1203,10/2/2014,0,0,0,0,0,0,0
22446,RM-1203,10/3/2014,0,0,0,0,0,0,0
22447,RM-1203,10/4/2014,0,0,0,0,0,0,0
22448,RM-1203,10/5/2014,0,0,0,0,0,0,0
22449,RM-1203,10/6/2014,0,0,0,0,0,0,0
22450,RM-1203,10/7/2014,0,0,0,0,0,0,0
22451,RM-1203,10/8/2014,0,0,0,0,0,0,0
22452,RM-1203,10/9/2014,0,0,0,0,0,0,0
22453,RM-1203,10/10/2014,0,0,0,0,0,0,0
22454,RM-1203,10/11/2014,0,0,0,0,0,0,0
22455,RM-1203,10/12/2014,0,0,0,0,0,0,0
22456,RM-1203,10/13/2014,0,0,0,0,0,0,0
22457,RM-1203,10/14/2014,0,0,0,0,0,0,0
22458,RM-1203,10/15/2014,0,0,0,0,0,0,0
22459,RM-1203,10/16/2014,0,0,0,0,0,0,0
22460,RM-1203,10/17/2014,0,0,0,0,0,0,0
22461,RM-1203,10/18/2014,0,0,0,0,0,0,0
22462,RM-1203,10/19/2014,0,0,0,0,0,0,0
22463,RM-1203,10/20/2014,0,0,0,0,0,0,0
22464,RM-1203,10/21/2014,0,0,0,0,0,0,0
22465,RM-1203,10/22/2014,0,0,0,0,0,0,0
22466,RM-1203,10/23/2014,0,0,0,0,0,0,0
22467,RM-1203,10/24/2014,0,0,0,0,0,0,0
22468,RM-1203,10/25/2014,0,0,0,0,0,0,0
22469,RM-1203,10/26/2014,0,0,0,0,0,0,0
22470,RM-1203,10/27/2014,0,0,0,0,0,0,0
22471,RM-1203,10/28/2014,0,0,0,0,0,0,0
22472,RM-1203,10/29/2014,0,0,0,0,0,0,0
22473,RM-1203,10/30/2014,0,0,0,0,0,0,0
22474,RM-1203,10/31/2014,0,0,0,0,0,0,0
22475,RM-1203,11/1/2014,0,0,0,0,0,0,0
22476,RM-1203,11/2/2014,0,0,0,0,0,0,0
22477,RM-1203,11/3/2014,0,0,0,0,0,0,0
22478,RM-1203,11/4/2014,0,0,0,0,0,0,0
22479,RM-1203,11/5/2014,0,0,0,0,0,0,0
22480,RM-1203,11/6/2014,0,0,0,0,0,0,0
22481,RM-1203,11/7/2014,0,0,0,0,0,0,0
22482,RM-1203,11/8/2014,0,0,0,0,0,0,0
22483,RM-1203,11/9/2014,0,0,0,0,0,0,0
22484,RM-1203,11/10/2014,0,0,0,0,0,0,0
22485,RM-1203,11/11/2014,0,0,0,0,0,0,0
22486,RM-1203,11/12/2014,0,0,0,0,0,0,0
22487,RM-1203,11/13/2014,0,0,0,0,0,0,0
22488,RM-1203,11/14/2014,0,0,0,0,0,0,0
22489,RM-1203,11/15/2014,0,0,0,0,0,0,0
22490,RM-1203,11/16/2014,0,0,0,0,0,0,0
22491,RM-1203,11/17/2014,0,0,0,0,0,0,0
22492,RM-1203,11/18/2014,0,0,0,0,0,0,0
22493,RM-1203,11/19/2014,0,0,0,0,0,0,0
22494,RM-1203,11/20/2014,0,0,0,0,0,0,0
22495,RM-1203,11/21/2014,0,0,0,0,0,0,0
22496,RM-1203,11/22/2014,0,0,0,0,0,0,0
22497,RM-1203,11/23/2014,0,0,0,0,0,0,0
22498,RM-1203,11/24/2014,0,0,0,0,0,0,0
22499,RM-1203,11/25/2014,0,0,0,0,0,0,0
22500,RM-1203,11/26/2014,0,0,0,0,0,0,0
22501,RM-1203,11/27/2014,0,0,0,0,0,0,0
22502,RM-1203,11/28/2014,0,0,0,0,0,0,0
22503,RM-1203,11/29/2014,0,0,0,0,0,0,0
22504,RM-1203,11/30/2014,0,0,0,0,0,0,0
22505,RM-1203,12/1/2014,0,0,0,0,0,0,0
22506,RM-1203,12/2/2014,0,0,0,0,0,0,0
22507,RM-1203,12/3/2014,0,0,0,0,0,0,0
22508,RM-1203,12/4/2014,0,0,0,0,0,0,0
22509,RM-1203,12/5/2014,0,0,0,0,0,0,0
22510,RM-1203,12/6/2014,0,0,0,0,0,0,0
22511,RM-1203,12/7/2014,0,0,0,0,0,0,0
22512,RM-1203,12/8/2014,0,0,0,0,0,0,0
22513,RM-1203,12/9/2014,0,0,0,0,0,0,0
22514,RM-1203,12/10/2014,0,0,0,0,0,0,0
22515,RM-1203,12/11/2014,0,0,0,0,0,0,0
22516,RM-1203,12/12/2014,0,0,0,0,0,0,0
22517,RM-1203,12/13/2014,0,0,0,0,0,0,0
22518,RM-1203,12/14/2014,0,0,0,0,0,0,0
22519,RM-1203,12/15/2014,0,0,0,0,0,0,0
22520,RM-1203,12/16/2014,0,0,0,0,0,0,0
22521,RM-1203,12/17/2014,0,0,0,0,0,0,0
22522,RM-1203,12/18/2014,0,0,0,0,0,0,0
22523,RM-1203,12/19/2014,0,0,0,0,0,0,0
22524,RM-1203,12/20/2014,0,0,0,0,0,0,0
22525,RM-1203,12/21/2014,0,0,0,0,0,0,0
22526,RM-1203,12/22/2014,0,0,0,0,0,0,0
22527,RM-1203,12/23/2014,0,0,0,0,0,0,0
22528,RM-1203,12/24/2014,0,0,0,0,0,0,0
22529,RM-1203,12/25/2014,0,0,0,0,0,0,0
22530,RM-1203,12/26/2014,0,0,0,0,0,0,0
22531,RM-1203,12/27/2014,0,0,0,0,0,0,0
22532,RM-1203,12/28/2014,0,0,0,0,0,0,0
22533,RM-1203,12/29/2014,0,0,0,0,0,0,0
22534,RM-1203,12/30/2014,0,0,0,0,0,0,0
22535,RM-1203,12/31/2014,0,0,0,0,0,0,0
22536,RM-1203,1/1/2015,0,0,0,0,0,0,0
22537,RM-1203,1/2/2015,0,0,0,0,0,0,0
22538,RM-1203,1/3/2015,0,0,0,0,0,0,0
22539,RM-1203,1/4/2015,0,0,0,0,0,0,0
22540,RM-1203,1/5/2015,0,0,0,0,0,0,0
22541,RM-1203,1/6/2015,0,0,0,0,0,0,0
22542,RM-1203,1/7/2015,0,0,0,0,0,0,0
22543,RM-1203,1/8/2015,0,0,0,0,0,0,0
22544,RM-1203,1/9/2015,0,0,0,0,0,0,0
22545,RM-1203,1/10/2015,0,0,0,0,0,0,0
22546,RM-1203,1/11/2015,0,0,0,0,0,0,0
22547,RM-1203,1/12/2015,0,0,0,0,0,0,0
22548,RM-1203,1/13/2015,0,0,0,0,0,0,0
22549,RM-1203,1/14/2015,0,0,0,0,0,0,0
22550,RM-1203,1/15/2015,0,0,0,0,0,0,0
22551,RM-1203,1/16/2015,0,0,0,0,0,0,0
22552,RM-1203,1/17/2015,0,0,0,0,0,0,0
22553,RM-1203,1/18/2015,0,0,0,0,0,0,0
22554,RM-1203,1/19/2015,0,0,0,0,0,0,0
22555,RM-1203,1/20/2015,0,0,0,0,0,0,0
22556,RM-1203,1/21/2015,0,0,0,0,0,0,0
22557,RM-1203,1/22/2015,0,0,0,0,0,0,0
22558,RM-1203,1/23/2015,0,0,0,0,0,0,0
22559,RM-1203,1/24/2015,0,0,0,0,0,0,0
22560,RM-1203,1/25/2015,0,0,0,0,0,0,0
22561,RM-1203,1/26/2015,0,0,0,0,0,0,0
22562,RM-1203,1/27/2015,0,0,0,0,0,0,0
22563,RM-1203,1/28/2015,0,0,0,0,0,0,0
22564,RM-1203,1/29/2015,0,0,0,0,0,0,0
22565,RM-1203,1/30/2015,0,0,0,0,0,0,0
22566,RM-1203,1/31/2015,0,0,0,0,0,0,0
22567,RM-1203,2/1/2015,0,0,0,0,0,0,0
22568,RM-1203,2/2/2015,0,0,0,0,0,0,0
22569,RM-1203,2/3/2015,0,0,0,0,0,0,0
22570,RM-1203,2/4/2015,0,0,0,0,0,0,0
22571,RM-1203,2/5/2015,0,0,0,0,0,0,0
22572,RM-1203,2/6/2015,0,0,0,0,0,0,0
22573,RM-1203,2/7/2015,0,0,0,0,0,0,0
22574,RM-1203,2/8/2015,0,0,0,0,0,0,0
22575,RM-1203,2/9/2015,0,0,0,0,0,0,0
22576,RM-1203,2/10/2015,0,0,0,0,0,0,0
22577,RM-1203,2/11/2015,0,0,0,0,0,0,0
22578,RM-1203,2/12/2015,0,0,0,0,0,0,0
22579,RM-1203,2/13/2015,0,0,0,0,0,0,0
22580,RM-1203,2/14/2015,0,0,0,0,0,0,0
22581,RM-1203,2/15/2015,0,0,0,0,0,0,0
22582,RM-1203,2/16/2015,0,0,0,0,0,0,0
22583,RM-1203,2/17/2015,0,0,0,0,0,0,0
22584,RM-1203,2/18/2015,0,0,0,0,0,0,0
22585,RM-1203,2/19/2015,0,0,0,0,0,0,0
22586,RM-1203,2/20/2015,0,0,0,0,0,0,0
22587,RM-1203,2/21/2015,0,0,0,0,0,0,0
22588,RM-1203,2/22/2015,0,0,0,0,0,0,0
22589,RM-1203,2/23/2015,0,0,0,0,0,0,0
22590,RM-1203,2/24/2015,0,0,0,0,0,0,0
22591,RM-1203,2/25/2015,0,0,0,0,0,0,0
22592,RM-1203,2/26/2015,0,0,0,0,0,0,0
22593,RM-1203,2/27/2015,0,0,0,0,0,0,0
22594,RM-1203,2/28/2015,0,0,0,0,0,0,0
22595,RM-1203,3/1/2015,0,0,0,0,0,0,0
22596,RM-1203,3/2/2015,0,0,0,0,0,0,0
22597,RM-1203,3/3/2015,0,0,0,0,0,0,0
22598,RM-1203,3/4/2015,0,0,0,0,0,0,0
22599,RM-1203,3/5/2015,0,0,0,0,0,0,0
22600,RM-1203,3/6/2015,0,0,0,0,0,0,0
22601,RM-1203,3/7/2015,0,0,0,0,0,0,0
22602,RM-1203,3/8/2015,0,0,0,0,0,0,0
22603,RM-1203,3/9/2015,0,0,0,0,0,0,0
22604,RM-1203,3/10/2015,0,0,0,0,0,0,0
22605,RM-1203,3/11/2015,0,0,0,0,0,0,0
22606,RM-1203,3/12/2015,0,0,0,0,0,0,0
22607,RM-1203,3/13/2015,0,0,0,0,0,0,0
22608,RM-1203,3/14/2015,0,0,0,0,0,0,0
22609,RM-1203,3/15/2015,0,0,0,0,0,0,0
22610,RM-1203,3/16/2015,0,0,0,0,0,0,0
22611,RM-1203,3/17/2015,0,0,0,0,0,0,0
22612,RM-1203,3/18/2015,0,0,0,0,0,0,0
22613,RM-1203,3/19/2015,0,0,0,0,0,0,0
22614,RM-1203,3/20/2015,0,0,0,0,0,0,0
22615,RM-1203,3/21/2015,0,0,0,0,0,0,0
22616,RM-1203,3/22/2015,0,0,0,0,0,0,0
22617,RM-1203,3/23/2015,0,0,0,0,0,0,0
22618,RM-1203,3/24/2015,0,0,0,0,0,0,0
22619,RM-1203,3/25/2015,0,0,0,0,0,0,0
22620,RM-1203,3/26/2015,0,0,0,0,0,0,0
22621,RM-1203,3/27/2015,0,0,0,0,0,0,0
22622,RM-1203,3/28/2015,0,0,0,0,0,0,0
22623,RM-1203,3/29/2015,0,0,0,0,0,0,0
22624,RM-1203,3/30/2015,0,0,0,0,0,0,0
22625,RM-1203,3/31/2015,0,0,0,0,0,0,0
22626,RM-1203,4/1/2015,0,0,0,0,0,0,0
22627,RM-1203,4/2/2015,0,0,0,0,0,0,0
22628,RM-1203,4/3/2015,0,0,0,0,0,0,0
22629,RM-1203,4/4/2015,0,0,0,0,0,0,0
22630,RM-1203,4/5/2015,0,0,0,0,0,0,0
22631,RM-1203,4/6/2015,0,0,0,0,0,0,0
22632,RM-1203,4/7/2015,0,0,0,0,0,0,0
22633,RM-1203,4/8/2015,0,0,0,0,0,0,0
22634,RM-1203,4/9/2015,0,0,0,0,0,0,0
22635,RM-1203,4/10/2015,0,0,0,0,0,0,0
22636,RM-1203,4/11/2015,0,0,0,0,0,0,0
22637,RM-1203,4/12/2015,0,0,0,0,0,0,0
22638,RM-1203,4/13/2015,0,0,0,0,0,0,0
22639,RM-1203,4/14/2015,0,0,0,0,0,0,0
22640,RM-1203,4/15/2015,0,0,0,0,0,0,0
22641,RM-1203,4/16/2015,0,0,0,0,0,0,0
22642,RM-1203,4/17/2015,0,0,0,0,0,0,0
22643,RM-1203,4/18/2015,0,0,0,0,0,0,0
22644,RM-1203,4/19/2015,0,0,0,0,0,0,0
22645,RM-1203,4/20/2015,0,0,0,0,0,0,0
22646,RM-1203,4/21/2015,0,0,0,0,0,0,0
22647,RM-1203,4/22/2015,0,0,0,0,0,0,0
22648,RM-1203,4/23/2015,0,0,0,0,0,0,0
22649,RM-1203,4/24/2015,0,0,0,0,0,0,0
22650,RM-1203,4/25/2015,0,0,0,0,0,0,0
22651,RM-1203,4/26/2015,0,0,0,0,0,0,0
22652,RM-1203,4/27/2015,0,0,0,0,0,0,0
22653,RM-1203,4/28/2015,0,0,0,0,0,0,0
22654,RM-1203,4/29/2015,0,0,0,0,0,0,0
22655,RM-1203,4/30/2015,0,0,0,0,0,0,0
22656,RM-1203,5/1/2015,0,0,0,0,0,0,0
22657,RM-1203,5/2/2015,0,0,0,0,0,0,0
22658,RM-1203,5/3/2015,0,0,0,0,0,0,0
22659,RM-1203,5/4/2015,0,0,0,0,0,0,0
22660,RM-1203,5/5/2015,0,0,0,0,0,0,0
22661,RM-1203,5/6/2015,0,0,0,0,0,0,0
22662,RM-1203,5/7/2015,0,0,0,0,0,0,0
22663,RM-1203,5/8/2015,0,0,0,0,0,0,0
22664,RM-1203,5/9/2015,0,0,0,0,0,0,0
22665,RM-1203,5/10/2015,0,0,0,0,0,0,0
22666,RM-1203,5/11/2015,0,0,0,0,0,0,0
22667,RM-1203,5/12/2015,0,0,0,0,0,0,0
22668,RM-1203,5/13/2015,0,0,0,0,0,0,0
22669,RM-1203,5/14/2015,0,0,0,0,0,0,0
22670,RM-1203,5/15/2015,0,0,0,0,0,0,0
22671,RM-1203,5/16/2015,0,0,0,0,0,0,0
22672,RM-1203,5/17/2015,0,0,0,0,0,0,0
22673,RM-1203,5/18/2015,0,0,0,0,0,0,0
22674,RM-1203,5/19/2015,0,0,0,0,0,0,0
22675,RM-1203,5/20/2015,0,0,0,0,0,0,0
22676,RM-1203,5/21/2015,0,0,0,0,0,0,0
22677,RM-1203,5/22/2015,0,0,0,0,0,0,0
22678,RM-1203,5/23/2015,0,0,0,0,0,0,0
22679,RM-1203,5/24/2015,0,0,0,0,0,0,0
22680,RM-1203,5/25/2015,0,0,0,0,0,0,0
22681,RM-1203,5/26/2015,0,0,0,0,0,0,0
22682,RM-1203,5/27/2015,0,0,0,0,0,0,0
22683,RM-1203,5/28/2015,0,0,0,0,0,0,0
22684,RM-1203,5/29/2015,0,0,0,0,0,0,0
22685,RM-1203,5/30/2015,0,0,0,0,0,0,0
22686,RM-1203,5/31/2015,0,0,0,0,0,0,0
22687,RM-1207,6/28/2013,0,0,0,0,0,0,0
22688,RM-1207,6/29/2013,0,0,0,0,0,0,0
22689,RM-1207,6/30/2013,0,0,0,0,0,0,0
22690,RM-1207,7/1/2013,0,0,0,0,0,0,0
22691,RM-1207,7/2/2013,0,0,0,0,0,0,0
22692,RM-1207,7/3/2013,0,0,0,0,0,0,0
22693,RM-1207,7/4/2013,0,0,0,0,0,0,0
22694,RM-1207,7/5/2013,0,0,0,0,0,0,0
22695,RM-1207,7/6/2013,0,0,0,0,0,0,0
22696,RM-1207,7/7/2013,0,0,0,0,0,0,0
22697,RM-1207,7/8/2013,0,0,0,0,0,0,0
22698,RM-1207,7/9/2013,0,0,0,0,0,0,0
22699,RM-1207,7/10/2013,0,0,0,0,0,0,0
22700,RM-1207,7/11/2013,0,0,0,0,0,0,0
22701,RM-1207,7/12/2013,0,0,0,0,0,0,0
22702,RM-1207,7/13/2013,0,0,0,0,0,0,0
22703,RM-1207,7/14/2013,0,0,0,0,0,0,0
22704,RM-1207,7/15/2013,0,0,0,0,0,0,0
22705,RM-1207,7/17/2013,0,0,0,0,0,0,0
22706,RM-1207,7/18/2013,0,0,0,0,0,0,0
22707,RM-1207,7/19/2013,0,0,0,0,0,0,0
22708,RM-1207,7/20/2013,0,0,0,0,0,0,0
22709,RM-1207,7/21/2013,0,0,0,0,0,0,0
22710,RM-1207,7/22/2013,0,0,0,0,0,0,0
22711,RM-1207,7/23/2013,0,0,0,0,0,0,0
22712,RM-1207,7/24/2013,0,0,0,0,0,0,0
22713,RM-1207,7/25/2013,0,0,0,0,0,0,0
22714,RM-1207,7/26/2013,0,0,0,0,0,0,0
22715,RM-1207,7/27/2013,0,0,0,0,0,0,0
22716,RM-1207,7/28/2013,0,0,0,0,0,0,0
22717,RM-1207,7/29/2013,0,0,0,0,0,0,0
22718,RM-1207,7/30/2013,0,0,0,0,0,0,0
22719,RM-1207,7/31/2013,0,0,0,0,0,0,0
22720,RM-1207,8/1/2013,0,0,0,0,0,0,0
22721,RM-1207,8/2/2013,0,0,0,0,0,0,0
22722,RM-1207,8/3/2013,0,0,0,0,0,0,0
22723,RM-1207,8/4/2013,0,0,0,0,0,0,0
22724,RM-1207,8/5/2013,0,0,0,0,0,0,0
22725,RM-1207,8/6/2013,0,0,0,0,0,0,0
22726,RM-1207,8/7/2013,0,0,0,0,0,0,0
22727,RM-1207,8/8/2013,0,0,0,0,0,0,0
22728,RM-1207,8/9/2013,0,0,0,0,0,0,0
22729,RM-1207,8/10/2013,0,0,0,0,0,0,0
22730,RM-1207,8/11/2013,0,0,0,0,0,0,0
22731,RM-1207,8/12/2013,0,0,0,0,0,0,0
22732,RM-1207,8/13/2013,0,0,0,0,0,0,0
22733,RM-1207,8/14/2013,0,0,0,0,0,0,0
22734,RM-1207,8/15/2013,0,0,0,0,0,0,0
22735,RM-1207,8/16/2013,0,0,0,0,0,0,0
22736,RM-1207,8/17/2013,0,0,0,0,0,0,0
22737,RM-1207,8/18/2013,0,0,0,0,0,0,0
22738,RM-1207,8/19/2013,0,0,0,0,0,0,0
22739,RM-1207,8/20/2013,0,0,0,0,0,0,0
22740,RM-1207,8/21/2013,0,0,0,0,0,0,0
22741,RM-1207,8/22/2013,0,0,0,0,0,0,0
22742,RM-1207,8/27/2013,0,0,0,0,0,0,0
22743,RM-1207,8/28/2013,0,0,0,0,0,0,0
22744,RM-1207,8/29/2013,0,0,0,0,0,0,0
22745,RM-1207,8/30/2013,0,0,0,0,0,0,0
22746,RM-1207,9/4/2013,0,0,0,0,0,0,0
22747,RM-1207,9/5/2013,0,0,0,0,0,0,0
22748,RM-1207,9/6/2013,0,0,0,0,0,0,0
22749,RM-1207,9/7/2013,0,0,0,0,0,0,0
22750,RM-1207,9/9/2013,0,0,0,0,0,0,0
22751,RM-1207,9/10/2013,0,0,0,0,0,0,0
22752,RM-1207,9/11/2013,0,0,0,0,0,0,0
22753,RM-1207,9/12/2013,0,0,0,0,0,0,0
22754,RM-1207,9/13/2013,0,0,0,0,0,0,0
22755,RM-1207,9/14/2013,0,0,0,0,0,0,0
22756,RM-1207,9/15/2013,0,0,0,0,0,0,0
22757,RM-1207,9/16/2013,0,0,0,0,0,0,0
22986,RM-1207,5/6/2014,0,0,0,0,0,0,0
23076,RM-1207,8/4/2014,0,0,0,0,0,0,0
23077,RM-1207,8/5/2014,0,0,0,0,0,0,0
23078,RM-1207,8/6/2014,0,0,0,0,0,0,0
23079,RM-1207,8/7/2014,0,0,0,0,0,0,0
23080,RM-1207,8/8/2014,0,0,0,0,0,0,0
23081,RM-1207,8/9/2014,0,0,0,0,0,0,0
23082,RM-1207,8/10/2014,0,0,0,0,0,0,0
23083,RM-1207,8/11/2014,0,0,0,0,0,0,0
23084,RM-1207,8/12/2014,0,0,0,0,0,0,0
23085,RM-1207,8/13/2014,0,0,0,0,0,0,0
23086,RM-1207,8/14/2014,0,0,0,0,0,0,0
23087,RM-1207,8/15/2014,0,0,0,0,0,0,0
23088,RM-1207,8/16/2014,0,0,0,0,0,0,0
23089,RM-1207,8/17/2014,0,0,0,0,0,0,0
23090,RM-1207,8/18/2014,0,0,0,0,0,0,0
23091,RM-1207,8/19/2014,0,0,0,0,0,0,0
23092,RM-1207,8/20/2014,0,0,0,0,0,0,0
23093,RM-1207,8/21/2014,0,0,0,0,0,0,0
23094,RM-1207,8/22/2014,0,0,0,0,0,0,0
23095,RM-1207,8/23/2014,0,0,0,0,0,0,0
23096,RM-1207,8/24/2014,0,0,0,0,0,0,0
23097,RM-1207,8/25/2014,0,0,0,0,0,0,0
23098,RM-1207,8/26/2014,0,0,0,0,0,0,0
23099,RM-1207,8/27/2014,0,0,0,0,0,0,0
23100,RM-1207,8/28/2014,0,0,0,0,0,0,0
23101,RM-1207,8/29/2014,0,0,0,0,0,0,0
23102,RM-1207,8/30/2014,0,0,0,0,0,0,0
23103,RM-1207,8/31/2014,0,0,0,0,0,0,0
23104,RM-1207,9/1/2014,0,0,0,0,0,0,0
23105,RM-1207,9/2/2014,0,0,0,0,0,0,0
23106,RM-1207,9/3/2014,0,0,0,0,0,0,0
23107,RM-1207,9/4/2014,0,0,0,0,0,0,0
23108,RM-1207,9/5/2014,0,0,0,0,0,0,0
23109,RM-1207,9/6/2014,0,0,0,0,0,0,0
23110,RM-1207,9/7/2014,0,0,0,0,0,0,0
23111,RM-1207,9/8/2014,0,0,0,0,0,0,0
23112,RM-1207,9/9/2014,0,0,0,0,0,0,0
23113,RM-1207,9/10/2014,0,0,0,0,0,0,0
23114,RM-1207,9/11/2014,0,0,0,0,0,0,0
23115,RM-1207,9/12/2014,0,0,0,0,0,0,0
23116,RM-1207,9/13/2014,0,0,0,0,0,0,0
23117,RM-1207,9/14/2014,0,0,0,0,0,0,0
23118,RM-1207,9/15/2014,0,0,0,0,0,0,0
23119,RM-1207,9/16/2014,0,0,0,0,0,0,0
23120,RM-1207,9/17/2014,0,0,0,0,0,0,0
23121,RM-1207,9/18/2014,0,0,0,0,0,0,0
23122,RM-1207,9/19/2014,0,0,0,0,0,0,0
23123,RM-1207,9/20/2014,0,0,0,0,0,0,0
23124,RM-1207,9/21/2014,0,0,0,0,0,0,0
23125,RM-1207,9/22/2014,0,0,0,0,0,0,0
23126,RM-1207,9/23/2014,0,0,0,0,0,0,0
23127,RM-1207,9/24/2014,0,0,0,0,0,0,0
23128,RM-1207,9/25/2014,0,0,0,0,0,0,0
23129,RM-1207,9/28/2014,0,0,0,0,0,0,0
23130,RM-1207,9/29/2014,0,0,0,0,0,0,0
23131,RM-1207,9/30/2014,0,0,0,0,0,0,0
23132,RM-1207,10/1/2014,0,0,0,0,0,0,0
23133,RM-1207,10/2/2014,0,0,0,0,0,0,0
23134,RM-1207,10/3/2014,0,0,0,0,0,0,0
23135,RM-1207,10/4/2014,0,0,0,0,0,0,0
23136,RM-1207,10/5/2014,0,0,0,0,0,0,0
23137,RM-1207,10/6/2014,0,0,0,0,0,0,0
23138,RM-1207,10/7/2014,0,0,0,0,0,0,0
23139,RM-1207,10/8/2014,0,0,0,0,0,0,0
23140,RM-1207,10/9/2014,0,0,0,0,0,0,0
23141,RM-1207,10/10/2014,0,0,0,0,0,0,0
23142,RM-1207,10/11/2014,0,0,0,0,0,0,0
23143,RM-1207,10/12/2014,0,0,0,0,0,0,0
23144,RM-1207,10/13/2014,0,0,0,0,0,0,0
23145,RM-1207,10/14/2014,0,0,0,0,0,0,0
23146,RM-1207,10/15/2014,0,0,0,0,0,0,0
23147,RM-1207,10/16/2014,0,0,0,0,0,0,0
23148,RM-1207,10/17/2014,0,0,0,0,0,0,0
23149,RM-1207,10/18/2014,0,0,0,0,0,0,0
23150,RM-1207,10/19/2014,0,0,0,0,0,0,0
23151,RM-1207,10/20/2014,0,0,0,0,0,0,0
23152,RM-1207,10/21/2014,0,0,0,0,0,0,0
23153,RM-1207,10/22/2014,0,0,0,0,0,0,0
23154,RM-1207,10/23/2014,0,0,0,0,0,0,0
23155,RM-1207,10/24/2014,0,0,0,0,0,0,0
23156,RM-1207,10/25/2014,0,0,0,0,0,0,0
23157,RM-1207,10/26/2014,0,0,0,0,0,0,0
23158,RM-1207,10/27/2014,0,0,0,0,0,0,0
23159,RM-1207,10/28/2014,0,0,0,0,0,0,0
23160,RM-1207,10/29/2014,0,0,0,0,0,0,0
23161,RM-1207,10/30/2014,0,0,0,0,0,0,0
23162,RM-1207,10/31/2014,0,0,0,0,0,0,0
23163,RM-1207,11/1/2014,0,0,0,0,0,0,0
23164,RM-1207,11/2/2014,0,0,0,0,0,0,0
23165,RM-1207,11/3/2014,0,0,0,0,0,0,0
23166,RM-1207,11/4/2014,0,0,0,0,0,0,0
23167,RM-1207,11/5/2014,0,0,0,0,0,0,0
23168,RM-1207,11/6/2014,0,0,0,0,0,0,0
23169,RM-1207,11/7/2014,0,0,0,0,0,0,0
23170,RM-1207,11/8/2014,0,0,0,0,0,0,0
23171,RM-1207,11/9/2014,0,0,0,0,0,0,0
23172,RM-1207,11/10/2014,0,0,0,0,0,0,0
23173,RM-1207,11/11/2014,0,0,0,0,0,0,0
23174,RM-1207,11/12/2014,0,0,0,0,0,0,0
23175,RM-1207,11/13/2014,0,0,0,0,0,0,0
23176,RM-1207,11/14/2014,0,0,0,0,0,0,0
23177,RM-1207,11/15/2014,0,0,0,0,0,0,0
23178,RM-1207,11/16/2014,0,0,0,0,0,0,0
23179,RM-1207,11/17/2014,0,0,0,0,0,0,0
23180,RM-1207,11/18/2014,0,0,0,0,0,0,0
23181,RM-1207,11/19/2014,0,0,0,0,0,0,0
23182,RM-1207,11/20/2014,0,0,0,0,0,0,0
23183,RM-1207,11/21/2014,0,0,0,0,0,0,0
23184,RM-1207,11/22/2014,0,0,0,0,0,0,0
23185,RM-1207,11/23/2014,0,0,0,0,0,0,0
23186,RM-1207,11/24/2014,0,0,0,0,0,0,0
23187,RM-1207,11/25/2014,0,0,0,0,0,0,0
23188,RM-1207,11/26/2014,0,0,0,0,0,0,0
23189,RM-1207,11/27/2014,0,0,0,0,0,0,0
23190,RM-1207,11/28/2014,0,0,0,0,0,0,0
23191,RM-1207,11/29/2014,0,0,0,0,0,0,0
23192,RM-1207,11/30/2014,0,0,0,0,0,0,0
23193,RM-1207,12/1/2014,0,0,0,0,0,0,0
23194,RM-1207,12/2/2014,0,0,0,0,0,0,0
23195,RM-1207,12/3/2014,0,0,0,0,0,0,0
23196,RM-1207,12/4/2014,0,0,0,0,0,0,0
23197,RM-1207,12/5/2014,0,0,0,0,0,0,0
23198,RM-1207,12/6/2014,0,0,0,0,0,0,0
23199,RM-1207,12/7/2014,0,0,0,0,0,0,0
23200,RM-1207,12/8/2014,0,0,0,0,0,0,0
23201,RM-1207,12/9/2014,0,0,0,0,0,0,0
23202,RM-1207,12/10/2014,0,0,0,0,0,0,0
23203,RM-1207,12/11/2014,0,0,0,0,0,0,0
23204,RM-1207,12/12/2014,0,0,0,0,0,0,0
23205,RM-1207,12/13/2014,0,0,0,0,0,0,0
23206,RM-1207,12/14/2014,0,0,0,0,0,0,0
23207,RM-1207,12/15/2014,0,0,0,0,0,0,0
23208,RM-1207,12/16/2014,0,0,0,0,0,0,0
23209,RM-1207,12/17/2014,0,0,0,0,0,0,0
23210,RM-1207,12/18/2014,0,0,0,0,0,0,0
23211,RM-1207,12/19/2014,0,0,0,0,0,0,0
23212,RM-1207,12/20/2014,0,0,0,0,0,0,0
23213,RM-1207,12/21/2014,0,0,0,0,0,0,0
23214,RM-1207,12/22/2014,0,0,0,0,0,0,0
23215,RM-1207,12/23/2014,0,0,0,0,0,0,0
23216,RM-1207,12/24/2014,0,0,0,0,0,0,0
23217,RM-1207,12/25/2014,0,0,0,0,0,0,0
23218,RM-1207,12/26/2014,0,0,0,0,0,0,0
23219,RM-1207,12/27/2014,0,0,0,0,0,0,0
23220,RM-1207,12/28/2014,0,0,0,0,0,0,0
23221,RM-1207,12/29/2014,0,0,0,0,0,0,0
23222,RM-1207,12/30/2014,0,0,0,0,0,0,0
23223,RM-1207,12/31/2014,0,0,0,0,0,0,0
23224,RM-1207,1/1/2015,0,0,0,0,0,0,0
23225,RM-1207,1/2/2015,0,0,0,0,0,0,0
23226,RM-1207,1/3/2015,0,0,0,0,0,0,0
23227,RM-1207,1/4/2015,0,0,0,0,0,0,0
23228,RM-1207,1/5/2015,0,0,0,0,0,0,0
23229,RM-1207,1/6/2015,0,0,0,0,0,0,0
23230,RM-1207,1/7/2015,0,0,0,0,0,0,0
23231,RM-1207,1/8/2015,0,0,0,0,0,0,0
23232,RM-1207,1/9/2015,0,0,0,0,0,0,0
23233,RM-1207,1/10/2015,0,0,0,0,0,0,0
23234,RM-1207,1/11/2015,0,0,0,0,0,0,0
23235,RM-1207,1/12/2015,0,0,0,0,0,0,0
23236,RM-1207,1/13/2015,0,0,0,0,0,0,0
23237,RM-1207,1/14/2015,0,0,0,0,0,0,0
23238,RM-1207,1/15/2015,0,0,0,0,0,0,0
23239,RM-1207,1/16/2015,0,0,0,0,0,0,0
23240,RM-1207,1/17/2015,0,0,0,0,0,0,0
23241,RM-1207,1/18/2015,0,0,0,0,0,0,0
23242,RM-1207,1/19/2015,0,0,0,0,0,0,0
23243,RM-1207,1/20/2015,0,0,0,0,0,0,0
23244,RM-1207,1/21/2015,0,0,0,0,0,0,0
23245,RM-1207,1/22/2015,0,0,0,0,0,0,0
23246,RM-1207,1/23/2015,0,0,0,0,0,0,0
23247,RM-1207,1/24/2015,0,0,0,0,0,0,0
23248,RM-1207,1/25/2015,0,0,0,0,0,0,0
23249,RM-1207,1/26/2015,0,0,0,0,0,0,0
23250,RM-1207,1/27/2015,0,0,0,0,0,0,0
23251,RM-1207,1/28/2015,0,0,0,0,0,0,0
23252,RM-1207,1/29/2015,0,0,0,0,0,0,0
23253,RM-1207,1/30/2015,0,0,0,0,0,0,0
23254,RM-1207,1/31/2015,0,0,0,0,0,0,0
23255,RM-1207,2/1/2015,0,0,0,0,0,0,0
23256,RM-1207,2/2/2015,0,0,0,0,0,0,0
23257,RM-1207,2/3/2015,0,0,0,0,0,0,0
23258,RM-1207,2/4/2015,0,0,0,0,0,0,0
23259,RM-1207,2/5/2015,0,0,0,0,0,0,0
23260,RM-1207,2/6/2015,0,0,0,0,0,0,0
23261,RM-1207,2/7/2015,0,0,0,0,0,0,0
23262,RM-1207,2/8/2015,0,0,0,0,0,0,0
23263,RM-1207,2/9/2015,0,0,0,0,0,0,0
23264,RM-1207,2/10/2015,0,0,0,0,0,0,0
23265,RM-1207,2/11/2015,0,0,0,0,0,0,0
23266,RM-1207,2/12/2015,0,0,0,0,0,0,0
23267,RM-1207,2/13/2015,0,0,0,0,0,0,0
23268,RM-1207,2/14/2015,0,0,0,0,0,0,0
23269,RM-1207,2/15/2015,0,0,0,0,0,0,0
23270,RM-1207,2/16/2015,0,0,0,0,0,0,0
23271,RM-1207,2/17/2015,0,0,0,0,0,0,0
23272,RM-1207,2/18/2015,0,0,0,0,0,0,0
23273,RM-1207,2/19/2015,0,0,0,0,0,0,0
23274,RM-1207,2/20/2015,0,0,0,0,0,0,0
23275,RM-1207,2/21/2015,0,0,0,0,0,0,0
23276,RM-1207,2/22/2015,0,0,0,0,0,0,0
23277,RM-1207,2/23/2015,0,0,0,0,0,0,0
23278,RM-1207,2/24/2015,0,0,0,0,0,0,0
23279,RM-1207,2/25/2015,0,0,0,0,0,0,0
23280,RM-1207,2/26/2015,0,0,0,0,0,0,0
23281,RM-1207,2/27/2015,0,0,0,0,0,0,0
23282,RM-1207,2/28/2015,0,0,0,0,0,0,0
23283,RM-1207,3/1/2015,0,0,0,0,0,0,0
23284,RM-1207,3/2/2015,0,0,0,0,0,0,0
23285,RM-1207,3/3/2015,0,0,0,0,0,0,0
23286,RM-1207,3/4/2015,0,0,0,0,0,0,0
23287,RM-1207,3/5/2015,0,0,0,0,0,0,0
23288,RM-1207,3/6/2015,0,0,0,0,0,0,0
23289,RM-1207,3/7/2015,0,0,0,0,0,0,0
23290,RM-1207,3/8/2015,0,0,0,0,0,0,0
23291,RM-1207,3/9/2015,0,0,0,0,0,0,0
23292,RM-1207,3/10/2015,0,0,0,0,0,0,0
23293,RM-1207,3/11/2015,0,0,0,0,0,0,0
23294,RM-1207,3/12/2015,0,0,0,0,0,0,0
23295,RM-1207,3/13/2015,0,0,0,0,0,0,0
23296,RM-1207,3/14/2015,0,0,0,0,0,0,0
23297,RM-1207,3/15/2015,0,0,0,0,0,0,0
23298,RM-1207,3/16/2015,0,0,0,0,0,0,0
23299,RM-1207,3/17/2015,0,0,0,0,0,0,0
23300,RM-1207,3/18/2015,0,0,0,0,0,0,0
23301,RM-1207,3/19/2015,0,0,0,0,0,0,0
23302,RM-1207,3/20/2015,0,0,0,0,0,0,0
23303,RM-1207,3/21/2015,0,0,0,0,0,0,0
23304,RM-1207,3/22/2015,0,0,0,0,0,0,0
23305,RM-1207,3/23/2015,0,0,0,0,0,0,0
23306,RM-1207,3/24/2015,0,0,0,0,0,0,0
23307,RM-1207,3/25/2015,0,0,0,0,0,0,0
23308,RM-1207,3/26/2015,0,0,0,0,0,0,0
23309,RM-1207,3/27/2015,0,0,0,0,0,0,0
23310,RM-1207,3/28/2015,0,0,0,0,0,0,0
23311,RM-1207,3/29/2015,0,0,0,0,0,0,0
23312,RM-1207,3/30/2015,0,0,0,0,0,0,0
23313,RM-1207,3/31/2015,0,0,0,0,0,0,0
23314,RM-1207,4/1/2015,0,0,0,0,0,0,0
23315,RM-1207,4/2/2015,0,0,0,0,0,0,0
23316,RM-1207,4/3/2015,0,0,0,0,0,0,0
23317,RM-1207,4/4/2015,0,0,0,0,0,0,0
23318,RM-1207,4/5/2015,0,0,0,0,0,0,0
23319,RM-1207,4/6/2015,0,0,0,0,0,0,0
23320,RM-1207,4/7/2015,0,0,0,0,0,0,0
23321,RM-1207,4/8/2015,0,0,0,0,0,0,0
23322,RM-1207,4/9/2015,0,0,0,0,0,0,0
23323,RM-1207,4/10/2015,0,0,0,0,0,0,0
23324,RM-1207,4/11/2015,0,0,0,0,0,0,0
23325,RM-1207,4/12/2015,0,0,0,0,0,0,0
23326,RM-1207,4/13/2015,0,0,0,0,0,0,0
23327,RM-1207,4/14/2015,0,0,0,0,0,0,0
23328,RM-1207,4/15/2015,0,0,0,0,0,0,0
23329,RM-1207,4/16/2015,0,0,0,0,0,0,0
23330,RM-1207,4/17/2015,0,0,0,0,0,0,0
23331,RM-1207,4/18/2015,0,0,0,0,0,0,0
23332,RM-1207,4/19/2015,0,0,0,0,0,0,0
23333,RM-1207,4/20/2015,0,0,0,0,0,0,0
23334,RM-1207,4/21/2015,0,0,0,0,0,0,0
23335,RM-1207,4/22/2015,0,0,0,0,0,0,0
23336,RM-1207,4/23/2015,0,0,0,0,0,0,0
23337,RM-1207,4/24/2015,0,0,0,0,0,0,0
23338,RM-1207,4/25/2015,0,0,0,0,0,0,0
23339,RM-1207,4/26/2015,0,0,0,0,0,0,0
23340,RM-1207,4/27/2015,0,0,0,0,0,0,0
23341,RM-1207,4/28/2015,0,0,0,0,0,0,0
23342,RM-1207,4/29/2015,0,0,0,0,0,0,0
23343,RM-1207,4/30/2015,0,0,0,0,0,0,0
23344,RM-1207,5/1/2015,0,0,0,0,0,0,0
23345,RM-1207,5/2/2015,0,0,0,0,0,0,0
23346,RM-1207,5/3/2015,0,0,0,0,0,0,0
23347,RM-1207,5/4/2015,0,0,0,0,0,0,0
23348,RM-1207,5/5/2015,0,0,0,0,0,0,0
23349,RM-1207,5/6/2015,0,0,0,0,0,0,0
23350,RM-1207,5/7/2015,0,0,0,0,0,0,0
23351,RM-1207,5/8/2015,0,0,0,0,0,0,0
23352,RM-1207,5/9/2015,0,0,0,0,0,0,0
23353,RM-1207,5/10/2015,0,0,0,0,0,0,0
23354,RM-1207,5/11/2015,0,0,0,0,0,0,0
23355,RM-1207,5/12/2015,0,0,0,0,0,0,0
23356,RM-1207,5/13/2015,0,0,0,0,0,0,0
23357,RM-1207,5/14/2015,0,0,0,0,0,0,0
23358,RM-1207,5/15/2015,0,0,0,0,0,0,0
23359,RM-1207,5/16/2015,0,0,0,0,0,0,0
23360,RM-1207,5/17/2015,0,0,0,0,0,0,0
23361,RM-1207,5/18/2015,0,0,0,0,0,0,0
23362,RM-1207,5/19/2015,0,0,0,0,0,0,0
23363,RM-1207,5/20/2015,0,0,0,0,0,0,0
23364,RM-1207,5/21/2015,0,0,0,0,0,0,0
23365,RM-1207,5/22/2015,0,0,0,0,0,0,0
23366,RM-1207,5/23/2015,0,0,0,0,0,0,0
23367,RM-1207,5/24/2015,0,0,0,0,0,0,0
23368,RM-1207,5/25/2015,0,0,0,0,0,0,0
23369,RM-1207,5/26/2015,0,0,0,0,0,0,0
23370,RM-1207,5/27/2015,0,0,0,0,0,0,0
23371,RM-1207,5/28/2015,0,0,0,0,0,0,0
23372,RM-1207,5/29/2015,0,0,0,0,0,0,0
23373,RM-1207,5/30/2015,0,0,0,0,0,0,0
23374,RM-1207,5/31/2015,0,0,0,0,0,0,0
23375,RM-1208,7/1/2013,0,0,0,0,0,0,0
23777,RM-1208,8/20/2014,0,0,0,0,0,0,0
23778,RM-1208,8/21/2014,0,0,0,0,0,0,0
23779,RM-1208,8/22/2014,0,0,0,0,0,0,0
23780,RM-1208,8/23/2014,0,0,0,0,0,0,0
23781,RM-1208,8/24/2014,0,0,0,0,0,0,0
23782,RM-1208,8/25/2014,0,0,0,0,0,0,0
23783,RM-1208,8/26/2014,0,0,0,0,0,0,0
23784,RM-1208,8/27/2014,0,0,0,0,0,0,0
23785,RM-1208,8/28/2014,0,0,0,0,0,0,0
23786,RM-1208,8/29/2014,0,0,0,0,0,0,0
23787,RM-1208,8/30/2014,0,0,0,0,0,0,0
23788,RM-1208,8/31/2014,0,0,0,0,0,0,0
23789,RM-1208,9/1/2014,0,0,0,0,0,0,0
23790,RM-1208,9/2/2014,0,0,0,0,0,0,0
23791,RM-1208,9/3/2014,0,0,0,0,0,0,0
23792,RM-1208,9/4/2014,0,0,0,0,0,0,0
23793,RM-1208,9/5/2014,0,0,0,0,0,0,0
23794,RM-1208,9/6/2014,0,0,0,0,0,0,0
23795,RM-1208,9/7/2014,0,0,0,0,0,0,0
23796,RM-1208,9/8/2014,0,0,0,0,0,0,0
23797,RM-1208,9/9/2014,0,0,0,0,0,0,0
23798,RM-1208,9/10/2014,0,0,0,0,0,0,0
23799,RM-1208,9/11/2014,0,0,0,0,0,0,0
23800,RM-1208,9/12/2014,0,0,0,0,0,0,0
23801,RM-1208,9/13/2014,0,0,0,0,0,0,0
23802,RM-1208,9/14/2014,0,0,0,0,0,0,0
23803,RM-1208,9/15/2014,0,0,0,0,0,0,0
23804,RM-1208,9/16/2014,0,0,0,0,0,0,0
23805,RM-1208,9/17/2014,0,0,0,0,0,0,0
23806,RM-1208,9/18/2014,0,0,0,0,0,0,0
23807,RM-1208,9/19/2014,0,0,0,0,0,0,0
23808,RM-1208,9/20/2014,0,0,0,0,0,0,0
23809,RM-1208,9/21/2014,0,0,0,0,0,0,0
23810,RM-1208,9/22/2014,0,0,0,0,0,0,0
23811,RM-1208,9/23/2014,0,0,0,0,0,0,0
23812,RM-1208,9/24/2014,0,0,0,0,0,0,0
23813,RM-1208,9/25/2014,0,0,0,0,0,0,0
23814,RM-1208,9/28/2014,0,0,0,0,0,0,0
23815,RM-1208,9/29/2014,0,0,0,0,0,0,0
23816,RM-1208,9/30/2014,0,0,0,0,0,0,0
23817,RM-1208,10/1/2014,0,0,0,0,0,0,0
23818,RM-1208,10/2/2014,0,0,0,0,0,0,0
23819,RM-1208,10/3/2014,0,0,0,0,0,0,0
23820,RM-1208,10/4/2014,0,0,0,0,0,0,0
23821,RM-1208,10/5/2014,0,0,0,0,0,0,0
23822,RM-1208,10/6/2014,0,0,0,0,0,0,0
23823,RM-1208,10/7/2014,0,0,0,0,0,0,0
23824,RM-1208,10/8/2014,0,0,0,0,0,0,0
23825,RM-1208,10/9/2014,0,0,0,0,0,0,0
23826,RM-1208,10/10/2014,0,0,0,0,0,0,0
23827,RM-1208,10/11/2014,0,0,0,0,0,0,0
23828,RM-1208,10/12/2014,0,0,0,0,0,0,0
23829,RM-1208,10/13/2014,0,0,0,0,0,0,0
23830,RM-1208,10/14/2014,0,0,0,0,0,0,0
23831,RM-1208,10/15/2014,0,0,0,0,0,0,0
23832,RM-1208,10/16/2014,0,0,0,0,0,0,0
23833,RM-1208,10/17/2014,0,0,0,0,0,0,0
23834,RM-1208,10/18/2014,0,0,0,0,0,0,0
23835,RM-1208,10/19/2014,0,0,0,0,0,0,0
23836,RM-1208,10/20/2014,0,0,0,0,0,0,0
23837,RM-1208,10/21/2014,0,0,0,0,0,0,0
23838,RM-1208,10/22/2014,0,0,0,0,0,0,0
23839,RM-1208,10/23/2014,0,0,0,0,0,0,0
23840,RM-1208,10/24/2014,0,0,0,0,0,0,0
23841,RM-1208,10/25/2014,0,0,0,0,0,0,0
23842,RM-1208,10/26/2014,0,0,0,0,0,0,0
23843,RM-1208,10/27/2014,0,0,0,0,0,0,0
23844,RM-1208,10/28/2014,0,0,0,0,0,0,0
23845,RM-1208,10/29/2014,0,0,0,0,0,0,0
23846,RM-1208,10/30/2014,0,0,0,0,0,0,0
23847,RM-1208,10/31/2014,0,0,0,0,0,0,0
23848,RM-1208,11/1/2014,0,0,0,0,0,0,0
23849,RM-1208,11/2/2014,0,0,0,0,0,0,0
23850,RM-1208,11/3/2014,0,0,0,0,0,0,0
23851,RM-1208,11/4/2014,0,0,0,0,0,0,0
23852,RM-1208,11/5/2014,0,0,0,0,0,0,0
23853,RM-1208,11/6/2014,0,0,0,0,0,0,0
23854,RM-1208,11/7/2014,0,0,0,0,0,0,0
23855,RM-1208,11/8/2014,0,0,0,0,0,0,0
23856,RM-1208,11/9/2014,0,0,0,0,0,0,0
23857,RM-1208,11/10/2014,0,0,0,0,0,0,0
23858,RM-1208,11/11/2014,0,0,0,0,0,0,0
23859,RM-1208,11/12/2014,0,0,0,0,0,0,0
23860,RM-1208,11/13/2014,0,0,0,0,0,0,0
23861,RM-1208,11/14/2014,0,0,0,0,0,0,0
23862,RM-1208,11/15/2014,0,0,0,0,0,0,0
23863,RM-1208,11/16/2014,0,0,0,0,0,0,0
23864,RM-1208,11/17/2014,0,0,0,0,0,0,0
23865,RM-1208,11/18/2014,0,0,0,0,0,0,0
23866,RM-1208,11/19/2014,0,0,0,0,0,0,0
23867,RM-1208,11/20/2014,0,0,0,0,0,0,0
23868,RM-1208,11/21/2014,0,0,0,0,0,0,0
23869,RM-1208,11/22/2014,0,0,0,0,0,0,0
23870,RM-1208,11/23/2014,0,0,0,0,0,0,0
23871,RM-1208,11/24/2014,0,0,0,0,0,0,0
23872,RM-1208,11/25/2014,0,0,0,0,0,0,0
23873,RM-1208,11/26/2014,0,0,0,0,0,0,0
23874,RM-1208,11/27/2014,0,0,0,0,0,0,0
23875,RM-1208,11/28/2014,0,0,0,0,0,0,0
23876,RM-1208,11/29/2014,0,0,0,0,0,0,0
23877,RM-1208,11/30/2014,0,0,0,0,0,0,0
23878,RM-1208,12/1/2014,0,0,0,0,0,0,0
23879,RM-1208,12/2/2014,0,0,0,0,0,0,0
23880,RM-1208,12/3/2014,0,0,0,0,0,0,0
23881,RM-1208,12/4/2014,0,0,0,0,0,0,0
23882,RM-1208,12/5/2014,0,0,0,0,0,0,0
23883,RM-1208,12/6/2014,0,0,0,0,0,0,0
23884,RM-1208,12/7/2014,0,0,0,0,0,0,0
23885,RM-1208,12/8/2014,0,0,0,0,0,0,0
23886,RM-1208,12/9/2014,0,0,0,0,0,0,0
23887,RM-1208,12/10/2014,0,0,0,0,0,0,0
23888,RM-1208,12/11/2014,0,0,0,0,0,0,0
23889,RM-1208,12/12/2014,0,0,0,0,0,0,0
23890,RM-1208,12/13/2014,0,0,0,0,0,0,0
23891,RM-1208,12/14/2014,0,0,0,0,0,0,0
23892,RM-1208,12/15/2014,0,0,0,0,0,0,0
23893,RM-1208,12/16/2014,0,0,0,0,0,0,0
23894,RM-1208,12/17/2014,0,0,0,0,0,0,0
23895,RM-1208,12/18/2014,0,0,0,0,0,0,0
23896,RM-1208,12/19/2014,0,0,0,0,0,0,0
23897,RM-1208,12/20/2014,0,0,0,0,0,0,0
23898,RM-1208,12/21/2014,0,0,0,0,0,0,0
23899,RM-1208,12/22/2014,0,0,0,0,0,0,0
23900,RM-1208,12/23/2014,0,0,0,0,0,0,0
23901,RM-1208,12/24/2014,0,0,0,0,0,0,0
23902,RM-1208,12/25/2014,0,0,0,0,0,0,0
23903,RM-1208,12/26/2014,0,0,0,0,0,0,0
23904,RM-1208,12/27/2014,0,0,0,0,0,0,0
23905,RM-1208,12/28/2014,0,0,0,0,0,0,0
23906,RM-1208,12/29/2014,0,0,0,0,0,0,0
23907,RM-1208,12/30/2014,0,0,0,0,0,0,0
23908,RM-1208,12/31/2014,0,0,0,0,0,0,0
23909,RM-1208,1/1/2015,0,0,0,0,0,0,0
23910,RM-1208,1/2/2015,0,0,0,0,0,0,0
23911,RM-1208,1/3/2015,0,0,0,0,0,0,0
23912,RM-1208,1/4/2015,0,0,0,0,0,0,0
23913,RM-1208,1/5/2015,0,0,0,0,0,0,0
23914,RM-1208,1/6/2015,0,0,0,0,0,0,0
23915,RM-1208,1/7/2015,0,0,0,0,0,0,0
23916,RM-1208,1/8/2015,0,0,0,0,0,0,0
23917,RM-1208,1/9/2015,0,0,0,0,0,0,0
23918,RM-1208,1/10/2015,0,0,0,0,0,0,0
23919,RM-1208,1/11/2015,0,0,0,0,0,0,0
23920,RM-1208,1/12/2015,0,0,0,0,0,0,0
23921,RM-1208,1/13/2015,0,0,0,0,0,0,0
23922,RM-1208,1/14/2015,0,0,0,0,0,0,0
23923,RM-1208,1/15/2015,0,0,0,0,0,0,0
23924,RM-1208,1/16/2015,0,0,0,0,0,0,0
23925,RM-1208,1/17/2015,0,0,0,0,0,0,0
23926,RM-1208,1/18/2015,0,0,0,0,0,0,0
23927,RM-1208,1/19/2015,0,0,0,0,0,0,0
23928,RM-1208,1/20/2015,0,0,0,0,0,0,0
23929,RM-1208,1/21/2015,0,0,0,0,0,0,0
23930,RM-1208,1/22/2015,0,0,0,0,0,0,0
23931,RM-1208,1/23/2015,0,0,0,0,0,0,0
23932,RM-1208,1/24/2015,0,0,0,0,0,0,0
23933,RM-1208,1/25/2015,0,0,0,0,0,0,0
23934,RM-1208,1/26/2015,0,0,0,0,0,0,0
23935,RM-1208,1/27/2015,0,0,0,0,0,0,0
23936,RM-1208,1/28/2015,0,0,0,0,0,0,0
23937,RM-1208,1/29/2015,0,0,0,0,0,0,0
23938,RM-1208,1/30/2015,0,0,0,0,0,0,0
23939,RM-1208,1/31/2015,0,0,0,0,0,0,0
23940,RM-1208,2/1/2015,0,0,0,0,0,0,0
23941,RM-1208,2/2/2015,0,0,0,0,0,0,0
23942,RM-1208,2/3/2015,0,0,0,0,0,0,0
23943,RM-1208,2/4/2015,0,0,0,0,0,0,0
23944,RM-1208,2/5/2015,0,0,0,0,0,0,0
23945,RM-1208,2/6/2015,0,0,0,0,0,0,0
23946,RM-1208,2/7/2015,0,0,0,0,0,0,0
23947,RM-1208,2/8/2015,0,0,0,0,0,0,0
23948,RM-1208,2/9/2015,0,0,0,0,0,0,0
23949,RM-1208,2/10/2015,0,0,0,0,0,0,0
23950,RM-1208,2/11/2015,0,0,0,0,0,0,0
23951,RM-1208,2/12/2015,0,0,0,0,0,0,0
23952,RM-1208,2/13/2015,0,0,0,0,0,0,0
23953,RM-1208,2/14/2015,0,0,0,0,0,0,0
23954,RM-1208,2/15/2015,0,0,0,0,0,0,0
23955,RM-1208,2/16/2015,0,0,0,0,0,0,0
23956,RM-1208,2/17/2015,0,0,0,0,0,0,0
23957,RM-1208,2/18/2015,0,0,0,0,0,0,0
23958,RM-1208,2/19/2015,0,0,0,0,0,0,0
23959,RM-1208,2/20/2015,0,0,0,0,0,0,0
23960,RM-1208,2/21/2015,0,0,0,0,0,0,0
23961,RM-1208,2/22/2015,0,0,0,0,0,0,0
23962,RM-1208,2/23/2015,0,0,0,0,0,0,0
23963,RM-1208,2/24/2015,0,0,0,0,0,0,0
23964,RM-1208,2/25/2015,0,0,0,0,0,0,0
23965,RM-1208,2/26/2015,0,0,0,0,0,0,0
23966,RM-1208,2/27/2015,0,0,0,0,0,0,0
23967,RM-1208,2/28/2015,0,0,0,0,0,0,0
23968,RM-1208,3/1/2015,0,0,0,0,0,0,0
23969,RM-1208,3/2/2015,0,0,0,0,0,0,0
23970,RM-1208,3/3/2015,0,0,0,0,0,0,0
23971,RM-1208,3/4/2015,0,0,0,0,0,0,0
23972,RM-1208,3/5/2015,0,0,0,0,0,0,0
23973,RM-1208,3/6/2015,0,0,0,0,0,0,0
23974,RM-1208,3/7/2015,0,0,0,0,0,0,0
23975,RM-1208,3/8/2015,0,0,0,0,0,0,0
23976,RM-1208,3/9/2015,0,0,0,0,0,0,0
23977,RM-1208,3/10/2015,0,0,0,0,0,0,0
23978,RM-1208,3/11/2015,0,0,0,0,0,0,0
23979,RM-1208,3/12/2015,0,0,0,0,0,0,0
23980,RM-1208,3/13/2015,0,0,0,0,0,0,0
23981,RM-1208,3/14/2015,0,0,0,0,0,0,0
23982,RM-1208,3/15/2015,0,0,0,0,0,0,0
23983,RM-1208,3/16/2015,0,0,0,0,0,0,0
23984,RM-1208,3/17/2015,0,0,0,0,0,0,0
23985,RM-1208,3/18/2015,0,0,0,0,0,0,0
23986,RM-1208,3/19/2015,0,0,0,0,0,0,0
23987,RM-1208,3/20/2015,0,0,0,0,0,0,0
23988,RM-1208,3/21/2015,0,0,0,0,0,0,0
23989,RM-1208,3/22/2015,0,0,0,0,0,0,0
23990,RM-1208,3/23/2015,0,0,0,0,0,0,0
23991,RM-1208,3/24/2015,0,0,0,0,0,0,0
23992,RM-1208,3/25/2015,0,0,0,0,0,0,0
23993,RM-1208,3/26/2015,0,0,0,0,0,0,0
23994,RM-1208,3/27/2015,0,0,0,0,0,0,0
23995,RM-1208,3/28/2015,0,0,0,0,0,0,0
23996,RM-1208,3/29/2015,0,0,0,0,0,0,0
23997,RM-1208,3/30/2015,0,0,0,0,0,0,0
23998,RM-1208,3/31/2015,0,0,0,0,0,0,0
23999,RM-1208,4/1/2015,0,0,0,0,0,0,0
24000,RM-1208,4/2/2015,0,0,0,0,0,0,0
24001,RM-1208,4/3/2015,0,0,0,0,0,0,0
24002,RM-1208,4/4/2015,0,0,0,0,0,0,0
24003,RM-1208,4/5/2015,0,0,0,0,0,0,0
24004,RM-1208,4/6/2015,0,0,0,0,0,0,0
24005,RM-1208,4/7/2015,0,0,0,0,0,0,0
24006,RM-1208,4/8/2015,0,0,0,0,0,0,0
24007,RM-1208,4/9/2015,0,0,0,0,0,0,0
24008,RM-1208,4/10/2015,0,0,0,0,0,0,0
24009,RM-1208,4/11/2015,0,0,0,0,0,0,0
24010,RM-1208,4/12/2015,0,0,0,0,0,0,0
24011,RM-1208,4/13/2015,0,0,0,0,0,0,0
24012,RM-1208,4/14/2015,0,0,0,0,0,0,0
24013,RM-1208,4/15/2015,0,0,0,0,0,0,0
24014,RM-1208,4/16/2015,0,0,0,0,0,0,0
24015,RM-1208,4/17/2015,0,0,0,0,0,0,0
24016,RM-1208,4/18/2015,0,0,0,0,0,0,0
24017,RM-1208,4/19/2015,0,0,0,0,0,0,0
24018,RM-1208,4/20/2015,0,0,0,0,0,0,0
24019,RM-1208,4/21/2015,0,0,0,0,0,0,0
24020,RM-1208,4/22/2015,0,0,0,0,0,0,0
24021,RM-1208,4/23/2015,0,0,0,0,0,0,0
24022,RM-1208,4/24/2015,0,0,0,0,0,0,0
24023,RM-1208,4/25/2015,0,0,0,0,0,0,0
24024,RM-1208,4/26/2015,0,0,0,0,0,0,0
24025,RM-1208,4/27/2015,0,0,0,0,0,0,0
24026,RM-1208,4/28/2015,0,0,0,0,0,0,0
24027,RM-1208,4/29/2015,0,0,0,0,0,0,0
24028,RM-1208,4/30/2015,0,0,0,0,0,0,0
24029,RM-1208,5/1/2015,0,0,0,0,0,0,0
24030,RM-1208,5/2/2015,0,0,0,0,0,0,0
24031,RM-1208,5/3/2015,0,0,0,0,0,0,0
24032,RM-1208,5/4/2015,0,0,0,0,0,0,0
24033,RM-1208,5/5/2015,0,0,0,0,0,0,0
24034,RM-1208,5/6/2015,0,0,0,0,0,0,0
24035,RM-1208,5/7/2015,0,0,0,0,0,0,0
24036,RM-1208,5/8/2015,0,0,0,0,0,0,0
24037,RM-1208,5/9/2015,0,0,0,0,0,0,0
24038,RM-1208,5/10/2015,0,0,0,0,0,0,0
24039,RM-1208,5/11/2015,0,0,0,0,0,0,0
24040,RM-1208,5/12/2015,0,0,0,0,0,0,0
24041,RM-1208,5/13/2015,0,0,0,0,0,0,0
24042,RM-1208,5/14/2015,0,0,0,0,0,0,0
24043,RM-1208,5/15/2015,0,0,0,0,0,0,0
24044,RM-1208,5/16/2015,0,0,0,0,0,0,0
24045,RM-1208,5/17/2015,0,0,0,0,0,0,0
24046,RM-1208,5/18/2015,0,0,0,0,0,0,0
24047,RM-1208,5/19/2015,0,0,0,0,0,0,0
24048,RM-1208,5/20/2015,0,0,0,0,0,0,0
24049,RM-1208,5/21/2015,0,0,0,0,0,0,0
24050,RM-1208,5/22/2015,0,0,0,0,0,0,0
24051,RM-1208,5/23/2015,0,0,0,0,0,0,0
24052,RM-1208,5/24/2015,0,0,0,0,0,0,0
24053,RM-1208,5/25/2015,0,0,0,0,0,0,0
24054,RM-1208,5/26/2015,0,0,0,0,0,0,0
24055,RM-1208,5/27/2015,0,0,0,0,0,0,0
24056,RM-1208,5/28/2015,0,0,0,0,0,0,0
24057,RM-1208,5/29/2015,0,0,0,0,0,0,0
24058,RM-1208,5/30/2015,0,0,0,0,0,0,0
24059,RM-1208,5/31/2015,0,0,0,0,0,0,0
24060,RM-1208B,6/28/2013,0,0,0,0,0,0,0
24061,RM-1208B,6/29/2013,0,0,0,0,0,0,0
24062,RM-1208B,6/30/2013,0,0,0,0,0,0,0
24063,RM-1208B,7/1/2013,0,0,0,0,0,0,0
24064,RM-1208B,7/2/2013,0,0,0,0,0,0,0
24065,RM-1208B,7/3/2013,0,0,0,0,0,0,0
24066,RM-1208B,7/4/2013,0,0,0,0,0,0,0
24067,RM-1208B,7/5/2013,0,0,0,0,0,0,0
24068,RM-1208B,7/6/2013,0,0,0,0,0,0,0
24069,RM-1208B,7/7/2013,0,0,0,0,0,0,0
24070,RM-1208B,7/8/2013,0,0,0,0,0,0,0
24071,RM-1208B,7/9/2013,0,0,0,0,0,0,0
24072,RM-1208B,7/10/2013,0,0,0,0,0,0,0
24073,RM-1208B,7/11/2013,0,0,0,0,0,0,0
24074,RM-1208B,7/12/2013,0,0,0,0,0,0,0
24075,RM-1208B,7/13/2013,0,0,0,0,0,0,0
24076,RM-1208B,7/14/2013,0,0,0,0,0,0,0
24077,RM-1208B,7/15/2013,0,0,0,0,0,0,0
24078,RM-1208B,7/17/2013,0,0,0,0,0,0,0
24079,RM-1208B,7/18/2013,0,0,0,0,0,0,0
24080,RM-1208B,7/19/2013,0,0,0,0,0,0,0
24081,RM-1208B,7/20/2013,0,0,0,0,0,0,0
24082,RM-1208B,7/21/2013,0,0,0,0,0,0,0
24083,RM-1208B,7/22/2013,0,0,0,0,0,0,0
24084,RM-1208B,7/23/2013,0,0,0,0,0,0,0
24085,RM-1208B,7/24/2013,0,0,0,0,0,0,0
24086,RM-1208B,7/25/2013,0,0,0,0,0,0,0
24087,RM-1208B,7/26/2013,0,0,0,0,0,0,0
24088,RM-1208B,7/27/2013,0,0,0,0,0,0,0
24089,RM-1208B,7/28/2013,0,0,0,0,0,0,0
24090,RM-1208B,7/29/2013,0,0,0,0,0,0,0
24091,RM-1208B,7/30/2013,0,0,0,0,0,0,0
24092,RM-1208B,7/31/2013,0,0,0,0,0,0,0
24093,RM-1208B,8/1/2013,0,0,0,0,0,0,0
24094,RM-1208B,8/2/2013,0,0,0,0,0,0,0
24095,RM-1208B,8/3/2013,0,0,0,0,0,0,0
24096,RM-1208B,8/4/2013,0,0,0,0,0,0,0
24097,RM-1208B,8/5/2013,0,0,0,0,0,0,0
24098,RM-1208B,8/6/2013,0,0,0,0,0,0,0
24099,RM-1208B,8/7/2013,0,0,0,0,0,0,0
24100,RM-1208B,8/8/2013,0,0,0,0,0,0,0
24101,RM-1208B,8/9/2013,0,0,0,0,0,0,0
24102,RM-1208B,8/10/2013,0,0,0,0,0,0,0
24103,RM-1208B,8/11/2013,0,0,0,0,0,0,0
24104,RM-1208B,8/12/2013,0,0,0,0,0,0,0
24105,RM-1208B,8/13/2013,0,0,0,0,0,0,0
24106,RM-1208B,8/14/2013,0,0,0,0,0,0,0
24107,RM-1208B,8/15/2013,0,0,0,0,0,0,0
24108,RM-1208B,8/16/2013,0,0,0,0,0,0,0
24109,RM-1208B,8/17/2013,0,0,0,0,0,0,0
24110,RM-1208B,8/18/2013,0,0,0,0,0,0,0
24111,RM-1208B,8/19/2013,0,0,0,0,0,0,0
24112,RM-1208B,8/20/2013,0,0,0,0,0,0,0
24113,RM-1208B,8/21/2013,0,0,0,0,0,0,0
24114,RM-1208B,8/22/2013,0,0,0,0,0,0,0
24115,RM-1208B,8/27/2013,0,0,0,0,0,0,0
24116,RM-1208B,8/28/2013,0,0,0,0,0,0,0
24117,RM-1208B,8/29/2013,0,0,0,0,0,0,0
24118,RM-1208B,8/30/2013,0,0,0,0,0,0,0
24119,RM-1208B,9/4/2013,0,0,0,0,0,0,0
24120,RM-1208B,9/5/2013,0,0,0,0,0,0,0
24121,RM-1208B,9/6/2013,0,0,0,0,0,0,0
24122,RM-1208B,9/7/2013,0,0,0,0,0,0,0
24123,RM-1208B,9/9/2013,0,0,0,0,0,0,0
24124,RM-1208B,9/10/2013,0,0,0,0,0,0,0
24125,RM-1208B,9/11/2013,0,0,0,0,0,0,0
24126,RM-1208B,9/12/2013,0,0,0,0,0,0,0
24127,RM-1208B,9/13/2013,0,0,0,0,0,0,0
24128,RM-1208B,9/14/2013,0,0,0,0,0,0,0
24129,RM-1208B,9/15/2013,0,0,0,0,0,0,0
24130,RM-1208B,9/16/2013,0,0,0,0,0,0,0
24131,RM-1208B,9/17/2013,0,0,0,0,0,0,0
24132,RM-1208B,9/18/2013,0,0,0,0,0,0,0
24133,RM-1208B,9/19/2013,0,0,0,0,0,0,0
24134,RM-1208B,9/20/2013,0,0,0,0,0,0,0
24135,RM-1208B,9/21/2013,0,0,0,0,0,0,0
24136,RM-1208B,9/22/2013,0,0,0,0,0,0,0
24137,RM-1208B,9/23/2013,0,0,0,0,0,0,0
24138,RM-1208B,9/24/2013,0,0,0,0,0,0,0
24139,RM-1208B,9/25/2013,0,0,0,0,0,0,0
24140,RM-1208B,9/26/2013,0,0,0,0,0,0,0
24141,RM-1208B,9/27/2013,0,0,0,0,0,0,0
24142,RM-1208B,9/28/2013,0,0,0,0,0,0,0
24143,RM-1208B,9/29/2013,0,0,0,0,0,0,0
24144,RM-1208B,9/30/2013,0,0,0,0,0,0,0
24145,RM-1208B,10/1/2013,0,0,0,0,0,0,0
24146,RM-1208B,10/2/2013,0,0,0,0,0,0,0
24147,RM-1208B,10/3/2013,0,0,0,0,0,0,0
24148,RM-1208B,10/4/2013,0,0,0,0,0,0,0
24149,RM-1208B,10/5/2013,0,0,0,0,0,0,0
24150,RM-1208B,10/6/2013,0,0,0,0,0,0,0
24151,RM-1208B,10/7/2013,0,0,0,0,0,0,0
24152,RM-1208B,10/8/2013,0,0,0,0,0,0,0
24153,RM-1208B,10/9/2013,0,0,0,0,0,0,0
24154,RM-1208B,10/10/2013,0,0,0,0,0,0,0
24155,RM-1208B,10/11/2013,0,0,0,0,0,0,0
24156,RM-1208B,10/12/2013,0,0,0,0,0,0,0
24157,RM-1208B,10/13/2013,0,0,0,0,0,0,0
24158,RM-1208B,10/14/2013,0,0,0,0,0,0,0
24159,RM-1208B,10/15/2013,0,0,0,0,0,0,0
24160,RM-1208B,10/16/2013,0,0,0,0,0,0,0
24161,RM-1208B,10/17/2013,0,0,0,0,0,0,0
24162,RM-1208B,10/18/2013,0,0,0,0,0,0,0
24163,RM-1208B,10/19/2013,0,0,0,0,0,0,0
24164,RM-1208B,10/20/2013,0,0,0,0,0,0,0
24165,RM-1208B,10/21/2013,0,0,0,0,0,0,0
24166,RM-1208B,10/22/2013,0,0,0,0,0,0,0
24167,RM-1208B,10/23/2013,0,0,0,0,0,0,0
24168,RM-1208B,10/24/2013,0,0,0,0,0,0,0
24169,RM-1208B,10/25/2013,0,0,0,0,0,0,0
24170,RM-1208B,10/26/2013,0,0,0,0,0,0,0
24171,RM-1208B,10/27/2013,0,0,0,0,0,0,0
24172,RM-1208B,10/28/2013,0,0,0,0,0,0,0
24173,RM-1208B,10/29/2013,0,0,0,0,0,0,0
24174,RM-1208B,10/30/2013,0,0,0,0,0,0,0
24175,RM-1208B,10/31/2013,0,0,0,0,0,0,0
24176,RM-1208B,11/1/2013,0,0,0,0,0,0,0
24177,RM-1208B,11/2/2013,0,0,0,0,0,0,0
24178,RM-1208B,11/3/2013,0,0,0,0,0,0,0
24179,RM-1208B,11/4/2013,0,0,0,0,0,0,0
24180,RM-1208B,11/5/2013,0,0,0,0,0,0,0
24181,RM-1208B,11/6/2013,0,0,0,0,0,0,0
24182,RM-1208B,11/7/2013,0,0,0,0,0,0,0
24183,RM-1208B,11/8/2013,0,0,0,0,0,0,0
24184,RM-1208B,11/9/2013,0,0,0,0,0,0,0
24185,RM-1208B,11/10/2013,0,0,0,0,0,0,0
24186,RM-1208B,11/11/2013,0,0,0,0,0,0,0
24187,RM-1208B,11/12/2013,0,0,0,0,0,0,0
24188,RM-1208B,11/13/2013,0,0,0,0,0,0,0
24189,RM-1208B,11/14/2013,0,0,0,0,0,0,0
24190,RM-1208B,11/15/2013,0,0,0,0,0,0,0
24191,RM-1208B,11/19/2013,0,0,0,0,0,0,0
24192,RM-1208B,11/20/2013,0,0,0,0,0,0,0
24193,RM-1208B,11/21/2013,0,0,0,0,0,0,0
24194,RM-1208B,11/22/2013,0,0,0,0,0,0,0
24195,RM-1208B,11/23/2013,0,0,0,0,0,0,0
24196,RM-1208B,11/24/2013,0,0,0,0,0,0,0
24197,RM-1208B,11/25/2013,0,0,0,0,0,0,0
24198,RM-1208B,11/26/2013,0,0,0,0,0,0,0
24199,RM-1208B,11/27/2013,0,0,0,0,0,0,0
24200,RM-1208B,11/28/2013,0,0,0,0,0,0,0
24201,RM-1208B,11/29/2013,0,0,0,0,0,0,0
24202,RM-1208B,11/30/2013,0,0,0,0,0,0,0
24203,RM-1208B,12/1/2013,0,0,0,0,0,0,0
24204,RM-1208B,12/2/2013,0,0,0,0,0,0,0
24748,RM-1212,7/1/2013,0,0,0,0,0,0,0
24749,RM-1212,7/2/2013,0,0,0,0,0,0,0
24750,RM-1212,7/3/2013,0,0,0,0,0,0,0
24751,RM-1212,7/4/2013,0,0,0,0,0,0,0
24752,RM-1212,7/5/2013,0,0,0,0,0,0,0
24753,RM-1212,7/6/2013,0,0,0,0,0,0,0
24754,RM-1212,7/7/2013,0,0,0,0,0,0,0
24755,RM-1212,7/8/2013,0,0,0,0,0,0,0
24756,RM-1212,7/9/2013,0,0,0,0,0,0,0
24757,RM-1212,7/10/2013,0,0,0,0,0,0,0
24758,RM-1212,7/11/2013,0,0,0,0,0,0,0
24759,RM-1212,7/12/2013,0,0,0,0,0,0,0
24760,RM-1212,7/13/2013,0,0,0,0,0,0,0
24761,RM-1212,7/14/2013,0,0,0,0,0,0,0
24762,RM-1212,7/15/2013,0,0,0,0,0,0,0
24763,RM-1212,7/17/2013,0,0,0,0,0,0,0
24764,RM-1212,7/18/2013,0,0,0,0,0,0,0
24765,RM-1212,7/19/2013,0,0,0,0,0,0,0
24766,RM-1212,7/20/2013,0,0,0,0,0,0,0
24767,RM-1212,7/21/2013,0,0,0,0,0,0,0
24768,RM-1212,7/22/2013,0,0,0,0,0,0,0
24769,RM-1212,7/23/2013,0,0,0,0,0,0,0
24770,RM-1212,7/24/2013,0,0,0,0,0,0,0
24771,RM-1212,7/25/2013,0,0,0,0,0,0,0
24772,RM-1212,7/26/2013,0,0,0,0,0,0,0
24773,RM-1212,7/27/2013,0,0,0,0,0,0,0
24774,RM-1212,7/28/2013,0,0,0,0,0,0,0
24775,RM-1212,7/29/2013,0,0,0,0,0,0,0
24776,RM-1212,7/30/2013,0,0,0,0,0,0,0
24777,RM-1212,7/31/2013,0,0,0,0,0,0,0
24778,RM-1212,8/1/2013,0,0,0,0,0,0,0
24779,RM-1212,8/2/2013,0,0,0,0,0,0,0
24780,RM-1212,8/3/2013,0,0,0,0,0,0,0
24781,RM-1212,8/4/2013,0,0,0,0,0,0,0
24782,RM-1212,8/5/2013,0,0,0,0,0,0,0
24783,RM-1212,8/6/2013,0,0,0,0,0,0,0
24784,RM-1212,8/7/2013,0,0,0,0,0,0,0
24785,RM-1212,8/8/2013,0,0,0,0,0,0,0
24786,RM-1212,8/9/2013,0,0,0,0,0,0,0
24787,RM-1212,8/10/2013,0,0,0,0,0,0,0
24788,RM-1212,8/11/2013,0,0,0,0,0,0,0
24789,RM-1212,8/12/2013,0,0,0,0,0,0,0
24790,RM-1212,8/13/2013,0,0,0,0,0,0,0
24791,RM-1212,8/14/2013,0,0,0,0,0,0,0
24792,RM-1212,8/15/2013,0,0,0,0,0,0,0
24793,RM-1212,8/16/2013,0,0,0,0,0,0,0
24794,RM-1212,8/17/2013,0,0,0,0,0,0,0
24795,RM-1212,8/18/2013,0,0,0,0,0,0,0
24796,RM-1212,8/19/2013,0,0,0,0,0,0,0
24797,RM-1212,8/20/2013,0,0,0,0,0,0,0
24798,RM-1212,8/21/2013,0,0,0,0,0,0,0
24799,RM-1212,8/22/2013,0,0,0,0,0,0,0
24800,RM-1212,8/27/2013,0,0,0,0,0,0,0
24801,RM-1212,8/28/2013,0,0,0,0,0,0,0
24802,RM-1212,8/29/2013,0,0,0,0,0,0,0
24803,RM-1212,8/30/2013,0,0,0,0,0,0,0
24804,RM-1212,9/4/2013,0,0,0,0,0,0,0
24805,RM-1212,9/5/2013,0,0,0,0,0,0,0
24806,RM-1212,9/6/2013,0,0,0,0,0,0,0
24807,RM-1212,9/7/2013,0,0,0,0,0,0,0
24808,RM-1212,9/9/2013,0,0,0,0,0,0,0
24809,RM-1212,9/10/2013,0,0,0,0,0,0,0
24810,RM-1212,9/11/2013,0,0,0,0,0,0,0
24811,RM-1212,9/12/2013,0,0,0,0,0,0,0
24812,RM-1212,9/13/2013,0,0,0,0,0,0,0
24813,RM-1212,9/14/2013,0,0,0,0,0,0,0
24814,RM-1212,9/15/2013,0,0,0,0,0,0,0
24815,RM-1212,9/16/2013,0,0,0,0,0,0,0
24816,RM-1212,9/17/2013,0,0,0,0,0,0,0
24817,RM-1212,9/18/2013,0,0,0,0,0,0,0
24818,RM-1212,9/19/2013,0,0,0,0,0,0,0
24819,RM-1212,9/20/2013,0,0,0,0,0,0,0
24820,RM-1212,9/21/2013,0,0,0,0,0,0,0
24821,RM-1212,9/22/2013,0,0,0,0,0,0,0
24822,RM-1212,9/23/2013,0,0,0,0,0,0,0
24823,RM-1212,9/24/2013,0,0,0,0,0,0,0
24824,RM-1212,9/25/2013,0,0,0,0,0,0,0
24825,RM-1212,9/26/2013,0,0,0,0,0,0,0
24826,RM-1212,9/27/2013,0,0,0,0,0,0,0
24827,RM-1212,9/28/2013,0,0,0,0,0,0,0
24828,RM-1212,9/29/2013,0,0,0,0,0,0,0
24829,RM-1212,9/30/2013,0,0,0,0,0,0,0
24830,RM-1212,10/1/2013,0,0,0,0,0,0,0
24831,RM-1212,10/2/2013,0,0,0,0,0,0,0
24832,RM-1212,10/3/2013,0,0,0,0,0,0,0
24833,RM-1212,10/4/2013,0,0,0,0,0,0,0
24834,RM-1212,10/5/2013,0,0,0,0,0,0,0
24835,RM-1212,10/6/2013,0,0,0,0,0,0,0
24836,RM-1212,10/7/2013,0,0,0,0,0,0,0
24837,RM-1212,10/8/2013,0,0,0,0,0,0,0
24838,RM-1212,10/9/2013,0,0,0,0,0,0,0
24839,RM-1212,10/10/2013,0,0,0,0,0,0,0
24840,RM-1212,10/11/2013,0,0,0,0,0,0,0
24841,RM-1212,10/12/2013,0,0,0,0,0,0,0
24842,RM-1212,10/13/2013,0,0,0,0,0,0,0
24843,RM-1212,10/14/2013,0,0,0,0,0,0,0
24844,RM-1212,10/15/2013,0,0,0,0,0,0,0
24845,RM-1212,10/16/2013,0,0,0,0,0,0,0
24846,RM-1212,10/17/2013,0,0,0,0,0,0,0
24847,RM-1212,10/18/2013,0,0,0,0,0,0,0
24848,RM-1212,10/19/2013,0,0,0,0,0,0,0
24849,RM-1212,10/20/2013,0,0,0,0,0,0,0
24850,RM-1212,10/21/2013,0,0,0,0,0,0,0
24851,RM-1212,10/22/2013,0,0,0,0,0,0,0
24852,RM-1212,10/23/2013,0,0,0,0,0,0,0
24853,RM-1212,10/24/2013,0,0,0,0,0,0,0
24854,RM-1212,10/25/2013,0,0,0,0,0,0,0
24855,RM-1212,10/26/2013,0,0,0,0,0,0,0
24856,RM-1212,10/27/2013,0,0,0,0,0,0,0
24857,RM-1212,10/28/2013,0,0,0,0,0,0,0
24858,RM-1212,10/29/2013,0,0,0,0,0,0,0
24859,RM-1212,10/30/2013,0,0,0,0,0,0,0
24860,RM-1212,10/31/2013,0,0,0,0,0,0,0
24861,RM-1212,11/1/2013,0,0,0,0,0,0,0
24862,RM-1212,11/2/2013,0,0,0,0,0,0,0
24863,RM-1212,11/3/2013,0,0,0,0,0,0,0
24864,RM-1212,11/4/2013,0,0,0,0,0,0,0
24865,RM-1212,11/5/2013,0,0,0,0,0,0,0
24866,RM-1212,11/6/2013,0,0,0,0,0,0,0
24867,RM-1212,11/7/2013,0,0,0,0,0,0,0
24868,RM-1212,11/8/2013,0,0,0,0,0,0,0
25044,RM-1212,5/6/2014,0,0,0,0,0,0,0
25274,RM-1212,12/24/2014,0,0,0,0,0,0,0
25275,RM-1212,12/25/2014,0,0,0,0,0,0,0
25276,RM-1212,12/26/2014,0,0,0,0,0,0,0
25277,RM-1212,12/27/2014,0,0,0,0,0,0,0
25278,RM-1212,12/28/2014,0,0,0,0,0,0,0
25279,RM-1212,12/29/2014,0,0,0,0,0,0,0
25280,RM-1212,12/30/2014,0,0,0,0,0,0,0
25281,RM-1212,12/31/2014,0,0,0,0,0,0,0
25282,RM-1212,1/1/2015,0,0,0,0,0,0,0
25283,RM-1212,1/2/2015,0,0,0,0,0,0,0
25284,RM-1212,1/3/2015,0,0,0,0,0,0,0
25285,RM-1212,1/4/2015,0,0,0,0,0,0,0
25286,RM-1212,1/5/2015,0,0,0,0,0,0,0
25287,RM-1212,1/6/2015,0,0,0,0,0,0,0
25288,RM-1212,1/7/2015,0,0,0,0,0,0,0
25289,RM-1212,1/8/2015,0,0,0,0,0,0,0
25290,RM-1212,1/9/2015,0,0,0,0,0,0,0
25291,RM-1212,1/10/2015,0,0,0,0,0,0,0
25292,RM-1212,1/11/2015,0,0,0,0,0,0,0
25293,RM-1212,1/12/2015,0,0,0,0,0,0,0
25294,RM-1212,1/13/2015,0,0,0,0,0,0,0
25295,RM-1212,1/14/2015,0,0,0,0,0,0,0
25296,RM-1212,1/15/2015,0,0,0,0,0,0,0
25297,RM-1212,1/16/2015,0,0,0,0,0,0,0
25298,RM-1212,1/17/2015,0,0,0,0,0,0,0
25299,RM-1212,1/18/2015,0,0,0,0,0,0,0
25300,RM-1212,1/19/2015,0,0,0,0,0,0,0
25301,RM-1212,1/20/2015,0,0,0,0,0,0,0
25302,RM-1212,1/21/2015,0,0,0,0,0,0,0
25303,RM-1212,1/22/2015,0,0,0,0,0,0,0
25304,RM-1212,1/23/2015,0,0,0,0,0,0,0
25305,RM-1212,1/24/2015,0,0,0,0,0,0,0
25306,RM-1212,1/25/2015,0,0,0,0,0,0,0
25307,RM-1212,1/26/2015,0,0,0,0,0,0,0
25308,RM-1212,1/27/2015,0,0,0,0,0,0,0
25309,RM-1212,1/28/2015,0,0,0,0,0,0,0
25310,RM-1212,1/29/2015,0,0,0,0,0,0,0
25311,RM-1212,1/30/2015,0,0,0,0,0,0,0
25312,RM-1212,1/31/2015,0,0,0,0,0,0,0
25313,RM-1212,2/1/2015,0,0,0,0,0,0,0
25314,RM-1212,2/2/2015,0,0,0,0,0,0,0
25315,RM-1212,2/3/2015,0,0,0,0,0,0,0
25316,RM-1212,2/4/2015,0,0,0,0,0,0,0
25317,RM-1212,2/5/2015,0,0,0,0,0,0,0
25318,RM-1212,2/6/2015,0,0,0,0,0,0,0
25319,RM-1212,2/7/2015,0,0,0,0,0,0,0
25320,RM-1212,2/8/2015,0,0,0,0,0,0,0
25321,RM-1212,2/9/2015,0,0,0,0,0,0,0
25322,RM-1212,2/10/2015,0,0,0,0,0,0,0
25323,RM-1212,2/11/2015,0,0,0,0,0,0,0
25324,RM-1212,2/12/2015,0,0,0,0,0,0,0
25325,RM-1212,2/13/2015,0,0,0,0,0,0,0
25326,RM-1212,2/14/2015,0,0,0,0,0,0,0
25327,RM-1212,2/15/2015,0,0,0,0,0,0,0
25328,RM-1212,2/16/2015,0,0,0,0,0,0,0
25329,RM-1212,2/17/2015,0,0,0,0,0,0,0
25330,RM-1212,2/18/2015,0,0,0,0,0,0,0
25331,RM-1212,2/19/2015,0,0,0,0,0,0,0
25332,RM-1212,2/20/2015,0,0,0,0,0,0,0
25333,RM-1212,2/21/2015,0,0,0,0,0,0,0
25334,RM-1212,2/22/2015,0,0,0,0,0,0,0
25335,RM-1212,2/23/2015,0,0,0,0,0,0,0
25336,RM-1212,2/24/2015,0,0,0,0,0,0,0
25337,RM-1212,2/25/2015,0,0,0,0,0,0,0
25338,RM-1212,2/26/2015,0,0,0,0,0,0,0
25339,RM-1212,2/27/2015,0,0,0,0,0,0,0
25340,RM-1212,3/15/2015,0,0,0,0,0,0,0
25341,RM-1212,3/16/2015,0,0,0,0,0,0,0
25342,RM-1212,3/17/2015,0,0,0,0,0,0,0
25343,RM-1212,3/18/2015,0,0,0,0,0,0,0
25344,RM-1212,3/19/2015,0,0,0,0,0,0,0
25345,RM-1212,3/20/2015,0,0,0,0,0,0,0
25346,RM-1212,3/21/2015,0,0,0,0,0,0,0
25347,RM-1212,3/22/2015,0,0,0,0,0,0,0
25348,RM-1212,3/23/2015,0,0,0,0,0,0,0
25349,RM-1212,3/24/2015,0,0,0,0,0,0,0
25350,RM-1212,3/25/2015,0,0,0,0,0,0,0
25351,RM-1212,3/26/2015,0,0,0,0,0,0,0
25352,RM-1212,3/27/2015,0,0,0,0,0,0,0
25353,RM-1212,3/28/2015,0,0,0,0,0,0,0
25354,RM-1212,3/29/2015,0,0,0,0,0,0,0
25355,RM-1212,3/30/2015,0,0,0,0,0,0,0
25356,RM-1212,3/31/2015,0,0,0,0,0,0,0
25357,RM-1212,4/1/2015,0,0,0,0,0,0,0
25358,RM-1212,4/2/2015,0,0,0,0,0,0,0
25359,RM-1212,4/3/2015,0,0,0,0,0,0,0
25360,RM-1212,4/4/2015,0,0,0,0,0,0,0
25361,RM-1212,4/5/2015,0,0,0,0,0,0,0
25362,RM-1212,4/6/2015,0,0,0,0,0,0,0
25363,RM-1212,4/7/2015,0,0,0,0,0,0,0
25364,RM-1212,4/8/2015,0,0,0,0,0,0,0
25365,RM-1212,4/9/2015,0,0,0,0,0,0,0
25366,RM-1212,4/10/2015,0,0,0,0,0,0,0
25367,RM-1212,4/11/2015,0,0,0,0,0,0,0
25368,RM-1212,4/12/2015,0,0,0,0,0,0,0
25369,RM-1212,4/13/2015,0,0,0,0,0,0,0
25370,RM-1212,4/14/2015,0,0,0,0,0,0,0
25371,RM-1212,4/15/2015,0,0,0,0,0,0,0
25372,RM-1212,4/16/2015,0,0,0,0,0,0,0
25373,RM-1212,4/17/2015,0,0,0,0,0,0,0
25374,RM-1212,4/18/2015,0,0,0,0,0,0,0
25375,RM-1212,4/19/2015,0,0,0,0,0,0,0
25376,RM-1212,4/20/2015,0,0,0,0,0,0,0
25377,RM-1212,4/21/2015,0,0,0,0,0,0,0
25378,RM-1212,4/22/2015,0,0,0,0,0,0,0
25379,RM-1212,4/23/2015,0,0,0,0,0,0,0
25380,RM-1212,4/24/2015,0,0,0,0,0,0,0
25381,RM-1212,4/25/2015,0,0,0,0,0,0,0
25382,RM-1212,4/26/2015,0,0,0,0,0,0,0
25383,RM-1212,4/27/2015,0,0,0,0,0,0,0
25384,RM-1212,4/28/2015,0,0,0,0,0,0,0
25385,RM-1212,4/29/2015,0,0,0,0,0,0,0
25386,RM-1212,4/30/2015,0,0,0,0,0,0,0
25387,RM-1212,5/1/2015,0,0,0,0,0,0,0
25388,RM-1212,5/2/2015,0,0,0,0,0,0,0
25389,RM-1212,5/3/2015,0,0,0,0,0,0,0
25390,RM-1212,5/4/2015,0,0,0,0,0,0,0
25391,RM-1212,5/5/2015,0,0,0,0,0,0,0
25392,RM-1212,5/6/2015,0,0,0,0,0,0,0
25393,RM-1212,5/7/2015,0,0,0,0,0,0,0
25394,RM-1212,5/8/2015,0,0,0,0,0,0,0
25395,RM-1212,5/9/2015,0,0,0,0,0,0,0
25396,RM-1212,5/10/2015,0,0,0,0,0,0,0
25397,RM-1212,5/11/2015,0,0,0,0,0,0,0
25398,RM-1212,5/12/2015,0,0,0,0,0,0,0
25399,RM-1212,5/13/2015,0,0,0,0,0,0,0
25400,RM-1212,5/14/2015,0,0,0,0,0,0,0
25401,RM-1212,5/15/2015,0,0,0,0,0,0,0
25402,RM-1212,5/16/2015,0,0,0,0,0,0,0
25403,RM-1212,5/17/2015,0,0,0,0,0,0,0
25404,RM-1212,5/18/2015,0,0,0,0,0,0,0
25405,RM-1212,5/19/2015,0,0,0,0,0,0,0
25406,RM-1212,5/20/2015,0,0,0,0,0,0,0
25407,RM-1212,5/21/2015,0,0,0,0,0,0,0
25408,RM-1212,5/22/2015,0,0,0,0,0,0,0
25409,RM-1212,5/23/2015,0,0,0,0,0,0,0
25410,RM-1212,5/24/2015,0,0,0,0,0,0,0
25411,RM-1212,5/25/2015,0,0,0,0,0,0,0
25412,RM-1212,5/26/2015,0,0,0,0,0,0,0
25413,RM-1212,5/27/2015,0,0,0,0,0,0,0
25414,RM-1212,5/28/2015,0,0,0,0,0,0,0
25415,RM-1212,5/29/2015,0,0,0,0,0,0,0
25416,RM-1212,5/30/2015,0,0,0,0,0,0,0
25417,RM-1212,5/31/2015,0,0,0,0,0,0,0
25484,RM-1213,9/15/2013,0,0,0,0,0,0,0
25485,RM-1213,9/16/2013,0,0,0,0,0,0,0
25486,RM-1213,9/17/2013,0,0,0,0,0,0,0
25487,RM-1213,9/18/2013,0,0,0,0,0,0,0
25488,RM-1213,9/19/2013,0,0,0,0,0,0,0
25489,RM-1213,9/20/2013,0,0,0,0,0,0,0
25490,RM-1213,9/21/2013,0,0,0,0,0,0,0
25491,RM-1213,9/22/2013,0,0,0,0,0,0,0
25492,RM-1213,9/23/2013,0,0,0,0,0,0,0
25493,RM-1213,9/24/2013,0,0,0,0,0,0,0
25494,RM-1213,9/25/2013,0,0,0,0,0,0,0
25495,RM-1213,9/26/2013,0,0,0,0,0,0,0
25496,RM-1213,9/27/2013,0,0,0,0,0,0,0
25497,RM-1213,9/28/2013,0,0,0,0,0,0,0
25498,RM-1213,9/29/2013,0,0,0,0,0,0,0
25499,RM-1213,9/30/2013,0,0,0,0,0,0,0
25500,RM-1213,10/1/2013,0,0,0,0,0,0,0
25501,RM-1213,10/2/2013,0,0,0,0,0,0,0
25502,RM-1213,10/3/2013,0,0,0,0,0,0,0
25503,RM-1213,10/4/2013,0,0,0,0,0,0,0
25504,RM-1213,10/5/2013,0,0,0,0,0,0,0
25505,RM-1213,10/6/2013,0,0,0,0,0,0,0
25506,RM-1213,10/7/2013,0,0,0,0,0,0,0
25676,RM-1213,3/29/2014,0,0,0,0,0,0,0
25677,RM-1213,3/30/2014,0,0,0,0,0,0,0
25678,RM-1213,3/31/2014,0,0,0,0,0,0,0
25679,RM-1213,4/1/2014,0,0,0,0,0,0,0
25680,RM-1213,4/2/2014,0,0,0,0,0,0,0
25681,RM-1213,4/3/2014,0,0,0,0,0,0,0
25682,RM-1213,4/4/2014,0,0,0,0,0,0,0
25683,RM-1213,4/5/2014,0,0,0,0,0,0,0
25684,RM-1213,4/6/2014,0,0,0,0,0,0,0
25685,RM-1213,4/7/2014,0,0,0,0,0,0,0
25686,RM-1213,4/8/2014,0,0,0,0,0,0,0
25687,RM-1213,4/9/2014,0,0,0,0,0,0,0
25688,RM-1213,4/10/2014,0,0,0,0,0,0,0
25689,RM-1213,4/11/2014,0,0,0,0,0,0,0
25690,RM-1213,4/12/2014,0,0,0,0,0,0,0
25691,RM-1213,4/13/2014,0,0,0,0,0,0,0
25692,RM-1213,4/14/2014,0,0,0,0,0,0,0
25693,RM-1213,4/15/2014,0,0,0,0,0,0,0
25694,RM-1213,4/16/2014,0,0,0,0,0,0,0
25695,RM-1213,4/17/2014,0,0,0,0,0,0,0
25696,RM-1213,4/18/2014,0,0,0,0,0,0,0
25697,RM-1213,4/19/2014,0,0,0,0,0,0,0
25698,RM-1213,4/20/2014,0,0,0,0,0,0,0
25699,RM-1213,4/21/2014,0,0,0,0,0,0,0
25700,RM-1213,4/22/2014,0,0,0,0,0,0,0
25701,RM-1213,4/23/2014,0,0,0,0,0,0,0
25702,RM-1213,4/24/2014,0,0,0,0,0,0,0
25703,RM-1213,4/25/2014,0,0,0,0,0,0,0
25704,RM-1213,4/26/2014,0,0,0,0,0,0,0
25705,RM-1213,4/27/2014,0,0,0,0,0,0,0
25706,RM-1213,4/28/2014,0,0,0,0,0,0,0
25707,RM-1213,4/29/2014,0,0,0,0,0,0,0
25708,RM-1213,4/30/2014,0,0,0,0,0,0,0
25709,RM-1213,5/1/2014,0,0,0,0,0,0,0
25710,RM-1213,5/2/2014,0,0,0,0,0,0,0
25711,RM-1213,5/3/2014,0,0,0,0,0,0,0
25712,RM-1213,5/4/2014,0,0,0,0,0,0,0
25713,RM-1213,5/5/2014,0,0,0,0,0,0,0
25714,RM-1213,5/6/2014,0,0,0,0,0,0,0
25715,RM-1213,5/7/2014,0,0,0,0,0,0,0
25716,RM-1213,5/8/2014,0,0,0,0,0,0,0
25717,RM-1213,5/9/2014,0,0,0,0,0,0,0
25718,RM-1213,5/10/2014,0,0,0,0,0,0,0
25719,RM-1213,5/11/2014,0,0,0,0,0,0,0
25720,RM-1213,5/12/2014,0,0,0,0,0,0,0
25721,RM-1213,5/13/2014,0,0,0,0,0,0,0
25722,RM-1213,5/14/2014,0,0,0,0,0,0,0
25723,RM-1213,5/15/2014,0,0,0,0,0,0,0
25724,RM-1213,5/16/2014,0,0,0,0,0,0,0
25725,RM-1213,5/17/2014,0,0,0,0,0,0,0
25726,RM-1213,5/18/2014,0,0,0,0,0,0,0
25727,RM-1213,5/19/2014,0,0,0,0,0,0,0
25728,RM-1213,5/20/2014,0,0,0,0,0,0,0
25729,RM-1213,5/21/2014,0,0,0,0,0,0,0
25730,RM-1213,5/22/2014,0,0,0,0,0,0,0
25731,RM-1213,5/23/2014,0,0,0,0,0,0,0
25732,RM-1213,5/24/2014,0,0,0,0,0,0,0
25733,RM-1213,5/25/2014,0,0,0,0,0,0,0
25734,RM-1213,5/26/2014,0,0,0,0,0,0,0
25735,RM-1213,5/27/2014,0,0,0,0,0,0,0
25736,RM-1213,5/28/2014,0,0,0,0,0,0,0
25737,RM-1213,5/29/2014,0,0,0,0,0,0,0
25738,RM-1213,5/30/2014,0,0,0,0,0,0,0
25739,RM-1213,5/31/2014,0,0,0,0,0,0,0
25740,RM-1213,6/1/2014,0,0,0,0,0,0,0
25741,RM-1213,6/2/2014,0,0,0,0,0,0,0
25742,RM-1213,6/3/2014,0,0,0,0,0,0,0
25743,RM-1213,6/4/2014,0,0,0,0,0,0,0
25744,RM-1213,6/5/2014,0,0,0,0,0,0,0
25745,RM-1213,6/6/2014,0,0,0,0,0,0,0
25746,RM-1213,6/7/2014,0,0,0,0,0,0,0
25747,RM-1213,6/8/2014,0,0,0,0,0,0,0
25748,RM-1213,6/9/2014,0,0,0,0,0,0,0
25749,RM-1213,6/10/2014,0,0,0,0,0,0,0
25750,RM-1213,6/11/2014,0,0,0,0,0,0,0
25751,RM-1213,6/12/2014,0,0,0,0,0,0,0
25752,RM-1213,6/13/2014,0,0,0,0,0,0,0
25753,RM-1213,6/14/2014,0,0,0,0,0,0,0
25754,RM-1213,6/15/2014,0,0,0,0,0,0,0
25755,RM-1213,6/16/2014,0,0,0,0,0,0,0
25756,RM-1213,6/17/2014,0,0,0,0,0,0,0
25757,RM-1213,6/18/2014,0,0,0,0,0,0,0
25758,RM-1213,6/19/2014,0,0,0,0,0,0,0
25759,RM-1213,6/20/2014,0,0,0,0,0,0,0
25760,RM-1213,6/21/2014,0,0,0,0,0,0,0
25761,RM-1213,6/22/2014,0,0,0,0,0,0,0
25762,RM-1213,6/23/2014,0,0,0,0,0,0,0
25763,RM-1213,6/24/2014,0,0,0,0,0,0,0
25764,RM-1213,6/25/2014,0,0,0,0,0,0,0
25765,RM-1213,6/26/2014,0,0,0,0,0,0,0
25766,RM-1213,6/27/2014,0,0,0,0,0,0,0
25767,RM-1213,6/28/2014,0,0,0,0,0,0,0
25768,RM-1213,6/29/2014,0,0,0,0,0,0,0
25769,RM-1213,6/30/2014,0,0,0,0,0,0,0
25770,RM-1213,7/1/2014,0,0,0,0,0,0,0
25771,RM-1213,7/2/2014,0,0,0,0,0,0,0
25772,RM-1213,7/3/2014,0,0,0,0,0,0,0
25773,RM-1213,7/4/2014,0,0,0,0,0,0,0
25774,RM-1213,7/5/2014,0,0,0,0,0,0,0
25775,RM-1213,7/6/2014,0,0,0,0,0,0,0
25776,RM-1213,7/7/2014,0,0,0,0,0,0,0
25777,RM-1213,7/8/2014,0,0,0,0,0,0,0
25778,RM-1213,7/9/2014,0,0,0,0,0,0,0
25779,RM-1213,7/10/2014,0,0,0,0,0,0,0
25780,RM-1213,7/11/2014,0,0,0,0,0,0,0
25781,RM-1213,7/12/2014,0,0,0,0,0,0,0
25782,RM-1213,7/13/2014,0,0,0,0,0,0,0
25783,RM-1213,7/14/2014,0,0,0,0,0,0,0
25784,RM-1213,7/15/2014,0,0,0,0,0,0,0
25785,RM-1213,7/16/2014,0,0,0,0,0,0,0
25786,RM-1213,7/17/2014,0,0,0,0,0,0,0
25787,RM-1213,7/18/2014,0,0,0,0,0,0,0
25788,RM-1213,7/19/2014,0,0,0,0,0,0,0
25789,RM-1213,7/20/2014,0,0,0,0,0,0,0
25790,RM-1213,7/21/2014,0,0,0,0,0,0,0
25791,RM-1213,7/22/2014,0,0,0,0,0,0,0
25792,RM-1213,7/23/2014,0,0,0,0,0,0,0
25793,RM-1213,7/24/2014,0,0,0,0,0,0,0
25794,RM-1213,7/25/2014,0,0,0,0,0,0,0
25795,RM-1213,7/26/2014,0,0,0,0,0,0,0
25796,RM-1213,7/27/2014,0,0,0,0,0,0,0
25797,RM-1213,7/28/2014,0,0,0,0,0,0,0
25798,RM-1213,7/29/2014,0,0,0,0,0,0,0
25799,RM-1213,7/30/2014,0,0,0,0,0,0,0
25800,RM-1213,7/31/2014,0,0,0,0,0,0,0
25801,RM-1213,8/1/2014,0,0,0,0,0,0,0
25802,RM-1213,8/2/2014,0,0,0,0,0,0,0
25803,RM-1213,8/3/2014,0,0,0,0,0,0,0
25804,RM-1213,8/4/2014,0,0,0,0,0,0,0
25805,RM-1213,8/5/2014,0,0,0,0,0,0,0
25806,RM-1213,8/6/2014,0,0,0,0,0,0,0
25807,RM-1213,8/7/2014,0,0,0,0,0,0,0
25808,RM-1213,8/8/2014,0,0,0,0,0,0,0
25809,RM-1213,8/9/2014,0,0,0,0,0,0,0
25810,RM-1213,8/10/2014,0,0,0,0,0,0,0
25811,RM-1213,8/11/2014,0,0,0,0,0,0,0
25812,RM-1213,8/12/2014,0,0,0,0,0,0,0
25813,RM-1213,8/13/2014,0,0,0,0,0,0,0
25814,RM-1213,8/14/2014,0,0,0,0,0,0,0
25815,RM-1213,8/15/2014,0,0,0,0,0,0,0
25816,RM-1213,8/16/2014,0,0,0,0,0,0,0
25817,RM-1213,8/17/2014,0,0,0,0,0,0,0
25818,RM-1213,8/18/2014,0,0,0,0,0,0,0
25819,RM-1213,8/19/2014,0,0,0,0,0,0,0
25820,RM-1213,8/20/2014,0,0,0,0,0,0,0
25821,RM-1213,8/21/2014,0,0,0,0,0,0,0
25822,RM-1213,8/22/2014,0,0,0,0,0,0,0
25823,RM-1213,8/23/2014,0,0,0,0,0,0,0
25824,RM-1213,8/24/2014,0,0,0,0,0,0,0
25825,RM-1213,8/25/2014,0,0,0,0,0,0,0
25826,RM-1213,8/26/2014,0,0,0,0,0,0,0
25827,RM-1213,8/27/2014,0,0,0,0,0,0,0
25828,RM-1213,8/28/2014,0,0,0,0,0,0,0
25829,RM-1213,8/29/2014,0,0,0,0,0,0,0
25830,RM-1213,8/30/2014,0,0,0,0,0,0,0
25831,RM-1213,8/31/2014,0,0,0,0,0,0,0
25832,RM-1213,9/1/2014,0,0,0,0,0,0,0
25833,RM-1213,9/2/2014,0,0,0,0,0,0,0
25834,RM-1213,9/3/2014,0,0,0,0,0,0,0
25835,RM-1213,9/4/2014,0,0,0,0,0,0,0
25836,RM-1213,9/5/2014,0,0,0,0,0,0,0
25837,RM-1213,9/6/2014,0,0,0,0,0,0,0
25838,RM-1213,9/7/2014,0,0,0,0,0,0,0
25839,RM-1213,9/8/2014,0,0,0,0,0,0,0
25840,RM-1213,9/9/2014,0,0,0,0,0,0,0
25841,RM-1213,9/10/2014,0,0,0,0,0,0,0
25842,RM-1213,9/11/2014,0,0,0,0,0,0,0
25843,RM-1213,9/12/2014,0,0,0,0,0,0,0
25844,RM-1213,9/13/2014,0,0,0,0,0,0,0
25845,RM-1213,9/14/2014,0,0,0,0,0,0,0
25846,RM-1213,9/15/2014,0,0,0,0,0,0,0
25847,RM-1213,9/16/2014,0,0,0,0,0,0,0
25848,RM-1213,9/17/2014,0,0,0,0,0,0,0
25849,RM-1213,9/18/2014,0,0,0,0,0,0,0
25850,RM-1213,9/19/2014,0,0,0,0,0,0,0
25851,RM-1213,9/20/2014,0,0,0,0,0,0,0
25852,RM-1213,9/21/2014,0,0,0,0,0,0,0
25853,RM-1213,9/22/2014,0,0,0,0,0,0,0
25854,RM-1213,9/23/2014,0,0,0,0,0,0,0
25855,RM-1213,9/24/2014,0,0,0,0,0,0,0
25856,RM-1213,9/25/2014,0,0,0,0,0,0,0
25857,RM-1213,9/28/2014,0,0,0,0,0,0,0
25858,RM-1213,9/29/2014,0,0,0,0,0,0,0
25859,RM-1213,9/30/2014,0,0,0,0,0,0,0
25860,RM-1213,10/1/2014,0,0,0,0,0,0,0
25861,RM-1213,10/2/2014,0,0,0,0,0,0,0
25862,RM-1213,10/3/2014,0,0,0,0,0,0,0
25863,RM-1213,10/4/2014,0,0,0,0,0,0,0
25864,RM-1213,10/5/2014,0,0,0,0,0,0,0
25865,RM-1213,10/6/2014,0,0,0,0,0,0,0
25866,RM-1213,10/7/2014,0,0,0,0,0,0,0
25867,RM-1213,10/8/2014,0,0,0,0,0,0,0
25868,RM-1213,10/9/2014,0,0,0,0,0,0,0
25869,RM-1213,10/10/2014,0,0,0,0,0,0,0
25870,RM-1213,10/11/2014,0,0,0,0,0,0,0
25871,RM-1213,10/12/2014,0,0,0,0,0,0,0
25872,RM-1213,10/13/2014,0,0,0,0,0,0,0
25873,RM-1213,10/14/2014,0,0,0,0,0,0,0
25874,RM-1213,10/15/2014,0,0,0,0,0,0,0
25875,RM-1213,10/16/2014,0,0,0,0,0,0,0
25876,RM-1213,10/17/2014,0,0,0,0,0,0,0
25877,RM-1213,10/18/2014,0,0,0,0,0,0,0
25878,RM-1213,10/19/2014,0,0,0,0,0,0,0
25879,RM-1213,10/20/2014,0,0,0,0,0,0,0
25880,RM-1213,10/21/2014,0,0,0,0,0,0,0
25881,RM-1213,10/22/2014,0,0,0,0,0,0,0
25882,RM-1213,10/23/2014,0,0,0,0,0,0,0
25883,RM-1213,10/24/2014,0,0,0,0,0,0,0
25884,RM-1213,10/25/2014,0,0,0,0,0,0,0
25885,RM-1213,10/26/2014,0,0,0,0,0,0,0
25886,RM-1213,10/27/2014,0,0,0,0,0,0,0
25887,RM-1213,10/28/2014,0,0,0,0,0,0,0
25888,RM-1213,10/29/2014,0,0,0,0,0,0,0
25889,RM-1213,10/30/2014,0,0,0,0,0,0,0
25890,RM-1213,10/31/2014,0,0,0,0,0,0,0
25891,RM-1213,11/1/2014,0,0,0,0,0,0,0
25892,RM-1213,11/2/2014,0,0,0,0,0,0,0
25893,RM-1213,11/3/2014,0,0,0,0,0,0,0
25894,RM-1213,11/4/2014,0,0,0,0,0,0,0
25895,RM-1213,11/5/2014,0,0,0,0,0,0,0
25896,RM-1213,11/6/2014,0,0,0,0,0,0,0
25897,RM-1213,11/7/2014,0,0,0,0,0,0,0
25898,RM-1213,11/8/2014,0,0,0,0,0,0,0
25899,RM-1213,11/9/2014,0,0,0,0,0,0,0
25900,RM-1213,11/10/2014,0,0,0,0,0,0,0
25901,RM-1213,11/11/2014,0,0,0,0,0,0,0
25902,RM-1213,11/12/2014,0,0,0,0,0,0,0
25903,RM-1213,11/13/2014,0,0,0,0,0,0,0
25904,RM-1213,11/14/2014,0,0,0,0,0,0,0
25905,RM-1213,11/15/2014,0,0,0,0,0,0,0
25906,RM-1213,11/16/2014,0,0,0,0,0,0,0
25907,RM-1213,11/17/2014,0,0,0,0,0,0,0
25908,RM-1213,11/18/2014,0,0,0,0,0,0,0
25909,RM-1213,11/19/2014,0,0,0,0,0,0,0
25910,RM-1213,11/20/2014,0,0,0,0,0,0,0
25911,RM-1213,11/21/2014,0,0,0,0,0,0,0
25912,RM-1213,11/22/2014,0,0,0,0,0,0,0
25913,RM-1213,11/23/2014,0,0,0,0,0,0,0
25914,RM-1213,11/24/2014,0,0,0,0,0,0,0
25915,RM-1213,11/25/2014,0,0,0,0,0,0,0
25916,RM-1213,11/26/2014,0,0,0,0,0,0,0
25917,RM-1213,11/27/2014,0,0,0,0,0,0,0
25918,RM-1213,11/28/2014,0,0,0,0,0,0,0
25919,RM-1213,11/29/2014,0,0,0,0,0,0,0
25920,RM-1213,11/30/2014,0,0,0,0,0,0,0
25921,RM-1213,12/1/2014,0,0,0,0,0,0,0
25922,RM-1213,12/2/2014,0,0,0,0,0,0,0
25923,RM-1213,12/3/2014,0,0,0,0,0,0,0
25924,RM-1213,12/4/2014,0,0,0,0,0,0,0
25925,RM-1213,12/5/2014,0,0,0,0,0,0,0
25926,RM-1213,12/6/2014,0,0,0,0,0,0,0
25927,RM-1213,12/7/2014,0,0,0,0,0,0,0
25928,RM-1213,12/8/2014,0,0,0,0,0,0,0
25929,RM-1213,12/9/2014,0,0,0,0,0,0,0
25930,RM-1213,12/10/2014,0,0,0,0,0,0,0
25931,RM-1213,12/11/2014,0,0,0,0,0,0,0
25932,RM-1213,12/12/2014,0,0,0,0,0,0,0
25933,RM-1213,12/13/2014,0,0,0,0,0,0,0
25934,RM-1213,12/14/2014,0,0,0,0,0,0,0
25935,RM-1213,12/15/2014,0,0,0,0,0,0,0
25936,RM-1213,12/16/2014,0,0,0,0,0,0,0
25937,RM-1213,12/17/2014,0,0,0,0,0,0,0
25938,RM-1213,12/18/2014,0,0,0,0,0,0,0
25939,RM-1213,12/19/2014,0,0,0,0,0,0,0
25940,RM-1213,12/20/2014,0,0,0,0,0,0,0
25941,RM-1213,12/21/2014,0,0,0,0,0,0,0
25942,RM-1213,12/22/2014,0,0,0,0,0,0,0
25943,RM-1213,12/23/2014,0,0,0,0,0,0,0
25944,RM-1213,12/24/2014,0,0,0,0,0,0,0
25945,RM-1213,12/25/2014,0,0,0,0,0,0,0
25946,RM-1213,12/26/2014,0,0,0,0,0,0,0
25947,RM-1213,12/27/2014,0,0,0,0,0,0,0
25948,RM-1213,12/28/2014,0,0,0,0,0,0,0
25949,RM-1213,12/29/2014,0,0,0,0,0,0,0
25950,RM-1213,12/30/2014,0,0,0,0,0,0,0
25951,RM-1213,12/31/2014,0,0,0,0,0,0,0
25952,RM-1213,1/1/2015,0,0,0,0,0,0,0
25953,RM-1213,1/2/2015,0,0,0,0,0,0,0
25954,RM-1213,1/3/2015,0,0,0,0,0,0,0
25955,RM-1213,1/4/2015,0,0,0,0,0,0,0
25956,RM-1213,1/5/2015,0,0,0,0,0,0,0
25957,RM-1213,1/6/2015,0,0,0,0,0,0,0
25958,RM-1213,1/7/2015,0,0,0,0,0,0,0
25959,RM-1213,1/8/2015,0,0,0,0,0,0,0
25960,RM-1213,1/9/2015,0,0,0,0,0,0,0
25961,RM-1213,1/10/2015,0,0,0,0,0,0,0
25962,RM-1213,1/11/2015,0,0,0,0,0,0,0
25963,RM-1213,1/12/2015,0,0,0,0,0,0,0
25964,RM-1213,1/13/2015,0,0,0,0,0,0,0
25965,RM-1213,1/14/2015,0,0,0,0,0,0,0
25966,RM-1213,1/15/2015,0,0,0,0,0,0,0
25967,RM-1213,1/16/2015,0,0,0,0,0,0,0
25968,RM-1213,1/17/2015,0,0,0,0,0,0,0
25969,RM-1213,1/18/2015,0,0,0,0,0,0,0
25970,RM-1213,1/19/2015,0,0,0,0,0,0,0
25971,RM-1213,1/20/2015,0,0,0,0,0,0,0
25972,RM-1213,1/21/2015,0,0,0,0,0,0,0
25973,RM-1213,1/22/2015,0,0,0,0,0,0,0
25974,RM-1213,1/23/2015,0,0,0,0,0,0,0
25975,RM-1213,1/24/2015,0,0,0,0,0,0,0
25976,RM-1213,1/25/2015,0,0,0,0,0,0,0
25977,RM-1213,1/26/2015,0,0,0,0,0,0,0
25978,RM-1213,1/27/2015,0,0,0,0,0,0,0
25979,RM-1213,1/28/2015,0,0,0,0,0,0,0
25980,RM-1213,1/29/2015,0,0,0,0,0,0,0
25981,RM-1213,1/30/2015,0,0,0,0,0,0,0
25982,RM-1213,1/31/2015,0,0,0,0,0,0,0
25983,RM-1213,2/1/2015,0,0,0,0,0,0,0
25984,RM-1213,2/2/2015,0,0,0,0,0,0,0
25985,RM-1213,2/3/2015,0,0,0,0,0,0,0
25986,RM-1213,2/4/2015,0,0,0,0,0,0,0
25987,RM-1213,2/5/2015,0,0,0,0,0,0,0
25988,RM-1213,2/6/2015,0,0,0,0,0,0,0
25989,RM-1213,2/7/2015,0,0,0,0,0,0,0
25990,RM-1213,2/8/2015,0,0,0,0,0,0,0
25991,RM-1213,2/9/2015,0,0,0,0,0,0,0
25992,RM-1213,2/10/2015,0,0,0,0,0,0,0
25993,RM-1213,2/11/2015,0,0,0,0,0,0,0
25994,RM-1213,2/12/2015,0,0,0,0,0,0,0
25995,RM-1213,2/13/2015,0,0,0,0,0,0,0
25996,RM-1213,2/14/2015,0,0,0,0,0,0,0
25997,RM-1213,2/15/2015,0,0,0,0,0,0,0
25998,RM-1213,2/16/2015,0,0,0,0,0,0,0
25999,RM-1213,2/17/2015,0,0,0,0,0,0,0
26000,RM-1213,2/18/2015,0,0,0,0,0,0,0
26001,RM-1213,2/19/2015,0,0,0,0,0,0,0
26002,RM-1213,2/20/2015,0,0,0,0,0,0,0
26003,RM-1213,2/21/2015,0,0,0,0,0,0,0
26004,RM-1213,2/22/2015,0,0,0,0,0,0,0
26005,RM-1213,2/23/2015,0,0,0,0,0,0,0
26006,RM-1213,2/24/2015,0,0,0,0,0,0,0
26007,RM-1213,2/25/2015,0,0,0,0,0,0,0
26008,RM-1213,2/26/2015,0,0,0,0,0,0,0
26009,RM-1213,2/27/2015,0,0,0,0,0,0,0
26010,RM-1213,2/28/2015,0,0,0,0,0,0,0
26011,RM-1213,3/1/2015,0,0,0,0,0,0,0
26012,RM-1213,3/2/2015,0,0,0,0,0,0,0
26013,RM-1213,3/3/2015,0,0,0,0,0,0,0
26014,RM-1213,3/4/2015,0,0,0,0,0,0,0
26015,RM-1213,3/5/2015,0,0,0,0,0,0,0
26016,RM-1213,3/6/2015,0,0,0,0,0,0,0
26017,RM-1213,3/7/2015,0,0,0,0,0,0,0
26018,RM-1213,3/8/2015,0,0,0,0,0,0,0
26019,RM-1213,3/9/2015,0,0,0,0,0,0,0
26020,RM-1213,3/10/2015,0,0,0,0,0,0,0
26021,RM-1213,3/11/2015,0,0,0,0,0,0,0
26022,RM-1213,3/12/2015,0,0,0,0,0,0,0
26023,RM-1213,3/13/2015,0,0,0,0,0,0,0
26024,RM-1213,3/14/2015,0,0,0,0,0,0,0
26025,RM-1213,3/15/2015,0,0,0,0,0,0,0
26026,RM-1213,3/16/2015,0,0,0,0,0,0,0
26027,RM-1213,3/17/2015,0,0,0,0,0,0,0
26028,RM-1213,3/18/2015,0,0,0,0,0,0,0
26029,RM-1213,3/19/2015,0,0,0,0,0,0,0
26030,RM-1213,3/20/2015,0,0,0,0,0,0,0
26031,RM-1213,3/21/2015,0,0,0,0,0,0,0
26032,RM-1213,3/22/2015,0,0,0,0,0,0,0
26033,RM-1213,3/23/2015,0,0,0,0,0,0,0
26034,RM-1213,3/24/2015,0,0,0,0,0,0,0
26035,RM-1213,3/25/2015,0,0,0,0,0,0,0
26036,RM-1213,3/26/2015,0,0,0,0,0,0,0
26037,RM-1213,3/27/2015,0,0,0,0,0,0,0
26038,RM-1213,3/28/2015,0,0,0,0,0,0,0
26039,RM-1213,3/29/2015,0,0,0,0,0,0,0
26040,RM-1213,3/30/2015,0,0,0,0,0,0,0
26041,RM-1213,3/31/2015,0,0,0,0,0,0,0
26042,RM-1213,4/1/2015,0,0,0,0,0,0,0
26043,RM-1213,4/2/2015,0,0,0,0,0,0,0
26044,RM-1213,4/3/2015,0,0,0,0,0,0,0
26045,RM-1213,4/4/2015,0,0,0,0,0,0,0
26046,RM-1213,4/5/2015,0,0,0,0,0,0,0
26047,RM-1213,4/6/2015,0,0,0,0,0,0,0
26048,RM-1213,4/7/2015,0,0,0,0,0,0,0
26049,RM-1213,4/8/2015,0,0,0,0,0,0,0
26050,RM-1213,4/9/2015,0,0,0,0,0,0,0
26051,RM-1213,4/10/2015,0,0,0,0,0,0,0
26052,RM-1213,4/11/2015,0,0,0,0,0,0,0
26053,RM-1213,4/12/2015,0,0,0,0,0,0,0
26054,RM-1213,4/13/2015,0,0,0,0,0,0,0
26055,RM-1213,4/14/2015,0,0,0,0,0,0,0
26056,RM-1213,4/15/2015,0,0,0,0,0,0,0
26057,RM-1213,4/16/2015,0,0,0,0,0,0,0
26058,RM-1213,4/17/2015,0,0,0,0,0,0,0
26059,RM-1213,4/18/2015,0,0,0,0,0,0,0
26060,RM-1213,4/19/2015,0,0,0,0,0,0,0
26061,RM-1213,4/20/2015,0,0,0,0,0,0,0
26062,RM-1213,4/21/2015,0,0,0,0,0,0,0
26063,RM-1213,4/22/2015,0,0,0,0,0,0,0
26064,RM-1213,4/23/2015,0,0,0,0,0,0,0
26065,RM-1213,4/24/2015,0,0,0,0,0,0,0
26066,RM-1213,4/25/2015,0,0,0,0,0,0,0
26067,RM-1213,4/26/2015,0,0,0,0,0,0,0
26068,RM-1213,4/27/2015,0,0,0,0,0,0,0
26069,RM-1213,4/28/2015,0,0,0,0,0,0,0
26070,RM-1213,4/29/2015,0,0,0,0,0,0,0
26071,RM-1213,4/30/2015,0,0,0,0,0,0,0
26072,RM-1213,5/1/2015,0,0,0,0,0,0,0
26073,RM-1213,5/2/2015,0,0,0,0,0,0,0
26074,RM-1213,5/3/2015,0,0,0,0,0,0,0
26075,RM-1213,5/4/2015,0,0,0,0,0,0,0
26076,RM-1213,5/5/2015,0,0,0,0,0,0,0
26077,RM-1213,5/6/2015,0,0,0,0,0,0,0
26078,RM-1213,5/7/2015,0,0,0,0,0,0,0
26079,RM-1213,5/8/2015,0,0,0,0,0,0,0
26080,RM-1213,5/9/2015,0,0,0,0,0,0,0
26081,RM-1213,5/10/2015,0,0,0,0,0,0,0
26082,RM-1213,5/11/2015,0,0,0,0,0,0,0
26083,RM-1213,5/12/2015,0,0,0,0,0,0,0
26084,RM-1213,5/13/2015,0,0,0,0,0,0,0
26085,RM-1213,5/14/2015,0,0,0,0,0,0,0
26086,RM-1213,5/15/2015,0,0,0,0,0,0,0
26087,RM-1213,5/16/2015,0,0,0,0,0,0,0
26088,RM-1213,5/17/2015,0,0,0,0,0,0,0
26089,RM-1213,5/18/2015,0,0,0,0,0,0,0
26090,RM-1213,5/19/2015,0,0,0,0,0,0,0
26091,RM-1213,5/20/2015,0,0,0,0,0,0,0
26092,RM-1213,5/21/2015,0,0,0,0,0,0,0
26093,RM-1213,5/22/2015,0,0,0,0,0,0,0
26094,RM-1213,5/23/2015,0,0,0,0,0,0,0
26095,RM-1213,5/24/2015,0,0,0,0,0,0,0
26096,RM-1213,5/25/2015,0,0,0,0,0,0,0
26097,RM-1213,5/26/2015,0,0,0,0,0,0,0
26098,RM-1213,5/27/2015,0,0,0,0,0,0,0
26099,RM-1213,5/28/2015,0,0,0,0,0,0,0
26100,RM-1213,5/29/2015,0,0,0,0,0,0,0
26101,RM-1213,5/30/2015,0,0,0,0,0,0,0
26102,RM-1213,5/31/2015,0,0,0,0,0,0,0
26103,RM-1213A,7/1/2013,0,0,0,0,0,0,0
26153,RM-1213A,8/21/2013,0,0,0,0,0,0,0
26154,RM-1213A,8/22/2013,0,0,0,0,0,0,0
26155,RM-1213A,8/27/2013,0,0,0,0,0,0,0
26156,RM-1213A,8/28/2013,0,0,0,0,0,0,0
26157,RM-1213A,8/29/2013,0,0,0,0,0,0,0
26158,RM-1213A,8/30/2013,0,0,0,0,0,0,0
26159,RM-1213A,9/4/2013,0,0,0,0,0,0,0
26160,RM-1213A,9/5/2013,0,0,0,0,0,0,0
26161,RM-1213A,9/6/2013,0,0,0,0,0,0,0
26162,RM-1213A,9/7/2013,0,0,0,0,0,0,0
26163,RM-1213A,9/9/2013,0,0,0,0,0,0,0
26164,RM-1213A,9/10/2013,0,0,0,0,0,0,0
26165,RM-1213A,9/11/2013,0,0,0,0,0,0,0
26166,RM-1213A,9/12/2013,0,0,0,0,0,0,0
26167,RM-1213A,9/13/2013,0,0,0,0,0,0,0
26168,RM-1213A,9/14/2013,0,0,0,0,0,0,0
26169,RM-1213A,9/15/2013,0,0,0,0,0,0,0
26170,RM-1213A,9/16/2013,0,0,0,0,0,0,0
26171,RM-1213A,9/17/2013,0,0,0,0,0,0,0
26172,RM-1213A,9/18/2013,0,0,0,0,0,0,0
26173,RM-1213A,9/19/2013,0,0,0,0,0,0,0
26174,RM-1213A,9/20/2013,0,0,0,0,0,0,0
26175,RM-1213A,9/21/2013,0,0,0,0,0,0,0
26176,RM-1213A,9/22/2013,0,0,0,0,0,0,0
26177,RM-1213A,9/23/2013,0,0,0,0,0,0,0
26178,RM-1213A,9/24/2013,0,0,0,0,0,0,0
26179,RM-1213A,9/25/2013,0,0,0,0,0,0,0
26180,RM-1213A,9/26/2013,0,0,0,0,0,0,0
26181,RM-1213A,9/27/2013,0,0,0,0,0,0,0
26182,RM-1213A,9/28/2013,0,0,0,0,0,0,0
26183,RM-1213A,9/29/2013,0,0,0,0,0,0,0
26184,RM-1213A,9/30/2013,0,0,0,0,0,0,0
26185,RM-1213A,10/1/2013,0,0,0,0,0,0,0
26186,RM-1213A,10/2/2013,0,0,0,0,0,0,0
26187,RM-1213A,10/3/2013,0,0,0,0,0,0,0
26188,RM-1213A,10/4/2013,0,0,0,0,0,0,0
26189,RM-1213A,10/5/2013,0,0,0,0,0,0,0
26190,RM-1213A,10/6/2013,0,0,0,0,0,0,0
26191,RM-1213A,10/7/2013,0,0,0,0,0,0,0
26192,RM-1213A,10/8/2013,0,0,0,0,0,0,0
26193,RM-1213A,10/9/2013,0,0,0,0,0,0,0
26194,RM-1213A,10/10/2013,0,0,0,0,0,0,0
26195,RM-1213A,10/11/2013,0,0,0,0,0,0,0
26196,RM-1213A,10/12/2013,0,0,0,0,0,0,0
26197,RM-1213A,10/13/2013,0,0,0,0,0,0,0
26198,RM-1213A,10/14/2013,0,0,0,0,0,0,0
26199,RM-1213A,10/15/2013,0,0,0,0,0,0,0
26200,RM-1213A,10/16/2013,0,0,0,0,0,0,0
26201,RM-1213A,10/17/2013,0,0,0,0,0,0,0
26202,RM-1213A,10/18/2013,0,0,0,0,0,0,0
26203,RM-1213A,10/19/2013,0,0,0,0,0,0,0
26204,RM-1213A,10/20/2013,0,0,0,0,0,0,0
26205,RM-1213A,10/21/2013,0,0,0,0,0,0,0
26206,RM-1213A,10/22/2013,0,0,0,0,0,0,0
26207,RM-1213A,10/23/2013,0,0,0,0,0,0,0
26208,RM-1213A,10/24/2013,0,0,0,0,0,0,0
26209,RM-1213A,10/25/2013,0,0,0,0,0,0,0
26210,RM-1213A,10/26/2013,0,0,0,0,0,0,0
26211,RM-1213A,10/27/2013,0,0,0,0,0,0,0
26212,RM-1213A,10/28/2013,0,0,0,0,0,0,0
26213,RM-1213A,10/29/2013,0,0,0,0,0,0,0
26214,RM-1213A,10/30/2013,0,0,0,0,0,0,0
26215,RM-1213A,10/31/2013,0,0,0,0,0,0,0
26216,RM-1213A,11/1/2013,0,0,0,0,0,0,0
26217,RM-1213A,11/2/2013,0,0,0,0,0,0,0
26218,RM-1213A,11/3/2013,0,0,0,0,0,0,0
26219,RM-1213A,11/4/2013,0,0,0,0,0,0,0
26220,RM-1213A,11/5/2013,0,0,0,0,0,0,0
26221,RM-1213A,11/6/2013,0,0,0,0,0,0,0
26222,RM-1213A,11/7/2013,0,0,0,0,0,0,0
26223,RM-1213A,11/8/2013,0,0,0,0,0,0,0
26224,RM-1213A,11/9/2013,0,0,0,0,0,0,0
26225,RM-1213A,11/10/2013,0,0,0,0,0,0,0
26226,RM-1213A,11/11/2013,0,0,0,0,0,0,0
26227,RM-1213A,11/12/2013,0,0,0,0,0,0,0
26228,RM-1213A,11/13/2013,0,0,0,0,0,0,0
26229,RM-1213A,11/14/2013,0,0,0,0,0,0,0
26230,RM-1213A,11/15/2013,0,0,0,0,0,0,0
26231,RM-1213A,11/19/2013,0,0,0,0,0,0,0
26232,RM-1213A,11/20/2013,0,0,0,0,0,0,0
26233,RM-1213A,11/21/2013,0,0,0,0,0,0,0
26234,RM-1213A,11/22/2013,0,0,0,0,0,0,0
26235,RM-1213A,11/23/2013,0,0,0,0,0,0,0
26236,RM-1213A,11/24/2013,0,0,0,0,0,0,0
26237,RM-1213A,11/25/2013,0,0,0,0,0,0,0
26238,RM-1213A,11/26/2013,0,0,0,0,0,0,0
26239,RM-1213A,11/27/2013,0,0,0,0,0,0,0
26240,RM-1213A,11/28/2013,0,0,0,0,0,0,0
26241,RM-1213A,11/29/2013,0,0,0,0,0,0,0
26242,RM-1213A,11/30/2013,0,0,0,0,0,0,0
26243,RM-1213A,12/1/2013,0,0,0,0,0,0,0
26244,RM-1213A,12/2/2013,0,0,0,0,0,0,0
26245,RM-1213A,12/3/2013,0,0,0,0,0,0,0
26246,RM-1213A,12/4/2013,0,0,0,0,0,0,0
26247,RM-1213A,12/5/2013,0,0,0,0,0,0,0
26248,RM-1213A,12/6/2013,0,0,0,0,0,0,0
26249,RM-1213A,12/7/2013,0,0,0,0,0,0,0
26250,RM-1213A,12/8/2013,0,0,0,0,0,0,0
26251,RM-1213A,12/9/2013,0,0,0,0,0,0,0
26252,RM-1213A,12/10/2013,0,0,0,0,0,0,0
26253,RM-1213A,12/11/2013,0,0,0,0,0,0,0
26254,RM-1213A,12/12/2013,0,0,0,0,0,0,0
26255,RM-1213A,12/13/2013,0,0,0,0,0,0,0
26256,RM-1213A,12/14/2013,0,0,0,0,0,0,0
26257,RM-1213A,12/15/2013,0,0,0,0,0,0,0
26258,RM-1213A,12/16/2013,0,0,0,0,0,0,0
26259,RM-1213A,12/17/2013,0,0,0,0,0,0,0
26260,RM-1213A,12/18/2013,0,0,0,0,0,0,0
26261,RM-1213A,12/19/2013,0,0,0,0,0,0,0
26262,RM-1213A,12/20/2013,0,0,0,0,0,0,0
26263,RM-1213A,12/21/2013,0,0,0,0,0,0,0
26264,RM-1213A,12/22/2013,0,0,0,0,0,0,0
26265,RM-1213A,12/23/2013,0,0,0,0,0,0,0
26266,RM-1213A,12/24/2013,0,0,0,0,0,0,0
26267,RM-1213A,12/25/2013,0,0,0,0,0,0,0
26268,RM-1213A,12/26/2013,0,0,0,0,0,0,0
26269,RM-1213A,12/27/2013,0,0,0,0,0,0,0
26270,RM-1213A,12/28/2013,0,0,0,0,0,0,0
26271,RM-1213A,12/29/2013,0,0,0,0,0,0,0
26272,RM-1213A,12/30/2013,0,0,0,0,0,0,0
26273,RM-1213A,12/31/2013,0,0,0,0,0,0,0
26274,RM-1213A,1/1/2014,0,0,0,0,0,0,0
26275,RM-1213A,1/2/2014,0,0,0,0,0,0,0
26276,RM-1213A,1/3/2014,0,0,0,0,0,0,0
26277,RM-1213A,1/4/2014,0,0,0,0,0,0,0
26278,RM-1213A,1/5/2014,0,0,0,0,0,0,0
26279,RM-1213A,1/6/2014,0,0,0,0,0,0,0
26280,RM-1213A,1/7/2014,0,0,0,0,0,0,0
26281,RM-1213A,1/8/2014,0,0,0,0,0,0,0
26282,RM-1213A,1/9/2014,0,0,0,0,0,0,0
26283,RM-1213A,1/10/2014,0,0,0,0,0,0,0
26284,RM-1213A,1/11/2014,0,0,0,0,0,0,0
26285,RM-1213A,1/12/2014,0,0,0,0,0,0,0
26286,RM-1213A,1/13/2014,0,0,0,0,0,0,0
26287,RM-1213A,1/14/2014,0,0,0,0,0,0,0
26288,RM-1213A,1/15/2014,0,0,0,0,0,0,0
26289,RM-1213A,1/16/2014,0,0,0,0,0,0,0
26290,RM-1213A,1/17/2014,0,0,0,0,0,0,0
26291,RM-1213A,1/18/2014,0,0,0,0,0,0,0
26292,RM-1213A,1/19/2014,0,0,0,0,0,0,0
26536,RM-1213A,9/20/2014,0,0,0,0,0,0,0
26537,RM-1213A,9/21/2014,0,0,0,0,0,0,0
26538,RM-1213A,9/22/2014,0,0,0,0,0,0,0
26539,RM-1213A,9/23/2014,0,0,0,0,0,0,0
26540,RM-1213A,9/24/2014,0,0,0,0,0,0,0
26541,RM-1213A,9/25/2014,0,0,0,0,0,0,0
26542,RM-1213A,9/28/2014,0,0,0,0,0,0,0
26543,RM-1213A,9/29/2014,0,0,0,0,0,0,0
26544,RM-1213A,9/30/2014,0,0,0,0,0,0,0
26545,RM-1213A,10/1/2014,0,0,0,0,0,0,0
26546,RM-1213A,10/2/2014,0,0,0,0,0,0,0
26547,RM-1213A,10/3/2014,0,0,0,0,0,0,0
26548,RM-1213A,10/4/2014,0,0,0,0,0,0,0
26549,RM-1213A,10/5/2014,0,0,0,0,0,0,0
26550,RM-1213A,10/6/2014,0,0,0,0,0,0,0
26551,RM-1213A,10/7/2014,0,0,0,0,0,0,0
26552,RM-1213A,10/8/2014,0,0,0,0,0,0,0
26553,RM-1213A,10/9/2014,0,0,0,0,0,0,0
26554,RM-1213A,10/10/2014,0,0,0,0,0,0,0
26555,RM-1213A,10/11/2014,0,0,0,0,0,0,0
26556,RM-1213A,10/12/2014,0,0,0,0,0,0,0
26557,RM-1213A,10/13/2014,0,0,0,0,0,0,0
26558,RM-1213A,10/14/2014,0,0,0,0,0,0,0
26559,RM-1213A,10/15/2014,0,0,0,0,0,0,0
26560,RM-1213A,10/16/2014,0,0,0,0,0,0,0
26561,RM-1213A,10/17/2014,0,0,0,0,0,0,0
26562,RM-1213A,10/18/2014,0,0,0,0,0,0,0
26563,RM-1213A,10/19/2014,0,0,0,0,0,0,0
26564,RM-1213A,10/20/2014,0,0,0,0,0,0,0
26565,RM-1213A,10/21/2014,0,0,0,0,0,0,0
26566,RM-1213A,10/22/2014,0,0,0,0,0,0,0
26567,RM-1213A,10/23/2014,0,0,0,0,0,0,0
26568,RM-1213A,10/24/2014,0,0,0,0,0,0,0
26569,RM-1213A,10/25/2014,0,0,0,0,0,0,0
26570,RM-1213A,10/26/2014,0,0,0,0,0,0,0
26571,RM-1213A,10/27/2014,0,0,0,0,0,0,0
26572,RM-1213A,10/28/2014,0,0,0,0,0,0,0
26573,RM-1213A,10/29/2014,0,0,0,0,0,0,0
26574,RM-1213A,10/30/2014,0,0,0,0,0,0,0
26575,RM-1213A,10/31/2014,0,0,0,0,0,0,0
26576,RM-1213A,11/1/2014,0,0,0,0,0,0,0
26577,RM-1213A,11/2/2014,0,0,0,0,0,0,0
26578,RM-1213A,11/3/2014,0,0,0,0,0,0,0
26579,RM-1213A,11/4/2014,0,0,0,0,0,0,0
26580,RM-1213A,11/5/2014,0,0,0,0,0,0,0
26581,RM-1213A,11/6/2014,0,0,0,0,0,0,0
26582,RM-1213A,11/7/2014,0,0,0,0,0,0,0
26583,RM-1213A,11/8/2014,0,0,0,0,0,0,0
26584,RM-1213A,11/9/2014,0,0,0,0,0,0,0
26585,RM-1213A,11/10/2014,0,0,0,0,0,0,0
26586,RM-1213A,11/11/2014,0,0,0,0,0,0,0
26587,RM-1213A,11/12/2014,0,0,0,0,0,0,0
26588,RM-1213A,11/13/2014,0,0,0,0,0,0,0
26589,RM-1213A,11/14/2014,0,0,0,0,0,0,0
26590,RM-1213A,11/15/2014,0,0,0,0,0,0,0
26591,RM-1213A,11/16/2014,0,0,0,0,0,0,0
26592,RM-1213A,11/17/2014,0,0,0,0,0,0,0
26593,RM-1213A,11/18/2014,0,0,0,0,0,0,0
26594,RM-1213A,11/19/2014,0,0,0,0,0,0,0
26595,RM-1213A,11/20/2014,0,0,0,0,0,0,0
26596,RM-1213A,11/21/2014,0,0,0,0,0,0,0
26597,RM-1213A,11/22/2014,0,0,0,0,0,0,0
26598,RM-1213A,11/23/2014,0,0,0,0,0,0,0
26599,RM-1213A,11/24/2014,0,0,0,0,0,0,0
26600,RM-1213A,11/25/2014,0,0,0,0,0,0,0
26601,RM-1213A,11/26/2014,0,0,0,0,0,0,0
26602,RM-1213A,11/27/2014,0,0,0,0,0,0,0
26603,RM-1213A,11/28/2014,0,0,0,0,0,0,0
26604,RM-1213A,11/29/2014,0,0,0,0,0,0,0
26605,RM-1213A,11/30/2014,0,0,0,0,0,0,0
26606,RM-1213A,12/1/2014,0,0,0,0,0,0,0
26607,RM-1213A,12/2/2014,0,0,0,0,0,0,0
26608,RM-1213A,12/3/2014,0,0,0,0,0,0,0
26609,RM-1213A,12/4/2014,0,0,0,0,0,0,0
26610,RM-1213A,12/5/2014,0,0,0,0,0,0,0
26611,RM-1213A,12/6/2014,0,0,0,0,0,0,0
26612,RM-1213A,12/7/2014,0,0,0,0,0,0,0
26613,RM-1213A,12/8/2014,0,0,0,0,0,0,0
26614,RM-1213A,12/9/2014,0,0,0,0,0,0,0
26615,RM-1213A,12/10/2014,0,0,0,0,0,0,0
26616,RM-1213A,12/11/2014,0,0,0,0,0,0,0
26617,RM-1213A,12/12/2014,0,0,0,0,0,0,0
26618,RM-1213A,12/13/2014,0,0,0,0,0,0,0
26619,RM-1213A,12/14/2014,0,0,0,0,0,0,0
26620,RM-1213A,12/15/2014,0,0,0,0,0,0,0
26621,RM-1213A,12/16/2014,0,0,0,0,0,0,0
26622,RM-1213A,12/17/2014,0,0,0,0,0,0,0
26623,RM-1213A,12/18/2014,0,0,0,0,0,0,0
26624,RM-1213A,12/19/2014,0,0,0,0,0,0,0
26625,RM-1213A,12/20/2014,0,0,0,0,0,0,0
26626,RM-1213A,12/21/2014,0,0,0,0,0,0,0
26627,RM-1213A,12/22/2014,0,0,0,0,0,0,0
26628,RM-1213A,12/23/2014,0,0,0,0,0,0,0
26629,RM-1213A,12/24/2014,0,0,0,0,0,0,0
26630,RM-1213A,12/25/2014,0,0,0,0,0,0,0
26631,RM-1213A,12/26/2014,0,0,0,0,0,0,0
26632,RM-1213A,12/27/2014,0,0,0,0,0,0,0
26633,RM-1213A,12/28/2014,0,0,0,0,0,0,0
26634,RM-1213A,12/29/2014,0,0,0,0,0,0,0
26635,RM-1213A,12/30/2014,0,0,0,0,0,0,0
26636,RM-1213A,12/31/2014,0,0,0,0,0,0,0
26637,RM-1213A,1/1/2015,0,0,0,0,0,0,0
26638,RM-1213A,1/2/2015,0,0,0,0,0,0,0
26639,RM-1213A,1/3/2015,0,0,0,0,0,0,0
26640,RM-1213A,1/4/2015,0,0,0,0,0,0,0
26641,RM-1213A,1/5/2015,0,0,0,0,0,0,0
26642,RM-1213A,1/6/2015,0,0,0,0,0,0,0
26643,RM-1213A,1/7/2015,0,0,0,0,0,0,0
26644,RM-1213A,1/8/2015,0,0,0,0,0,0,0
26645,RM-1213A,1/9/2015,0,0,0,0,0,0,0
26646,RM-1213A,1/10/2015,0,0,0,0,0,0,0
26647,RM-1213A,1/11/2015,0,0,0,0,0,0,0
26648,RM-1213A,1/12/2015,0,0,0,0,0,0,0
26649,RM-1213A,1/13/2015,0,0,0,0,0,0,0
26650,RM-1213A,1/14/2015,0,0,0,0,0,0,0
26651,RM-1213A,1/15/2015,0,0,0,0,0,0,0
26652,RM-1213A,1/16/2015,0,0,0,0,0,0,0
26653,RM-1213A,1/17/2015,0,0,0,0,0,0,0
26654,RM-1213A,1/18/2015,0,0,0,0,0,0,0
26655,RM-1213A,1/19/2015,0,0,0,0,0,0,0
26656,RM-1213A,1/20/2015,0,0,0,0,0,0,0
26657,RM-1213A,1/21/2015,0,0,0,0,0,0,0
26658,RM-1213A,1/22/2015,0,0,0,0,0,0,0
26659,RM-1213A,1/23/2015,0,0,0,0,0,0,0
26660,RM-1213A,1/24/2015,0,0,0,0,0,0,0
26661,RM-1213A,1/25/2015,0,0,0,0,0,0,0
26662,RM-1213A,1/26/2015,0,0,0,0,0,0,0
26663,RM-1213A,1/27/2015,0,0,0,0,0,0,0
26664,RM-1213A,1/28/2015,0,0,0,0,0,0,0
26665,RM-1213A,1/29/2015,0,0,0,0,0,0,0
26666,RM-1213A,1/30/2015,0,0,0,0,0,0,0
26667,RM-1213A,1/31/2015,0,0,0,0,0,0,0
26668,RM-1213A,2/1/2015,0,0,0,0,0,0,0
26669,RM-1213A,2/2/2015,0,0,0,0,0,0,0
26670,RM-1213A,2/3/2015,0,0,0,0,0,0,0
26671,RM-1213A,2/4/2015,0,0,0,0,0,0,0
26672,RM-1213A,2/5/2015,0,0,0,0,0,0,0
26673,RM-1213A,2/6/2015,0,0,0,0,0,0,0
26674,RM-1213A,2/7/2015,0,0,0,0,0,0,0
26675,RM-1213A,2/8/2015,0,0,0,0,0,0,0
26676,RM-1213A,2/9/2015,0,0,0,0,0,0,0
26677,RM-1213A,2/10/2015,0,0,0,0,0,0,0
26678,RM-1213A,2/11/2015,0,0,0,0,0,0,0
26679,RM-1213A,2/12/2015,0,0,0,0,0,0,0
26680,RM-1213A,2/13/2015,0,0,0,0,0,0,0
26681,RM-1213A,2/14/2015,0,0,0,0,0,0,0
26682,RM-1213A,2/15/2015,0,0,0,0,0,0,0
26683,RM-1213A,2/16/2015,0,0,0,0,0,0,0
26684,RM-1213A,2/17/2015,0,0,0,0,0,0,0
26685,RM-1213A,2/18/2015,0,0,0,0,0,0,0
26686,RM-1213A,2/19/2015,0,0,0,0,0,0,0
26687,RM-1213A,2/20/2015,0,0,0,0,0,0,0
26688,RM-1213A,2/21/2015,0,0,0,0,0,0,0
26689,RM-1213A,2/22/2015,0,0,0,0,0,0,0
26690,RM-1213A,2/23/2015,0,0,0,0,0,0,0
26691,RM-1213A,2/24/2015,0,0,0,0,0,0,0
26692,RM-1213A,2/25/2015,0,0,0,0,0,0,0
26693,RM-1213A,2/26/2015,0,0,0,0,0,0,0
26694,RM-1213A,2/27/2015,0,0,0,0,0,0,0
26695,RM-1213A,2/28/2015,0,0,0,0,0,0,0
26696,RM-1213A,3/1/2015,0,0,0,0,0,0,0
26697,RM-1213A,3/2/2015,0,0,0,0,0,0,0
26698,RM-1213A,3/3/2015,0,0,0,0,0,0,0
26699,RM-1213A,3/4/2015,0,0,0,0,0,0,0
26700,RM-1213A,3/5/2015,0,0,0,0,0,0,0
26701,RM-1213A,3/6/2015,0,0,0,0,0,0,0
26702,RM-1213A,3/7/2015,0,0,0,0,0,0,0
26703,RM-1213A,3/8/2015,0,0,0,0,0,0,0
26704,RM-1213A,3/9/2015,0,0,0,0,0,0,0
26705,RM-1213A,3/10/2015,0,0,0,0,0,0,0
26706,RM-1213A,3/11/2015,0,0,0,0,0,0,0
26707,RM-1213A,3/12/2015,0,0,0,0,0,0,0
26708,RM-1213A,3/13/2015,0,0,0,0,0,0,0
26709,RM-1213A,3/14/2015,0,0,0,0,0,0,0
26710,RM-1213A,3/15/2015,0,0,0,0,0,0,0
26711,RM-1213A,3/16/2015,0,0,0,0,0,0,0
26712,RM-1213A,3/17/2015,0,0,0,0,0,0,0
26713,RM-1213A,3/18/2015,0,0,0,0,0,0,0
26714,RM-1213A,3/19/2015,0,0,0,0,0,0,0
26715,RM-1213A,3/20/2015,0,0,0,0,0,0,0
26716,RM-1213A,3/21/2015,0,0,0,0,0,0,0
26717,RM-1213A,3/22/2015,0,0,0,0,0,0,0
26718,RM-1213A,3/23/2015,0,0,0,0,0,0,0
26719,RM-1213A,3/24/2015,0,0,0,0,0,0,0
26720,RM-1213A,3/25/2015,0,0,0,0,0,0,0
26721,RM-1213A,3/26/2015,0,0,0,0,0,0,0
26722,RM-1213A,3/27/2015,0,0,0,0,0,0,0
26723,RM-1213A,3/28/2015,0,0,0,0,0,0,0
26724,RM-1213A,3/29/2015,0,0,0,0,0,0,0
26725,RM-1213A,3/30/2015,0,0,0,0,0,0,0
26726,RM-1213A,3/31/2015,0,0,0,0,0,0,0
26727,RM-1213A,4/1/2015,0,0,0,0,0,0,0
26728,RM-1213A,4/2/2015,0,0,0,0,0,0,0
26729,RM-1213A,4/3/2015,0,0,0,0,0,0,0
26730,RM-1213A,4/4/2015,0,0,0,0,0,0,0
26731,RM-1213A,4/5/2015,0,0,0,0,0,0,0
26732,RM-1213A,4/6/2015,0,0,0,0,0,0,0
26733,RM-1213A,4/7/2015,0,0,0,0,0,0,0
26734,RM-1213A,4/8/2015,0,0,0,0,0,0,0
26735,RM-1213A,4/9/2015,0,0,0,0,0,0,0
26736,RM-1213A,4/10/2015,0,0,0,0,0,0,0
26737,RM-1213A,4/11/2015,0,0,0,0,0,0,0
26738,RM-1213A,4/12/2015,0,0,0,0,0,0,0
26739,RM-1213A,4/13/2015,0,0,0,0,0,0,0
26740,RM-1213A,4/14/2015,0,0,0,0,0,0,0
26741,RM-1213A,4/15/2015,0,0,0,0,0,0,0
26742,RM-1213A,4/16/2015,0,0,0,0,0,0,0
26743,RM-1213A,4/17/2015,0,0,0,0,0,0,0
26744,RM-1213A,4/18/2015,0,0,0,0,0,0,0
26745,RM-1213A,4/19/2015,0,0,0,0,0,0,0
26746,RM-1213A,4/20/2015,0,0,0,0,0,0,0
26747,RM-1213A,4/21/2015,0,0,0,0,0,0,0
26748,RM-1213A,4/22/2015,0,0,0,0,0,0,0
26749,RM-1213A,4/23/2015,0,0,0,0,0,0,0
26750,RM-1213A,4/24/2015,0,0,0,0,0,0,0
26751,RM-1213A,4/25/2015,0,0,0,0,0,0,0
26752,RM-1213A,4/26/2015,0,0,0,0,0,0,0
26753,RM-1213A,4/27/2015,0,0,0,0,0,0,0
26754,RM-1213A,4/28/2015,0,0,0,0,0,0,0
26755,RM-1213A,4/29/2015,0,0,0,0,0,0,0
26756,RM-1213A,4/30/2015,0,0,0,0,0,0,0
26757,RM-1213A,5/1/2015,0,0,0,0,0,0,0
26758,RM-1213A,5/2/2015,0,0,0,0,0,0,0
26759,RM-1213A,5/3/2015,0,0,0,0,0,0,0
26760,RM-1213A,5/4/2015,0,0,0,0,0,0,0
26761,RM-1213A,5/5/2015,0,0,0,0,0,0,0
26762,RM-1213A,5/6/2015,0,0,0,0,0,0,0
26763,RM-1213A,5/7/2015,0,0,0,0,0,0,0
26764,RM-1213A,5/8/2015,0,0,0,0,0,0,0
26765,RM-1213A,5/9/2015,0,0,0,0,0,0,0
26766,RM-1213A,5/10/2015,0,0,0,0,0,0,0
26767,RM-1213A,5/11/2015,0,0,0,0,0,0,0
26768,RM-1213A,5/12/2015,0,0,0,0,0,0,0
26769,RM-1213A,5/13/2015,0,0,0,0,0,0,0
26770,RM-1213A,5/14/2015,0,0,0,0,0,0,0
26771,RM-1213A,5/15/2015,0,0,0,0,0,0,0
26772,RM-1213A,5/16/2015,0,0,0,0,0,0,0
26773,RM-1213A,5/17/2015,0,0,0,0,0,0,0
26774,RM-1213A,5/18/2015,0,0,0,0,0,0,0
26775,RM-1213A,5/19/2015,0,0,0,0,0,0,0
26776,RM-1213A,5/20/2015,0,0,0,0,0,0,0
26777,RM-1213A,5/21/2015,0,0,0,0,0,0,0
26778,RM-1213A,5/22/2015,0,0,0,0,0,0,0
26779,RM-1213A,5/23/2015,0,0,0,0,0,0,0
26780,RM-1213A,5/24/2015,0,0,0,0,0,0,0
26781,RM-1213A,5/25/2015,0,0,0,0,0,0,0
26782,RM-1213A,5/26/2015,0,0,0,0,0,0,0
26783,RM-1213A,5/27/2015,0,0,0,0,0,0,0
26784,RM-1213A,5/28/2015,0,0,0,0,0,0,0
26785,RM-1213A,5/29/2015,0,0,0,0,0,0,0
26786,RM-1213A,5/30/2015,0,0,0,0,0,0,0
26787,RM-1213A,5/31/2015,0,0,0,0,0,0,0
26788,RM-1217,7/1/2013,0,0,0,0,0,0,0
26789,RM-1217,7/2/2013,0,0,0,0,0,0,0
26790,RM-1217,7/3/2013,0,0,0,0,0,0,0
26791,RM-1217,7/4/2013,0,0,0,0,0,0,0
26792,RM-1217,7/5/2013,0,0,0,0,0,0,0
26793,RM-1217,7/6/2013,0,0,0,0,0,0,0
26794,RM-1217,7/7/2013,0,0,0,0,0,0,0
26795,RM-1217,7/8/2013,0,0,0,0,0,0,0
26796,RM-1217,7/9/2013,0,0,0,0,0,0,0
26797,RM-1217,7/10/2013,0,0,0,0,0,0,0
26798,RM-1217,7/11/2013,0,0,0,0,0,0,0
26799,RM-1217,7/12/2013,0,0,0,0,0,0,0
26800,RM-1217,7/13/2013,0,0,0,0,0,0,0
26801,RM-1217,7/14/2013,0,0,0,0,0,0,0
26802,RM-1217,7/15/2013,0,0,0,0,0,0,0
26803,RM-1217,7/17/2013,0,0,0,0,0,0,0
26804,RM-1217,7/18/2013,0,0,0,0,0,0,0
26805,RM-1217,7/19/2013,0,0,0,0,0,0,0
26806,RM-1217,7/20/2013,0,0,0,0,0,0,0
26807,RM-1217,7/21/2013,0,0,0,0,0,0,0
26808,RM-1217,7/22/2013,0,0,0,0,0,0,0
26809,RM-1217,7/23/2013,0,0,0,0,0,0,0
26810,RM-1217,7/24/2013,0,0,0,0,0,0,0
26811,RM-1217,7/25/2013,0,0,0,0,0,0,0
26812,RM-1217,7/26/2013,0,0,0,0,0,0,0
26813,RM-1217,7/27/2013,0,0,0,0,0,0,0
26814,RM-1217,7/28/2013,0,0,0,0,0,0,0
26815,RM-1217,7/29/2013,0,0,0,0,0,0,0
26816,RM-1217,7/30/2013,0,0,0,0,0,0,0
26817,RM-1217,7/31/2013,0,0,0,0,0,0,0
26818,RM-1217,8/1/2013,0,0,0,0,0,0,0
26819,RM-1217,8/2/2013,0,0,0,0,0,0,0
26820,RM-1217,8/3/2013,0,0,0,0,0,0,0
27216,RM-1217,9/15/2014,0,0,0,0,0,0,0
27217,RM-1217,9/16/2014,0,0,0,0,0,0,0
27218,RM-1217,9/17/2014,0,0,0,0,0,0,0
27219,RM-1217,9/18/2014,0,0,0,0,0,0,0
27220,RM-1217,9/19/2014,0,0,0,0,0,0,0
27221,RM-1217,9/20/2014,0,0,0,0,0,0,0
27222,RM-1217,9/21/2014,0,0,0,0,0,0,0
27223,RM-1217,9/22/2014,0,0,0,0,0,0,0
27224,RM-1217,9/23/2014,0,0,0,0,0,0,0
27225,RM-1217,9/24/2014,0,0,0,0,0,0,0
27226,RM-1217,9/25/2014,0,0,0,0,0,0,0
27227,RM-1217,9/28/2014,0,0,0,0,0,0,0
27228,RM-1217,9/29/2014,0,0,0,0,0,0,0
27229,RM-1217,9/30/2014,0,0,0,0,0,0,0
27230,RM-1217,10/1/2014,0,0,0,0,0,0,0
27231,RM-1217,10/2/2014,0,0,0,0,0,0,0
27232,RM-1217,10/3/2014,0,0,0,0,0,0,0
27233,RM-1217,10/4/2014,0,0,0,0,0,0,0
27234,RM-1217,10/5/2014,0,0,0,0,0,0,0
27235,RM-1217,10/6/2014,0,0,0,0,0,0,0
27236,RM-1217,10/7/2014,0,0,0,0,0,0,0
27237,RM-1217,10/8/2014,0,0,0,0,0,0,0
27238,RM-1217,10/9/2014,0,0,0,0,0,0,0
27239,RM-1217,10/10/2014,0,0,0,0,0,0,0
27240,RM-1217,10/11/2014,0,0,0,0,0,0,0
27241,RM-1217,10/12/2014,0,0,0,0,0,0,0
27242,RM-1217,10/13/2014,0,0,0,0,0,0,0
27243,RM-1217,10/14/2014,0,0,0,0,0,0,0
27244,RM-1217,10/15/2014,0,0,0,0,0,0,0
27245,RM-1217,10/16/2014,0,0,0,0,0,0,0
27246,RM-1217,10/17/2014,0,0,0,0,0,0,0
27247,RM-1217,10/18/2014,0,0,0,0,0,0,0
27248,RM-1217,10/19/2014,0,0,0,0,0,0,0
27249,RM-1217,10/20/2014,0,0,0,0,0,0,0
27250,RM-1217,10/21/2014,0,0,0,0,0,0,0
27251,RM-1217,10/22/2014,0,0,0,0,0,0,0
27252,RM-1217,10/23/2014,0,0,0,0,0,0,0
27253,RM-1217,10/24/2014,0,0,0,0,0,0,0
27254,RM-1217,10/25/2014,0,0,0,0,0,0,0
27255,RM-1217,10/26/2014,0,0,0,0,0,0,0
27256,RM-1217,10/27/2014,0,0,0,0,0,0,0
27257,RM-1217,10/28/2014,0,0,0,0,0,0,0
27258,RM-1217,10/29/2014,0,0,0,0,0,0,0
27259,RM-1217,10/30/2014,0,0,0,0,0,0,0
27260,RM-1217,10/31/2014,0,0,0,0,0,0,0
27261,RM-1217,11/1/2014,0,0,0,0,0,0,0
27262,RM-1217,11/2/2014,0,0,0,0,0,0,0
27263,RM-1217,11/3/2014,0,0,0,0,0,0,0
27264,RM-1217,11/4/2014,0,0,0,0,0,0,0
27265,RM-1217,11/5/2014,0,0,0,0,0,0,0
27266,RM-1217,11/6/2014,0,0,0,0,0,0,0
27267,RM-1217,11/7/2014,0,0,0,0,0,0,0
27268,RM-1217,11/8/2014,0,0,0,0,0,0,0
27269,RM-1217,11/9/2014,0,0,0,0,0,0,0
27270,RM-1217,11/10/2014,0,0,0,0,0,0,0
27271,RM-1217,11/11/2014,0,0,0,0,0,0,0
27272,RM-1217,11/12/2014,0,0,0,0,0,0,0
27273,RM-1217,11/13/2014,0,0,0,0,0,0,0
27274,RM-1217,11/14/2014,0,0,0,0,0,0,0
27275,RM-1217,11/15/2014,0,0,0,0,0,0,0
27276,RM-1217,11/16/2014,0,0,0,0,0,0,0
27277,RM-1217,11/17/2014,0,0,0,0,0,0,0
27278,RM-1217,11/18/2014,0,0,0,0,0,0,0
27279,RM-1217,11/19/2014,0,0,0,0,0,0,0
27280,RM-1217,11/20/2014,0,0,0,0,0,0,0
27281,RM-1217,11/21/2014,0,0,0,0,0,0,0
27282,RM-1217,11/22/2014,0,0,0,0,0,0,0
27283,RM-1217,11/23/2014,0,0,0,0,0,0,0
27284,RM-1217,11/24/2014,0,0,0,0,0,0,0
27285,RM-1217,11/25/2014,0,0,0,0,0,0,0
27286,RM-1217,11/26/2014,0,0,0,0,0,0,0
27287,RM-1217,11/27/2014,0,0,0,0,0,0,0
27288,RM-1217,11/28/2014,0,0,0,0,0,0,0
27289,RM-1217,11/29/2014,0,0,0,0,0,0,0
27290,RM-1217,11/30/2014,0,0,0,0,0,0,0
27291,RM-1217,12/1/2014,0,0,0,0,0,0,0
27292,RM-1217,12/2/2014,0,0,0,0,0,0,0
27293,RM-1217,12/3/2014,0,0,0,0,0,0,0
27294,RM-1217,12/4/2014,0,0,0,0,0,0,0
27295,RM-1217,12/5/2014,0,0,0,0,0,0,0
27296,RM-1217,12/6/2014,0,0,0,0,0,0,0
27297,RM-1217,12/7/2014,0,0,0,0,0,0,0
27298,RM-1217,12/8/2014,0,0,0,0,0,0,0
27299,RM-1217,12/9/2014,0,0,0,0,0,0,0
27300,RM-1217,12/10/2014,0,0,0,0,0,0,0
27301,RM-1217,12/11/2014,0,0,0,0,0,0,0
27302,RM-1217,12/12/2014,0,0,0,0,0,0,0
27303,RM-1217,12/13/2014,0,0,0,0,0,0,0
27304,RM-1217,12/14/2014,0,0,0,0,0,0,0
27305,RM-1217,12/15/2014,0,0,0,0,0,0,0
27306,RM-1217,12/16/2014,0,0,0,0,0,0,0
27307,RM-1217,12/17/2014,0,0,0,0,0,0,0
27308,RM-1217,12/18/2014,0,0,0,0,0,0,0
27309,RM-1217,12/19/2014,0,0,0,0,0,0,0
27310,RM-1217,12/20/2014,0,0,0,0,0,0,0
27311,RM-1217,12/21/2014,0,0,0,0,0,0,0
27312,RM-1217,12/22/2014,0,0,0,0,0,0,0
27313,RM-1217,12/23/2014,0,0,0,0,0,0,0
27314,RM-1217,12/24/2014,0,0,0,0,0,0,0
27315,RM-1217,12/25/2014,0,0,0,0,0,0,0
27316,RM-1217,12/26/2014,0,0,0,0,0,0,0
27317,RM-1217,12/27/2014,0,0,0,0,0,0,0
27318,RM-1217,12/28/2014,0,0,0,0,0,0,0
27319,RM-1217,12/29/2014,0,0,0,0,0,0,0
27320,RM-1217,12/30/2014,0,0,0,0,0,0,0
27321,RM-1217,12/31/2014,0,0,0,0,0,0,0
27322,RM-1217,1/1/2015,0,0,0,0,0,0,0
27323,RM-1217,1/2/2015,0,0,0,0,0,0,0
27324,RM-1217,1/3/2015,0,0,0,0,0,0,0
27325,RM-1217,1/4/2015,0,0,0,0,0,0,0
27326,RM-1217,1/5/2015,0,0,0,0,0,0,0
27327,RM-1217,1/6/2015,0,0,0,0,0,0,0
27328,RM-1217,1/7/2015,0,0,0,0,0,0,0
27329,RM-1217,1/8/2015,0,0,0,0,0,0,0
27330,RM-1217,1/9/2015,0,0,0,0,0,0,0
27331,RM-1217,1/10/2015,0,0,0,0,0,0,0
27332,RM-1217,1/11/2015,0,0,0,0,0,0,0
27333,RM-1217,1/12/2015,0,0,0,0,0,0,0
27334,RM-1217,1/13/2015,0,0,0,0,0,0,0
27335,RM-1217,1/14/2015,0,0,0,0,0,0,0
27336,RM-1217,1/15/2015,0,0,0,0,0,0,0
27337,RM-1217,1/16/2015,0,0,0,0,0,0,0
27338,RM-1217,1/17/2015,0,0,0,0,0,0,0
27339,RM-1217,1/18/2015,0,0,0,0,0,0,0
27340,RM-1217,1/19/2015,0,0,0,0,0,0,0
27341,RM-1217,1/20/2015,0,0,0,0,0,0,0
27342,RM-1217,1/21/2015,0,0,0,0,0,0,0
27343,RM-1217,1/22/2015,0,0,0,0,0,0,0
27344,RM-1217,1/23/2015,0,0,0,0,0,0,0
27345,RM-1217,1/24/2015,0,0,0,0,0,0,0
27346,RM-1217,1/25/2015,0,0,0,0,0,0,0
27347,RM-1217,1/26/2015,0,0,0,0,0,0,0
27348,RM-1217,1/27/2015,0,0,0,0,0,0,0
27349,RM-1217,1/28/2015,0,0,0,0,0,0,0
27350,RM-1217,1/29/2015,0,0,0,0,0,0,0
27351,RM-1217,1/30/2015,0,0,0,0,0,0,0
27352,RM-1217,1/31/2015,0,0,0,0,0,0,0
27353,RM-1217,2/1/2015,0,0,0,0,0,0,0
27354,RM-1217,2/2/2015,0,0,0,0,0,0,0
27355,RM-1217,2/3/2015,0,0,0,0,0,0,0
27356,RM-1217,2/4/2015,0,0,0,0,0,0,0
27357,RM-1217,2/5/2015,0,0,0,0,0,0,0
27358,RM-1217,2/6/2015,0,0,0,0,0,0,0
27359,RM-1217,2/7/2015,0,0,0,0,0,0,0
27360,RM-1217,2/8/2015,0,0,0,0,0,0,0
27361,RM-1217,2/9/2015,0,0,0,0,0,0,0
27362,RM-1217,2/10/2015,0,0,0,0,0,0,0
27363,RM-1217,2/11/2015,0,0,0,0,0,0,0
27364,RM-1217,2/12/2015,0,0,0,0,0,0,0
27365,RM-1217,2/13/2015,0,0,0,0,0,0,0
27366,RM-1217,2/14/2015,0,0,0,0,0,0,0
27367,RM-1217,2/15/2015,0,0,0,0,0,0,0
27368,RM-1217,2/16/2015,0,0,0,0,0,0,0
27369,RM-1217,2/17/2015,0,0,0,0,0,0,0
27370,RM-1217,2/18/2015,0,0,0,0,0,0,0
27371,RM-1217,2/19/2015,0,0,0,0,0,0,0
27372,RM-1217,2/20/2015,0,0,0,0,0,0,0
27373,RM-1217,2/21/2015,0,0,0,0,0,0,0
27374,RM-1217,2/22/2015,0,0,0,0,0,0,0
27375,RM-1217,2/23/2015,0,0,0,0,0,0,0
27376,RM-1217,2/24/2015,0,0,0,0,0,0,0
27377,RM-1217,2/25/2015,0,0,0,0,0,0,0
27378,RM-1217,2/26/2015,0,0,0,0,0,0,0
27379,RM-1217,2/27/2015,0,0,0,0,0,0,0
27380,RM-1217,2/28/2015,0,0,0,0,0,0,0
27381,RM-1217,3/1/2015,0,0,0,0,0,0,0
27382,RM-1217,3/2/2015,0,0,0,0,0,0,0
27383,RM-1217,3/3/2015,0,0,0,0,0,0,0
27384,RM-1217,3/4/2015,0,0,0,0,0,0,0
27385,RM-1217,3/5/2015,0,0,0,0,0,0,0
27386,RM-1217,3/6/2015,0,0,0,0,0,0,0
27387,RM-1217,3/7/2015,0,0,0,0,0,0,0
27388,RM-1217,3/8/2015,0,0,0,0,0,0,0
27389,RM-1217,3/9/2015,0,0,0,0,0,0,0
27390,RM-1217,3/10/2015,0,0,0,0,0,0,0
27391,RM-1217,3/11/2015,0,0,0,0,0,0,0
27392,RM-1217,3/12/2015,0,0,0,0,0,0,0
27393,RM-1217,3/13/2015,0,0,0,0,0,0,0
27394,RM-1217,3/14/2015,0,0,0,0,0,0,0
27395,RM-1217,3/15/2015,0,0,0,0,0,0,0
27396,RM-1217,3/16/2015,0,0,0,0,0,0,0
27397,RM-1217,3/17/2015,0,0,0,0,0,0,0
27398,RM-1217,3/18/2015,0,0,0,0,0,0,0
27399,RM-1217,3/19/2015,0,0,0,0,0,0,0
27400,RM-1217,3/20/2015,0,0,0,0,0,0,0
27401,RM-1217,3/21/2015,0,0,0,0,0,0,0
27402,RM-1217,3/22/2015,0,0,0,0,0,0,0
27403,RM-1217,3/23/2015,0,0,0,0,0,0,0
27404,RM-1217,3/24/2015,0,0,0,0,0,0,0
27405,RM-1217,3/25/2015,0,0,0,0,0,0,0
27406,RM-1217,3/26/2015,0,0,0,0,0,0,0
27407,RM-1217,3/27/2015,0,0,0,0,0,0,0
27408,RM-1217,3/28/2015,0,0,0,0,0,0,0
27409,RM-1217,3/29/2015,0,0,0,0,0,0,0
27410,RM-1217,3/30/2015,0,0,0,0,0,0,0
27411,RM-1217,3/31/2015,0,0,0,0,0,0,0
27412,RM-1217,4/1/2015,0,0,0,0,0,0,0
27413,RM-1217,4/2/2015,0,0,0,0,0,0,0
27414,RM-1217,4/3/2015,0,0,0,0,0,0,0
27415,RM-1217,4/4/2015,0,0,0,0,0,0,0
27416,RM-1217,4/5/2015,0,0,0,0,0,0,0
27417,RM-1217,4/6/2015,0,0,0,0,0,0,0
27418,RM-1217,4/7/2015,0,0,0,0,0,0,0
27419,RM-1217,4/8/2015,0,0,0,0,0,0,0
27420,RM-1217,4/9/2015,0,0,0,0,0,0,0
27421,RM-1217,4/10/2015,0,0,0,0,0,0,0
27422,RM-1217,4/11/2015,0,0,0,0,0,0,0
27423,RM-1217,4/12/2015,0,0,0,0,0,0,0
27424,RM-1217,4/13/2015,0,0,0,0,0,0,0
27425,RM-1217,4/14/2015,0,0,0,0,0,0,0
27426,RM-1217,4/15/2015,0,0,0,0,0,0,0
27427,RM-1217,4/16/2015,0,0,0,0,0,0,0
27428,RM-1217,4/17/2015,0,0,0,0,0,0,0
27429,RM-1217,4/18/2015,0,0,0,0,0,0,0
27430,RM-1217,4/19/2015,0,0,0,0,0,0,0
27431,RM-1217,4/20/2015,0,0,0,0,0,0,0
27432,RM-1217,4/21/2015,0,0,0,0,0,0,0
27433,RM-1217,4/22/2015,0,0,0,0,0,0,0
27434,RM-1217,4/23/2015,0,0,0,0,0,0,0
27435,RM-1217,4/24/2015,0,0,0,0,0,0,0
27436,RM-1217,4/25/2015,0,0,0,0,0,0,0
27437,RM-1217,4/26/2015,0,0,0,0,0,0,0
27438,RM-1217,4/27/2015,0,0,0,0,0,0,0
27439,RM-1217,4/28/2015,0,0,0,0,0,0,0
27440,RM-1217,4/29/2015,0,0,0,0,0,0,0
27441,RM-1217,4/30/2015,0,0,0,0,0,0,0
27442,RM-1217,5/1/2015,0,0,0,0,0,0,0
27443,RM-1217,5/2/2015,0,0,0,0,0,0,0
27444,RM-1217,5/3/2015,0,0,0,0,0,0,0
27445,RM-1217,5/4/2015,0,0,0,0,0,0,0
27446,RM-1217,5/5/2015,0,0,0,0,0,0,0
27447,RM-1217,5/6/2015,0,0,0,0,0,0,0
27448,RM-1217,5/7/2015,0,0,0,0,0,0,0
27449,RM-1217,5/8/2015,0,0,0,0,0,0,0
27450,RM-1217,5/9/2015,0,0,0,0,0,0,0
27451,RM-1217,5/10/2015,0,0,0,0,0,0,0
27452,RM-1217,5/11/2015,0,0,0,0,0,0,0
27453,RM-1217,5/12/2015,0,0,0,0,0,0,0
27454,RM-1217,5/13/2015,0,0,0,0,0,0,0
27455,RM-1217,5/14/2015,0,0,0,0,0,0,0
27456,RM-1217,5/15/2015,0,0,0,0,0,0,0
27457,RM-1217,5/16/2015,0,0,0,0,0,0,0
27458,RM-1217,5/17/2015,0,0,0,0,0,0,0
27459,RM-1217,5/18/2015,0,0,0,0,0,0,0
27460,RM-1217,5/19/2015,0,0,0,0,0,0,0
27461,RM-1217,5/20/2015,0,0,0,0,0,0,0
27462,RM-1217,5/21/2015,0,0,0,0,0,0,0
27463,RM-1217,5/22/2015,0,0,0,0,0,0,0
27464,RM-1217,5/23/2015,0,0,0,0,0,0,0
27465,RM-1217,5/24/2015,0,0,0,0,0,0,0
27466,RM-1217,5/25/2015,0,0,0,0,0,0,0
27467,RM-1217,5/26/2015,0,0,0,0,0,0,0
27468,RM-1217,5/27/2015,0,0,0,0,0,0,0
27469,RM-1217,5/28/2015,0,0,0,0,0,0,0
27470,RM-1217,5/29/2015,0,0,0,0,0,0,0
27471,RM-1217,5/30/2015,0,0,0,0,0,0,0
27472,RM-1217,5/31/2015,0,0,0,0,0,0,0
27473,RM-1218,6/28/2013,0,0,0,0,0,0,0
27474,RM-1218,6/29/2013,0,0,0,0,0,0,0
27475,RM-1218,6/30/2013,0,0,0,0,0,0,0
27491,RM-1218,7/17/2013,0,0,0,0,0,0,0
27492,RM-1218,7/18/2013,0,0,0,0,0,0,0
27493,RM-1218,7/19/2013,0,0,0,0,0,0,0
27494,RM-1218,7/20/2013,0,0,0,0,0,0,0
27495,RM-1218,7/21/2013,0,0,0,0,0,0,0
27496,RM-1218,7/22/2013,0,0,0,0,0,0,0
27497,RM-1218,7/23/2013,0,0,0,0,0,0,0
27498,RM-1218,7/24/2013,0,0,0,0,0,0,0
27499,RM-1218,7/25/2013,0,0,0,0,0,0,0
27500,RM-1218,7/26/2013,0,0,0,0,0,0,0
27501,RM-1218,7/27/2013,0,0,0,0,0,0,0
27502,RM-1218,7/28/2013,0,0,0,0,0,0,0
27503,RM-1218,7/29/2013,0,0,0,0,0,0,0
27504,RM-1218,7/30/2013,0,0,0,0,0,0,0
27505,RM-1218,7/31/2013,0,0,0,0,0,0,0
27506,RM-1218,8/1/2013,0,0,0,0,0,0,0
27507,RM-1218,8/2/2013,0,0,0,0,0,0,0
27508,RM-1218,8/3/2013,0,0,0,0,0,0,0
27509,RM-1218,8/4/2013,0,0,0,0,0,0,0
27510,RM-1218,8/5/2013,0,0,0,0,0,0,0
27511,RM-1218,8/6/2013,0,0,0,0,0,0,0
27512,RM-1218,8/7/2013,0,0,0,0,0,0,0
27513,RM-1218,8/8/2013,0,0,0,0,0,0,0
27514,RM-1218,8/9/2013,0,0,0,0,0,0,0
27515,RM-1218,8/10/2013,0,0,0,0,0,0,0
27516,RM-1218,8/11/2013,0,0,0,0,0,0,0
27517,RM-1218,8/12/2013,0,0,0,0,0,0,0
27518,RM-1218,8/13/2013,0,0,0,0,0,0,0
27519,RM-1218,8/14/2013,0,0,0,0,0,0,0
27520,RM-1218,8/15/2013,0,0,0,0,0,0,0
27521,RM-1218,8/16/2013,0,0,0,0,0,0,0
27522,RM-1218,8/17/2013,0,0,0,0,0,0,0
27523,RM-1218,8/18/2013,0,0,0,0,0,0,0
27524,RM-1218,8/19/2013,0,0,0,0,0,0,0
27525,RM-1218,8/20/2013,0,0,0,0,0,0,0
27526,RM-1218,8/21/2013,0,0,0,0,0,0,0
27527,RM-1218,8/22/2013,0,0,0,0,0,0,0
27528,RM-1218,8/27/2013,0,0,0,0,0,0,0
27529,RM-1218,8/28/2013,0,0,0,0,0,0,0
27530,RM-1218,8/29/2013,0,0,0,0,0,0,0
27531,RM-1218,8/30/2013,0,0,0,0,0,0,0
27532,RM-1218,9/4/2013,0,0,0,0,0,0,0
27533,RM-1218,9/5/2013,0,0,0,0,0,0,0
27534,RM-1218,9/6/2013,0,0,0,0,0,0,0
27535,RM-1218,9/7/2013,0,0,0,0,0,0,0
27536,RM-1218,9/9/2013,0,0,0,0,0,0,0
27537,RM-1218,9/10/2013,0,0,0,0,0,0,0
27538,RM-1218,9/11/2013,0,0,0,0,0,0,0
27539,RM-1218,9/12/2013,0,0,0,0,0,0,0
27540,RM-1218,9/13/2013,0,0,0,0,0,0,0
27541,RM-1218,9/14/2013,0,0,0,0,0,0,0
27542,RM-1218,9/15/2013,0,0,0,0,0,0,0
27543,RM-1218,9/16/2013,0,0,0,0,0,0,0
27544,RM-1218,9/17/2013,0,0,0,0,0,0,0
27545,RM-1218,9/18/2013,0,0,0,0,0,0,0
27546,RM-1218,9/19/2013,0,0,0,0,0,0,0
27547,RM-1218,9/20/2013,0,0,0,0,0,0,0
27548,RM-1218,9/21/2013,0,0,0,0,0,0,0
27549,RM-1218,9/22/2013,0,0,0,0,0,0,0
27550,RM-1218,9/23/2013,0,0,0,0,0,0,0
27551,RM-1218,9/24/2013,0,0,0,0,0,0,0
27552,RM-1218,9/25/2013,0,0,0,0,0,0,0
27553,RM-1218,9/26/2013,0,0,0,0,0,0,0
27554,RM-1218,9/27/2013,0,0,0,0,0,0,0
27555,RM-1218,9/28/2013,0,0,0,0,0,0,0
27556,RM-1218,9/29/2013,0,0,0,0,0,0,0
27557,RM-1218,9/30/2013,0,0,0,0,0,0,0
27558,RM-1218,10/1/2013,0,0,0,0,0,0,0
27559,RM-1218,10/2/2013,0,0,0,0,0,0,0
27560,RM-1218,10/3/2013,0,0,0,0,0,0,0
27561,RM-1218,10/4/2013,0,0,0,0,0,0,0
27562,RM-1218,10/5/2013,0,0,0,0,0,0,0
27563,RM-1218,10/6/2013,0,0,0,0,0,0,0
27564,RM-1218,10/7/2013,0,0,0,0,0,0,0
27565,RM-1218,10/8/2013,0,0,0,0,0,0,0
27566,RM-1218,10/9/2013,0,0,0,0,0,0,0
27567,RM-1218,10/10/2013,0,0,0,0,0,0,0
27568,RM-1218,10/11/2013,0,0,0,0,0,0,0
27569,RM-1218,10/12/2013,0,0,0,0,0,0,0
27570,RM-1218,10/13/2013,0,0,0,0,0,0,0
27571,RM-1218,10/14/2013,0,0,0,0,0,0,0
27572,RM-1218,10/15/2013,0,0,0,0,0,0,0
27573,RM-1218,10/16/2013,0,0,0,0,0,0,0
27574,RM-1218,10/17/2013,0,0,0,0,0,0,0
27575,RM-1218,10/18/2013,0,0,0,0,0,0,0
27576,RM-1218,10/19/2013,0,0,0,0,0,0,0
27577,RM-1218,10/20/2013,0,0,0,0,0,0,0
27578,RM-1218,10/21/2013,0,0,0,0,0,0,0
27579,RM-1218,10/22/2013,0,0,0,0,0,0,0
27580,RM-1218,10/23/2013,0,0,0,0,0,0,0
27581,RM-1218,10/24/2013,0,0,0,0,0,0,0
27582,RM-1218,10/25/2013,0,0,0,0,0,0,0
27583,RM-1218,10/26/2013,0,0,0,0,0,0,0
27584,RM-1218,10/27/2013,0,0,0,0,0,0,0
27585,RM-1218,10/28/2013,0,0,0,0,0,0,0
27586,RM-1218,10/29/2013,0,0,0,0,0,0,0
27587,RM-1218,10/30/2013,0,0,0,0,0,0,0
27588,RM-1218,10/31/2013,0,0,0,0,0,0,0
27589,RM-1218,11/1/2013,0,0,0,0,0,0,0
27590,RM-1218,11/2/2013,0,0,0,0,0,0,0
27591,RM-1218,11/3/2013,0,0,0,0,0,0,0
27592,RM-1218,11/4/2013,0,0,0,0,0,0,0
27593,RM-1218,11/5/2013,0,0,0,0,0,0,0
27594,RM-1218,11/6/2013,0,0,0,0,0,0,0
27595,RM-1218,11/7/2013,0,0,0,0,0,0,0
27596,RM-1218,11/8/2013,0,0,0,0,0,0,0
27597,RM-1218,11/9/2013,0,0,0,0,0,0,0
27598,RM-1218,11/10/2013,0,0,0,0,0,0,0
27599,RM-1218,11/11/2013,0,0,0,0,0,0,0
27600,RM-1218,11/12/2013,0,0,0,0,0,0,0
27601,RM-1218,11/13/2013,0,0,0,0,0,0,0
27602,RM-1218,11/14/2013,0,0,0,0,0,0,0
27603,RM-1218,11/15/2013,0,0,0,0,0,0,0
27604,RM-1218,11/19/2013,0,0,0,0,0,0,0
27605,RM-1218,11/20/2013,0,0,0,0,0,0,0
27606,RM-1218,11/21/2013,0,0,0,0,0,0,0
27607,RM-1218,11/22/2013,0,0,0,0,0,0,0
27608,RM-1218,11/23/2013,0,0,0,0,0,0,0
27609,RM-1218,11/24/2013,0,0,0,0,0,0,0
27610,RM-1218,11/25/2013,0,0,0,0,0,0,0
27611,RM-1218,11/26/2013,0,0,0,0,0,0,0
27612,RM-1218,11/27/2013,0,0,0,0,0,0,0
27613,RM-1218,11/28/2013,0,0,0,0,0,0,0
27614,RM-1218,11/29/2013,0,0,0,0,0,0,0
27615,RM-1218,11/30/2013,0,0,0,0,0,0,0
27616,RM-1218,12/1/2013,0,0,0,0,0,0,0
27617,RM-1218,12/2/2013,0,0,0,0,0,0,0
27618,RM-1218,12/3/2013,0,0,0,0,0,0,0
27619,RM-1218,12/4/2013,0,0,0,0,0,0,0
27620,RM-1218,12/5/2013,0,0,0,0,0,0,0
27621,RM-1218,12/6/2013,0,0,0,0,0,0,0
27622,RM-1218,12/7/2013,0,0,0,0,0,0,0
27623,RM-1218,12/8/2013,0,0,0,0,0,0,0
27624,RM-1218,12/9/2013,0,0,0,0,0,0,0
27625,RM-1218,12/10/2013,0,0,0,0,0,0,0
27626,RM-1218,12/11/2013,0,0,0,0,0,0,0
27627,RM-1218,12/12/2013,0,0,0,0,0,0,0
27628,RM-1218,12/13/2013,0,0,0,0,0,0,0
27629,RM-1218,12/14/2013,0,0,0,0,0,0,0
27630,RM-1218,12/15/2013,0,0,0,0,0,0,0
27631,RM-1218,12/16/2013,0,0,0,0,0,0,0
27632,RM-1218,12/17/2013,0,0,0,0,0,0,0
27633,RM-1218,12/18/2013,0,0,0,0,0,0,0
27634,RM-1218,12/19/2013,0,0,0,0,0,0,0
27635,RM-1218,12/20/2013,0,0,0,0,0,0,0
27636,RM-1218,12/21/2013,0,0,0,0,0,0,0
27637,RM-1218,12/22/2013,0,0,0,0,0,0,0
27638,RM-1218,12/23/2013,0,0,0,0,0,0,0
27639,RM-1218,12/24/2013,0,0,0,0,0,0,0
27640,RM-1218,12/25/2013,0,0,0,0,0,0,0
27641,RM-1218,12/26/2013,0,0,0,0,0,0,0
27642,RM-1218,12/27/2013,0,0,0,0,0,0,0
27643,RM-1218,12/28/2013,0,0,0,0,0,0,0
27644,RM-1218,12/29/2013,0,0,0,0,0,0,0
27645,RM-1218,12/30/2013,0,0,0,0,0,0,0
27646,RM-1218,12/31/2013,0,0,0,0,0,0,0
27647,RM-1218,1/1/2014,0,0,0,0,0,0,0
27648,RM-1218,1/2/2014,0,0,0,0,0,0,0
27649,RM-1218,1/3/2014,0,0,0,0,0,0,0
27650,RM-1218,1/4/2014,0,0,0,0,0,0,0
27651,RM-1218,1/5/2014,0,0,0,0,0,0,0
27652,RM-1218,1/6/2014,0,0,0,0,0,0,0
27653,RM-1218,1/7/2014,0,0,0,0,0,0,0
27654,RM-1218,1/8/2014,0,0,0,0,0,0,0
27655,RM-1218,1/9/2014,0,0,0,0,0,0,0
27656,RM-1218,1/10/2014,0,0,0,0,0,0,0
27657,RM-1218,1/11/2014,0,0,0,0,0,0,0
27658,RM-1218,1/12/2014,0,0,0,0,0,0,0
27659,RM-1218,1/13/2014,0,0,0,0,0,0,0
27660,RM-1218,1/14/2014,0,0,0,0,0,0,0
27661,RM-1218,1/15/2014,0,0,0,0,0,0,0
27830,RM-1218,7/3/2014,0,0,0,0,0,0,0
27831,RM-1218,7/4/2014,0,0,0,0,0,0,0
27832,RM-1218,7/5/2014,0,0,0,0,0,0,0
27833,RM-1218,7/6/2014,0,0,0,0,0,0,0
27834,RM-1218,7/7/2014,0,0,0,0,0,0,0
27835,RM-1218,7/8/2014,0,0,0,0,0,0,0
27836,RM-1218,7/9/2014,0,0,0,0,0,0,0
27837,RM-1218,7/10/2014,0,0,0,0,0,0,0
27838,RM-1218,7/11/2014,0,0,0,0,0,0,0
27839,RM-1218,7/12/2014,0,0,0,0,0,0,0
27840,RM-1218,7/13/2014,0,0,0,0,0,0,0
27841,RM-1218,7/14/2014,0,0,0,0,0,0,0
27842,RM-1218,7/15/2014,0,0,0,0,0,0,0
27843,RM-1218,7/16/2014,0,0,0,0,0,0,0
27844,RM-1218,7/17/2014,0,0,0,0,0,0,0
27845,RM-1218,7/18/2014,0,0,0,0,0,0,0
27846,RM-1218,7/19/2014,0,0,0,0,0,0,0
27847,RM-1218,7/20/2014,0,0,0,0,0,0,0
27848,RM-1218,7/21/2014,0,0,0,0,0,0,0
27849,RM-1218,7/22/2014,0,0,0,0,0,0,0
27850,RM-1218,7/23/2014,0,0,0,0,0,0,0
27851,RM-1218,7/24/2014,0,0,0,0,0,0,0
27852,RM-1218,7/25/2014,0,0,0,0,0,0,0
27853,RM-1218,7/26/2014,0,0,0,0,0,0,0
27854,RM-1218,7/27/2014,0,0,0,0,0,0,0
27855,RM-1218,7/28/2014,0,0,0,0,0,0,0
27856,RM-1218,7/29/2014,0,0,0,0,0,0,0
27857,RM-1218,7/30/2014,0,0,0,0,0,0,0
27858,RM-1218,7/31/2014,0,0,0,0,0,0,0
27859,RM-1218,8/1/2014,0,0,0,0,0,0,0
27860,RM-1218,8/2/2014,0,0,0,0,0,0,0
27861,RM-1218,8/3/2014,0,0,0,0,0,0,0
27862,RM-1218,8/4/2014,0,0,0,0,0,0,0
27863,RM-1218,8/5/2014,0,0,0,0,0,0,0
27864,RM-1218,8/6/2014,0,0,0,0,0,0,0
27865,RM-1218,8/7/2014,0,0,0,0,0,0,0
27866,RM-1218,8/8/2014,0,0,0,0,0,0,0
27867,RM-1218,8/9/2014,0,0,0,0,0,0,0
27868,RM-1218,8/10/2014,0,0,0,0,0,0,0
27869,RM-1218,8/11/2014,0,0,0,0,0,0,0
27870,RM-1218,8/12/2014,0,0,0,0,0,0,0
27871,RM-1218,8/13/2014,0,0,0,0,0,0,0
27872,RM-1218,8/14/2014,0,0,0,0,0,0,0
27873,RM-1218,8/15/2014,0,0,0,0,0,0,0
27874,RM-1218,8/16/2014,0,0,0,0,0,0,0
27875,RM-1218,8/17/2014,0,0,0,0,0,0,0
27876,RM-1218,8/18/2014,0,0,0,0,0,0,0
27877,RM-1218,8/19/2014,0,0,0,0,0,0,0
27878,RM-1218,8/20/2014,0,0,0,0,0,0,0
27879,RM-1218,8/21/2014,0,0,0,0,0,0,0
27880,RM-1218,8/22/2014,0,0,0,0,0,0,0
27881,RM-1218,8/23/2014,0,0,0,0,0,0,0
27882,RM-1218,8/24/2014,0,0,0,0,0,0,0
27883,RM-1218,8/25/2014,0,0,0,0,0,0,0
27884,RM-1218,8/26/2014,0,0,0,0,0,0,0
27885,RM-1218,8/27/2014,0,0,0,0,0,0,0
27886,RM-1218,8/28/2014,0,0,0,0,0,0,0
27887,RM-1218,8/29/2014,0,0,0,0,0,0,0
27888,RM-1218,8/30/2014,0,0,0,0,0,0,0
27889,RM-1218,8/31/2014,0,0,0,0,0,0,0
27890,RM-1218,9/1/2014,0,0,0,0,0,0,0
27891,RM-1218,9/2/2014,0,0,0,0,0,0,0
27892,RM-1218,9/3/2014,0,0,0,0,0,0,0
27893,RM-1218,9/4/2014,0,0,0,0,0,0,0
27894,RM-1218,9/5/2014,0,0,0,0,0,0,0
27895,RM-1218,9/6/2014,0,0,0,0,0,0,0
27896,RM-1218,9/7/2014,0,0,0,0,0,0,0
27897,RM-1218,9/8/2014,0,0,0,0,0,0,0
27898,RM-1218,9/9/2014,0,0,0,0,0,0,0
27899,RM-1218,9/10/2014,0,0,0,0,0,0,0
27900,RM-1218,9/11/2014,0,0,0,0,0,0,0
27901,RM-1218,9/12/2014,0,0,0,0,0,0,0
27902,RM-1218,9/13/2014,0,0,0,0,0,0,0
27903,RM-1218,9/14/2014,0,0,0,0,0,0,0
27904,RM-1218,9/15/2014,0,0,0,0,0,0,0
27905,RM-1218,9/16/2014,0,0,0,0,0,0,0
27906,RM-1218,9/17/2014,0,0,0,0,0,0,0
27907,RM-1218,9/18/2014,0,0,0,0,0,0,0
27908,RM-1218,9/19/2014,0,0,0,0,0,0,0
27909,RM-1218,9/20/2014,0,0,0,0,0,0,0
27910,RM-1218,9/21/2014,0,0,0,0,0,0,0
27911,RM-1218,9/22/2014,0,0,0,0,0,0,0
27912,RM-1218,9/23/2014,0,0,0,0,0,0,0
27913,RM-1218,9/24/2014,0,0,0,0,0,0,0
27914,RM-1218,9/25/2014,0,0,0,0,0,0,0
27915,RM-1218,9/28/2014,0,0,0,0,0,0,0
27916,RM-1218,9/29/2014,0,0,0,0,0,0,0
27917,RM-1218,9/30/2014,0,0,0,0,0,0,0
27918,RM-1218,10/1/2014,0,0,0,0,0,0,0
27919,RM-1218,10/2/2014,0,0,0,0,0,0,0
27920,RM-1218,10/3/2014,0,0,0,0,0,0,0
27921,RM-1218,10/4/2014,0,0,0,0,0,0,0
27922,RM-1218,10/5/2014,0,0,0,0,0,0,0
27923,RM-1218,10/6/2014,0,0,0,0,0,0,0
27924,RM-1218,10/7/2014,0,0,0,0,0,0,0
27925,RM-1218,10/8/2014,0,0,0,0,0,0,0
27926,RM-1218,10/9/2014,0,0,0,0,0,0,0
27927,RM-1218,10/10/2014,0,0,0,0,0,0,0
27928,RM-1218,10/11/2014,0,0,0,0,0,0,0
27929,RM-1218,10/12/2014,0,0,0,0,0,0,0
27930,RM-1218,10/13/2014,0,0,0,0,0,0,0
28161,RM-1221,6/28/2013,0,0,0,0,0,0,0
28162,RM-1221,6/29/2013,0,0,0,0,0,0,0
28163,RM-1221,6/30/2013,0,0,0,0,0,0,0
28164,RM-1221,7/1/2013,0,0,0,0,0,0,0
28202,RM-1221,8/9/2013,0,0,0,0,0,0,0
28203,RM-1221,8/10/2013,0,0,0,0,0,0,0
28204,RM-1221,8/11/2013,0,0,0,0,0,0,0
28205,RM-1221,8/12/2013,0,0,0,0,0,0,0
28206,RM-1221,8/13/2013,0,0,0,0,0,0,0
28207,RM-1221,8/14/2013,0,0,0,0,0,0,0
28208,RM-1221,8/15/2013,0,0,0,0,0,0,0
28209,RM-1221,8/16/2013,0,0,0,0,0,0,0
28210,RM-1221,8/17/2013,0,0,0,0,0,0,0
28211,RM-1221,8/18/2013,0,0,0,0,0,0,0
28212,RM-1221,8/19/2013,0,0,0,0,0,0,0
28213,RM-1221,8/20/2013,0,0,0,0,0,0,0
28214,RM-1221,8/21/2013,0,0,0,0,0,0,0
28215,RM-1221,8/22/2013,0,0,0,0,0,0,0
28216,RM-1221,8/27/2013,0,0,0,0,0,0,0
28217,RM-1221,8/28/2013,0,0,0,0,0,0,0
28218,RM-1221,8/29/2013,0,0,0,0,0,0,0
28219,RM-1221,8/30/2013,0,0,0,0,0,0,0
28220,RM-1221,9/4/2013,0,0,0,0,0,0,0
28221,RM-1221,9/5/2013,0,0,0,0,0,0,0
28222,RM-1221,9/6/2013,0,0,0,0,0,0,0
28223,RM-1221,9/7/2013,0,0,0,0,0,0,0
28224,RM-1221,9/9/2013,0,0,0,0,0,0,0
28225,RM-1221,9/10/2013,0,0,0,0,0,0,0
28226,RM-1221,9/11/2013,0,0,0,0,0,0,0
28227,RM-1221,9/12/2013,0,0,0,0,0,0,0
28228,RM-1221,9/13/2013,0,0,0,0,0,0,0
28229,RM-1221,9/14/2013,0,0,0,0,0,0,0
28230,RM-1221,9/15/2013,0,0,0,0,0,0,0
28231,RM-1221,9/16/2013,0,0,0,0,0,0,0
28232,RM-1221,9/17/2013,0,0,0,0,0,0,0
28233,RM-1221,9/18/2013,0,0,0,0,0,0,0
28234,RM-1221,9/19/2013,0,0,0,0,0,0,0
28235,RM-1221,9/20/2013,0,0,0,0,0,0,0
28236,RM-1221,9/21/2013,0,0,0,0,0,0,0
28237,RM-1221,9/22/2013,0,0,0,0,0,0,0
28238,RM-1221,9/23/2013,0,0,0,0,0,0,0
28239,RM-1221,9/24/2013,0,0,0,0,0,0,0
28240,RM-1221,9/25/2013,0,0,0,0,0,0,0
28241,RM-1221,9/26/2013,0,0,0,0,0,0,0
28242,RM-1221,9/27/2013,0,0,0,0,0,0,0
28243,RM-1221,9/28/2013,0,0,0,0,0,0,0
28244,RM-1221,9/29/2013,0,0,0,0,0,0,0
28245,RM-1221,9/30/2013,0,0,0,0,0,0,0
28246,RM-1221,10/1/2013,0,0,0,0,0,0,0
28247,RM-1221,10/2/2013,0,0,0,0,0,0,0
28248,RM-1221,10/3/2013,0,0,0,0,0,0,0
28249,RM-1221,10/4/2013,0,0,0,0,0,0,0
28250,RM-1221,10/5/2013,0,0,0,0,0,0,0
28251,RM-1221,10/6/2013,0,0,0,0,0,0,0
28252,RM-1221,10/7/2013,0,0,0,0,0,0,0
28253,RM-1221,10/8/2013,0,0,0,0,0,0,0
28254,RM-1221,10/9/2013,0,0,0,0,0,0,0
28255,RM-1221,10/10/2013,0,0,0,0,0,0,0
28256,RM-1221,10/11/2013,0,0,0,0,0,0,0
28257,RM-1221,10/12/2013,0,0,0,0,0,0,0
28422,RM-1221,3/29/2014,0,0,0,0,0,0,0
28423,RM-1221,3/30/2014,0,0,0,0,0,0,0
28424,RM-1221,3/31/2014,0,0,0,0,0,0,0
28425,RM-1221,4/1/2014,0,0,0,0,0,0,0
28426,RM-1221,4/2/2014,0,0,0,0,0,0,0
28427,RM-1221,4/3/2014,0,0,0,0,0,0,0
28428,RM-1221,4/4/2014,0,0,0,0,0,0,0
28429,RM-1221,4/5/2014,0,0,0,0,0,0,0
28430,RM-1221,4/6/2014,0,0,0,0,0,0,0
28431,RM-1221,4/7/2014,0,0,0,0,0,0,0
28432,RM-1221,4/8/2014,0,0,0,0,0,0,0
28433,RM-1221,4/9/2014,0,0,0,0,0,0,0
28434,RM-1221,4/10/2014,0,0,0,0,0,0,0
28435,RM-1221,4/11/2014,0,0,0,0,0,0,0
28436,RM-1221,4/12/2014,0,0,0,0,0,0,0
28437,RM-1221,4/13/2014,0,0,0,0,0,0,0
28438,RM-1221,4/14/2014,0,0,0,0,0,0,0
28439,RM-1221,4/15/2014,0,0,0,0,0,0,0
28440,RM-1221,4/16/2014,0,0,0,0,0,0,0
28441,RM-1221,4/17/2014,0,0,0,0,0,0,0
28442,RM-1221,4/18/2014,0,0,0,0,0,0,0
28443,RM-1221,4/19/2014,0,0,0,0,0,0,0
28444,RM-1221,4/20/2014,0,0,0,0,0,0,0
28445,RM-1221,4/21/2014,0,0,0,0,0,0,0
28446,RM-1221,4/22/2014,0,0,0,0,0,0,0
28447,RM-1221,4/23/2014,0,0,0,0,0,0,0
28448,RM-1221,4/24/2014,0,0,0,0,0,0,0
28449,RM-1221,4/25/2014,0,0,0,0,0,0,0
28450,RM-1221,4/26/2014,0,0,0,0,0,0,0
28451,RM-1221,4/27/2014,0,0,0,0,0,0,0
28452,RM-1221,4/28/2014,0,0,0,0,0,0,0
28453,RM-1221,4/29/2014,0,0,0,0,0,0,0
28454,RM-1221,4/30/2014,0,0,0,0,0,0,0
28455,RM-1221,5/1/2014,0,0,0,0,0,0,0
28456,RM-1221,5/2/2014,0,0,0,0,0,0,0
28457,RM-1221,5/3/2014,0,0,0,0,0,0,0
28458,RM-1221,5/4/2014,0,0,0,0,0,0,0
28459,RM-1221,5/5/2014,0,0,0,0,0,0,0
28460,RM-1221,5/6/2014,0,0,0,0,0,0,0
28461,RM-1221,5/7/2014,0,0,0,0,0,0,0
28462,RM-1221,5/8/2014,0,0,0,0,0,0,0
28463,RM-1221,5/9/2014,0,0,0,0,0,0,0
28464,RM-1221,5/10/2014,0,0,0,0,0,0,0
28465,RM-1221,5/11/2014,0,0,0,0,0,0,0
28466,RM-1221,5/12/2014,0,0,0,0,0,0,0
28467,RM-1221,5/13/2014,0,0,0,0,0,0,0
28468,RM-1221,5/14/2014,0,0,0,0,0,0,0
28469,RM-1221,5/15/2014,0,0,0,0,0,0,0
28470,RM-1221,5/16/2014,0,0,0,0,0,0,0
28471,RM-1221,5/17/2014,0,0,0,0,0,0,0
28636,RM-1221,10/31/2014,0,0,0,0,0,0,0
28637,RM-1221,11/1/2014,0,0,0,0,0,0,0
28638,RM-1221,11/2/2014,0,0,0,0,0,0,0
28639,RM-1221,11/3/2014,0,0,0,0,0,0,0
28640,RM-1221,11/4/2014,0,0,0,0,0,0,0
28641,RM-1221,11/5/2014,0,0,0,0,0,0,0
28642,RM-1221,11/6/2014,0,0,0,0,0,0,0
28643,RM-1221,11/7/2014,0,0,0,0,0,0,0
28644,RM-1221,11/8/2014,0,0,0,0,0,0,0
28645,RM-1221,11/9/2014,0,0,0,0,0,0,0
28646,RM-1221,11/10/2014,0,0,0,0,0,0,0
28647,RM-1221,11/11/2014,0,0,0,0,0,0,0
28648,RM-1221,11/12/2014,0,0,0,0,0,0,0
28649,RM-1221,11/13/2014,0,0,0,0,0,0,0
28650,RM-1221,11/14/2014,0,0,0,0,0,0,0
28651,RM-1221,11/15/2014,0,0,0,0,0,0,0
28652,RM-1221,11/16/2014,0,0,0,0,0,0,0
28653,RM-1221,11/17/2014,0,0,0,0,0,0,0
28654,RM-1221,11/18/2014,0,0,0,0,0,0,0
28655,RM-1221,11/19/2014,0,0,0,0,0,0,0
28656,RM-1221,11/20/2014,0,0,0,0,0,0,0
28657,RM-1221,11/21/2014,0,0,0,0,0,0,0
28658,RM-1221,11/22/2014,0,0,0,0,0,0,0
28659,RM-1221,11/23/2014,0,0,0,0,0,0,0
28660,RM-1221,11/24/2014,0,0,0,0,0,0,0
28661,RM-1221,11/25/2014,0,0,0,0,0,0,0
28662,RM-1221,11/26/2014,0,0,0,0,0,0,0
28663,RM-1221,11/27/2014,0,0,0,0,0,0,0
28664,RM-1221,11/28/2014,0,0,0,0,0,0,0
28665,RM-1221,11/29/2014,0,0,0,0,0,0,0
28666,RM-1221,11/30/2014,0,0,0,0,0,0,0
28667,RM-1221,12/1/2014,0,0,0,0,0,0,0
28668,RM-1221,12/2/2014,0,0,0,0,0,0,0
28669,RM-1221,12/3/2014,0,0,0,0,0,0,0
28670,RM-1221,12/4/2014,0,0,0,0,0,0,0
28671,RM-1221,12/5/2014,0,0,0,0,0,0,0
28672,RM-1221,12/6/2014,0,0,0,0,0,0,0
28673,RM-1221,12/7/2014,0,0,0,0,0,0,0
28674,RM-1221,12/8/2014,0,0,0,0,0,0,0
28675,RM-1221,12/9/2014,0,0,0,0,0,0,0
28676,RM-1221,12/10/2014,0,0,0,0,0,0,0
28677,RM-1221,12/11/2014,0,0,0,0,0,0,0
28678,RM-1221,12/12/2014,0,0,0,0,0,0,0
28679,RM-1221,12/13/2014,0,0,0,0,0,0,0
28680,RM-1221,12/14/2014,0,0,0,0,0,0,0
28681,RM-1221,12/15/2014,0,0,0,0,0,0,0
28682,RM-1221,12/16/2014,0,0,0,0,0,0,0
28683,RM-1221,12/17/2014,0,0,0,0,0,0,0
28684,RM-1221,12/18/2014,0,0,0,0,0,0,0
28685,RM-1221,12/19/2014,0,0,0,0,0,0,0
28686,RM-1221,12/20/2014,0,0,0,0,0,0,0
28687,RM-1221,12/21/2014,0,0,0,0,0,0,0
28688,RM-1221,12/22/2014,0,0,0,0,0,0,0
28689,RM-1221,12/23/2014,0,0,0,0,0,0,0
28690,RM-1221,12/24/2014,0,0,0,0,0,0,0
28691,RM-1221,12/25/2014,0,0,0,0,0,0,0
28692,RM-1221,12/26/2014,0,0,0,0,0,0,0
28693,RM-1221,12/27/2014,0,0,0,0,0,0,0
28694,RM-1221,12/28/2014,0,0,0,0,0,0,0
28695,RM-1221,12/29/2014,0,0,0,0,0,0,0
28696,RM-1221,12/30/2014,0,0,0,0,0,0,0
28697,RM-1221,12/31/2014,0,0,0,0,0,0,0
28698,RM-1221,1/1/2015,0,0,0,0,0,0,0
28699,RM-1221,1/2/2015,0,0,0,0,0,0,0
28700,RM-1221,1/3/2015,0,0,0,0,0,0,0
28701,RM-1221,1/4/2015,0,0,0,0,0,0,0
28702,RM-1221,1/5/2015,0,0,0,0,0,0,0
28703,RM-1221,1/6/2015,0,0,0,0,0,0,0
28704,RM-1221,1/7/2015,0,0,0,0,0,0,0
28705,RM-1221,1/8/2015,0,0,0,0,0,0,0
28706,RM-1221,1/9/2015,0,0,0,0,0,0,0
28707,RM-1221,1/10/2015,0,0,0,0,0,0,0
28708,RM-1221,1/11/2015,0,0,0,0,0,0,0
28709,RM-1221,1/12/2015,0,0,0,0,0,0,0
28710,RM-1221,1/13/2015,0,0,0,0,0,0,0
28711,RM-1221,1/14/2015,0,0,0,0,0,0,0
28712,RM-1221,1/15/2015,0,0,0,0,0,0,0
28713,RM-1221,1/16/2015,0,0,0,0,0,0,0
28714,RM-1221,1/17/2015,0,0,0,0,0,0,0
28715,RM-1221,1/18/2015,0,0,0,0,0,0,0
28716,RM-1221,1/19/2015,0,0,0,0,0,0,0
28717,RM-1221,1/20/2015,0,0,0,0,0,0,0
28718,RM-1221,1/21/2015,0,0,0,0,0,0,0
28719,RM-1221,1/22/2015,0,0,0,0,0,0,0
28720,RM-1221,1/23/2015,0,0,0,0,0,0,0
28721,RM-1221,1/24/2015,0,0,0,0,0,0,0
28722,RM-1221,1/25/2015,0,0,0,0,0,0,0
28723,RM-1221,1/26/2015,0,0,0,0,0,0,0
28724,RM-1221,1/27/2015,0,0,0,0,0,0,0
28725,RM-1221,1/28/2015,0,0,0,0,0,0,0
28726,RM-1221,1/29/2015,0,0,0,0,0,0,0
28727,RM-1221,1/30/2015,0,0,0,0,0,0,0
28728,RM-1221,1/31/2015,0,0,0,0,0,0,0
28729,RM-1221,2/1/2015,0,0,0,0,0,0,0
28730,RM-1221,2/2/2015,0,0,0,0,0,0,0
28731,RM-1221,2/3/2015,0,0,0,0,0,0,0
28732,RM-1221,2/4/2015,0,0,0,0,0,0,0
28733,RM-1221,2/5/2015,0,0,0,0,0,0,0
28734,RM-1221,2/6/2015,0,0,0,0,0,0,0
28735,RM-1221,2/7/2015,0,0,0,0,0,0,0
28736,RM-1221,2/8/2015,0,0,0,0,0,0,0
28737,RM-1221,2/9/2015,0,0,0,0,0,0,0
28738,RM-1221,2/10/2015,0,0,0,0,0,0,0
28739,RM-1221,2/11/2015,0,0,0,0,0,0,0
28740,RM-1221,2/12/2015,0,0,0,0,0,0,0
28741,RM-1221,2/13/2015,0,0,0,0,0,0,0
28742,RM-1221,2/14/2015,0,0,0,0,0,0,0
28743,RM-1221,2/15/2015,0,0,0,0,0,0,0
28744,RM-1221,2/16/2015,0,0,0,0,0,0,0
28745,RM-1221,2/17/2015,0,0,0,0,0,0,0
28746,RM-1221,2/18/2015,0,0,0,0,0,0,0
28747,RM-1221,2/19/2015,0,0,0,0,0,0,0
28748,RM-1221,2/20/2015,0,0,0,0,0,0,0
28749,RM-1221,2/21/2015,0,0,0,0,0,0,0
28750,RM-1221,2/22/2015,0,0,0,0,0,0,0
28751,RM-1221,2/23/2015,0,0,0,0,0,0,0
28752,RM-1221,2/24/2015,0,0,0,0,0,0,0
28753,RM-1221,2/25/2015,0,0,0,0,0,0,0
28754,RM-1221,2/26/2015,0,0,0,0,0,0,0
28755,RM-1221,2/27/2015,0,0,0,0,0,0,0
28756,RM-1221,2/28/2015,0,0,0,0,0,0,0
28757,RM-1221,3/1/2015,0,0,0,0,0,0,0
28758,RM-1221,3/2/2015,0,0,0,0,0,0,0
28759,RM-1221,3/3/2015,0,0,0,0,0,0,0
28760,RM-1221,3/4/2015,0,0,0,0,0,0,0
28761,RM-1221,3/5/2015,0,0,0,0,0,0,0
28762,RM-1221,3/6/2015,0,0,0,0,0,0,0
28763,RM-1221,3/7/2015,0,0,0,0,0,0,0
28764,RM-1221,3/8/2015,0,0,0,0,0,0,0
28765,RM-1221,3/9/2015,0,0,0,0,0,0,0
28766,RM-1221,3/10/2015,0,0,0,0,0,0,0
28767,RM-1221,3/11/2015,0,0,0,0,0,0,0
28768,RM-1221,3/12/2015,0,0,0,0,0,0,0
28769,RM-1221,3/13/2015,0,0,0,0,0,0,0
28770,RM-1221,3/14/2015,0,0,0,0,0,0,0
28771,RM-1221,3/15/2015,0,0,0,0,0,0,0
28772,RM-1221,3/16/2015,0,0,0,0,0,0,0
28773,RM-1221,3/17/2015,0,0,0,0,0,0,0
28774,RM-1221,3/18/2015,0,0,0,0,0,0,0
28775,RM-1221,3/19/2015,0,0,0,0,0,0,0
28776,RM-1221,3/20/2015,0,0,0,0,0,0,0
28777,RM-1221,3/21/2015,0,0,0,0,0,0,0
28778,RM-1221,3/22/2015,0,0,0,0,0,0,0
28779,RM-1221,3/23/2015,0,0,0,0,0,0,0
28780,RM-1221,3/24/2015,0,0,0,0,0,0,0
28781,RM-1221,3/25/2015,0,0,0,0,0,0,0
28782,RM-1221,3/26/2015,0,0,0,0,0,0,0
28783,RM-1221,3/27/2015,0,0,0,0,0,0,0
28784,RM-1221,3/28/2015,0,0,0,0,0,0,0
28785,RM-1221,3/29/2015,0,0,0,0,0,0,0
28786,RM-1221,3/30/2015,0,0,0,0,0,0,0
28787,RM-1221,3/31/2015,0,0,0,0,0,0,0
28788,RM-1221,4/1/2015,0,0,0,0,0,0,0
28789,RM-1221,4/2/2015,0,0,0,0,0,0,0
28790,RM-1221,4/3/2015,0,0,0,0,0,0,0
28791,RM-1221,4/4/2015,0,0,0,0,0,0,0
28792,RM-1221,4/5/2015,0,0,0,0,0,0,0
28793,RM-1221,4/6/2015,0,0,0,0,0,0,0
28794,RM-1221,4/7/2015,0,0,0,0,0,0,0
28795,RM-1221,4/8/2015,0,0,0,0,0,0,0
28796,RM-1221,4/9/2015,0,0,0,0,0,0,0
28797,RM-1221,4/10/2015,0,0,0,0,0,0,0
28798,RM-1221,4/11/2015,0,0,0,0,0,0,0
28799,RM-1221,4/12/2015,0,0,0,0,0,0,0
28800,RM-1221,4/13/2015,0,0,0,0,0,0,0
28801,RM-1221,4/14/2015,0,0,0,0,0,0,0
28802,RM-1221,4/15/2015,0,0,0,0,0,0,0
28803,RM-1221,4/16/2015,0,0,0,0,0,0,0
28804,RM-1221,4/17/2015,0,0,0,0,0,0,0
28805,RM-1221,4/18/2015,0,0,0,0,0,0,0
28806,RM-1221,4/19/2015,0,0,0,0,0,0,0
28807,RM-1221,4/20/2015,0,0,0,0,0,0,0
28808,RM-1221,4/21/2015,0,0,0,0,0,0,0
28809,RM-1221,4/22/2015,0,0,0,0,0,0,0
28810,RM-1221,4/23/2015,0,0,0,0,0,0,0
28811,RM-1221,4/24/2015,0,0,0,0,0,0,0
28812,RM-1221,4/25/2015,0,0,0,0,0,0,0
28813,RM-1221,4/26/2015,0,0,0,0,0,0,0
28814,RM-1221,4/27/2015,0,0,0,0,0,0,0
28815,RM-1221,4/28/2015,0,0,0,0,0,0,0
28816,RM-1221,4/29/2015,0,0,0,0,0,0,0
28817,RM-1221,4/30/2015,0,0,0,0,0,0,0
28818,RM-1221,5/1/2015,0,0,0,0,0,0,0
28819,RM-1221,5/2/2015,0,0,0,0,0,0,0
28820,RM-1221,5/3/2015,0,0,0,0,0,0,0
28821,RM-1221,5/4/2015,0,0,0,0,0,0,0
28822,RM-1221,5/5/2015,0,0,0,0,0,0,0
28823,RM-1221,5/6/2015,0,0,0,0,0,0,0
28824,RM-1221,5/7/2015,0,0,0,0,0,0,0
28825,RM-1221,5/8/2015,0,0,0,0,0,0,0
28826,RM-1221,5/9/2015,0,0,0,0,0,0,0
28827,RM-1221,5/10/2015,0,0,0,0,0,0,0
28828,RM-1221,5/11/2015,0,0,0,0,0,0,0
28829,RM-1221,5/12/2015,0,0,0,0,0,0,0
28830,RM-1221,5/13/2015,0,0,0,0,0,0,0
28831,RM-1221,5/14/2015,0,0,0,0,0,0,0
28832,RM-1221,5/15/2015,0,0,0,0,0,0,0
28833,RM-1221,5/16/2015,0,0,0,0,0,0,0
28834,RM-1221,5/17/2015,0,0,0,0,0,0,0
28835,RM-1221,5/18/2015,0,0,0,0,0,0,0
28836,RM-1221,5/19/2015,0,0,0,0,0,0,0
28837,RM-1221,5/20/2015,0,0,0,0,0,0,0
28838,RM-1221,5/21/2015,0,0,0,0,0,0,0
28839,RM-1221,5/22/2015,0,0,0,0,0,0,0
28840,RM-1221,5/23/2015,0,0,0,0,0,0,0
28841,RM-1221,5/24/2015,0,0,0,0,0,0,0
28842,RM-1221,5/25/2015,0,0,0,0,0,0,0
28843,RM-1221,5/26/2015,0,0,0,0,0,0,0
28844,RM-1221,5/27/2015,0,0,0,0,0,0,0
28845,RM-1221,5/28/2015,0,0,0,0,0,0,0
28846,RM-1221,5/29/2015,0,0,0,0,0,0,0
28847,RM-1221,5/30/2015,0,0,0,0,0,0,0
28848,RM-1221,5/31/2015,0,0,0,0,0,0,0
28849,RM-1223,7/1/2013,0,0,0,0,0,0,0
28850,RM-1223,7/2/2013,0,0,0,0,0,0,0
28851,RM-1223,7/3/2013,0,0,0,0,0,0,0
28852,RM-1223,7/4/2013,0,0,0,0,0,0,0
28853,RM-1223,7/5/2013,0,0,0,0,0,0,0
28854,RM-1223,7/6/2013,0,0,0,0,0,0,0
28855,RM-1223,7/7/2013,0,0,0,0,0,0,0
28856,RM-1223,7/8/2013,0,0,0,0,0,0,0
28857,RM-1223,7/9/2013,0,0,0,0,0,0,0
28858,RM-1223,7/10/2013,0,0,0,0,0,0,0
28859,RM-1223,7/11/2013,0,0,0,0,0,0,0
28860,RM-1223,7/12/2013,0,0,0,0,0,0,0
28861,RM-1223,7/13/2013,0,0,0,0,0,0,0
28862,RM-1223,7/14/2013,0,0,0,0,0,0,0
28863,RM-1223,7/15/2013,0,0,0,0,0,0,0
28864,RM-1223,7/17/2013,0,0,0,0,0,0,0
28865,RM-1223,7/18/2013,0,0,0,0,0,0,0
28866,RM-1223,7/19/2013,0,0,0,0,0,0,0
28867,RM-1223,7/20/2013,0,0,0,0,0,0,0
28868,RM-1223,7/21/2013,0,0,0,0,0,0,0
28869,RM-1223,7/22/2013,0,0,0,0,0,0,0
28870,RM-1223,7/23/2013,0,0,0,0,0,0,0
28871,RM-1223,7/24/2013,0,0,0,0,0,0,0
28872,RM-1223,7/25/2013,0,0,0,0,0,0,0
28873,RM-1223,7/26/2013,0,0,0,0,0,0,0
28874,RM-1223,7/27/2013,0,0,0,0,0,0,0
28875,RM-1223,7/28/2013,0,0,0,0,0,0,0
28876,RM-1223,7/29/2013,0,0,0,0,0,0,0
28877,RM-1223,7/30/2013,0,0,0,0,0,0,0
28878,RM-1223,7/31/2013,0,0,0,0,0,0,0
28879,RM-1223,8/1/2013,0,0,0,0,0,0,0
28880,RM-1223,8/2/2013,0,0,0,0,0,0,0
28881,RM-1223,8/3/2013,0,0,0,0,0,0,0
28882,RM-1223,8/4/2013,0,0,0,0,0,0,0
28883,RM-1223,8/5/2013,0,0,0,0,0,0,0
28884,RM-1223,8/6/2013,0,0,0,0,0,0,0
28885,RM-1223,8/7/2013,0,0,0,0,0,0,0
28886,RM-1223,8/8/2013,0,0,0,0,0,0,0
28887,RM-1223,8/9/2013,0,0,0,0,0,0,0
28888,RM-1223,8/10/2013,0,0,0,0,0,0,0
28889,RM-1223,8/11/2013,0,0,0,0,0,0,0
28890,RM-1223,8/12/2013,0,0,0,0,0,0,0
28891,RM-1223,8/13/2013,0,0,0,0,0,0,0
28892,RM-1223,8/14/2013,0,0,0,0,0,0,0
28893,RM-1223,8/15/2013,0,0,0,0,0,0,0
28894,RM-1223,8/16/2013,0,0,0,0,0,0,0
28895,RM-1223,8/17/2013,0,0,0,0,0,0,0
28896,RM-1223,8/18/2013,0,0,0,0,0,0,0
28897,RM-1223,8/19/2013,0,0,0,0,0,0,0
28898,RM-1223,8/20/2013,0,0,0,0,0,0,0
28899,RM-1223,8/21/2013,0,0,0,0,0,0,0
28900,RM-1223,8/22/2013,0,0,0,0,0,0,0
28901,RM-1223,8/27/2013,0,0,0,0,0,0,0
28902,RM-1223,8/28/2013,0,0,0,0,0,0,0
28903,RM-1223,8/29/2013,0,0,0,0,0,0,0
28904,RM-1223,8/30/2013,0,0,0,0,0,0,0
28905,RM-1223,9/4/2013,0,0,0,0,0,0,0
28906,RM-1223,9/5/2013,0,0,0,0,0,0,0
28907,RM-1223,9/6/2013,0,0,0,0,0,0,0
28908,RM-1223,9/7/2013,0,0,0,0,0,0,0
28909,RM-1223,9/9/2013,0,0,0,0,0,0,0
28910,RM-1223,9/10/2013,0,0,0,0,0,0,0
28911,RM-1223,9/11/2013,0,0,0,0,0,0,0
28912,RM-1223,9/12/2013,0,0,0,0,0,0,0
28913,RM-1223,9/13/2013,0,0,0,0,0,0,0
28914,RM-1223,9/14/2013,0,0,0,0,0,0,0
28915,RM-1223,9/15/2013,0,0,0,0,0,0,0
28916,RM-1223,9/16/2013,0,0,0,0,0,0,0
28917,RM-1223,9/17/2013,0,0,0,0,0,0,0
28918,RM-1223,9/18/2013,0,0,0,0,0,0,0
28919,RM-1223,9/19/2013,0,0,0,0,0,0,0
28920,RM-1223,9/20/2013,0,0,0,0,0,0,0
28921,RM-1223,9/21/2013,0,0,0,0,0,0,0
28922,RM-1223,9/22/2013,0,0,0,0,0,0,0
28923,RM-1223,9/23/2013,0,0,0,0,0,0,0
28924,RM-1223,9/24/2013,0,0,0,0,0,0,0
28925,RM-1223,9/25/2013,0,0,0,0,0,0,0
28926,RM-1223,9/26/2013,0,0,0,0,0,0,0
28927,RM-1223,9/27/2013,0,0,0,0,0,0,0
28928,RM-1223,9/28/2013,0,0,0,0,0,0,0
28929,RM-1223,9/29/2013,0,0,0,0,0,0,0
28930,RM-1223,9/30/2013,0,0,0,0,0,0,0
28931,RM-1223,10/1/2013,0,0,0,0,0,0,0
28932,RM-1223,10/2/2013,0,0,0,0,0,0,0
28933,RM-1223,10/3/2013,0,0,0,0,0,0,0
28934,RM-1223,10/4/2013,0,0,0,0,0,0,0
28935,RM-1223,10/5/2013,0,0,0,0,0,0,0
28936,RM-1223,10/6/2013,0,0,0,0,0,0,0
28937,RM-1223,10/7/2013,0,0,0,0,0,0,0
28938,RM-1223,10/8/2013,0,0,0,0,0,0,0
28939,RM-1223,10/9/2013,0,0,0,0,0,0,0
28940,RM-1223,10/10/2013,0,0,0,0,0,0,0
28941,RM-1223,10/11/2013,0,0,0,0,0,0,0
28942,RM-1223,10/12/2013,0,0,0,0,0,0,0
28943,RM-1223,10/13/2013,0,0,0,0,0,0,0
28944,RM-1223,10/14/2013,0,0,0,0,0,0,0
28945,RM-1223,10/15/2013,0,0,0,0,0,0,0
28946,RM-1223,10/16/2013,0,0,0,0,0,0,0
28947,RM-1223,10/17/2013,0,0,0,0,0,0,0
28948,RM-1223,10/18/2013,0,0,0,0,0,0,0
28949,RM-1223,10/19/2013,0,0,0,0,0,0,0
28950,RM-1223,10/20/2013,0,0,0,0,0,0,0
28951,RM-1223,10/21/2013,0,0,0,0,0,0,0
28952,RM-1223,10/22/2013,0,0,0,0,0,0,0
28953,RM-1223,10/23/2013,0,0,0,0,0,0,0
28954,RM-1223,10/24/2013,0,0,0,0,0,0,0
28955,RM-1223,10/25/2013,0,0,0,0,0,0,0
28956,RM-1223,10/26/2013,0,0,0,0,0,0,0
28957,RM-1223,10/27/2013,0,0,0,0,0,0,0
28958,RM-1223,10/28/2013,0,0,0,0,0,0,0
28959,RM-1223,10/29/2013,0,0,0,0,0,0,0
28960,RM-1223,10/30/2013,0,0,0,0,0,0,0
28961,RM-1223,10/31/2013,0,0,0,0,0,0,0
28962,RM-1223,11/1/2013,0,0,0,0,0,0,0
28963,RM-1223,11/2/2013,0,0,0,0,0,0,0
28964,RM-1223,11/3/2013,0,0,0,0,0,0,0
28965,RM-1223,11/4/2013,0,0,0,0,0,0,0
28966,RM-1223,11/5/2013,0,0,0,0,0,0,0
28967,RM-1223,11/6/2013,0,0,0,0,0,0,0
28968,RM-1223,11/7/2013,0,0,0,0,0,0,0
28969,RM-1223,11/8/2013,0,0,0,0,0,0,0
28970,RM-1223,11/9/2013,0,0,0,0,0,0,0
28971,RM-1223,11/10/2013,0,0,0,0,0,0,0
28972,RM-1223,11/11/2013,0,0,0,0,0,0,0
28973,RM-1223,11/12/2013,0,0,0,0,0,0,0
28974,RM-1223,11/13/2013,0,0,0,0,0,0,0
28975,RM-1223,11/14/2013,0,0,0,0,0,0,0
28976,RM-1223,11/15/2013,0,0,0,0,0,0,0
28977,RM-1223,11/19/2013,0,0,0,0,0,0,0
28978,RM-1223,11/20/2013,0,0,0,0,0,0,0
28979,RM-1223,11/21/2013,0,0,0,0,0,0,0
28980,RM-1223,11/22/2013,0,0,0,0,0,0,0
28981,RM-1223,11/23/2013,0,0,0,0,0,0,0
28982,RM-1223,11/24/2013,0,0,0,0,0,0,0
28983,RM-1223,11/25/2013,0,0,0,0,0,0,0
28984,RM-1223,11/26/2013,0,0,0,0,0,0,0
28985,RM-1223,11/27/2013,0,0,0,0,0,0,0
28986,RM-1223,11/28/2013,0,0,0,0,0,0,0
28987,RM-1223,11/29/2013,0,0,0,0,0,0,0
28988,RM-1223,11/30/2013,0,0,0,0,0,0,0
28989,RM-1223,12/1/2013,0,0,0,0,0,0,0
28990,RM-1223,12/2/2013,0,0,0,0,0,0,0
28991,RM-1223,12/3/2013,0,0,0,0,0,0,0
28992,RM-1223,12/4/2013,0,0,0,0,0,0,0
28993,RM-1223,12/5/2013,0,0,0,0,0,0,0
28994,RM-1223,12/6/2013,0,0,0,0,0,0,0
28995,RM-1223,12/7/2013,0,0,0,0,0,0,0
28996,RM-1223,12/8/2013,0,0,0,0,0,0,0
28997,RM-1223,12/9/2013,0,0,0,0,0,0,0
28998,RM-1223,12/10/2013,0,0,0,0,0,0,0
28999,RM-1223,12/11/2013,0,0,0,0,0,0,0
29000,RM-1223,12/12/2013,0,0,0,0,0,0,0
29001,RM-1223,12/13/2013,0,0,0,0,0,0,0
29002,RM-1223,12/14/2013,0,0,0,0,0,0,0
29003,RM-1223,12/15/2013,0,0,0,0,0,0,0
29004,RM-1223,12/16/2013,0,0,0,0,0,0,0
29005,RM-1223,12/17/2013,0,0,0,0,0,0,0
29006,RM-1223,12/18/2013,0,0,0,0,0,0,0
29007,RM-1223,12/19/2013,0,0,0,0,0,0,0
29008,RM-1223,12/20/2013,0,0,0,0,0,0,0
29009,RM-1223,12/21/2013,0,0,0,0,0,0,0
29010,RM-1223,12/22/2013,0,0,0,0,0,0,0
29011,RM-1223,12/23/2013,0,0,0,0,0,0,0
29012,RM-1223,12/24/2013,0,0,0,0,0,0,0
29013,RM-1223,12/25/2013,0,0,0,0,0,0,0
29014,RM-1223,12/26/2013,0,0,0,0,0,0,0
29015,RM-1223,12/27/2013,0,0,0,0,0,0,0
29016,RM-1223,12/28/2013,0,0,0,0,0,0,0
29017,RM-1223,12/29/2013,0,0,0,0,0,0,0
29018,RM-1223,12/30/2013,0,0,0,0,0,0,0
29019,RM-1223,12/31/2013,0,0,0,0,0,0,0
29020,RM-1223,1/1/2014,0,0,0,0,0,0,0
29021,RM-1223,1/2/2014,0,0,0,0,0,0,0
29022,RM-1223,1/3/2014,0,0,0,0,0,0,0
29023,RM-1223,1/4/2014,0,0,0,0,0,0,0
29024,RM-1223,1/5/2014,0,0,0,0,0,0,0
29025,RM-1223,1/6/2014,0,0,0,0,0,0,0
29026,RM-1223,1/7/2014,0,0,0,0,0,0,0
29027,RM-1223,1/8/2014,0,0,0,0,0,0,0
29028,RM-1223,1/9/2014,0,0,0,0,0,0,0
29029,RM-1223,1/10/2014,0,0,0,0,0,0,0
29030,RM-1223,1/11/2014,0,0,0,0,0,0,0
29031,RM-1223,1/12/2014,0,0,0,0,0,0,0
29032,RM-1223,1/13/2014,0,0,0,0,0,0,0
29033,RM-1223,1/14/2014,0,0,0,0,0,0,0
29034,RM-1223,1/15/2014,0,0,0,0,0,0,0
29035,RM-1223,1/16/2014,0,0,0,0,0,0,0
29036,RM-1223,1/17/2014,0,0,0,0,0,0,0
29037,RM-1223,1/18/2014,0,0,0,0,0,0,0
29038,RM-1223,1/19/2014,0,0,0,0,0,0,0
29039,RM-1223,1/20/2014,0,0,0,0,0,0,0
29040,RM-1223,1/21/2014,0,0,0,0,0,0,0
29041,RM-1223,1/22/2014,0,0,0,0,0,0,0
29042,RM-1223,1/23/2014,0,0,0,0,0,0,0
29043,RM-1223,1/24/2014,0,0,0,0,0,0,0
29044,RM-1223,1/25/2014,0,0,0,0,0,0,0
29045,RM-1223,1/26/2014,0,0,0,0,0,0,0
29046,RM-1223,1/27/2014,0,0,0,0,0,0,0
29047,RM-1223,1/28/2014,0,0,0,0,0,0,0
29048,RM-1223,1/29/2014,0,0,0,0,0,0,0
29049,RM-1223,1/30/2014,0,0,0,0,0,0,0
29050,RM-1223,1/31/2014,0,0,0,0,0,0,0
29051,RM-1223,2/1/2014,0,0,0,0,0,0,0
29052,RM-1223,2/2/2014,0,0,0,0,0,0,0
29053,RM-1223,2/3/2014,0,0,0,0,0,0,0
29054,RM-1223,2/4/2014,0,0,0,0,0,0,0
29055,RM-1223,2/5/2014,0,0,0,0,0,0,0
29056,RM-1223,2/6/2014,0,0,0,0,0,0,0
29057,RM-1223,2/7/2014,0,0,0,0,0,0,0
29058,RM-1223,2/8/2014,0,0,0,0,0,0,0
29059,RM-1223,2/9/2014,0,0,0,0,0,0,0
29060,RM-1223,2/10/2014,0,0,0,0,0,0,0
29061,RM-1223,2/11/2014,0,0,0,0,0,0,0
29062,RM-1223,2/12/2014,0,0,0,0,0,0,0
29063,RM-1223,2/13/2014,0,0,0,0,0,0,0
29064,RM-1223,2/14/2014,0,0,0,0,0,0,0
29065,RM-1223,2/15/2014,0,0,0,0,0,0,0
29066,RM-1223,2/16/2014,0,0,0,0,0,0,0
29067,RM-1223,2/17/2014,0,0,0,0,0,0,0
29068,RM-1223,2/18/2014,0,0,0,0,0,0,0
29069,RM-1223,2/19/2014,0,0,0,0,0,0,0
29070,RM-1223,2/20/2014,0,0,0,0,0,0,0
29071,RM-1223,2/21/2014,0,0,0,0,0,0,0
29072,RM-1223,2/22/2014,0,0,0,0,0,0,0
29073,RM-1223,2/23/2014,0,0,0,0,0,0,0
29074,RM-1223,2/24/2014,0,0,0,0,0,0,0
29075,RM-1223,2/25/2014,0,0,0,0,0,0,0
29076,RM-1223,2/26/2014,0,0,0,0,0,0,0
29077,RM-1223,2/27/2014,0,0,0,0,0,0,0
29078,RM-1223,2/28/2014,0,0,0,0,0,0,0
29079,RM-1223,3/1/2014,0,0,0,0,0,0,0
29080,RM-1223,3/2/2014,0,0,0,0,0,0,0
29081,RM-1223,3/3/2014,0,0,0,0,0,0,0
29082,RM-1223,3/4/2014,0,0,0,0,0,0,0
29083,RM-1223,3/5/2014,0,0,0,0,0,0,0
29084,RM-1223,3/6/2014,0,0,0,0,0,0,0
29085,RM-1223,3/7/2014,0,0,0,0,0,0,0
29086,RM-1223,3/8/2014,0,0,0,0,0,0,0
29087,RM-1223,3/9/2014,0,0,0,0,0,0,0
29088,RM-1223,3/10/2014,0,0,0,0,0,0,0
29089,RM-1223,3/11/2014,0,0,0,0,0,0,0
29090,RM-1223,3/12/2014,0,0,0,0,0,0,0
29091,RM-1223,3/13/2014,0,0,0,0,0,0,0
29092,RM-1223,3/14/2014,0,0,0,0,0,0,0
29093,RM-1223,3/15/2014,0,0,0,0,0,0,0
29094,RM-1223,3/16/2014,0,0,0,0,0,0,0
29095,RM-1223,3/17/2014,0,0,0,0,0,0,0
29096,RM-1223,3/18/2014,0,0,0,0,0,0,0
29097,RM-1223,3/19/2014,0,0,0,0,0,0,0
29098,RM-1223,3/20/2014,0,0,0,0,0,0,0
29099,RM-1223,3/21/2014,0,0,0,0,0,0,0
29100,RM-1223,3/22/2014,0,0,0,0,0,0,0
29101,RM-1223,3/23/2014,0,0,0,0,0,0,0
29102,RM-1223,3/24/2014,0,0,0,0,0,0,0
29103,RM-1223,3/25/2014,0,0,0,0,0,0,0
29104,RM-1223,3/26/2014,0,0,0,0,0,0,0
29105,RM-1223,3/27/2014,0,0,0,0,0,0,0
29106,RM-1223,3/28/2014,0,0,0,0,0,0,0
29107,RM-1223,3/29/2014,0,0,0,0,0,0,0
29108,RM-1223,3/30/2014,0,0,0,0,0,0,0
29109,RM-1223,3/31/2014,0,0,0,0,0,0,0
29110,RM-1223,4/1/2014,0,0,0,0,0,0,0
29111,RM-1223,4/2/2014,0,0,0,0,0,0,0
29112,RM-1223,4/3/2014,0,0,0,0,0,0,0
29113,RM-1223,4/4/2014,0,0,0,0,0,0,0
29114,RM-1223,4/5/2014,0,0,0,0,0,0,0
29115,RM-1223,4/6/2014,0,0,0,0,0,0,0
29116,RM-1223,4/7/2014,0,0,0,0,0,0,0
29117,RM-1223,4/8/2014,0,0,0,0,0,0,0
29118,RM-1223,4/9/2014,0,0,0,0,0,0,0
29119,RM-1223,4/10/2014,0,0,0,0,0,0,0
29120,RM-1223,4/11/2014,0,0,0,0,0,0,0
29121,RM-1223,4/12/2014,0,0,0,0,0,0,0
29122,RM-1223,4/13/2014,0,0,0,0,0,0,0
29123,RM-1223,4/14/2014,0,0,0,0,0,0,0
29124,RM-1223,4/15/2014,0,0,0,0,0,0,0
29125,RM-1223,4/16/2014,0,0,0,0,0,0,0
29126,RM-1223,4/17/2014,0,0,0,0,0,0,0
29127,RM-1223,4/18/2014,0,0,0,0,0,0,0
29128,RM-1223,4/19/2014,0,0,0,0,0,0,0
29129,RM-1223,4/20/2014,0,0,0,0,0,0,0
29130,RM-1223,4/21/2014,0,0,0,0,0,0,0
29131,RM-1223,4/22/2014,0,0,0,0,0,0,0
29132,RM-1223,4/23/2014,0,0,0,0,0,0,0
29133,RM-1223,4/24/2014,0,0,0,0,0,0,0
29134,RM-1223,4/25/2014,0,0,0,0,0,0,0
29145,RM-1223,5/6/2014,0,0,0,0,0,0,0
29534,RM-1224,7/1/2013,0,0,0,0,0,0,0
29535,RM-1224,7/2/2013,0,0,0,0,0,0,0
29536,RM-1224,7/3/2013,0,0,0,0,0,0,0
29537,RM-1224,7/4/2013,0,0,0,0,0,0,0
29538,RM-1224,7/5/2013,0,0,0,0,0,0,0
29539,RM-1224,7/6/2013,0,0,0,0,0,0,0
29540,RM-1224,7/7/2013,0,0,0,0,0,0,0
29541,RM-1224,7/8/2013,0,0,0,0,0,0,0
29542,RM-1224,7/9/2013,0,0,0,0,0,0,0
29543,RM-1224,7/10/2013,0,0,0,0,0,0,0
29544,RM-1224,7/11/2013,0,0,0,0,0,0,0
29545,RM-1224,7/12/2013,0,0,0,0,0,0,0
29546,RM-1224,7/13/2013,0,0,0,0,0,0,0
29547,RM-1224,7/14/2013,0,0,0,0,0,0,0
29548,RM-1224,7/15/2013,0,0,0,0,0,0,0
29549,RM-1224,7/17/2013,0,0,0,0,0,0,0
29550,RM-1224,7/18/2013,0,0,0,0,0,0,0
29551,RM-1224,7/19/2013,0,0,0,0,0,0,0
29552,RM-1224,7/20/2013,0,0,0,0,0,0,0
29553,RM-1224,7/21/2013,0,0,0,0,0,0,0
29554,RM-1224,7/22/2013,0,0,0,0,0,0,0
29555,RM-1224,7/23/2013,0,0,0,0,0,0,0
29556,RM-1224,7/24/2013,0,0,0,0,0,0,0
29557,RM-1224,7/25/2013,0,0,0,0,0,0,0
29558,RM-1224,7/26/2013,0,0,0,0,0,0,0
29559,RM-1224,7/27/2013,0,0,0,0,0,0,0
29560,RM-1224,7/28/2013,0,0,0,0,0,0,0
29561,RM-1224,7/29/2013,0,0,0,0,0,0,0
29562,RM-1224,7/30/2013,0,0,0,0,0,0,0
29563,RM-1224,7/31/2013,0,0,0,0,0,0,0
29564,RM-1224,8/1/2013,0,0,0,0,0,0,0
29565,RM-1224,8/2/2013,0,0,0,0,0,0,0
29566,RM-1224,8/3/2013,0,0,0,0,0,0,0
29567,RM-1224,8/4/2013,0,0,0,0,0,0,0
29568,RM-1224,8/5/2013,0,0,0,0,0,0,0
29569,RM-1224,8/6/2013,0,0,0,0,0,0,0
29570,RM-1224,8/7/2013,0,0,0,0,0,0,0
29571,RM-1224,8/8/2013,0,0,0,0,0,0,0
29572,RM-1224,8/9/2013,0,0,0,0,0,0,0
29573,RM-1224,8/10/2013,0,0,0,0,0,0,0
29574,RM-1224,8/11/2013,0,0,0,0,0,0,0
29575,RM-1224,8/12/2013,0,0,0,0,0,0,0
29576,RM-1224,8/13/2013,0,0,0,0,0,0,0
29577,RM-1224,8/14/2013,0,0,0,0,0,0,0
29578,RM-1224,8/15/2013,0,0,0,0,0,0,0
29579,RM-1224,8/16/2013,0,0,0,0,0,0,0
29580,RM-1224,8/17/2013,0,0,0,0,0,0,0
29581,RM-1224,8/18/2013,0,0,0,0,0,0,0
29582,RM-1224,8/19/2013,0,0,0,0,0,0,0
29583,RM-1224,8/20/2013,0,0,0,0,0,0,0
29584,RM-1224,8/21/2013,0,0,0,0,0,0,0
29585,RM-1224,8/22/2013,0,0,0,0,0,0,0
29586,RM-1224,8/27/2013,0,0,0,0,0,0,0
29587,RM-1224,8/28/2013,0,0,0,0,0,0,0
29588,RM-1224,8/29/2013,0,0,0,0,0,0,0
29589,RM-1224,8/30/2013,0,0,0,0,0,0,0
29590,RM-1224,9/4/2013,0,0,0,0,0,0,0
29591,RM-1224,9/5/2013,0,0,0,0,0,0,0
29592,RM-1224,9/6/2013,0,0,0,0,0,0,0
29593,RM-1224,9/7/2013,0,0,0,0,0,0,0
29594,RM-1224,9/9/2013,0,0,0,0,0,0,0
29595,RM-1224,9/10/2013,0,0,0,0,0,0,0
29596,RM-1224,9/11/2013,0,0,0,0,0,0,0
29597,RM-1224,9/12/2013,0,0,0,0,0,0,0
29598,RM-1224,9/13/2013,0,0,0,0,0,0,0
29599,RM-1224,9/14/2013,0,0,0,0,0,0,0
29600,RM-1224,9/15/2013,0,0,0,0,0,0,0
29601,RM-1224,9/16/2013,0,0,0,0,0,0,0
29602,RM-1224,9/17/2013,0,0,0,0,0,0,0
29603,RM-1224,9/18/2013,0,0,0,0,0,0,0
29604,RM-1224,9/19/2013,0,0,0,0,0,0,0
29605,RM-1224,9/20/2013,0,0,0,0,0,0,0
29606,RM-1224,9/21/2013,0,0,0,0,0,0,0
29607,RM-1224,9/22/2013,0,0,0,0,0,0,0
29608,RM-1224,9/23/2013,0,0,0,0,0,0,0
29609,RM-1224,9/24/2013,0,0,0,0,0,0,0
29610,RM-1224,9/25/2013,0,0,0,0,0,0,0
29611,RM-1224,9/26/2013,0,0,0,0,0,0,0
29612,RM-1224,9/27/2013,0,0,0,0,0,0,0
29613,RM-1224,9/28/2013,0,0,0,0,0,0,0
29614,RM-1224,9/29/2013,0,0,0,0,0,0,0
29615,RM-1224,9/30/2013,0,0,0,0,0,0,0
29616,RM-1224,10/1/2013,0,0,0,0,0,0,0
29617,RM-1224,10/2/2013,0,0,0,0,0,0,0
29618,RM-1224,10/3/2013,0,0,0,0,0,0,0
29619,RM-1224,10/4/2013,0,0,0,0,0,0,0
29620,RM-1224,10/5/2013,0,0,0,0,0,0,0
29621,RM-1224,10/6/2013,0,0,0,0,0,0,0
29622,RM-1224,10/7/2013,0,0,0,0,0,0,0
29623,RM-1224,10/8/2013,0,0,0,0,0,0,0
29624,RM-1224,10/9/2013,0,0,0,0,0,0,0
29625,RM-1224,10/10/2013,0,0,0,0,0,0,0
29626,RM-1224,10/11/2013,0,0,0,0,0,0,0
29627,RM-1224,10/12/2013,0,0,0,0,0,0,0
29628,RM-1224,10/13/2013,0,0,0,0,0,0,0
29629,RM-1224,10/14/2013,0,0,0,0,0,0,0
29630,RM-1224,10/15/2013,0,0,0,0,0,0,0
29631,RM-1224,10/16/2013,0,0,0,0,0,0,0
29632,RM-1224,10/17/2013,0,0,0,0,0,0,0
29633,RM-1224,10/18/2013,0,0,0,0,0,0,0
29634,RM-1224,10/19/2013,0,0,0,0,0,0,0
29635,RM-1224,10/20/2013,0,0,0,0,0,0,0
29636,RM-1224,10/21/2013,0,0,0,0,0,0,0
29637,RM-1224,10/22/2013,0,0,0,0,0,0,0
29638,RM-1224,10/23/2013,0,0,0,0,0,0,0
29639,RM-1224,10/24/2013,0,0,0,0,0,0,0
29640,RM-1224,10/25/2013,0,0,0,0,0,0,0
29641,RM-1224,10/26/2013,0,0,0,0,0,0,0
29642,RM-1224,10/27/2013,0,0,0,0,0,0,0
29643,RM-1224,10/28/2013,0,0,0,0,0,0,0
29644,RM-1224,10/29/2013,0,0,0,0,0,0,0
29645,RM-1224,10/30/2013,0,0,0,0,0,0,0
29646,RM-1224,10/31/2013,0,0,0,0,0,0,0
29647,RM-1224,11/1/2013,0,0,0,0,0,0,0
29648,RM-1224,11/2/2013,0,0,0,0,0,0,0
29649,RM-1224,11/3/2013,0,0,0,0,0,0,0
29650,RM-1224,11/4/2013,0,0,0,0,0,0,0
29651,RM-1224,11/5/2013,0,0,0,0,0,0,0
29652,RM-1224,11/6/2013,0,0,0,0,0,0,0
29653,RM-1224,11/7/2013,0,0,0,0,0,0,0
29654,RM-1224,11/8/2013,0,0,0,0,0,0,0
29655,RM-1224,11/9/2013,0,0,0,0,0,0,0
29656,RM-1224,11/10/2013,0,0,0,0,0,0,0
29657,RM-1224,11/11/2013,0,0,0,0,0,0,0
29658,RM-1224,11/12/2013,0,0,0,0,0,0,0
29659,RM-1224,11/13/2013,0,0,0,0,0,0,0
29660,RM-1224,11/14/2013,0,0,0,0,0,0,0
29661,RM-1224,11/15/2013,0,0,0,0,0,0,0
29662,RM-1224,11/19/2013,0,0,0,0,0,0,0
29663,RM-1224,11/20/2013,0,0,0,0,0,0,0
29664,RM-1224,11/21/2013,0,0,0,0,0,0,0
29665,RM-1224,11/22/2013,0,0,0,0,0,0,0
29666,RM-1224,11/23/2013,0,0,0,0,0,0,0
29667,RM-1224,11/24/2013,0,0,0,0,0,0,0
29668,RM-1224,11/25/2013,0,0,0,0,0,0,0
29669,RM-1224,11/26/2013,0,0,0,0,0,0,0
29670,RM-1224,11/27/2013,0,0,0,0,0,0,0
29671,RM-1224,11/28/2013,0,0,0,0,0,0,0
29672,RM-1224,11/29/2013,0,0,0,0,0,0,0
29673,RM-1224,11/30/2013,0,0,0,0,0,0,0
29674,RM-1224,12/1/2013,0,0,0,0,0,0,0
29675,RM-1224,12/2/2013,0,0,0,0,0,0,0
29676,RM-1224,12/3/2013,0,0,0,0,0,0,0
29677,RM-1224,12/4/2013,0,0,0,0,0,0,0
29678,RM-1224,12/5/2013,0,0,0,0,0,0,0
29679,RM-1224,12/6/2013,0,0,0,0,0,0,0
29680,RM-1224,12/7/2013,0,0,0,0,0,0,0
29681,RM-1224,12/8/2013,0,0,0,0,0,0,0
29682,RM-1224,12/9/2013,0,0,0,0,0,0,0
29683,RM-1224,12/10/2013,0,0,0,0,0,0,0
29684,RM-1224,12/11/2013,0,0,0,0,0,0,0
29685,RM-1224,12/12/2013,0,0,0,0,0,0,0
29686,RM-1224,12/13/2013,0,0,0,0,0,0,0
29687,RM-1224,12/14/2013,0,0,0,0,0,0,0
29688,RM-1224,12/15/2013,0,0,0,0,0,0,0
29689,RM-1224,12/16/2013,0,0,0,0,0,0,0
29690,RM-1224,12/17/2013,0,0,0,0,0,0,0
29691,RM-1224,12/18/2013,0,0,0,0,0,0,0
29692,RM-1224,12/19/2013,0,0,0,0,0,0,0
29693,RM-1224,12/20/2013,0,0,0,0,0,0,0
29694,RM-1224,12/21/2013,0,0,0,0,0,0,0
29695,RM-1224,12/22/2013,0,0,0,0,0,0,0
29696,RM-1224,12/23/2013,0,0,0,0,0,0,0
29697,RM-1224,12/24/2013,0,0,0,0,0,0,0
29698,RM-1224,12/25/2013,0,0,0,0,0,0,0
29699,RM-1224,12/26/2013,0,0,0,0,0,0,0
29700,RM-1224,12/27/2013,0,0,0,0,0,0,0
29701,RM-1224,12/28/2013,0,0,0,0,0,0,0
29702,RM-1224,12/29/2013,0,0,0,0,0,0,0
29703,RM-1224,12/30/2013,0,0,0,0,0,0,0
29704,RM-1224,12/31/2013,0,0,0,0,0,0,0
29705,RM-1224,1/1/2014,0,0,0,0,0,0,0
29706,RM-1224,1/2/2014,0,0,0,0,0,0,0
29707,RM-1224,1/3/2014,0,0,0,0,0,0,0
29708,RM-1224,1/4/2014,0,0,0,0,0,0,0
29709,RM-1224,1/5/2014,0,0,0,0,0,0,0
29710,RM-1224,1/6/2014,0,0,0,0,0,0,0
29711,RM-1224,1/7/2014,0,0,0,0,0,0,0
29713,RM-1224,1/9/2014,0,0,0,0,0,0,0
29717,RM-1224,1/13/2014,0,0,0,0,0,0,0
29718,RM-1224,1/14/2014,0,0,0,0,0,0,0
29888,RM-1224,7/3/2014,0,0,0,0,0,0,0
29889,RM-1224,7/4/2014,0,0,0,0,0,0,0
29890,RM-1224,7/5/2014,0,0,0,0,0,0,0
29891,RM-1224,7/6/2014,0,0,0,0,0,0,0
29892,RM-1224,7/7/2014,0,0,0,0,0,0,0
29893,RM-1224,7/8/2014,0,0,0,0,0,0,0
29894,RM-1224,7/9/2014,0,0,0,0,0,0,0
29895,RM-1224,7/10/2014,0,0,0,0,0,0,0
29896,RM-1224,7/11/2014,0,0,0,0,0,0,0
29897,RM-1224,7/12/2014,0,0,0,0,0,0,0
29898,RM-1224,7/13/2014,0,0,0,0,0,0,0
29899,RM-1224,7/14/2014,0,0,0,0,0,0,0
29900,RM-1224,7/15/2014,0,0,0,0,0,0,0
29901,RM-1224,7/16/2014,0,0,0,0,0,0,0
29902,RM-1224,7/17/2014,0,0,0,0,0,0,0
29903,RM-1224,7/18/2014,0,0,0,0,0,0,0
29904,RM-1224,7/19/2014,0,0,0,0,0,0,0
29905,RM-1224,7/20/2014,0,0,0,0,0,0,0
29906,RM-1224,7/21/2014,0,0,0,0,0,0,0
29907,RM-1224,7/22/2014,0,0,0,0,0,0,0
29908,RM-1224,7/23/2014,0,0,0,0,0,0,0
29909,RM-1224,7/24/2014,0,0,0,0,0,0,0
29910,RM-1224,7/25/2014,0,0,0,0,0,0,0
29911,RM-1224,7/26/2014,0,0,0,0,0,0,0
29912,RM-1224,7/27/2014,0,0,0,0,0,0,0
29913,RM-1224,7/28/2014,0,0,0,0,0,0,0
29914,RM-1224,7/29/2014,0,0,0,0,0,0,0
29915,RM-1224,7/30/2014,0,0,0,0,0,0,0
29916,RM-1224,7/31/2014,0,0,0,0,0,0,0
29917,RM-1224,8/1/2014,0,0,0,0,0,0,0
29918,RM-1224,8/2/2014,0,0,0,0,0,0,0
29919,RM-1224,8/3/2014,0,0,0,0,0,0,0
29920,RM-1224,8/4/2014,0,0,0,0,0,0,0
29921,RM-1224,8/5/2014,0,0,0,0,0,0,0
29922,RM-1224,8/6/2014,0,0,0,0,0,0,0
29923,RM-1224,8/7/2014,0,0,0,0,0,0,0
29924,RM-1224,8/8/2014,0,0,0,0,0,0,0
29925,RM-1224,8/9/2014,0,0,0,0,0,0,0
29926,RM-1224,8/10/2014,0,0,0,0,0,0,0
29927,RM-1224,8/11/2014,0,0,0,0,0,0,0
29928,RM-1224,8/12/2014,0,0,0,0,0,0,0
29929,RM-1224,8/13/2014,0,0,0,0,0,0,0
29930,RM-1224,8/14/2014,0,0,0,0,0,0,0
29931,RM-1224,8/15/2014,0,0,0,0,0,0,0
29932,RM-1224,8/16/2014,0,0,0,0,0,0,0
29933,RM-1224,8/17/2014,0,0,0,0,0,0,0
29934,RM-1224,8/18/2014,0,0,0,0,0,0,0
29935,RM-1224,8/19/2014,0,0,0,0,0,0,0
29936,RM-1224,8/20/2014,0,0,0,0,0,0,0
29937,RM-1224,8/21/2014,0,0,0,0,0,0,0
29938,RM-1224,8/22/2014,0,0,0,0,0,0,0
29939,RM-1224,8/23/2014,0,0,0,0,0,0,0
29940,RM-1224,8/24/2014,0,0,0,0,0,0,0
29941,RM-1224,8/25/2014,0,0,0,0,0,0,0
29942,RM-1224,8/26/2014,0,0,0,0,0,0,0
29943,RM-1224,8/27/2014,0,0,0,0,0,0,0
29944,RM-1224,8/28/2014,0,0,0,0,0,0,0
29945,RM-1224,8/29/2014,0,0,0,0,0,0,0
29946,RM-1224,8/30/2014,0,0,0,0,0,0,0
29947,RM-1224,8/31/2014,0,0,0,0,0,0,0
29948,RM-1224,9/1/2014,0,0,0,0,0,0,0
29949,RM-1224,9/2/2014,0,0,0,0,0,0,0
29950,RM-1224,9/3/2014,0,0,0,0,0,0,0
29951,RM-1224,9/4/2014,0,0,0,0,0,0,0
29952,RM-1224,9/5/2014,0,0,0,0,0,0,0
29953,RM-1224,9/6/2014,0,0,0,0,0,0,0
29954,RM-1224,9/7/2014,0,0,0,0,0,0,0
29955,RM-1224,9/8/2014,0,0,0,0,0,0,0
29956,RM-1224,9/9/2014,0,0,0,0,0,0,0
29957,RM-1224,9/10/2014,0,0,0,0,0,0,0
29958,RM-1224,9/11/2014,0,0,0,0,0,0,0
29959,RM-1224,9/12/2014,0,0,0,0,0,0,0
29960,RM-1224,9/13/2014,0,0,0,0,0,0,0
29961,RM-1224,9/14/2014,0,0,0,0,0,0,0
29962,RM-1224,9/15/2014,0,0,0,0,0,0,0
29963,RM-1224,9/16/2014,0,0,0,0,0,0,0
29964,RM-1224,9/17/2014,0,0,0,0,0,0,0
29965,RM-1224,9/18/2014,0,0,0,0,0,0,0
29966,RM-1224,9/19/2014,0,0,0,0,0,0,0
29967,RM-1224,9/20/2014,0,0,0,0,0,0,0
29968,RM-1224,9/21/2014,0,0,0,0,0,0,0
29969,RM-1224,9/22/2014,0,0,0,0,0,0,0
29970,RM-1224,9/23/2014,0,0,0,0,0,0,0
29971,RM-1224,9/24/2014,0,0,0,0,0,0,0
29972,RM-1224,9/25/2014,0,0,0,0,0,0,0
29973,RM-1224,9/28/2014,0,0,0,0,0,0,0
29974,RM-1224,9/29/2014,0,0,0,0,0,0,0
29975,RM-1224,9/30/2014,0,0,0,0,0,0,0
29976,RM-1224,10/1/2014,0,0,0,0,0,0,0
29977,RM-1224,10/2/2014,0,0,0,0,0,0,0
29978,RM-1224,10/3/2014,0,0,0,0,0,0,0
29979,RM-1224,10/4/2014,0,0,0,0,0,0,0
29980,RM-1224,10/5/2014,0,0,0,0,0,0,0
29981,RM-1224,10/6/2014,0,0,0,0,0,0,0
29982,RM-1224,10/7/2014,0,0,0,0,0,0,0
29983,RM-1224,10/8/2014,0,0,0,0,0,0,0
29984,RM-1224,10/9/2014,0,0,0,0,0,0,0
29985,RM-1224,10/10/2014,0,0,0,0,0,0,0
29986,RM-1224,10/11/2014,0,0,0,0,0,0,0
29987,RM-1224,10/12/2014,0,0,0,0,0,0,0
29988,RM-1224,10/13/2014,0,0,0,0,0,0,0
29989,RM-1224,10/14/2014,0,0,0,0,0,0,0
29990,RM-1224,10/15/2014,0,0,0,0,0,0,0
29991,RM-1224,10/16/2014,0,0,0,0,0,0,0
29992,RM-1224,10/17/2014,0,0,0,0,0,0,0
29993,RM-1224,10/18/2014,0,0,0,0,0,0,0
29994,RM-1224,10/19/2014,0,0,0,0,0,0,0
29995,RM-1224,10/20/2014,0,0,0,0,0,0,0
29996,RM-1224,10/21/2014,0,0,0,0,0,0,0
29997,RM-1224,10/22/2014,0,0,0,0,0,0,0
29998,RM-1224,10/23/2014,0,0,0,0,0,0,0
29999,RM-1224,10/24/2014,0,0,0,0,0,0,0
30000,RM-1224,10/25/2014,0,0,0,0,0,0,0
30001,RM-1224,10/26/2014,0,0,0,0,0,0,0
30002,RM-1224,10/27/2014,0,0,0,0,0,0,0
30003,RM-1224,10/28/2014,0,0,0,0,0,0,0
30004,RM-1224,10/29/2014,0,0,0,0,0,0,0
30005,RM-1224,10/30/2014,0,0,0,0,0,0,0
30006,RM-1224,10/31/2014,0,0,0,0,0,0,0
30007,RM-1224,11/1/2014,0,0,0,0,0,0,0
30008,RM-1224,11/2/2014,0,0,0,0,0,0,0
30009,RM-1224,11/3/2014,0,0,0,0,0,0,0
30010,RM-1224,11/4/2014,0,0,0,0,0,0,0
30011,RM-1224,11/5/2014,0,0,0,0,0,0,0
30012,RM-1224,11/6/2014,0,0,0,0,0,0,0
30013,RM-1224,11/7/2014,0,0,0,0,0,0,0
30014,RM-1224,11/8/2014,0,0,0,0,0,0,0
30015,RM-1224,11/9/2014,0,0,0,0,0,0,0
30016,RM-1224,11/10/2014,0,0,0,0,0,0,0
30017,RM-1224,11/11/2014,0,0,0,0,0,0,0
30018,RM-1224,11/12/2014,0,0,0,0,0,0,0
30019,RM-1224,11/13/2014,0,0,0,0,0,0,0
30020,RM-1224,11/14/2014,0,0,0,0,0,0,0
30021,RM-1224,11/15/2014,0,0,0,0,0,0,0
30022,RM-1224,11/16/2014,0,0,0,0,0,0,0
30023,RM-1224,11/17/2014,0,0,0,0,0,0,0
30024,RM-1224,11/18/2014,0,0,0,0,0,0,0
30025,RM-1224,11/19/2014,0,0,0,0,0,0,0
30026,RM-1224,11/20/2014,0,0,0,0,0,0,0
30027,RM-1224,11/21/2014,0,0,0,0,0,0,0
30028,RM-1224,11/22/2014,0,0,0,0,0,0,0
30029,RM-1224,11/23/2014,0,0,0,0,0,0,0
30030,RM-1224,11/24/2014,0,0,0,0,0,0,0
30031,RM-1224,11/25/2014,0,0,0,0,0,0,0
30032,RM-1224,11/26/2014,0,0,0,0,0,0,0
30033,RM-1224,11/27/2014,0,0,0,0,0,0,0
30034,RM-1224,11/28/2014,0,0,0,0,0,0,0
30035,RM-1224,11/29/2014,0,0,0,0,0,0,0
30036,RM-1224,11/30/2014,0,0,0,0,0,0,0
30037,RM-1224,12/1/2014,0,0,0,0,0,0,0
30038,RM-1224,12/2/2014,0,0,0,0,0,0,0
30039,RM-1224,12/3/2014,0,0,0,0,0,0,0
30040,RM-1224,12/4/2014,0,0,0,0,0,0,0
30041,RM-1224,12/5/2014,0,0,0,0,0,0,0
30042,RM-1224,12/6/2014,0,0,0,0,0,0,0
30043,RM-1224,12/7/2014,0,0,0,0,0,0,0
30044,RM-1224,12/8/2014,0,0,0,0,0,0,0
30045,RM-1224,12/9/2014,0,0,0,0,0,0,0
30046,RM-1224,12/10/2014,0,0,0,0,0,0,0
30047,RM-1224,12/11/2014,0,0,0,0,0,0,0
30048,RM-1224,12/12/2014,0,0,0,0,0,0,0
30049,RM-1224,12/13/2014,0,0,0,0,0,0,0
30050,RM-1224,12/14/2014,0,0,0,0,0,0,0
30051,RM-1224,12/15/2014,0,0,0,0,0,0,0
30052,RM-1224,12/16/2014,0,0,0,0,0,0,0
30053,RM-1224,12/17/2014,0,0,0,0,0,0,0
30054,RM-1224,12/18/2014,0,0,0,0,0,0,0
30055,RM-1224,12/19/2014,0,0,0,0,0,0,0
30056,RM-1224,12/20/2014,0,0,0,0,0,0,0
30057,RM-1224,12/21/2014,0,0,0,0,0,0,0
30058,RM-1224,12/22/2014,0,0,0,0,0,0,0
30059,RM-1224,12/23/2014,0,0,0,0,0,0,0
30060,RM-1224,12/24/2014,0,0,0,0,0,0,0
30888,RM-1229,5/13/2015,0,0,0,0,0,0,0
30889,RM-1229,5/14/2015,0,0,0,0,0,0,0
30890,RM-1229,5/15/2015,0,0,0,0,0,0,0
30891,RM-1229,5/16/2015,0,0,0,0,0,0,0
30892,RM-1229,5/17/2015,0,0,0,0,0,0,0
30893,RM-1229,5/18/2015,0,0,0,0,0,0,0
30894,RM-1229,5/19/2015,0,0,0,0,0,0,0
30895,RM-1229,5/20/2015,0,0,0,0,0,0,0
30896,RM-1229,5/21/2015,0,0,0,0,0,0,0
30897,RM-1229,5/22/2015,0,0,0,0,0,0,0
30898,RM-1229,5/23/2015,0,0,0,0,0,0,0
30899,RM-1229,5/24/2015,0,0,0,0,0,0,0
30900,RM-1229,5/25/2015,0,0,0,0,0,0,0
30901,RM-1229,5/26/2015,0,0,0,0,0,0,0
30902,RM-1229,5/27/2015,0,0,0,0,0,0,0
30903,RM-1229,5/28/2015,0,0,0,0,0,0,0
30904,RM-1229,5/29/2015,0,0,0,0,0,0,0
30905,RM-1229,5/30/2015,0,0,0,0,0,0,0
30906,RM-1229,5/31/2015,0,0,0,0,0,0,0
30907,RM-1230,7/1/2013,0,0,0,0,0,0,0
30908,RM-1230,7/2/2013,0,0,0,0,0,0,0
30909,RM-1230,7/3/2013,0,0,0,0,0,0,0
30910,RM-1230,7/4/2013,0,0,0,0,0,0,0
30911,RM-1230,7/5/2013,0,0,0,0,0,0,0
30912,RM-1230,7/6/2013,0,0,0,0,0,0,0
30913,RM-1230,7/31/2013,0,0,0,0,0,0,0
30914,RM-1230,8/3/2013,0,0,0,0,0,0,0
30915,RM-1230,8/4/2013,0,0,0,0,0,0,0
30916,RM-1230,8/5/2013,0,0,0,0,0,0,0
30917,RM-1230,8/6/2013,0,0,0,0,0,0,0
30918,RM-1230,8/7/2013,0,0,0,0,0,0,0
30919,RM-1230,8/8/2013,0,0,0,0,0,0,0
30920,RM-1230,8/9/2013,0,0,0,0,0,0,0
30921,RM-1230,8/10/2013,0,0,0,0,0,0,0
30922,RM-1230,8/11/2013,0,0,0,0,0,0,0
30923,RM-1230,8/12/2013,0,0,0,0,0,0,0
30924,RM-1230,8/13/2013,0,0,0,0,0,0,0
30925,RM-1230,8/14/2013,0,0,0,0,0,0,0
30926,RM-1230,8/15/2013,0,0,0,0,0,0,0
30927,RM-1230,8/16/2013,0,0,0,0,0,0,0
30928,RM-1230,8/17/2013,0,0,0,0,0,0,0
30929,RM-1230,8/18/2013,0,0,0,0,0,0,0
30930,RM-1230,8/19/2013,0,0,0,0,0,0,0
30931,RM-1230,8/20/2013,0,0,0,0,0,0,0
30932,RM-1230,8/21/2013,0,0,0,0,0,0,0
30933,RM-1230,8/22/2013,0,0,0,0,0,0,0
30934,RM-1230,9/4/2013,0,0,0,0,0,0,0
30935,RM-1230,9/5/2013,0,0,0,0,0,0,0
30936,RM-1230,9/6/2013,0,0,0,0,0,0,0
30937,RM-1230,9/7/2013,0,0,0,0,0,0,0
30938,RM-1230,9/9/2013,0,0,0,0,0,0,0
30939,RM-1230,9/10/2013,0,0,0,0,0,0,0
30940,RM-1230,9/11/2013,0,0,0,0,0,0,0
30941,RM-1230,9/12/2013,0,0,0,0,0,0,0
30942,RM-1230,9/13/2013,0,0,0,0,0,0,0
30943,RM-1230,9/14/2013,0,0,0,0,0,0,0
30944,RM-1230,9/15/2013,0,0,0,0,0,0,0
30945,RM-1230,9/16/2013,0,0,0,0,0,0,0
30946,RM-1230,9/17/2013,0,0,0,0,0,0,0
30947,RM-1230,9/18/2013,0,0,0,0,0,0,0
30948,RM-1230,9/19/2013,0,0,0,0,0,0,0
30949,RM-1230,9/20/2013,0,0,0,0,0,0,0
30950,RM-1230,9/21/2013,0,0,0,0,0,0,0
30951,RM-1230,9/22/2013,0,0,0,0,0,0,0
30952,RM-1230,9/23/2013,0,0,0,0,0,0,0
30953,RM-1230,9/24/2013,0,0,0,0,0,0,0
30954,RM-1230,9/25/2013,0,0,0,0,0,0,0
30955,RM-1230,9/26/2013,0,0,0,0,0,0,0
30956,RM-1230,9/27/2013,0,0,0,0,0,0,0
30957,RM-1230,9/28/2013,0,0,0,0,0,0,0
30958,RM-1230,9/29/2013,0,0,0,0,0,0,0
30959,RM-1230,9/30/2013,0,0,0,0,0,0,0
30960,RM-1230,10/1/2013,0,0,0,0,0,0,0
30961,RM-1230,10/2/2013,0,0,0,0,0,0,0
30962,RM-1230,10/3/2013,0,0,0,0,0,0,0
30963,RM-1230,10/4/2013,0,0,0,0,0,0,0
30964,RM-1230,10/5/2013,0,0,0,0,0,0,0
30965,RM-1230,10/6/2013,0,0,0,0,0,0,0
30966,RM-1230,10/7/2013,0,0,0,0,0,0,0
30967,RM-1230,10/8/2013,0,0,0,0,0,0,0
30968,RM-1230,10/9/2013,0,0,0,0,0,0,0
30969,RM-1230,10/10/2013,0,0,0,0,0,0,0
30970,RM-1230,10/11/2013,0,0,0,0,0,0,0
30971,RM-1230,10/12/2013,0,0,0,0,0,0,0
30972,RM-1230,10/13/2013,0,0,0,0,0,0,0
30973,RM-1230,10/14/2013,0,0,0,0,0,0,0
30974,RM-1230,10/15/2013,0,0,0,0,0,0,0
30975,RM-1230,10/16/2013,0,0,0,0,0,0,0
30976,RM-1230,10/17/2013,0,0,0,0,0,0,0
30977,RM-1230,10/18/2013,0,0,0,0,0,0,0
30978,RM-1230,10/19/2013,0,0,0,0,0,0,0
30979,RM-1230,10/20/2013,0,0,0,0,0,0,0
30980,RM-1230,10/21/2013,0,0,0,0,0,0,0
30981,RM-1230,10/22/2013,0,0,0,0,0,0,0
30982,RM-1230,10/23/2013,0,0,0,0,0,0,0
30983,RM-1230,10/24/2013,0,0,0,0,0,0,0
30984,RM-1230,10/25/2013,0,0,0,0,0,0,0
30985,RM-1230,10/26/2013,0,0,0,0,0,0,0
30986,RM-1230,10/27/2013,0,0,0,0,0,0,0
30987,RM-1230,10/28/2013,0,0,0,0,0,0,0
30988,RM-1230,10/29/2013,0,0,0,0,0,0,0
30989,RM-1230,10/30/2013,0,0,0,0,0,0,0
30990,RM-1230,11/1/2013,0,0,0,0,0,0,0
30991,RM-1230,11/2/2013,0,0,0,0,0,0,0
30992,RM-1230,11/3/2013,0,0,0,0,0,0,0
30993,RM-1230,11/4/2013,0,0,0,0,0,0,0
30994,RM-1230,11/5/2013,0,0,0,0,0,0,0
30995,RM-1230,11/6/2013,0,0,0,0,0,0,0
30996,RM-1230,11/7/2013,0,0,0,0,0,0,0
30997,RM-1230,11/8/2013,0,0,0,0,0,0,0
30998,RM-1230,11/9/2013,0,0,0,0,0,0,0
30999,RM-1230,11/10/2013,0,0,0,0,0,0,0
31000,RM-1230,11/11/2013,0,0,0,0,0,0,0
31001,RM-1230,11/12/2013,0,0,0,0,0,0,0
31002,RM-1230,11/13/2013,0,0,0,0,0,0,0
31003,RM-1230,11/14/2013,0,0,0,0,0,0,0
31004,RM-1230,11/15/2013,0,0,0,0,0,0,0
31005,RM-1230,11/19/2013,0,0,0,0,0,0,0
31006,RM-1230,11/20/2013,0,0,0,0,0,0,0
31007,RM-1230,11/21/2013,0,0,0,0,0,0,0
31008,RM-1230,11/22/2013,0,0,0,0,0,0,0
31009,RM-1230,11/23/2013,0,0,0,0,0,0,0
31010,RM-1230,11/24/2013,0,0,0,0,0,0,0
31011,RM-1230,11/25/2013,0,0,0,0,0,0,0
31012,RM-1230,11/26/2013,0,0,0,0,0,0,0
31013,RM-1230,11/27/2013,0,0,0,0,0,0,0
31014,RM-1230,11/28/2013,0,0,0,0,0,0,0
31015,RM-1230,11/29/2013,0,0,0,0,0,0,0
31016,RM-1230,11/30/2013,0,0,0,0,0,0,0
31017,RM-1230,12/1/2013,0,0,0,0,0,0,0
31018,RM-1230,12/2/2013,0,0,0,0,0,0,0
31019,RM-1230,12/3/2013,0,0,0,0,0,0,0
31020,RM-1230,12/4/2013,0,0,0,0,0,0,0
31021,RM-1230,12/5/2013,0,0,0,0,0,0,0
31022,RM-1230,12/6/2013,0,0,0,0,0,0,0
31023,RM-1230,12/7/2013,0,0,0,0,0,0,0
31024,RM-1230,12/8/2013,0,0,0,0,0,0,0
31025,RM-1230,12/9/2013,0,0,0,0,0,0,0
31026,RM-1230,12/10/2013,0,0,0,0,0,0,0
31027,RM-1230,12/11/2013,0,0,0,0,0,0,0
31028,RM-1230,12/12/2013,0,0,0,0,0,0,0
31029,RM-1230,12/13/2013,0,0,0,0,0,0,0
31030,RM-1230,12/14/2013,0,0,0,0,0,0,0
31031,RM-1230,12/15/2013,0,0,0,0,0,0,0
31032,RM-1230,12/16/2013,0,0,0,0,0,0,0
31033,RM-1230,12/17/2013,0,0,0,0,0,0,0
31034,RM-1230,12/18/2013,0,0,0,0,0,0,0
31035,RM-1230,12/19/2013,0,0,0,0,0,0,0
31036,RM-1230,12/20/2013,0,0,0,0,0,0,0
31037,RM-1230,12/21/2013,0,0,0,0,0,0,0
31038,RM-1230,12/22/2013,0,0,0,0,0,0,0
31039,RM-1230,12/23/2013,0,0,0,0,0,0,0
31040,RM-1230,12/24/2013,0,0,0,0,0,0,0
31041,RM-1230,12/25/2013,0,0,0,0,0,0,0
31042,RM-1230,12/26/2013,0,0,0,0,0,0,0
31043,RM-1230,12/27/2013,0,0,0,0,0,0,0
31044,RM-1230,12/28/2013,0,0,0,0,0,0,0
31045,RM-1230,12/29/2013,0,0,0,0,0,0,0
31046,RM-1230,1/2/2014,0,0,0,0,0,0,0
31047,RM-1230,1/3/2014,0,0,0,0,0,0,0
31048,RM-1230,1/4/2014,0,0,0,0,0,0,0
31049,RM-1230,1/5/2014,0,0,0,0,0,0,0
31050,RM-1230,1/6/2014,0,0,0,0,0,0,0
31051,RM-1230,1/7/2014,0,0,0,0,0,0,0
31053,RM-1230,1/9/2014,0,0,0,0,0,0,0
31057,RM-1230,1/13/2014,0,0,0,0,0,0,0
31058,RM-1230,1/14/2014,0,0,0,0,0,0,0
31228,RM-1230,7/3/2014,0,0,0,0,0,0,0
31229,RM-1230,7/4/2014,0,0,0,0,0,0,0
31230,RM-1230,7/5/2014,0,0,0,0,0,0,0
31231,RM-1230,7/6/2014,0,0,0,0,0,0,0
31232,RM-1230,7/7/2014,0,0,0,0,0,0,0
31233,RM-1230,7/8/2014,0,0,0,0,0,0,0
31234,RM-1230,7/9/2014,0,0,0,0,0,0,0
31235,RM-1230,7/10/2014,0,0,0,0,0,0,0
31236,RM-1230,7/11/2014,0,0,0,0,0,0,0
31237,RM-1230,7/12/2014,0,0,0,0,0,0,0
31238,RM-1230,7/13/2014,0,0,0,0,0,0,0
31239,RM-1230,7/14/2014,0,0,0,0,0,0,0
31240,RM-1230,7/15/2014,0,0,0,0,0,0,0
31241,RM-1230,7/16/2014,0,0,0,0,0,0,0
31242,RM-1230,7/17/2014,0,0,0,0,0,0,0
31243,RM-1230,7/18/2014,0,0,0,0,0,0,0
31244,RM-1230,7/19/2014,0,0,0,0,0,0,0
31245,RM-1230,7/20/2014,0,0,0,0,0,0,0
31246,RM-1230,7/21/2014,0,0,0,0,0,0,0
31247,RM-1230,7/22/2014,0,0,0,0,0,0,0
31248,RM-1230,7/23/2014,0,0,0,0,0,0,0
31249,RM-1230,7/24/2014,0,0,0,0,0,0,0
31250,RM-1230,7/25/2014,0,0,0,0,0,0,0
31251,RM-1230,7/26/2014,0,0,0,0,0,0,0
31252,RM-1230,7/27/2014,0,0,0,0,0,0,0
31253,RM-1230,7/28/2014,0,0,0,0,0,0,0
31254,RM-1230,7/29/2014,0,0,0,0,0,0,0
31255,RM-1230,7/30/2014,0,0,0,0,0,0,0
31256,RM-1230,7/31/2014,0,0,0,0,0,0,0
31257,RM-1230,8/1/2014,0,0,0,0,0,0,0
31258,RM-1230,8/2/2014,0,0,0,0,0,0,0
31259,RM-1230,8/3/2014,0,0,0,0,0,0,0
31260,RM-1230,8/4/2014,0,0,0,0,0,0,0
31261,RM-1230,8/5/2014,0,0,0,0,0,0,0
31262,RM-1230,8/6/2014,0,0,0,0,0,0,0
31263,RM-1230,8/7/2014,0,0,0,0,0,0,0
31264,RM-1230,8/8/2014,0,0,0,0,0,0,0
31265,RM-1230,8/9/2014,0,0,0,0,0,0,0
31266,RM-1230,8/10/2014,0,0,0,0,0,0,0
31267,RM-1230,8/11/2014,0,0,0,0,0,0,0
31268,RM-1230,8/12/2014,0,0,0,0,0,0,0
31269,RM-1230,8/13/2014,0,0,0,0,0,0,0
31270,RM-1230,8/14/2014,0,0,0,0,0,0,0
31271,RM-1230,8/15/2014,0,0,0,0,0,0,0
31272,RM-1230,8/16/2014,0,0,0,0,0,0,0
31273,RM-1230,8/17/2014,0,0,0,0,0,0,0
31274,RM-1230,8/18/2014,0,0,0,0,0,0,0
31275,RM-1230,8/19/2014,0,0,0,0,0,0,0
31276,RM-1230,8/20/2014,0,0,0,0,0,0,0
31277,RM-1230,8/21/2014,0,0,0,0,0,0,0
31278,RM-1230,8/22/2014,0,0,0,0,0,0,0
31279,RM-1230,8/23/2014,0,0,0,0,0,0,0
31280,RM-1230,8/24/2014,0,0,0,0,0,0,0
31281,RM-1230,8/25/2014,0,0,0,0,0,0,0
31282,RM-1230,8/26/2014,0,0,0,0,0,0,0
31283,RM-1230,8/27/2014,0,0,0,0,0,0,0
31284,RM-1230,8/28/2014,0,0,0,0,0,0,0
31285,RM-1230,8/29/2014,0,0,0,0,0,0,0
31286,RM-1230,8/30/2014,0,0,0,0,0,0,0
31287,RM-1230,8/31/2014,0,0,0,0,0,0,0
31288,RM-1230,9/1/2014,0,0,0,0,0,0,0
31289,RM-1230,9/2/2014,0,0,0,0,0,0,0
31290,RM-1230,9/3/2014,0,0,0,0,0,0,0
31291,RM-1230,9/4/2014,0,0,0,0,0,0,0
31292,RM-1230,9/5/2014,0,0,0,0,0,0,0
31293,RM-1230,9/6/2014,0,0,0,0,0,0,0
31294,RM-1230,9/7/2014,0,0,0,0,0,0,0
31295,RM-1230,9/8/2014,0,0,0,0,0,0,0
31296,RM-1230,9/9/2014,0,0,0,0,0,0,0
31297,RM-1230,9/10/2014,0,0,0,0,0,0,0
31298,RM-1230,9/11/2014,0,0,0,0,0,0,0
31299,RM-1230,9/12/2014,0,0,0,0,0,0,0
31300,RM-1230,9/13/2014,0,0,0,0,0,0,0
31301,RM-1230,9/14/2014,0,0,0,0,0,0,0
31302,RM-1230,9/15/2014,0,0,0,0,0,0,0
31303,RM-1230,9/16/2014,0,0,0,0,0,0,0
31304,RM-1230,9/17/2014,0,0,0,0,0,0,0
31305,RM-1230,9/18/2014,0,0,0,0,0,0,0
31306,RM-1230,9/19/2014,0,0,0,0,0,0,0
31307,RM-1230,9/20/2014,0,0,0,0,0,0,0
31308,RM-1230,9/21/2014,0,0,0,0,0,0,0
31309,RM-1230,9/22/2014,0,0,0,0,0,0,0
31310,RM-1230,9/23/2014,0,0,0,0,0,0,0
31311,RM-1230,9/24/2014,0,0,0,0,0,0,0
31312,RM-1230,9/25/2014,0,0,0,0,0,0,0
31313,RM-1230,9/28/2014,0,0,0,0,0,0,0
31314,RM-1230,9/29/2014,0,0,0,0,0,0,0
31315,RM-1230,9/30/2014,0,0,0,0,0,0,0
31316,RM-1230,10/1/2014,0,0,0,0,0,0,0
31317,RM-1230,10/2/2014,0,0,0,0,0,0,0
31318,RM-1230,10/3/2014,0,0,0,0,0,0,0
31319,RM-1230,10/4/2014,0,0,0,0,0,0,0
31320,RM-1230,10/5/2014,0,0,0,0,0,0,0
31321,RM-1230,10/6/2014,0,0,0,0,0,0,0
31322,RM-1230,10/7/2014,0,0,0,0,0,0,0
31323,RM-1230,10/8/2014,0,0,0,0,0,0,0
31324,RM-1230,10/9/2014,0,0,0,0,0,0,0
31325,RM-1230,10/10/2014,0,0,0,0,0,0,0
31326,RM-1230,10/11/2014,0,0,0,0,0,0,0
31327,RM-1230,10/12/2014,0,0,0,0,0,0,0
31328,RM-1230,10/13/2014,0,0,0,0,0,0,0
31329,RM-1230,10/14/2014,0,0,0,0,0,0,0
31330,RM-1230,10/15/2014,0,0,0,0,0,0,0
31331,RM-1230,10/16/2014,0,0,0,0,0,0,0
31332,RM-1230,10/17/2014,0,0,0,0,0,0,0
31333,RM-1230,10/18/2014,0,0,0,0,0,0,0
31334,RM-1230,10/19/2014,0,0,0,0,0,0,0
31335,RM-1230,10/20/2014,0,0,0,0,0,0,0
31336,RM-1230,10/21/2014,0,0,0,0,0,0,0
31337,RM-1230,10/22/2014,0,0,0,0,0,0,0
31338,RM-1230,10/23/2014,0,0,0,0,0,0,0
31339,RM-1230,10/24/2014,0,0,0,0,0,0,0
31340,RM-1230,10/25/2014,0,0,0,0,0,0,0
31341,RM-1230,10/26/2014,0,0,0,0,0,0,0
31342,RM-1230,10/27/2014,0,0,0,0,0,0,0
31343,RM-1230,10/28/2014,0,0,0,0,0,0,0
31344,RM-1230,10/29/2014,0,0,0,0,0,0,0
31345,RM-1230,10/30/2014,0,0,0,0,0,0,0
31346,RM-1230,10/31/2014,0,0,0,0,0,0,0
31347,RM-1230,11/1/2014,0,0,0,0,0,0,0
31348,RM-1230,11/2/2014,0,0,0,0,0,0,0
31349,RM-1230,11/3/2014,0,0,0,0,0,0,0
31350,RM-1230,11/4/2014,0,0,0,0,0,0,0
31351,RM-1230,11/5/2014,0,0,0,0,0,0,0
31352,RM-1230,11/6/2014,0,0,0,0,0,0,0
31353,RM-1230,11/7/2014,0,0,0,0,0,0,0
31354,RM-1230,11/8/2014,0,0,0,0,0,0,0
31355,RM-1230,11/9/2014,0,0,0,0,0,0,0
31356,RM-1230,11/10/2014,0,0,0,0,0,0,0
31357,RM-1230,11/11/2014,0,0,0,0,0,0,0
31358,RM-1230,11/12/2014,0,0,0,0,0,0,0
31359,RM-1230,11/13/2014,0,0,0,0,0,0,0
31360,RM-1230,11/14/2014,0,0,0,0,0,0,0
31361,RM-1230,11/15/2014,0,0,0,0,0,0,0
31362,RM-1230,11/16/2014,0,0,0,0,0,0,0
31363,RM-1230,11/17/2014,0,0,0,0,0,0,0
31364,RM-1230,11/18/2014,0,0,0,0,0,0,0
31365,RM-1230,11/19/2014,0,0,0,0,0,0,0
31366,RM-1230,11/20/2014,0,0,0,0,0,0,0
31367,RM-1230,11/21/2014,0,0,0,0,0,0,0
31368,RM-1230,11/22/2014,0,0,0,0,0,0,0
31369,RM-1230,11/23/2014,0,0,0,0,0,0,0
31370,RM-1230,11/24/2014,0,0,0,0,0,0,0
31371,RM-1230,11/25/2014,0,0,0,0,0,0,0
31372,RM-1230,11/26/2014,0,0,0,0,0,0,0
31373,RM-1230,11/27/2014,0,0,0,0,0,0,0
31374,RM-1230,11/28/2014,0,0,0,0,0,0,0
31375,RM-1230,11/29/2014,0,0,0,0,0,0,0
31376,RM-1230,11/30/2014,0,0,0,0,0,0,0
31377,RM-1230,12/1/2014,0,0,0,0,0,0,0
31378,RM-1230,12/2/2014,0,0,0,0,0,0,0
31379,RM-1230,12/3/2014,0,0,0,0,0,0,0
31380,RM-1230,12/4/2014,0,0,0,0,0,0,0
31381,RM-1230,12/5/2014,0,0,0,0,0,0,0
31382,RM-1230,12/6/2014,0,0,0,0,0,0,0
31383,RM-1230,12/7/2014,0,0,0,0,0,0,0
31384,RM-1230,12/8/2014,0,0,0,0,0,0,0
31385,RM-1230,12/9/2014,0,0,0,0,0,0,0
31386,RM-1230,12/10/2014,0,0,0,0,0,0,0
31387,RM-1230,12/11/2014,0,0,0,0,0,0,0
31388,RM-1230,12/12/2014,0,0,0,0,0,0,0
31389,RM-1230,12/13/2014,0,0,0,0,0,0,0
31390,RM-1230,12/14/2014,0,0,0,0,0,0,0
31391,RM-1230,12/15/2014,0,0,0,0,0,0,0
31392,RM-1230,12/16/2014,0,0,0,0,0,0,0
31393,RM-1230,12/17/2014,0,0,0,0,0,0,0
31394,RM-1230,12/18/2014,0,0,0,0,0,0,0
31395,RM-1230,12/19/2014,0,0,0,0,0,0,0
31396,RM-1230,12/20/2014,0,0,0,0,0,0,0
31397,RM-1230,12/21/2014,0,0,0,0,0,0,0
31398,RM-1230,12/22/2014,0,0,0,0,0,0,0
31399,RM-1230,12/23/2014,0,0,0,0,0,0,0
31400,RM-1230,12/24/2014,0,0,0,0,0,0,0
31401,RM-1230,12/25/2014,0,0,0,0,0,0,0
31402,RM-1230,12/26/2014,0,0,0,0,0,0,0
31403,RM-1230,12/27/2014,0,0,0,0,0,0,0
31404,RM-1230,12/28/2014,0,0,0,0,0,0,0
31405,RM-1230,12/29/2014,0,0,0,0,0,0,0
31406,RM-1230,12/30/2014,0,0,0,0,0,0,0
31407,RM-1230,12/31/2014,0,0,0,0,0,0,0
31408,RM-1230,1/1/2015,0,0,0,0,0,0,0
31409,RM-1230,1/2/2015,0,0,0,0,0,0,0
31410,RM-1230,1/3/2015,0,0,0,0,0,0,0
31411,RM-1230,1/4/2015,0,0,0,0,0,0,0
31412,RM-1230,1/5/2015,0,0,0,0,0,0,0
31413,RM-1230,1/6/2015,0,0,0,0,0,0,0
31414,RM-1230,1/7/2015,0,0,0,0,0,0,0
31415,RM-1230,1/8/2015,0,0,0,0,0,0,0
31416,RM-1230,1/9/2015,0,0,0,0,0,0,0
31417,RM-1230,1/10/2015,0,0,0,0,0,0,0
31418,RM-1230,1/11/2015,0,0,0,0,0,0,0
31419,RM-1230,1/12/2015,0,0,0,0,0,0,0
31420,RM-1230,1/13/2015,0,0,0,0,0,0,0
31421,RM-1230,1/14/2015,0,0,0,0,0,0,0
31422,RM-1230,1/15/2015,0,0,0,0,0,0,0
31423,RM-1230,1/16/2015,0,0,0,0,0,0,0
31424,RM-1230,1/17/2015,0,0,0,0,0,0,0
31425,RM-1230,1/18/2015,0,0,0,0,0,0,0
31426,RM-1230,1/19/2015,0,0,0,0,0,0,0
31427,RM-1230,1/20/2015,0,0,0,0,0,0,0
31428,RM-1230,1/21/2015,0,0,0,0,0,0,0
31429,RM-1230,1/22/2015,0,0,0,0,0,0,0
31430,RM-1230,1/23/2015,0,0,0,0,0,0,0
31431,RM-1230,1/24/2015,0,0,0,0,0,0,0
31432,RM-1230,1/25/2015,0,0,0,0,0,0,0
31433,RM-1230,1/26/2015,0,0,0,0,0,0,0
31434,RM-1230,1/27/2015,0,0,0,0,0,0,0
31435,RM-1230,1/28/2015,0,0,0,0,0,0,0
31436,RM-1230,1/29/2015,0,0,0,0,0,0,0
31437,RM-1230,1/30/2015,0,0,0,0,0,0,0
31438,RM-1230,1/31/2015,0,0,0,0,0,0,0
31439,RM-1230,2/1/2015,0,0,0,0,0,0,0
31440,RM-1230,2/2/2015,0,0,0,0,0,0,0
31441,RM-1230,2/3/2015,0,0,0,0,0,0,0
31442,RM-1230,2/4/2015,0,0,0,0,0,0,0
31443,RM-1230,2/5/2015,0,0,0,0,0,0,0
31444,RM-1230,2/6/2015,0,0,0,0,0,0,0
31445,RM-1230,2/7/2015,0,0,0,0,0,0,0
31446,RM-1230,2/8/2015,0,0,0,0,0,0,0
31447,RM-1230,2/9/2015,0,0,0,0,0,0,0
31448,RM-1230,2/10/2015,0,0,0,0,0,0,0
31449,RM-1230,2/11/2015,0,0,0,0,0,0,0
31450,RM-1230,2/12/2015,0,0,0,0,0,0,0
31451,RM-1230,2/13/2015,0,0,0,0,0,0,0
31452,RM-1230,2/14/2015,0,0,0,0,0,0,0
31453,RM-1230,2/15/2015,0,0,0,0,0,0,0
31454,RM-1230,2/16/2015,0,0,0,0,0,0,0
31455,RM-1230,2/17/2015,0,0,0,0,0,0,0
31456,RM-1230,2/18/2015,0,0,0,0,0,0,0
31457,RM-1230,2/19/2015,0,0,0,0,0,0,0
31458,RM-1230,2/20/2015,0,0,0,0,0,0,0
31459,RM-1230,2/21/2015,0,0,0,0,0,0,0
31460,RM-1230,2/22/2015,0,0,0,0,0,0,0
31461,RM-1230,2/23/2015,0,0,0,0,0,0,0
31462,RM-1230,2/24/2015,0,0,0,0,0,0,0
31463,RM-1230,2/25/2015,0,0,0,0,0,0,0
31464,RM-1230,2/26/2015,0,0,0,0,0,0,0
31465,RM-1230,2/27/2015,0,0,0,0,0,0,0
31466,RM-1230,2/28/2015,0,0,0,0,0,0,0
31467,RM-1230,3/1/2015,0,0,0,0,0,0,0
31468,RM-1230,3/2/2015,0,0,0,0,0,0,0
31469,RM-1230,3/3/2015,0,0,0,0,0,0,0
31470,RM-1230,3/4/2015,0,0,0,0,0,0,0
31471,RM-1230,3/5/2015,0,0,0,0,0,0,0
31472,RM-1230,3/6/2015,0,0,0,0,0,0,0
31473,RM-1230,3/7/2015,0,0,0,0,0,0,0
31474,RM-1230,3/8/2015,0,0,0,0,0,0,0
31475,RM-1230,3/9/2015,0,0,0,0,0,0,0
31476,RM-1230,3/10/2015,0,0,0,0,0,0,0
31477,RM-1230,3/11/2015,0,0,0,0,0,0,0
31478,RM-1230,3/12/2015,0,0,0,0,0,0,0
31479,RM-1230,3/13/2015,0,0,0,0,0,0,0
31480,RM-1230,3/14/2015,0,0,0,0,0,0,0
31481,RM-1230,3/15/2015,0,0,0,0,0,0,0
31482,RM-1230,3/16/2015,0,0,0,0,0,0,0
31483,RM-1230,3/17/2015,0,0,0,0,0,0,0
31484,RM-1230,3/18/2015,0,0,0,0,0,0,0
31485,RM-1230,3/19/2015,0,0,0,0,0,0,0
31486,RM-1230,3/20/2015,0,0,0,0,0,0,0
31487,RM-1230,3/21/2015,0,0,0,0,0,0,0
31488,RM-1230,3/22/2015,0,0,0,0,0,0,0
31489,RM-1230,3/23/2015,0,0,0,0,0,0,0
31490,RM-1230,3/24/2015,0,0,0,0,0,0,0
31491,RM-1230,3/25/2015,0,0,0,0,0,0,0
31492,RM-1230,3/26/2015,0,0,0,0,0,0,0
31493,RM-1230,3/27/2015,0,0,0,0,0,0,0
31494,RM-1230,3/28/2015,0,0,0,0,0,0,0
31495,RM-1230,3/29/2015,0,0,0,0,0,0,0
31496,RM-1230,3/30/2015,0,0,0,0,0,0,0
31497,RM-1230,3/31/2015,0,0,0,0,0,0,0
31498,RM-1230,4/1/2015,0,0,0,0,0,0,0
31499,RM-1230,4/2/2015,0,0,0,0,0,0,0
31500,RM-1230,4/3/2015,0,0,0,0,0,0,0
31501,RM-1230,4/4/2015,0,0,0,0,0,0,0
31502,RM-1230,4/5/2015,0,0,0,0,0,0,0
31503,RM-1230,4/6/2015,0,0,0,0,0,0,0
31504,RM-1230,4/7/2015,0,0,0,0,0,0,0
31505,RM-1230,4/8/2015,0,0,0,0,0,0,0
31506,RM-1230,4/9/2015,0,0,0,0,0,0,0
31507,RM-1230,4/10/2015,0,0,0,0,0,0,0
31508,RM-1230,4/11/2015,0,0,0,0,0,0,0
31509,RM-1230,4/12/2015,0,0,0,0,0,0,0
31510,RM-1230,4/13/2015,0,0,0,0,0,0,0
31511,RM-1230,4/14/2015,0,0,0,0,0,0,0
31512,RM-1230,4/15/2015,0,0,0,0,0,0,0
31513,RM-1230,4/16/2015,0,0,0,0,0,0,0
31514,RM-1230,4/17/2015,0,0,0,0,0,0,0
31515,RM-1230,4/18/2015,0,0,0,0,0,0,0
31516,RM-1230,4/19/2015,0,0,0,0,0,0,0
31517,RM-1230,4/20/2015,0,0,0,0,0,0,0
31518,RM-1230,4/21/2015,0,0,0,0,0,0,0
31519,RM-1230,4/22/2015,0,0,0,0,0,0,0
31520,RM-1230,4/23/2015,0,0,0,0,0,0,0
31521,RM-1230,4/24/2015,0,0,0,0,0,0,0
31522,RM-1230,4/25/2015,0,0,0,0,0,0,0
31523,RM-1230,4/26/2015,0,0,0,0,0,0,0
31524,RM-1230,4/27/2015,0,0,0,0,0,0,0
31525,RM-1230,4/28/2015,0,0,0,0,0,0,0
31526,RM-1230,4/29/2015,0,0,0,0,0,0,0
31527,RM-1230,4/30/2015,0,0,0,0,0,0,0
31528,RM-1230,5/1/2015,0,0,0,0,0,0,0
31529,RM-1230,5/2/2015,0,0,0,0,0,0,0
31530,RM-1230,5/3/2015,0,0,0,0,0,0,0
31531,RM-1230,5/4/2015,0,0,0,0,0,0,0
31532,RM-1230,5/5/2015,0,0,0,0,0,0,0
31533,RM-1230,5/6/2015,0,0,0,0,0,0,0
31534,RM-1230,5/7/2015,0,0,0,0,0,0,0
31535,RM-1230,5/8/2015,0,0,0,0,0,0,0
31536,RM-1230,5/9/2015,0,0,0,0,0,0,0
31537,RM-1230,5/10/2015,0,0,0,0,0,0,0
31538,RM-1230,5/11/2015,0,0,0,0,0,0,0
31539,RM-1230,5/12/2015,0,0,0,0,0,0,0
31540,RM-1230,5/13/2015,0,0,0,0,0,0,0
31541,RM-1230,5/14/2015,0,0,0,0,0,0,0
31542,RM-1230,5/15/2015,0,0,0,0,0,0,0
31543,RM-1230,5/16/2015,0,0,0,0,0,0,0
31544,RM-1230,5/17/2015,0,0,0,0,0,0,0
31545,RM-1230,5/18/2015,0,0,0,0,0,0,0
31546,RM-1230,5/19/2015,0,0,0,0,0,0,0
31547,RM-1230,5/20/2015,0,0,0,0,0,0,0
31548,RM-1230,5/21/2015,0,0,0,0,0,0,0
31549,RM-1230,5/22/2015,0,0,0,0,0,0,0
31550,RM-1230,5/23/2015,0,0,0,0,0,0,0
31551,RM-1230,5/24/2015,0,0,0,0,0,0,0
31552,RM-1230,5/25/2015,0,0,0,0,0,0,0
31553,RM-1230,5/26/2015,0,0,0,0,0,0,0
31554,RM-1230,5/27/2015,0,0,0,0,0,0,0
31555,RM-1230,5/28/2015,0,0,0,0,0,0,0
31556,RM-1230,5/29/2015,0,0,0,0,0,0,0
31557,RM-1230,5/30/2015,0,0,0,0,0,0,0
31558,RM-1230,5/31/2015,0,0,0,0,0,0,0
31559,RM-1231,7/1/2013,0,0,0,0,0,0,0
31560,RM-1231,7/2/2013,0,0,0,0,0,0,0
31561,RM-1231,7/3/2013,0,0,0,0,0,0,0
31562,RM-1231,7/4/2013,0,0,0,0,0,0,0
31563,RM-1231,7/5/2013,0,0,0,0,0,0,0
31564,RM-1231,7/6/2013,0,0,0,0,0,0,0
31565,RM-1231,7/7/2013,0,0,0,0,0,0,0
31566,RM-1231,7/8/2013,0,0,0,0,0,0,0
31567,RM-1231,7/9/2013,0,0,0,0,0,0,0
31568,RM-1231,7/10/2013,0,0,0,0,0,0,0
31569,RM-1231,7/11/2013,0,0,0,0,0,0,0
31570,RM-1231,7/12/2013,0,0,0,0,0,0,0
31571,RM-1231,7/13/2013,0,0,0,0,0,0,0
31572,RM-1231,7/14/2013,0,0,0,0,0,0,0
31573,RM-1231,7/15/2013,0,0,0,0,0,0,0
31574,RM-1231,7/17/2013,0,0,0,0,0,0,0
31575,RM-1231,7/18/2013,0,0,0,0,0,0,0
31576,RM-1231,7/19/2013,0,0,0,0,0,0,0
31577,RM-1231,7/20/2013,0,0,0,0,0,0,0
31578,RM-1231,7/21/2013,0,0,0,0,0,0,0
31579,RM-1231,7/22/2013,0,0,0,0,0,0,0
31580,RM-1231,7/23/2013,0,0,0,0,0,0,0
31817,RM-1231,3/29/2014,0,0,0,0,0,0,0
31818,RM-1231,3/30/2014,0,0,0,0,0,0,0
31819,RM-1231,3/31/2014,0,0,0,0,0,0,0
31820,RM-1231,4/1/2014,0,0,0,0,0,0,0
31821,RM-1231,4/2/2014,0,0,0,0,0,0,0
31822,RM-1231,4/3/2014,0,0,0,0,0,0,0
31823,RM-1231,4/4/2014,0,0,0,0,0,0,0
31824,RM-1231,4/5/2014,0,0,0,0,0,0,0
31825,RM-1231,4/6/2014,0,0,0,0,0,0,0
31826,RM-1231,4/7/2014,0,0,0,0,0,0,0
31827,RM-1231,4/8/2014,0,0,0,0,0,0,0
31828,RM-1231,4/9/2014,0,0,0,0,0,0,0
31829,RM-1231,4/10/2014,0,0,0,0,0,0,0
31830,RM-1231,4/11/2014,0,0,0,0,0,0,0
31831,RM-1231,4/12/2014,0,0,0,0,0,0,0
31832,RM-1231,4/13/2014,0,0,0,0,0,0,0
31833,RM-1231,4/14/2014,0,0,0,0,0,0,0
31834,RM-1231,4/15/2014,0,0,0,0,0,0,0
31835,RM-1231,4/16/2014,0,0,0,0,0,0,0
31836,RM-1231,4/17/2014,0,0,0,0,0,0,0
31837,RM-1231,4/18/2014,0,0,0,0,0,0,0
31838,RM-1231,4/19/2014,0,0,0,0,0,0,0
31839,RM-1231,4/20/2014,0,0,0,0,0,0,0
31840,RM-1231,4/21/2014,0,0,0,0,0,0,0
31841,RM-1231,4/22/2014,0,0,0,0,0,0,0
31842,RM-1231,4/23/2014,0,0,0,0,0,0,0
31843,RM-1231,4/24/2014,0,0,0,0,0,0,0
31844,RM-1231,4/25/2014,0,0,0,0,0,0,0
31845,RM-1231,4/26/2014,0,0,0,0,0,0,0
31846,RM-1231,4/27/2014,0,0,0,0,0,0,0
31847,RM-1231,4/28/2014,0,0,0,0,0,0,0
31848,RM-1231,4/29/2014,0,0,0,0,0,0,0
31849,RM-1231,4/30/2014,0,0,0,0,0,0,0
31850,RM-1231,5/1/2014,0,0,0,0,0,0,0
31851,RM-1231,5/2/2014,0,0,0,0,0,0,0
31852,RM-1231,5/3/2014,0,0,0,0,0,0,0
31853,RM-1231,5/4/2014,0,0,0,0,0,0,0
31854,RM-1231,5/5/2014,0,0,0,0,0,0,0
31855,RM-1231,5/6/2014,0,0,0,0,0,0,0
31856,RM-1231,5/7/2014,0,0,0,0,0,0,0
31857,RM-1231,5/8/2014,0,0,0,0,0,0,0
31858,RM-1231,5/9/2014,0,0,0,0,0,0,0
31859,RM-1231,5/10/2014,0,0,0,0,0,0,0
31860,RM-1231,5/11/2014,0,0,0,0,0,0,0
31861,RM-1231,5/12/2014,0,0,0,0,0,0,0
31862,RM-1231,5/13/2014,0,0,0,0,0,0,0
31863,RM-1231,5/14/2014,0,0,0,0,0,0,0
31864,RM-1231,5/15/2014,0,0,0,0,0,0,0
31865,RM-1231,5/16/2014,0,0,0,0,0,0,0
31866,RM-1231,5/17/2014,0,0,0,0,0,0,0
31867,RM-1231,5/18/2014,0,0,0,0,0,0,0
31868,RM-1231,5/19/2014,0,0,0,0,0,0,0
31869,RM-1231,5/20/2014,0,0,0,0,0,0,0
31870,RM-1231,5/21/2014,0,0,0,0,0,0,0
31871,RM-1231,5/22/2014,0,0,0,0,0,0,0
31872,RM-1231,5/23/2014,0,0,0,0,0,0,0
31873,RM-1231,5/24/2014,0,0,0,0,0,0,0
31874,RM-1231,5/25/2014,0,0,0,0,0,0,0
31875,RM-1231,5/26/2014,0,0,0,0,0,0,0
31876,RM-1231,5/27/2014,0,0,0,0,0,0,0
31877,RM-1231,5/28/2014,0,0,0,0,0,0,0
31878,RM-1231,5/29/2014,0,0,0,0,0,0,0
31879,RM-1231,5/30/2014,0,0,0,0,0,0,0
31880,RM-1231,5/31/2014,0,0,0,0,0,0,0
31881,RM-1231,6/1/2014,0,0,0,0,0,0,0
31882,RM-1231,6/2/2014,0,0,0,0,0,0,0
31883,RM-1231,6/3/2014,0,0,0,0,0,0,0
31884,RM-1231,6/4/2014,0,0,0,0,0,0,0
31885,RM-1231,6/5/2014,0,0,0,0,0,0,0
31886,RM-1231,6/6/2014,0,0,0,0,0,0,0
31887,RM-1231,6/7/2014,0,0,0,0,0,0,0
31888,RM-1231,6/8/2014,0,0,0,0,0,0,0
31889,RM-1231,6/9/2014,0,0,0,0,0,0,0
31890,RM-1231,6/10/2014,0,0,0,0,0,0,0
31891,RM-1231,6/11/2014,0,0,0,0,0,0,0
31892,RM-1231,6/12/2014,0,0,0,0,0,0,0
31893,RM-1231,6/13/2014,0,0,0,0,0,0,0
31894,RM-1231,6/14/2014,0,0,0,0,0,0,0
31895,RM-1231,6/15/2014,0,0,0,0,0,0,0
31896,RM-1231,6/16/2014,0,0,0,0,0,0,0
31897,RM-1231,6/17/2014,0,0,0,0,0,0,0
31898,RM-1231,6/18/2014,0,0,0,0,0,0,0
31899,RM-1231,6/19/2014,0,0,0,0,0,0,0
31900,RM-1231,6/20/2014,0,0,0,0,0,0,0
31901,RM-1231,6/21/2014,0,0,0,0,0,0,0
31902,RM-1231,6/22/2014,0,0,0,0,0,0,0
31903,RM-1231,6/23/2014,0,0,0,0,0,0,0
31904,RM-1231,6/24/2014,0,0,0,0,0,0,0
31905,RM-1231,6/25/2014,0,0,0,0,0,0,0
31906,RM-1231,6/26/2014,0,0,0,0,0,0,0
31907,RM-1231,6/27/2014,0,0,0,0,0,0,0
31908,RM-1231,6/28/2014,0,0,0,0,0,0,0
31909,RM-1231,6/29/2014,0,0,0,0,0,0,0
31910,RM-1231,6/30/2014,0,0,0,0,0,0,0
31911,RM-1231,7/1/2014,0,0,0,0,0,0,0
31912,RM-1231,7/2/2014,0,0,0,0,0,0,0
31913,RM-1231,7/3/2014,0,0,0,0,0,0,0
31914,RM-1231,7/4/2014,0,0,0,0,0,0,0
31915,RM-1231,7/5/2014,0,0,0,0,0,0,0
31916,RM-1231,7/6/2014,0,0,0,0,0,0,0
31917,RM-1231,7/7/2014,0,0,0,0,0,0,0
31918,RM-1231,7/8/2014,0,0,0,0,0,0,0
31919,RM-1231,7/9/2014,0,0,0,0,0,0,0
31920,RM-1231,7/10/2014,0,0,0,0,0,0,0
31921,RM-1231,7/11/2014,0,0,0,0,0,0,0
31922,RM-1231,7/12/2014,0,0,0,0,0,0,0
31923,RM-1231,7/13/2014,0,0,0,0,0,0,0
31924,RM-1231,7/14/2014,0,0,0,0,0,0,0
31925,RM-1231,7/15/2014,0,0,0,0,0,0,0
31926,RM-1231,7/16/2014,0,0,0,0,0,0,0
31927,RM-1231,7/17/2014,0,0,0,0,0,0,0
31928,RM-1231,7/18/2014,0,0,0,0,0,0,0
31929,RM-1231,7/19/2014,0,0,0,0,0,0,0
31930,RM-1231,7/20/2014,0,0,0,0,0,0,0
31931,RM-1231,7/21/2014,0,0,0,0,0,0,0
31932,RM-1231,7/22/2014,0,0,0,0,0,0,0
31933,RM-1231,7/23/2014,0,0,0,0,0,0,0
31934,RM-1231,7/24/2014,0,0,0,0,0,0,0
31935,RM-1231,7/25/2014,0,0,0,0,0,0,0
31936,RM-1231,7/26/2014,0,0,0,0,0,0,0
31937,RM-1231,7/27/2014,0,0,0,0,0,0,0
31938,RM-1231,7/28/2014,0,0,0,0,0,0,0
31939,RM-1231,7/29/2014,0,0,0,0,0,0,0
31940,RM-1231,7/30/2014,0,0,0,0,0,0,0
31941,RM-1231,7/31/2014,0,0,0,0,0,0,0
31942,RM-1231,8/1/2014,0,0,0,0,0,0,0
31943,RM-1231,8/2/2014,0,0,0,0,0,0,0
31944,RM-1231,8/3/2014,0,0,0,0,0,0,0
31945,RM-1231,8/4/2014,0,0,0,0,0,0,0
31946,RM-1231,8/5/2014,0,0,0,0,0,0,0
31947,RM-1231,8/6/2014,0,0,0,0,0,0,0
31948,RM-1231,8/7/2014,0,0,0,0,0,0,0
31949,RM-1231,8/8/2014,0,0,0,0,0,0,0
31950,RM-1231,8/9/2014,0,0,0,0,0,0,0
31951,RM-1231,8/10/2014,0,0,0,0,0,0,0
31952,RM-1231,8/11/2014,0,0,0,0,0,0,0
31953,RM-1231,8/12/2014,0,0,0,0,0,0,0
31954,RM-1231,8/13/2014,0,0,0,0,0,0,0
31955,RM-1231,8/14/2014,0,0,0,0,0,0,0
31956,RM-1231,8/15/2014,0,0,0,0,0,0,0
31957,RM-1231,8/16/2014,0,0,0,0,0,0,0
31958,RM-1231,8/17/2014,0,0,0,0,0,0,0
31959,RM-1231,8/18/2014,0,0,0,0,0,0,0
31960,RM-1231,8/19/2014,0,0,0,0,0,0,0
31961,RM-1231,8/20/2014,0,0,0,0,0,0,0
31962,RM-1231,8/21/2014,0,0,0,0,0,0,0
31963,RM-1231,8/22/2014,0,0,0,0,0,0,0
31964,RM-1231,8/23/2014,0,0,0,0,0,0,0
31965,RM-1231,8/24/2014,0,0,0,0,0,0,0
31966,RM-1231,8/25/2014,0,0,0,0,0,0,0
31967,RM-1231,8/26/2014,0,0,0,0,0,0,0
31968,RM-1231,8/27/2014,0,0,0,0,0,0,0
31969,RM-1231,8/28/2014,0,0,0,0,0,0,0
31970,RM-1231,8/29/2014,0,0,0,0,0,0,0
31971,RM-1231,8/30/2014,0,0,0,0,0,0,0
31972,RM-1231,8/31/2014,0,0,0,0,0,0,0
31973,RM-1231,9/1/2014,0,0,0,0,0,0,0
31974,RM-1231,9/2/2014,0,0,0,0,0,0,0
31975,RM-1231,9/3/2014,0,0,0,0,0,0,0
31976,RM-1231,9/4/2014,0,0,0,0,0,0,0
31977,RM-1231,9/5/2014,0,0,0,0,0,0,0
31978,RM-1231,9/6/2014,0,0,0,0,0,0,0
31979,RM-1231,9/7/2014,0,0,0,0,0,0,0
31980,RM-1231,9/8/2014,0,0,0,0,0,0,0
31981,RM-1231,9/9/2014,0,0,0,0,0,0,0
31982,RM-1231,9/10/2014,0,0,0,0,0,0,0
31983,RM-1231,9/11/2014,0,0,0,0,0,0,0
31984,RM-1231,9/12/2014,0,0,0,0,0,0,0
31985,RM-1231,9/13/2014,0,0,0,0,0,0,0
31986,RM-1231,9/14/2014,0,0,0,0,0,0,0
31987,RM-1231,9/15/2014,0,0,0,0,0,0,0
31988,RM-1231,9/16/2014,0,0,0,0,0,0,0
31989,RM-1231,9/17/2014,0,0,0,0,0,0,0
31990,RM-1231,9/18/2014,0,0,0,0,0,0,0
31991,RM-1231,9/19/2014,0,0,0,0,0,0,0
31992,RM-1231,9/20/2014,0,0,0,0,0,0,0
31993,RM-1231,9/21/2014,0,0,0,0,0,0,0
31994,RM-1231,9/22/2014,0,0,0,0,0,0,0
31995,RM-1231,9/23/2014,0,0,0,0,0,0,0
31996,RM-1231,9/24/2014,0,0,0,0,0,0,0
31997,RM-1231,9/25/2014,0,0,0,0,0,0,0
31998,RM-1231,9/26/2014,0,0,0,0,0,0,0
31999,RM-1231,9/27/2014,0,0,0,0,0,0,0
32000,RM-1231,9/28/2014,0,0,0,0,0,0,0
32001,RM-1231,9/29/2014,0,0,0,0,0,0,0
32002,RM-1231,9/30/2014,0,0,0,0,0,0,0
32003,RM-1231,10/1/2014,0,0,0,0,0,0,0
32004,RM-1231,10/2/2014,0,0,0,0,0,0,0
32005,RM-1231,10/3/2014,0,0,0,0,0,0,0
32006,RM-1231,10/4/2014,0,0,0,0,0,0,0
32007,RM-1231,10/5/2014,0,0,0,0,0,0,0
32008,RM-1231,10/6/2014,0,0,0,0,0,0,0
32009,RM-1231,10/7/2014,0,0,0,0,0,0,0
32010,RM-1231,10/8/2014,0,0,0,0,0,0,0
32011,RM-1231,10/9/2014,0,0,0,0,0,0,0
32012,RM-1231,10/10/2014,0,0,0,0,0,0,0
32013,RM-1231,10/11/2014,0,0,0,0,0,0,0
32014,RM-1231,10/12/2014,0,0,0,0,0,0,0
32015,RM-1231,10/13/2014,0,0,0,0,0,0,0
32016,RM-1231,10/14/2014,0,0,0,0,0,0,0
32017,RM-1231,10/15/2014,0,0,0,0,0,0,0
32018,RM-1231,10/16/2014,0,0,0,0,0,0,0
32019,RM-1231,10/17/2014,0,0,0,0,0,0,0
32020,RM-1231,10/18/2014,0,0,0,0,0,0,0
32021,RM-1231,10/19/2014,0,0,0,0,0,0,0
32022,RM-1231,10/20/2014,0,0,0,0,0,0,0
32023,RM-1231,10/21/2014,0,0,0,0,0,0,0
32024,RM-1231,10/22/2014,0,0,0,0,0,0,0
32025,RM-1231,10/23/2014,0,0,0,0,0,0,0
32026,RM-1231,10/24/2014,0,0,0,0,0,0,0
32027,RM-1231,10/25/2014,0,0,0,0,0,0,0
32028,RM-1231,10/26/2014,0,0,0,0,0,0,0
32029,RM-1231,10/27/2014,0,0,0,0,0,0,0
32030,RM-1231,10/28/2014,0,0,0,0,0,0,0
32031,RM-1231,10/29/2014,0,0,0,0,0,0,0
32032,RM-1231,10/30/2014,0,0,0,0,0,0,0
32033,RM-1231,10/31/2014,0,0,0,0,0,0,0
32034,RM-1231,11/1/2014,0,0,0,0,0,0,0
32035,RM-1231,11/2/2014,0,0,0,0,0,0,0
32036,RM-1231,11/3/2014,0,0,0,0,0,0,0
32037,RM-1231,11/4/2014,0,0,0,0,0,0,0
32038,RM-1231,11/5/2014,0,0,0,0,0,0,0
32039,RM-1231,11/6/2014,0,0,0,0,0,0,0
32040,RM-1231,11/7/2014,0,0,0,0,0,0,0
32041,RM-1231,11/8/2014,0,0,0,0,0,0,0
32042,RM-1231,11/9/2014,0,0,0,0,0,0,0
32043,RM-1231,11/10/2014,0,0,0,0,0,0,0
32044,RM-1231,11/11/2014,0,0,0,0,0,0,0
32045,RM-1231,11/12/2014,0,0,0,0,0,0,0
32046,RM-1231,11/13/2014,0,0,0,0,0,0,0
32047,RM-1231,11/14/2014,0,0,0,0,0,0,0
32048,RM-1231,11/15/2014,0,0,0,0,0,0,0
32049,RM-1231,11/16/2014,0,0,0,0,0,0,0
32050,RM-1231,11/17/2014,0,0,0,0,0,0,0
32051,RM-1231,11/18/2014,0,0,0,0,0,0,0
32052,RM-1231,11/19/2014,0,0,0,0,0,0,0
32053,RM-1231,11/20/2014,0,0,0,0,0,0,0
32054,RM-1231,11/21/2014,0,0,0,0,0,0,0
32055,RM-1231,11/22/2014,0,0,0,0,0,0,0
32056,RM-1231,11/23/2014,0,0,0,0,0,0,0
32057,RM-1231,11/24/2014,0,0,0,0,0,0,0
32058,RM-1231,11/25/2014,0,0,0,0,0,0,0
32059,RM-1231,11/26/2014,0,0,0,0,0,0,0
32060,RM-1231,11/27/2014,0,0,0,0,0,0,0
32061,RM-1231,11/28/2014,0,0,0,0,0,0,0
32062,RM-1231,11/29/2014,0,0,0,0,0,0,0
32063,RM-1231,11/30/2014,0,0,0,0,0,0,0
32064,RM-1231,12/1/2014,0,0,0,0,0,0,0
32065,RM-1231,12/2/2014,0,0,0,0,0,0,0
32066,RM-1231,12/3/2014,0,0,0,0,0,0,0
32067,RM-1231,12/4/2014,0,0,0,0,0,0,0
32068,RM-1231,12/5/2014,0,0,0,0,0,0,0
32069,RM-1231,12/6/2014,0,0,0,0,0,0,0
32070,RM-1231,12/7/2014,0,0,0,0,0,0,0
32071,RM-1231,12/8/2014,0,0,0,0,0,0,0
32072,RM-1231,12/9/2014,0,0,0,0,0,0,0
32073,RM-1231,12/10/2014,0,0,0,0,0,0,0
32074,RM-1231,12/11/2014,0,0,0,0,0,0,0
32075,RM-1231,12/12/2014,0,0,0,0,0,0,0
32076,RM-1231,12/13/2014,0,0,0,0,0,0,0
32077,RM-1231,12/14/2014,0,0,0,0,0,0,0
32078,RM-1231,12/15/2014,0,0,0,0,0,0,0
32079,RM-1231,12/16/2014,0,0,0,0,0,0,0
32080,RM-1231,12/17/2014,0,0,0,0,0,0,0
32081,RM-1231,12/18/2014,0,0,0,0,0,0,0
32082,RM-1231,12/19/2014,0,0,0,0,0,0,0
32083,RM-1231,12/20/2014,0,0,0,0,0,0,0
32084,RM-1231,12/21/2014,0,0,0,0,0,0,0
32085,RM-1231,12/22/2014,0,0,0,0,0,0,0
32086,RM-1231,12/23/2014,0,0,0,0,0,0,0
32087,RM-1231,12/24/2014,0,0,0,0,0,0,0
32088,RM-1231,12/25/2014,0,0,0,0,0,0,0
32089,RM-1231,12/26/2014,0,0,0,0,0,0,0
32090,RM-1231,12/27/2014,0,0,0,0,0,0,0
32091,RM-1231,12/28/2014,0,0,0,0,0,0,0
32092,RM-1231,12/29/2014,0,0,0,0,0,0,0
32093,RM-1231,12/30/2014,0,0,0,0,0,0,0
32094,RM-1231,12/31/2014,0,0,0,0,0,0,0
32095,RM-1231,1/1/2015,0,0,0,0,0,0,0
32096,RM-1231,1/2/2015,0,0,0,0,0,0,0
32097,RM-1231,1/3/2015,0,0,0,0,0,0,0
32098,RM-1231,1/4/2015,0,0,0,0,0,0,0
32099,RM-1231,1/5/2015,0,0,0,0,0,0,0
32100,RM-1231,1/6/2015,0,0,0,0,0,0,0
32101,RM-1231,1/7/2015,0,0,0,0,0,0,0
32102,RM-1231,1/8/2015,0,0,0,0,0,0,0
32103,RM-1231,1/9/2015,0,0,0,0,0,0,0
32104,RM-1231,1/10/2015,0,0,0,0,0,0,0
32105,RM-1231,1/11/2015,0,0,0,0,0,0,0
32106,RM-1231,1/12/2015,0,0,0,0,0,0,0
32107,RM-1231,1/13/2015,0,0,0,0,0,0,0
32108,RM-1231,1/14/2015,0,0,0,0,0,0,0
32109,RM-1231,1/15/2015,0,0,0,0,0,0,0
32110,RM-1231,1/16/2015,0,0,0,0,0,0,0
32111,RM-1231,1/17/2015,0,0,0,0,0,0,0
32112,RM-1231,1/18/2015,0,0,0,0,0,0,0
32113,RM-1231,1/19/2015,0,0,0,0,0,0,0
32114,RM-1231,1/20/2015,0,0,0,0,0,0,0
32115,RM-1231,1/21/2015,0,0,0,0,0,0,0
32116,RM-1231,1/22/2015,0,0,0,0,0,0,0
32117,RM-1231,1/23/2015,0,0,0,0,0,0,0
32118,RM-1231,1/24/2015,0,0,0,0,0,0,0
32119,RM-1231,1/25/2015,0,0,0,0,0,0,0
32120,RM-1231,1/26/2015,0,0,0,0,0,0,0
32121,RM-1231,1/27/2015,0,0,0,0,0,0,0
32122,RM-1231,1/28/2015,0,0,0,0,0,0,0
32123,RM-1231,1/29/2015,0,0,0,0,0,0,0
32124,RM-1231,1/30/2015,0,0,0,0,0,0,0
32125,RM-1231,1/31/2015,0,0,0,0,0,0,0
32126,RM-1231,2/1/2015,0,0,0,0,0,0,0
32127,RM-1231,2/2/2015,0,0,0,0,0,0,0
32128,RM-1231,2/3/2015,0,0,0,0,0,0,0
32129,RM-1231,2/4/2015,0,0,0,0,0,0,0
32130,RM-1231,2/5/2015,0,0,0,0,0,0,0
32131,RM-1231,2/6/2015,0,0,0,0,0,0,0
32132,RM-1231,2/7/2015,0,0,0,0,0,0,0
32133,RM-1231,2/8/2015,0,0,0,0,0,0,0
32134,RM-1231,2/9/2015,0,0,0,0,0,0,0
32135,RM-1231,2/10/2015,0,0,0,0,0,0,0
32136,RM-1231,2/11/2015,0,0,0,0,0,0,0
32137,RM-1231,2/12/2015,0,0,0,0,0,0,0
32138,RM-1231,2/13/2015,0,0,0,0,0,0,0
32139,RM-1231,2/14/2015,0,0,0,0,0,0,0
32140,RM-1231,2/15/2015,0,0,0,0,0,0,0
32141,RM-1231,2/16/2015,0,0,0,0,0,0,0
32142,RM-1231,2/17/2015,0,0,0,0,0,0,0
32143,RM-1231,2/18/2015,0,0,0,0,0,0,0
32144,RM-1231,2/19/2015,0,0,0,0,0,0,0
32145,RM-1231,2/20/2015,0,0,0,0,0,0,0
32146,RM-1231,2/21/2015,0,0,0,0,0,0,0
32147,RM-1231,2/22/2015,0,0,0,0,0,0,0
32148,RM-1231,2/23/2015,0,0,0,0,0,0,0
32149,RM-1231,2/24/2015,0,0,0,0,0,0,0
32150,RM-1231,2/25/2015,0,0,0,0,0,0,0
32151,RM-1231,2/26/2015,0,0,0,0,0,0,0
32152,RM-1231,2/27/2015,0,0,0,0,0,0,0
32153,RM-1231,2/28/2015,0,0,0,0,0,0,0
32154,RM-1231,3/1/2015,0,0,0,0,0,0,0
32155,RM-1231,3/2/2015,0,0,0,0,0,0,0
32156,RM-1231,3/3/2015,0,0,0,0,0,0,0
32157,RM-1231,3/4/2015,0,0,0,0,0,0,0
32158,RM-1231,3/5/2015,0,0,0,0,0,0,0
32159,RM-1231,3/6/2015,0,0,0,0,0,0,0
32160,RM-1231,3/7/2015,0,0,0,0,0,0,0
32161,RM-1231,3/8/2015,0,0,0,0,0,0,0
32162,RM-1231,3/9/2015,0,0,0,0,0,0,0
32163,RM-1231,3/10/2015,0,0,0,0,0,0,0
32164,RM-1231,3/11/2015,0,0,0,0,0,0,0
32165,RM-1231,3/12/2015,0,0,0,0,0,0,0
32166,RM-1231,3/13/2015,0,0,0,0,0,0,0
32167,RM-1231,3/14/2015,0,0,0,0,0,0,0
32168,RM-1231,3/15/2015,0,0,0,0,0,0,0
32169,RM-1231,3/16/2015,0,0,0,0,0,0,0
32170,RM-1231,3/17/2015,0,0,0,0,0,0,0
32171,RM-1231,3/18/2015,0,0,0,0,0,0,0
32172,RM-1231,3/19/2015,0,0,0,0,0,0,0
32173,RM-1231,3/20/2015,0,0,0,0,0,0,0
32174,RM-1231,3/21/2015,0,0,0,0,0,0,0
32175,RM-1231,3/22/2015,0,0,0,0,0,0,0
32176,RM-1231,3/23/2015,0,0,0,0,0,0,0
32177,RM-1231,3/24/2015,0,0,0,0,0,0,0
32178,RM-1231,3/25/2015,0,0,0,0,0,0,0
32179,RM-1231,3/26/2015,0,0,0,0,0,0,0
32180,RM-1231,3/27/2015,0,0,0,0,0,0,0
32181,RM-1231,3/28/2015,0,0,0,0,0,0,0
32182,RM-1231,3/29/2015,0,0,0,0,0,0,0
32183,RM-1231,3/30/2015,0,0,0,0,0,0,0
32184,RM-1231,3/31/2015,0,0,0,0,0,0,0
32185,RM-1231,4/1/2015,0,0,0,0,0,0,0
32186,RM-1231,4/2/2015,0,0,0,0,0,0,0
32187,RM-1231,4/3/2015,0,0,0,0,0,0,0
32188,RM-1231,4/4/2015,0,0,0,0,0,0,0
32189,RM-1231,4/5/2015,0,0,0,0,0,0,0
32190,RM-1231,4/6/2015,0,0,0,0,0,0,0
32191,RM-1231,4/7/2015,0,0,0,0,0,0,0
32192,RM-1231,4/8/2015,0,0,0,0,0,0,0
32193,RM-1231,4/9/2015,0,0,0,0,0,0,0
32194,RM-1231,4/10/2015,0,0,0,0,0,0,0
32195,RM-1231,4/11/2015,0,0,0,0,0,0,0
32196,RM-1231,4/12/2015,0,0,0,0,0,0,0
32197,RM-1231,4/13/2015,0,0,0,0,0,0,0
32198,RM-1231,4/14/2015,0,0,0,0,0,0,0
32199,RM-1231,4/15/2015,0,0,0,0,0,0,0
32200,RM-1231,4/16/2015,0,0,0,0,0,0,0
32201,RM-1231,4/17/2015,0,0,0,0,0,0,0
32202,RM-1231,4/18/2015,0,0,0,0,0,0,0
32203,RM-1231,4/19/2015,0,0,0,0,0,0,0
32204,RM-1231,4/20/2015,0,0,0,0,0,0,0
32205,RM-1231,4/21/2015,0,0,0,0,0,0,0
32206,RM-1231,4/22/2015,0,0,0,0,0,0,0
32207,RM-1231,4/23/2015,0,0,0,0,0,0,0
32208,RM-1231,4/24/2015,0,0,0,0,0,0,0
32209,RM-1231,4/25/2015,0,0,0,0,0,0,0
32210,RM-1231,4/26/2015,0,0,0,0,0,0,0
32913,RM-1236,5/11/2015,0,0,0,0,0,0,0
32914,RM-1236,5/12/2015,0,0,0,0,0,0,0
32915,RM-1236,5/13/2015,0,0,0,0,0,0,0
32916,RM-1236,5/14/2015,0,0,0,0,0,0,0
32917,RM-1236,5/15/2015,0,0,0,0,0,0,0
32918,RM-1236,5/16/2015,0,0,0,0,0,0,0
32919,RM-1236,5/17/2015,0,0,0,0,0,0,0
32920,RM-1236,5/18/2015,0,0,0,0,0,0,0
32921,RM-1236,5/19/2015,0,0,0,0,0,0,0
32922,RM-1236,5/20/2015,0,0,0,0,0,0,0
32923,RM-1236,5/21/2015,0,0,0,0,0,0,0
32924,RM-1236,5/22/2015,0,0,0,0,0,0,0
32925,RM-1236,5/23/2015,0,0,0,0,0,0,0
32926,RM-1236,5/24/2015,0,0,0,0,0,0,0
32927,RM-1236,5/25/2015,0,0,0,0,0,0,0
32928,RM-1236,5/26/2015,0,0,0,0,0,0,0
32929,RM-1236,5/27/2015,0,0,0,0,0,0,0
32930,RM-1236,5/28/2015,0,0,0,0,0,0,0
32931,RM-1236,5/29/2015,0,0,0,0,0,0,0
32932,RM-1236,5/30/2015,0,0,0,0,0,0,0
32933,RM-1236,5/31/2015,0,0,0,0,0,0,0
32934,RM-230,7/11/2014,0,0,0,0,0,0,0
32935,RM-230,7/12/2014,0,0,0,0,0,0,0
32936,RM-230,7/13/2014,0,0,0,0,0,0,0
32937,RM-230,7/14/2014,0,0,0,0,0,0,0
32938,RM-230,7/15/2014,0,0,0,0,0,0,0
32939,RM-230,7/16/2014,0,0,0,0,0,0,0
32940,RM-230,7/17/2014,0,0,0,0,0,0,0
32941,RM-230,7/18/2014,0,0,0,0,0,0,0
32942,RM-230,7/19/2014,0,0,0,0,0,0,0
32943,RM-230,7/20/2014,0,0,0,0,0,0,0
32944,RM-230,7/21/2014,0,0,0,0,0,0,0
32945,RM-230,7/22/2014,0,0,0,0,0,0,0
32946,RM-230,7/23/2014,0,0,0,0,0,0,0
32947,RM-230,7/24/2014,0,0,0,0,0,0,0
32948,RM-230,7/25/2014,0,0,0,0,0,0,0
32949,RM-230,7/26/2014,0,0,0,0,0,0,0
32950,RM-230,7/27/2014,0,0,0,0,0,0,0
32951,RM-230,7/28/2014,0,0,0,0,0,0,0
32952,RM-230,7/29/2014,0,0,0,0,0,0,0
32953,RM-230,7/30/2014,0,0,0,0,0,0,0
32954,RM-230,7/31/2014,0,0,0,0,0,0,0
32955,RM-230,8/1/2014,0,0,0,0,0,0,0
32956,RM-230,8/2/2014,0,0,0,0,0,0,0
32957,RM-230,8/3/2014,0,0,0,0,0,0,0
32958,RM-230,8/4/2014,0,0,0,0,0,0,0
32959,RM-230,8/5/2014,0,0,0,0,0,0,0
32960,RM-230,8/6/2014,0,0,0,0,0,0,0
32961,RM-230,8/7/2014,0,0,0,0,0,0,0
32962,RM-230,8/8/2014,0,0,0,0,0,0,0
32963,RM-230,8/9/2014,0,0,0,0,0,0,0
32964,RM-230,8/10/2014,0,0,0,0,0,0,0
32965,RM-230,8/11/2014,0,0,0,0,0,0,0
32966,RM-230,8/12/2014,0,0,0,0,0,0,0
32967,RM-230,8/13/2014,0,0,0,0,0,0,0
32968,RM-230,8/14/2014,0,0,0,0,0,0,0
32969,RM-230,8/15/2014,0,0,0,0,0,0,0
32970,RM-230,8/16/2014,0,0,0,0,0,0,0
32971,RM-230,8/17/2014,0,0,0,0,0,0,0
32972,RM-230,8/18/2014,0,0,0,0,0,0,0
32973,RM-230,8/19/2014,0,0,0,0,0,0,0
32974,RM-230,8/20/2014,0,0,0,0,0,0,0
32975,RM-230,8/21/2014,0,0,0,0,0,0,0
32976,RM-230,8/22/2014,0,0,0,0,0,0,0
32977,RM-230,8/23/2014,0,0,0,0,0,0,0
32978,RM-230,8/24/2014,0,0,0,0,0,0,0
32979,RM-230,8/25/2014,0,0,0,0,0,0,0
32980,RM-230,8/26/2014,0,0,0,0,0,0,0
32981,RM-230,8/27/2014,0,0,0,0,0,0,0
32982,RM-230,8/28/2014,0,0,0,0,0,0,0
32983,RM-230,8/29/2014,0,0,0,0,0,0,0
32984,RM-230,8/30/2014,0,0,0,0,0,0,0
32985,RM-230,8/31/2014,0,0,0,0,0,0,0
32986,RM-230,9/1/2014,0,0,0,0,0,0,0
32987,RM-230,9/2/2014,0,0,0,0,0,0,0
32988,RM-230,9/3/2014,0,0,0,0,0,0,0
32989,RM-230,9/4/2014,0,0,0,0,0,0,0
32990,RM-230,9/5/2014,0,0,0,0,0,0,0
32991,RM-230,9/6/2014,0,0,0,0,0,0,0
32992,RM-230,9/7/2014,0,0,0,0,0,0,0
32993,RM-230,9/8/2014,0,0,0,0,0,0,0
32994,RM-230,9/9/2014,0,0,0,0,0,0,0
32995,RM-230,9/10/2014,0,0,0,0,0,0,0
32996,RM-230,9/11/2014,0,0,0,0,0,0,0
32997,RM-230,9/12/2014,0,0,0,0,0,0,0
32998,RM-230,9/13/2014,0,0,0,0,0,0,0
32999,RM-230,9/14/2014,0,0,0,0,0,0,0
33000,RM-230,9/15/2014,0,0,0,0,0,0,0
33001,RM-230,9/16/2014,0,0,0,0,0,0,0
33002,RM-230,9/17/2014,0,0,0,0,0,0,0
33003,RM-230,9/18/2014,0,0,0,0,0,0,0
33004,RM-230,9/19/2014,0,0,0,0,0,0,0
33005,RM-230,9/20/2014,0,0,0,0,0,0,0
33006,RM-230,9/21/2014,0,0,0,0,0,0,0
33007,RM-230,9/22/2014,0,0,0,0,0,0,0
33008,RM-230,9/23/2014,0,0,0,0,0,0,0
33009,RM-230,9/24/2014,0,0,0,0,0,0,0
33010,RM-230,9/25/2014,0,0,0,0,0,0,0
33011,RM-230,9/28/2014,0,0,0,0,0,0,0
33012,RM-230,9/29/2014,0,0,0,0,0,0,0
33013,RM-230,9/30/2014,0,0,0,0,0,0,0
33014,RM-230,10/1/2014,0,0,0,0,0,0,0
33015,RM-230,10/2/2014,0,0,0,0,0,0,0
33016,RM-230,10/3/2014,0,0,0,0,0,0,0
33017,RM-230,10/4/2014,0,0,0,0,0,0,0
33018,RM-230,10/5/2014,0,0,0,0,0,0,0
33019,RM-230,10/6/2014,0,0,0,0,0,0,0
33020,RM-230,10/7/2014,0,0,0,0,0,0,0
33021,RM-230,10/8/2014,0,0,0,0,0,0,0
33022,RM-230,10/9/2014,0,0,0,0,0,0,0
33023,RM-230,10/10/2014,0,0,0,0,0,0,0
33024,RM-230,10/11/2014,0,0,0,0,0,0,0
33025,RM-230,10/12/2014,0,0,0,0,0,0,0
33026,RM-230,10/13/2014,0,0,0,0,0,0,0
33027,RM-230,10/14/2014,0,0,0,0,0,0,0
33028,RM-230,10/15/2014,0,0,0,0,0,0,0
33029,RM-230,10/16/2014,0,0,0,0,0,0,0
33030,RM-230,10/17/2014,0,0,0,0,0,0,0
33031,RM-230,10/18/2014,0,0,0,0,0,0,0
33032,RM-230,10/19/2014,0,0,0,0,0,0,0
33033,RM-230,10/20/2014,0,0,0,0,0,0,0
33034,RM-230,10/21/2014,0,0,0,0,0,0,0
33035,RM-230,10/22/2014,0,0,0,0,0,0,0
33036,RM-230,10/23/2014,0,0,0,0,0,0,0
33037,RM-230,10/24/2014,0,0,0,0,0,0,0
33038,RM-230,10/25/2014,0,0,0,0,0,0,0
33039,RM-230,10/26/2014,0,0,0,0,0,0,0
33040,RM-230,10/27/2014,0,0,0,0,0,0,0
33041,RM-230,10/28/2014,0,0,0,0,0,0,0
33042,RM-230,10/29/2014,0,0,0,0,0,0,0
33043,RM-230,10/30/2014,0,0,0,0,0,0,0
33044,RM-230,10/31/2014,0,0,0,0,0,0,0
33045,RM-230,11/1/2014,0,0,0,0,0,0,0
33046,RM-230,11/2/2014,0,0,0,0,0,0,0
33047,RM-230,11/3/2014,0,0,0,0,0,0,0
33048,RM-230,11/4/2014,0,0,0,0,0,0,0
33049,RM-230,11/5/2014,0,0,0,0,0,0,0
33050,RM-230,11/6/2014,0,0,0,0,0,0,0
33051,RM-230,11/7/2014,0,0,0,0,0,0,0
33052,RM-230,11/8/2014,0,0,0,0,0,0,0
33053,RM-230,11/9/2014,0,0,0,0,0,0,0
33054,RM-230,11/10/2014,0,0,0,0,0,0,0
33055,RM-230,11/11/2014,0,0,0,0,0,0,0
33056,RM-230,11/12/2014,0,0,0,0,0,0,0
33057,RM-230,11/13/2014,0,0,0,0,0,0,0
33058,RM-230,11/14/2014,0,0,0,0,0,0,0
33059,RM-230,11/15/2014,0,0,0,0,0,0,0
33060,RM-230,11/16/2014,0,0,0,0,0,0,0
33061,RM-230,11/17/2014,0,0,0,0,0,0,0
33062,RM-230,11/18/2014,0,0,0,0,0,0,0
33063,RM-230,11/19/2014,0,0,0,0,0,0,0
33064,RM-230,11/20/2014,0,0,0,0,0,0,0
33065,RM-230,11/21/2014,0,0,0,0,0,0,0
33066,RM-230,11/22/2014,0,0,0,0,0,0,0
33067,RM-230,11/23/2014,0,0,0,0,0,0,0
33068,RM-230,11/24/2014,0,0,0,0,0,0,0
33069,RM-230,11/25/2014,0,0,0,0,0,0,0
33070,RM-230,11/26/2014,0,0,0,0,0,0,0
33071,RM-230,11/27/2014,0,0,0,0,0,0,0
33072,RM-230,11/28/2014,0,0,0,0,0,0,0
33073,RM-230,11/29/2014,0,0,0,0,0,0,0
33074,RM-230,11/30/2014,0,0,0,0,0,0,0
33075,RM-230,12/1/2014,0,0,0,0,0,0,0
33076,RM-230,12/2/2014,0,0,0,0,0,0,0
33077,RM-230,12/3/2014,0,0,0,0,0,0,0
33078,RM-230,12/4/2014,0,0,0,0,0,0,0
33079,RM-230,12/5/2014,0,0,0,0,0,0,0
33080,RM-230,12/6/2014,0,0,0,0,0,0,0
33081,RM-230,12/7/2014,0,0,0,0,0,0,0
33082,RM-230,12/8/2014,0,0,0,0,0,0,0
33083,RM-230,12/9/2014,0,0,0,0,0,0,0
33084,RM-230,12/10/2014,0,0,0,0,0,0,0
33085,RM-230,12/11/2014,0,0,0,0,0,0,0
33086,RM-230,12/12/2014,0,0,0,0,0,0,0
33087,RM-230,12/13/2014,0,0,0,0,0,0,0
33088,RM-230,12/14/2014,0,0,0,0,0,0,0
33089,RM-230,12/15/2014,0,0,0,0,0,0,0
33090,RM-230,12/16/2014,0,0,0,0,0,0,0
33091,RM-230,12/17/2014,0,0,0,0,0,0,0
33092,RM-230,12/18/2014,0,0,0,0,0,0,0
33093,RM-230,12/19/2014,0,0,0,0,0,0,0
33094,RM-230,12/20/2014,0,0,0,0,0,0,0
33095,RM-230,12/21/2014,0,0,0,0,0,0,0
33096,RM-230,12/22/2014,0,0,0,0,0,0,0
33097,RM-230,12/23/2014,0,0,0,0,0,0,0
33098,RM-230,12/24/2014,0,0,0,0,0,0,0
33099,RM-230,12/25/2014,0,0,0,0,0,0,0
33100,RM-230,12/26/2014,0,0,0,0,0,0,0
33101,RM-230,12/27/2014,0,0,0,0,0,0,0
33102,RM-230,12/28/2014,0,0,0,0,0,0,0
33103,RM-230,12/29/2014,0,0,0,0,0,0,0
33104,RM-230,12/30/2014,0,0,0,0,0,0,0
33105,RM-230,12/31/2014,0,0,0,0,0,0,0
33106,RM-230,1/1/2015,0,0,0,0,0,0,0
33107,RM-230,1/2/2015,0,0,0,0,0,0,0
33108,RM-230,1/3/2015,0,0,0,0,0,0,0
33109,RM-230,1/4/2015,0,0,0,0,0,0,0
33110,RM-230,1/5/2015,0,0,0,0,0,0,0
33111,RM-230,1/6/2015,0,0,0,0,0,0,0
33112,RM-230,1/7/2015,0,0,0,0,0,0,0
33113,RM-230,1/8/2015,0,0,0,0,0,0,0
33114,RM-230,1/9/2015,0,0,0,0,0,0,0
33115,RM-230,1/10/2015,0,0,0,0,0,0,0
33116,RM-230,1/11/2015,0,0,0,0,0,0,0
33117,RM-230,1/12/2015,0,0,0,0,0,0,0
33118,RM-230,1/13/2015,0,0,0,0,0,0,0
33119,RM-230,1/14/2015,0,0,0,0,0,0,0
33120,RM-230,1/15/2015,0,0,0,0,0,0,0
33121,RM-230,1/16/2015,0,0,0,0,0,0,0
33122,RM-230,1/17/2015,0,0,0,0,0,0,0
33123,RM-230,1/18/2015,0,0,0,0,0,0,0
33124,RM-230,1/19/2015,0,0,0,0,0,0,0
33125,RM-230,1/20/2015,0,0,0,0,0,0,0
33126,RM-230,1/21/2015,0,0,0,0,0,0,0
33127,RM-230,1/22/2015,0,0,0,0,0,0,0
33128,RM-230,1/23/2015,0,0,0,0,0,0,0
33129,RM-230,1/24/2015,0,0,0,0,0,0,0
33130,RM-230,1/25/2015,0,0,0,0,0,0,0
33131,RM-230,1/26/2015,0,0,0,0,0,0,0
33132,RM-230,1/27/2015,0,0,0,0,0,0,0
33133,RM-230,1/28/2015,0,0,0,0,0,0,0
33134,RM-230,1/29/2015,0,0,0,0,0,0,0
33135,RM-230,1/30/2015,0,0,0,0,0,0,0
33136,RM-230,1/31/2015,0,0,0,0,0,0,0
33137,RM-230,2/1/2015,0,0,0,0,0,0,0
33138,RM-230,2/2/2015,0,0,0,0,0,0,0
33139,RM-230,2/3/2015,0,0,0,0,0,0,0
33140,RM-230,2/4/2015,0,0,0,0,0,0,0
33141,RM-230,2/5/2015,0,0,0,0,0,0,0
33142,RM-230,2/6/2015,0,0,0,0,0,0,0
33143,RM-230,2/7/2015,0,0,0,0,0,0,0
33144,RM-230,2/8/2015,0,0,0,0,0,0,0
33145,RM-230,2/9/2015,0,0,0,0,0,0,0
33146,RM-230,2/10/2015,0,0,0,0,0,0,0
33147,RM-230,2/11/2015,0,0,0,0,0,0,0
33148,RM-230,2/12/2015,0,0,0,0,0,0,0
33149,RM-230,2/13/2015,0,0,0,0,0,0,0
33150,RM-230,2/14/2015,0,0,0,0,0,0,0
33151,RM-230,2/15/2015,0,0,0,0,0,0,0
33152,RM-230,2/16/2015,0,0,0,0,0,0,0
33153,RM-230,2/17/2015,0,0,0,0,0,0,0
33154,RM-230,2/18/2015,0,0,0,0,0,0,0
33155,RM-230,2/19/2015,0,0,0,0,0,0,0
33156,RM-230,2/20/2015,0,0,0,0,0,0,0
33157,RM-230,2/21/2015,0,0,0,0,0,0,0
33158,RM-230,2/22/2015,0,0,0,0,0,0,0
33159,RM-230,2/23/2015,0,0,0,0,0,0,0
33160,RM-230,2/24/2015,0,0,0,0,0,0,0
33161,RM-230,2/25/2015,0,0,0,0,0,0,0
33162,RM-230,2/26/2015,0,0,0,0,0,0,0
33163,RM-230,2/27/2015,0,0,0,0,0,0,0
33164,RM-230,2/28/2015,0,0,0,0,0,0,0
33165,RM-230,3/1/2015,0,0,0,0,0,0,0
33166,RM-230,3/2/2015,0,0,0,0,0,0,0
33167,RM-230,3/3/2015,0,0,0,0,0,0,0
33168,RM-230,3/4/2015,0,0,0,0,0,0,0
33169,RM-230,3/5/2015,0,0,0,0,0,0,0
33170,RM-230,3/6/2015,0,0,0,0,0,0,0
33171,RM-230,3/7/2015,0,0,0,0,0,0,0
33172,RM-230,3/8/2015,0,0,0,0,0,0,0
33173,RM-230,3/9/2015,0,0,0,0,0,0,0
33174,RM-230,3/10/2015,0,0,0,0,0,0,0
33175,RM-230,3/11/2015,0,0,0,0,0,0,0
33176,RM-230,3/12/2015,0,0,0,0,0,0,0
33177,RM-230,3/13/2015,0,0,0,0,0,0,0
33178,RM-230,3/14/2015,0,0,0,0,0,0,0
33179,RM-230,3/15/2015,0,0,0,0,0,0,0
33180,RM-230,3/16/2015,0,0,0,0,0,0,0
33181,RM-230,3/17/2015,0,0,0,0,0,0,0
33182,RM-230,3/18/2015,0,0,0,0,0,0,0
33183,RM-230,3/19/2015,0,0,0,0,0,0,0
33184,RM-230,3/20/2015,0,0,0,0,0,0,0
33185,RM-230,3/21/2015,0,0,0,0,0,0,0
33186,RM-230,3/22/2015,0,0,0,0,0,0,0
33187,RM-230,3/23/2015,0,0,0,0,0,0,0
33188,RM-230,3/24/2015,0,0,0,0,0,0,0
33189,RM-230,3/25/2015,0,0,0,0,0,0,0
33190,RM-230,3/26/2015,0,0,0,0,0,0,0
33191,RM-230,3/27/2015,0,0,0,0,0,0,0
33192,RM-230,3/28/2015,0,0,0,0,0,0,0
33193,RM-230,3/29/2015,0,0,0,0,0,0,0
33194,RM-230,3/30/2015,0,0,0,0,0,0,0
33195,RM-230,3/31/2015,0,0,0,0,0,0,0
33196,RM-230,4/1/2015,0,0,0,0,0,0,0
33197,RM-230,4/2/2015,0,0,0,0,0,0,0
33198,RM-230,4/3/2015,0,0,0,0,0,0,0
33199,RM-230,4/4/2015,0,0,0,0,0,0,0
33200,RM-230,4/5/2015,0,0,0,0,0,0,0
33201,RM-230,4/6/2015,0,0,0,0,0,0,0
33202,RM-230,4/7/2015,0,0,0,0,0,0,0
33203,RM-230,4/8/2015,0,0,0,0,0,0,0
33204,RM-3xxx,8/19/2014,0,0,0,0,0,0,0
33205,RM-3xxx,8/20/2014,0,0,0,0,0,0,0
33206,RM-3xxx,8/21/2014,0,0,0,0,0,0,0
33207,RM-3xxx,8/22/2014,0,0,0,0,0,0,0
33208,RM-3xxx,8/23/2014,0,0,0,0,0,0,0
33209,RM-3xxx,8/24/2014,0,0,0,0,0,0,0
33210,RM-3xxx,8/25/2014,0,0,0,0,0,0,0
33211,RM-3xxx,8/26/2014,0,0,0,0,0,0,0
33212,RM-3xxx,8/27/2014,0,0,0,0,0,0,0
33213,RM-3xxx,8/28/2014,0,0,0,0,0,0,0
33214,RM-3xxx,8/29/2014,0,0,0,0,0,0,0
33215,RM-3xxx,8/30/2014,0,0,0,0,0,0,0
33216,RM-3xxx,8/31/2014,0,0,0,0,0,0,0
33217,RM-3xxx,9/1/2014,0,0,0,0,0,0,0
33218,RM-3xxx,9/2/2014,0,0,0,0,0,0,0
33219,RM-3xxx,9/3/2014,0,0,0,0,0,0,0
33220,RM-3xxx,9/4/2014,0,0,0,0,0,0,0
33221,RM-3xxx,9/5/2014,0,0,0,0,0,0,0
33222,RM-3xxx,9/6/2014,0,0,0,0,0,0,0
33223,RM-3xxx,9/7/2014,0,0,0,0,0,0,0
33224,RM-3xxx,9/8/2014,0,0,0,0,0,0,0
33225,RM-3xxx,9/9/2014,0,0,0,0,0,0,0
33226,RM-3xxx,9/10/2014,0,0,0,0,0,0,0
33227,RM-3xxx,9/11/2014,0,0,0,0,0,0,0
33228,RM-3xxx,9/12/2014,0,0,0,0,0,0,0
33229,RM-3xxx,9/13/2014,0,0,0,0,0,0,0
33230,RM-3xxx,9/14/2014,0,0,0,0,0,0,0
33231,RM-3xxx,9/15/2014,0,0,0,0,0,0,0
33232,RM-3xxx,9/16/2014,0,0,0,0,0,0,0
33233,RM-3xxx,9/17/2014,0,0,0,0,0,0,0
33234,RM-3xxx,9/18/2014,0,0,0,0,0,0,0
33235,RM-3xxx,9/19/2014,0,0,0,0,0,0,0
33236,RM-3xxx,9/20/2014,0,0,0,0,0,0,0
33237,RM-3xxx,9/21/2014,0,0,0,0,0,0,0
33238,RM-3xxx,9/22/2014,0,0,0,0,0,0,0
33239,RM-3xxx,9/23/2014,0,0,0,0,0,0,0
33240,RM-3xxx,9/24/2014,0,0,0,0,0,0,0
33241,RM-3xxx,9/25/2014,0,0,0,0,0,0,0
33242,RM-3xxx,9/28/2014,0,0,0,0,0,0,0
33243,RM-3xxx,9/29/2014,0,0,0,0,0,0,0
33244,RM-3xxx,9/30/2014,0,0,0,0,0,0,0
33245,RM-3xxx,10/1/2014,0,0,0,0,0,0,0
33246,RM-3xxx,10/2/2014,0,0,0,0,0,0,0
33247,RM-3xxx,10/3/2014,0,0,0,0,0,0,0
33248,RM-3xxx,10/4/2014,0,0,0,0,0,0,0
33249,RM-3xxx,10/5/2014,0,0,0,0,0,0,0
33250,RM-3xxx,10/6/2014,0,0,0,0,0,0,0
33251,RM-3xxx,10/7/2014,0,0,0,0,0,0,0
33252,RM-3xxx,10/8/2014,0,0,0,0,0,0,0
33253,RM-3xxx,10/9/2014,0,0,0,0,0,0,0
33254,RM-3xxx,10/10/2014,0,0,0,0,0,0,0
33255,RM-3xxx,10/11/2014,0,0,0,0,0,0,0
33256,RM-3xxx,10/12/2014,0,0,0,0,0,0,0
33257,RM-3xxx,10/13/2014,0,0,0,0,0,0,0
33258,RM-3xxx,10/14/2014,0,0,0,0,0,0,0
33259,RM-3xxx,10/15/2014,0,0,0,0,0,0,0
33260,RM-3xxx,10/16/2014,0,0,0,0,0,0,0
33261,RM-3xxx,10/17/2014,0,0,0,0,0,0,0
33262,RM-3xxx,10/18/2014,0,0,0,0,0,0,0
33263,RM-3xxx,10/19/2014,0,0,0,0,0,0,0
33264,RM-3xxx,10/20/2014,0,0,0,0,0,0,0
33265,RM-3xxx,10/21/2014,0,0,0,0,0,0,0
33266,RM-3xxx,10/22/2014,0,0,0,0,0,0,0
33267,RM-3xxx,10/23/2014,0,0,0,0,0,0,0
33268,RM-3xxx,10/24/2014,0,0,0,0,0,0,0
33269,RM-3xxx,10/25/2014,0,0,0,0,0,0,0
33270,RM-3xxx,10/26/2014,0,0,0,0,0,0,0
33271,RM-3xxx,10/27/2014,0,0,0,0,0,0,0
33272,RM-3xxx,10/28/2014,0,0,0,0,0,0,0
33273,RM-3xxx,10/29/2014,0,0,0,0,0,0,0
33274,RM-3xxx,10/30/2014,0,0,0,0,0,0,0
33275,RM-3xxx,10/31/2014,0,0,0,0,0,0,0
33276,RM-3xxx,11/1/2014,0,0,0,0,0,0,0
33277,RM-3xxx,11/2/2014,0,0,0,0,0,0,0
33278,RM-3xxx,11/3/2014,0,0,0,0,0,0,0
33279,RM-3xxx,11/4/2014,0,0,0,0,0,0,0
33280,RM-3xxx,11/5/2014,0,0,0,0,0,0,0
33281,RM-3xxx,11/6/2014,0,0,0,0,0,0,0
33282,RM-3xxx,11/7/2014,0,0,0,0,0,0,0
33283,RM-3xxx,11/8/2014,0,0,0,0,0,0,0
33284,RM-3xxx,11/9/2014,0,0,0,0,0,0,0
33285,RM-3xxx,11/10/2014,0,0,0,0,0,0,0
33286,RM-3xxx,11/11/2014,0,0,0,0,0,0,0
33287,RM-3xxx,11/12/2014,0,0,0,0,0,0,0
33288,RM-3xxx,11/13/2014,0,0,0,0,0,0,0
33289,RM-3xxx,11/14/2014,0,0,0,0,0,0,0
33290,RM-3xxx,11/15/2014,0,0,0,0,0,0,0
33291,RM-3xxx,11/16/2014,0,0,0,0,0,0,0
33292,RM-3xxx,11/17/2014,0,0,0,0,0,0,0
33293,RM-3xxx,11/18/2014,0,0,0,0,0,0,0
33294,RM-3xxx,11/19/2014,0,0,0,0,0,0,0
33295,RM-3xxx,11/20/2014,0,0,0,0,0,0,0
33296,RM-3xxx,11/21/2014,0,0,0,0,0,0,0
33297,RM-3xxx,11/22/2014,0,0,0,0,0,0,0
33298,RM-3xxx,11/23/2014,0,0,0,0,0,0,0
33299,RM-3xxx,11/24/2014,0,0,0,0,0,0,0
33300,RM-3xxx,11/25/2014,0,0,0,0,0,0,0
33301,RM-3xxx,11/26/2014,0,0,0,0,0,0,0
33302,RM-3xxx,11/27/2014,0,0,0,0,0,0,0
33303,RM-3xxx,11/28/2014,0,0,0,0,0,0,0
33304,RM-3xxx,11/29/2014,0,0,0,0,0,0,0
33305,RM-3xxx,11/30/2014,0,0,0,0,0,0,0
33306,RM-3xxx,12/1/2014,0,0,0,0,0,0,0
33307,RM-3xxx,12/2/2014,0,0,0,0,0,0,0
33308,RM-3xxx,12/3/2014,0,0,0,0,0,0,0
33309,RM-3xxx,12/4/2014,0,0,0,0,0,0,0
33310,RM-3xxx,12/5/2014,0,0,0,0,0,0,0
33311,RM-3xxx,12/6/2014,0,0,0,0,0,0,0
33312,RM-3xxx,12/7/2014,0,0,0,0,0,0,0
33313,RM-3xxx,12/8/2014,0,0,0,0,0,0,0
33314,RM-3xxx,12/9/2014,0,0,0,0,0,0,0
33315,RM-3xxx,12/10/2014,0,0,0,0,0,0,0
33316,RM-3xxx,12/11/2014,0,0,0,0,0,0,0
33317,RM-3xxx,12/12/2014,0,0,0,0,0,0,0
33318,RM-3xxx,12/13/2014,0,0,0,0,0,0,0
33319,RM-3xxx,12/14/2014,0,0,0,0,0,0,0
33320,RM-3xxx,12/15/2014,0,0,0,0,0,0,0
33321,RM-3xxx,12/16/2014,0,0,0,0,0,0,0
33322,RM-3xxx,12/17/2014,0,0,0,0,0,0,0
33323,RM-3xxx,12/18/2014,0,0,0,0,0,0,0
33324,RM-3xxx,12/19/2014,0,0,0,0,0,0,0
33325,RM-3xxx,12/20/2014,0,0,0,0,0,0,0
33326,RM-3xxx,12/21/2014,0,0,0,0,0,0,0
33327,RM-3xxx,12/22/2014,0,0,0,0,0,0,0
33328,RM-3xxx,12/23/2014,0,0,0,0,0,0,0
33329,RM-3xxx,12/24/2014,0,0,0,0,0,0,0
33330,RM-3xxx,12/25/2014,0,0,0,0,0,0,0
33331,RM-3xxx,12/26/2014,0,0,0,0,0,0,0
33332,RM-3xxx,12/27/2014,0,0,0,0,0,0,0
33333,RM-3xxx,12/28/2014,0,0,0,0,0,0,0
33334,RM-3xxx,12/29/2014,0,0,0,0,0,0,0
33335,RM-3xxx,12/30/2014,0,0,0,0,0,0,0
33336,RM-3xxx,12/31/2014,0,0,0,0,0,0,0
33337,RM-3xxx,1/1/2015,0,0,0,0,0,0,0
33338,RM-3xxx,1/2/2015,0,0,0,0,0,0,0
33339,RM-3xxx,1/3/2015,0,0,0,0,0,0,0
33340,RM-3xxx,1/4/2015,0,0,0,0,0,0,0
33341,RM-3xxx,1/5/2015,0,0,0,0,0,0,0
33342,RM-3xxx,1/6/2015,0,0,0,0,0,0,0
33343,RM-3xxx,1/7/2015,0,0,0,0,0,0,0
33344,RM-3xxx,1/8/2015,0,0,0,0,0,0,0
33345,RM-3xxx,1/9/2015,0,0,0,0,0,0,0
33346,RM-3xxx,1/10/2015,0,0,0,0,0,0,0
33347,RM-3xxx,1/11/2015,0,0,0,0,0,0,0
33348,RM-3xxx,1/12/2015,0,0,0,0,0,0,0
33349,RM-3xxx,1/13/2015,0,0,0,0,0,0,0
33350,RM-3xxx,1/14/2015,0,0,0,0,0,0,0
33351,RM-3xxx,1/15/2015,0,0,0,0,0,0,0
33352,RM-3xxx,1/16/2015,0,0,0,0,0,0,0
33353,RM-3xxx,1/17/2015,0,0,0,0,0,0,0
33354,RM-3xxx,1/18/2015,0,0,0,0,0,0,0
33355,RM-3xxx,1/19/2015,0,0,0,0,0,0,0
33356,RM-3xxx,1/20/2015,0,0,0,0,0,0,0
33357,RM-3xxx,1/21/2015,0,0,0,0,0,0,0
33358,RM-3xxx,1/22/2015,0,0,0,0,0,0,0
33359,RM-3xxx,1/23/2015,0,0,0,0,0,0,0
33360,RM-3xxx,1/24/2015,0,0,0,0,0,0,0
33361,RM-3xxx,1/25/2015,0,0,0,0,0,0,0
33362,RM-3xxx,1/26/2015,0,0,0,0,0,0,0
33363,RM-3xxx,1/27/2015,0,0,0,0,0,0,0
33364,RM-3xxx,1/28/2015,0,0,0,0,0,0,0
33365,RM-3xxx,1/29/2015,0,0,0,0,0,0,0
33366,RM-3xxx,1/30/2015,0,0,0,0,0,0,0
33367,RM-3xxx,1/31/2015,0,0,0,0,0,0,0
33368,RM-3xxx,2/1/2015,0,0,0,0,0,0,0
33369,RM-3xxx,2/2/2015,0,0,0,0,0,0,0
33370,RM-3xxx,2/3/2015,0,0,0,0,0,0,0
33371,RM-3xxx,2/4/2015,0,0,0,0,0,0,0
33372,RM-3xxx,2/5/2015,0,0,0,0,0,0,0
33373,RM-3xxx,2/6/2015,0,0,0,0,0,0,0
33374,RM-3xxx,2/7/2015,0,0,0,0,0,0,0
33375,RM-3xxx,2/8/2015,0,0,0,0,0,0,0
33376,RM-3xxx,2/9/2015,0,0,0,0,0,0,0
33377,RM-3xxx,2/10/2015,0,0,0,0,0,0,0
33378,RM-3xxx,2/11/2015,0,0,0,0,0,0,0
33379,RM-3xxx,2/12/2015,0,0,0,0,0,0,0
33380,RM-3xxx,2/13/2015,0,0,0,0,0,0,0
33381,RM-3xxx,2/14/2015,0,0,0,0,0,0,0
33382,RM-3xxx,2/15/2015,0,0,0,0,0,0,0
33383,RM-3xxx,2/16/2015,0,0,0,0,0,0,0
33384,RM-3xxx,2/17/2015,0,0,0,0,0,0,0
33385,RM-3xxx,2/18/2015,0,0,0,0,0,0,0
33386,RM-3xxx,2/19/2015,0,0,0,0,0,0,0
33387,RM-3xxx,2/20/2015,0,0,0,0,0,0,0
33388,RM-3xxx,2/21/2015,0,0,0,0,0,0,0
33389,RM-3xxx,2/22/2015,0,0,0,0,0,0,0
33390,RM-3xxx,2/23/2015,0,0,0,0,0,0,0
33391,RM-3xxx,2/24/2015,0,0,0,0,0,0,0
33392,RM-3xxx,2/25/2015,0,0,0,0,0,0,0
33393,RM-3xxx,2/26/2015,0,0,0,0,0,0,0
33394,RM-3xxx,2/27/2015,0,0,0,0,0,0,0
33395,RM-3xxx,2/28/2015,0,0,0,0,0,0,0
33396,RM-3xxx,3/1/2015,0,0,0,0,0,0,0
33397,RM-3xxx,3/2/2015,0,0,0,0,0,0,0
33398,RM-3xxx,3/3/2015,0,0,0,0,0,0,0
33399,RM-3xxx,3/4/2015,0,0,0,0,0,0,0
33400,RM-3xxx,3/5/2015,0,0,0,0,0,0,0
33401,RM-3xxx,3/6/2015,0,0,0,0,0,0,0
33402,RM-3xxx,3/7/2015,0,0,0,0,0,0,0
33403,RM-3xxx,3/8/2015,0,0,0,0,0,0,0
33404,RM-3xxx,3/9/2015,0,0,0,0,0,0,0
33405,RM-3xxx,3/10/2015,0,0,0,0,0,0,0
33406,RM-3xxx,3/11/2015,0,0,0,0,0,0,0
33407,RM-3xxx,3/12/2015,0,0,0,0,0,0,0
33408,RM-3xxx,3/13/2015,0,0,0,0,0,0,0
33409,RM-3xxx,3/14/2015,0,0,0,0,0,0,0
33410,RM-3xxx,3/15/2015,0,0,0,0,0,0,0
33411,RM-3xxx,3/16/2015,0,0,0,0,0,0,0
33412,RM-3xxx,3/17/2015,0,0,0,0,0,0,0
33413,RM-3xxx,3/18/2015,0,0,0,0,0,0,0
33414,RM-3xxx,3/19/2015,0,0,0,0,0,0,0
33415,RM-3xxx,3/20/2015,0,0,0,0,0,0,0
33416,RM-3xxx,3/21/2015,0,0,0,0,0,0,0
33417,RM-3xxx,3/22/2015,0,0,0,0,0,0,0
33418,RM-3xxx,3/23/2015,0,0,0,0,0,0,0
33419,RM-3xxx,3/24/2015,0,0,0,0,0,0,0
33420,RM-3xxx,3/25/2015,0,0,0,0,0,0,0
33421,RM-3xxx,3/26/2015,0,0,0,0,0,0,0
33422,RM-3xxx,3/27/2015,0,0,0,0,0,0,0
33423,RM-3xxx,3/28/2015,0,0,0,0,0,0,0
33424,RM-3xxx,3/29/2015,0,0,0,0,0,0,0
33425,RM-3xxx,3/30/2015,0,0,0,0,0,0,0
33426,RM-3xxx,3/31/2015,0,0,0,0,0,0,0
33427,RM-3xxx,4/1/2015,0,0,0,0,0,0,0
33428,RM-3xxx,4/2/2015,0,0,0,0,0,0,0
33429,RM-3xxx,4/3/2015,0,0,0,0,0,0,0
33430,RM-3xxx,4/4/2015,0,0,0,0,0,0,0
33431,RM-3xxx,4/5/2015,0,0,0,0,0,0,0
33432,RM-3xxx,4/6/2015,0,0,0,0,0,0,0
33433,RM-3xxx,4/7/2015,0,0,0,0,0,0,0
33434,RM-3xxx,4/8/2015,0,0,0,0,0,0,0
33435,RM-3xxx,4/9/2015,0,0,0,0,0,0,0
33436,RM-3xxx,4/10/2015,0,0,0,0,0,0,0
33437,RM-3xxx,4/11/2015,0,0,0,0,0,0,0
33438,RM-3xxx,4/12/2015,0,0,0,0,0,0,0
33439,RM-3xxx,4/13/2015,0,0,0,0,0,0,0
33440,RM-3xxx,4/14/2015,0,0,0,0,0,0,0
33441,RM-3xxx,4/15/2015,0,0,0,0,0,0,0
33442,RM-3xxx,4/16/2015,0,0,0,0,0,0,0
33443,RM-3xxx,4/17/2015,0,0,0,0,0,0,0
33444,RM-3xxx,4/18/2015,0,0,0,0,0,0,0
33445,RM-3xxx,4/19/2015,0,0,0,0,0,0,0
33446,RM-3xxx,4/20/2015,0,0,0,0,0,0,0
33447,RM-3xxx,4/21/2015,0,0,0,0,0,0,0
33448,RM-3xxx,4/22/2015,0,0,0,0,0,0,0
33449,RM-3xxx,4/23/2015,0,0,0,0,0,0,0
33450,RM-3xxx,4/24/2015,0,0,0,0,0,0,0
33451,RM-3xxx,4/25/2015,0,0,0,0,0,0,0
33452,RM-3xxx,4/26/2015,0,0,0,0,0,0,0
33453,RM-3xxx,4/27/2015,0,0,0,0,0,0,0
33454,RM-3xxx,4/28/2015,0,0,0,0,0,0,0
33455,RM-3xxx,4/29/2015,0,0,0,0,0,0,0
33456,RM-3xxx,4/30/2015,0,0,0,0,0,0,0
33457,RM-3xxx,5/1/2015,0,0,0,0,0,0,0
33458,RM-3xxx,5/2/2015,0,0,0,0,0,0,0
33459,RM-3xxx,5/3/2015,0,0,0,0,0,0,0
33460,RM-3xxx,5/4/2015,0,0,0,0,0,0,0
33461,RM-3xxx,5/5/2015,0,0,0,0,0,0,0
33462,RM-3xxx,5/6/2015,0,0,0,0,0,0,0
33463,RM-3xxx,5/7/2015,0,0,0,0,0,0,0
33464,RM-3xxx,5/8/2015,0,0,0,0,0,0,0
33465,RM-3xxx,5/9/2015,0,0,0,0,0,0,0
33466,RM-3xxx,5/10/2015,0,0,0,0,0,0,0
33467,RM-3xxx,5/11/2015,0,0,0,0,0,0,0
33468,RM-3xxx,5/12/2015,0,0,0,0,0,0,0
33469,RM-3xxx,5/13/2015,0,0,0,0,0,0,0
33470,RM-3xxx,5/14/2015,0,0,0,0,0,0,0
33471,RM-3xxx,5/15/2015,0,0,0,0,0,0,0
33472,RM-3xxx,5/16/2015,0,0,0,0,0,0,0
33473,RM-3xxx,5/17/2015,0,0,0,0,0,0,0
33474,RM-3xxx,5/18/2015,0,0,0,0,0,0,0
33475,RM-3xxx,5/19/2015,0,0,0,0,0,0,0
33476,RM-3xxx,5/20/2015,0,0,0,0,0,0,0
33477,RM-3xxx,5/21/2015,0,0,0,0,0,0,0
33478,RM-3xxx,5/22/2015,0,0,0,0,0,0,0
33479,RM-3xxx,5/23/2015,0,0,0,0,0,0,0
33480,RM-3xxx,5/24/2015,0,0,0,0,0,0,0
33481,RM-3xxx,5/25/2015,0,0,0,0,0,0,0
33482,RM-3xxx,5/26/2015,0,0,0,0,0,0,0
33483,RM-3xxx,5/27/2015,0,0,0,0,0,0,0
33484,RM-3xxx,5/28/2015,0,0,0,0,0,0,0
33485,RM-3xxx,5/29/2015,0,0,0,0,0,0,0
33486,RM-3xxx,5/30/2015,0,0,0,0,0,0,0
33487,RM-3xxx,5/31/2015,0,0,0,0,0,0,0
33725,RM-B102C,9/13/2013,0,0,0,0,0,0,0
33726,RM-B102C,9/14/2013,0,0,0,0,0,0,0
33727,RM-B102C,9/15/2013,0,0,0,0,0,0,0
33728,RM-B102C,9/16/2013,0,0,0,0,0,0,0
33729,RM-B102C,9/17/2013,0,0,0,0,0,0,0
33730,RM-B102C,9/18/2013,0,0,0,0,0,0,0
33731,RM-B102C,9/19/2013,0,0,0,0,0,0,0
33732,RM-B102C,9/20/2013,0,0,0,0,0,0,0
33733,RM-B102C,9/21/2013,0,0,0,0,0,0,0
33734,RM-B102C,9/22/2013,0,0,0,0,0,0,0
33735,RM-B102C,9/23/2013,0,0,0,0,0,0,0
33736,RM-B102C,9/24/2013,0,0,0,0,0,0,0
33737,RM-B102C,9/25/2013,0,0,0,0,0,0,0
33738,RM-B102C,9/26/2013,0,0,0,0,0,0,0
33739,RM-B102C,9/27/2013,0,0,0,0,0,0,0
33740,RM-B102C,9/28/2013,0,0,0,0,0,0,0
33741,RM-B102C,9/29/2013,0,0,0,0,0,0,0
33742,RM-B102C,9/30/2013,0,0,0,0,0,0,0
33743,RM-B102C,10/1/2013,0,0,0,0,0,0,0
33744,RM-B102C,10/2/2013,0,0,0,0,0,0,0
33745,RM-B102C,10/3/2013,0,0,0,0,0,0,0
33746,RM-B102C,10/4/2013,0,0,0,0,0,0,0
33747,RM-B102C,10/5/2013,0,0,0,0,0,0,0
33748,RM-B102C,10/6/2013,0,0,0,0,0,0,0
33749,RM-B102C,10/7/2013,0,0,0,0,0,0,0
33750,RM-B102C,10/8/2013,0,0,0,0,0,0,0
33751,RM-B102C,10/9/2013,0,0,0,0,0,0,0
33752,RM-B102C,10/10/2013,0,0,0,0,0,0,0
33753,RM-B102C,10/11/2013,0,0,0,0,0,0,0
33754,RM-B102C,10/12/2013,0,0,0,0,0,0,0
33755,RM-B102C,10/13/2013,0,0,0,0,0,0,0
33756,RM-B102C,10/14/2013,0,0,0,0,0,0,0
33757,RM-B102C,10/15/2013,0,0,0,0,0,0,0
33758,RM-B102C,10/16/2013,0,0,0,0,0,0,0
33759,RM-B102C,10/17/2013,0,0,0,0,0,0,0
33760,RM-B102C,10/18/2013,0,0,0,0,0,0,0
33761,RM-B102C,10/19/2013,0,0,0,0,0,0,0
33762,RM-B102C,10/20/2013,0,0,0,0,0,0,0
33763,RM-B102C,10/21/2013,0,0,0,0,0,0,0
33764,RM-B102C,10/22/2013,0,0,0,0,0,0,0
33765,RM-B102C,10/23/2013,0,0,0,0,0,0,0
33766,RM-B102C,10/24/2013,0,0,0,0,0,0,0
33767,RM-B102C,10/25/2013,0,0,0,0,0,0,0
33768,RM-B102C,10/26/2013,0,0,0,0,0,0,0
33769,RM-B102C,10/27/2013,0,0,0,0,0,0,0
33770,RM-B102C,10/28/2013,0,0,0,0,0,0,0
33771,RM-B102C,10/29/2013,0,0,0,0,0,0,0
33772,RM-B102C,10/30/2013,0,0,0,0,0,0,0
33773,RM-B102C,10/31/2013,0,0,0,0,0,0,0
33774,RM-B102C,11/1/2013,0,0,0,0,0,0,0
33775,RM-B102C,11/2/2013,0,0,0,0,0,0,0
33776,RM-B102C,11/3/2013,0,0,0,0,0,0,0
33777,RM-B102C,11/4/2013,0,0,0,0,0,0,0
33778,RM-B102C,11/5/2013,0,0,0,0,0,0,0
33779,RM-B102C,11/6/2013,0,0,0,0,0,0,0
33780,RM-B102C,11/7/2013,0,0,0,0,0,0,0
33781,RM-B102C,11/8/2013,0,0,0,0,0,0,0
33782,RM-B102C,11/9/2013,0,0,0,0,0,0,0
33783,RM-B102C,11/10/2013,0,0,0,0,0,0,0
33784,RM-B102C,11/11/2013,0,0,0,0,0,0,0
33785,RM-B102C,11/12/2013,0,0,0,0,0,0,0
33786,RM-B102C,11/13/2013,0,0,0,0,0,0,0
33787,RM-B102C,11/14/2013,0,0,0,0,0,0,0
33788,RM-B102C,11/15/2013,0,0,0,0,0,0,0
33789,RM-B102C,11/19/2013,0,0,0,0,0,0,0
33790,RM-B102C,11/20/2013,0,0,0,0,0,0,0
33791,RM-B102C,11/21/2013,0,0,0,0,0,0,0
33792,RM-B102C,11/22/2013,0,0,0,0,0,0,0
33793,RM-B102C,11/23/2013,0,0,0,0,0,0,0
33794,RM-B102C,11/24/2013,0,0,0,0,0,0,0
33795,RM-B102C,11/25/2013,0,0,0,0,0,0,0
33796,RM-B102C,11/26/2013,0,0,0,0,0,0,0
33797,RM-B102C,11/27/2013,0,0,0,0,0,0,0
33798,RM-B102C,11/28/2013,0,0,0,0,0,0,0
33799,RM-B102C,11/29/2013,0,0,0,0,0,0,0
33800,RM-B102C,11/30/2013,0,0,0,0,0,0,0
33801,RM-B102C,12/1/2013,0,0,0,0,0,0,0
33802,RM-B102C,12/2/2013,0,0,0,0,0,0,0
33803,RM-B102C,12/3/2013,0,0,0,0,0,0,0
33804,RM-B102C,12/4/2013,0,0,0,0,0,0,0
33805,RM-B102C,12/5/2013,0,0,0,0,0,0,0
33806,RM-B102C,12/6/2013,0,0,0,0,0,0,0
33807,RM-B102C,12/7/2013,0,0,0,0,0,0,0
33808,RM-B102C,12/8/2013,0,0,0,0,0,0,0
33809,RM-B102C,12/9/2013,0,0,0,0,0,0,0
33810,RM-B102C,12/10/2013,0,0,0,0,0,0,0
33811,RM-B102C,12/11/2013,0,0,0,0,0,0,0
33812,RM-B102C,12/12/2013,0,0,0,0,0,0,0
33813,RM-B102C,12/13/2013,0,0,0,0,0,0,0
33814,RM-B102C,12/14/2013,0,0,0,0,0,0,0
33815,RM-B102C,12/15/2013,0,0,0,0,0,0,0
33816,RM-B102C,12/16/2013,0,0,0,0,0,0,0
33817,RM-B102C,12/17/2013,0,0,0,0,0,0,0
33818,RM-B102C,12/18/2013,0,0,0,0,0,0,0
33819,RM-B102C,12/19/2013,0,0,0,0,0,0,0
33820,RM-B102C,12/20/2013,0,0,0,0,0,0,0
33821,RM-B102C,12/21/2013,0,0,0,0,0,0,0
33822,RM-B102C,12/22/2013,0,0,0,0,0,0,0
33823,RM-B102C,12/23/2013,0,0,0,0,0,0,0
33824,RM-B102C,12/24/2013,0,0,0,0,0,0,0
33825,RM-B102C,12/25/2013,0,0,0,0,0,0,0
33826,RM-B102C,12/26/2013,0,0,0,0,0,0,0
33827,RM-B102C,12/27/2013,0,0,0,0,0,0,0
33828,RM-B102C,12/28/2013,0,0,0,0,0,0,0
33829,RM-B102C,12/29/2013,0,0,0,0,0,0,0
33830,RM-B102C,12/30/2013,0,0,0,0,0,0,0
33831,RM-B102C,12/31/2013,0,0,0,0,0,0,0
33832,RM-B102C,1/1/2014,0,0,0,0,0,0,0
33833,RM-B102C,1/2/2014,0,0,0,0,0,0,0
33834,RM-B102C,1/3/2014,0,0,0,0,0,0,0
33835,RM-B102C,1/4/2014,0,0,0,0,0,0,0
33836,RM-B102C,1/5/2014,0,0,0,0,0,0,0
33837,RM-B102C,1/6/2014,0,0,0,0,0,0,0
33838,RM-B102C,1/7/2014,0,0,0,0,0,0,0
33839,RM-B102C,1/8/2014,0,0,0,0,0,0,0
33840,RM-B102C,1/9/2014,0,0,0,0,0,0,0
33841,RM-B102C,1/10/2014,0,0,0,0,0,0,0
33842,RM-B102C,1/11/2014,0,0,0,0,0,0,0
33843,RM-B102C,1/12/2014,0,0,0,0,0,0,0
33844,RM-B102C,1/13/2014,0,0,0,0,0,0,0
33845,RM-B102C,1/14/2014,0,0,0,0,0,0,0
33846,RM-B102C,1/15/2014,0,0,0,0,0,0,0
33847,RM-B102C,1/16/2014,0,0,0,0,0,0,0
33848,RM-B102C,1/17/2014,0,0,0,0,0,0,0
33849,RM-B102C,1/18/2014,0,0,0,0,0,0,0
33850,RM-B102C,1/19/2014,0,0,0,0,0,0,0
33851,RM-B102C,1/20/2014,0,0,0,0,0,0,0
33852,RM-B102C,1/21/2014,0,0,0,0,0,0,0
33853,RM-B102C,1/22/2014,0,0,0,0,0,0,0
33854,RM-B102C,1/23/2014,0,0,0,0,0,0,0
33855,RM-B102C,1/24/2014,0,0,0,0,0,0,0
33856,RM-B102C,1/25/2014,0,0,0,0,0,0,0
33857,RM-B102C,1/26/2014,0,0,0,0,0,0,0
33858,RM-B102C,1/27/2014,0,0,0,0,0,0,0
33859,RM-B102C,1/28/2014,0,0,0,0,0,0,0
33860,RM-B102C,1/29/2014,0,0,0,0,0,0,0
33861,RM-B102C,1/30/2014,0,0,0,0,0,0,0
33862,RM-B102C,1/31/2014,0,0,0,0,0,0,0
33863,RM-B102C,2/1/2014,0,0,0,0,0,0,0
33864,RM-B102C,2/2/2014,0,0,0,0,0,0,0
33865,RM-B102C,2/3/2014,0,0,0,0,0,0,0
33866,RM-B102C,2/4/2014,0,0,0,0,0,0,0
33867,RM-B102C,2/5/2014,0,0,0,0,0,0,0
33868,RM-B102C,2/6/2014,0,0,0,0,0,0,0
33869,RM-B102C,2/7/2014,0,0,0,0,0,0,0
33870,RM-B102C,2/8/2014,0,0,0,0,0,0,0
33871,RM-B102C,2/9/2014,0,0,0,0,0,0,0
33872,RM-B102C,2/10/2014,0,0,0,0,0,0,0
33873,RM-B102C,2/11/2014,0,0,0,0,0,0,0
33874,RM-B102C,2/12/2014,0,0,0,0,0,0,0
33875,RM-B102C,2/13/2014,0,0,0,0,0,0,0
33876,RM-B102C,2/14/2014,0,0,0,0,0,0,0
33877,RM-B102C,2/15/2014,0,0,0,0,0,0,0
33878,RM-B102C,2/16/2014,0,0,0,0,0,0,0
33879,RM-B102C,2/17/2014,0,0,0,0,0,0,0
33880,RM-B102C,2/18/2014,0,0,0,0,0,0,0
33881,RM-B102C,2/19/2014,0,0,0,0,0,0,0
33882,RM-B102C,2/20/2014,0,0,0,0,0,0,0
33883,RM-B102C,2/21/2014,0,0,0,0,0,0,0
33884,RM-B102C,2/22/2014,0,0,0,0,0,0,0
33885,RM-B102C,2/23/2014,0,0,0,0,0,0,0
33886,RM-B102C,2/24/2014,0,0,0,0,0,0,0
33887,RM-B102C,2/25/2014,0,0,0,0,0,0,0
33888,RM-B102C,2/26/2014,0,0,0,0,0,0,0
33889,RM-B102C,2/27/2014,0,0,0,0,0,0,0
33890,RM-B102C,2/28/2014,0,0,0,0,0,0,0
33891,RM-B102C,3/1/2014,0,0,0,0,0,0,0
33892,RM-B102C,3/2/2014,0,0,0,0,0,0,0
33893,RM-B102C,3/3/2014,0,0,0,0,0,0,0
33894,RM-B102C,3/4/2014,0,0,0,0,0,0,0
33895,RM-B102C,3/5/2014,0,0,0,0,0,0,0
33896,RM-B102C,3/6/2014,0,0,0,0,0,0,0
33897,RM-B102C,3/7/2014,0,0,0,0,0,0,0
33898,RM-B102C,3/8/2014,0,0,0,0,0,0,0
33899,RM-B102C,3/9/2014,0,0,0,0,0,0,0
33900,RM-B102C,3/10/2014,0,0,0,0,0,0,0
33901,RM-B102C,3/11/2014,0,0,0,0,0,0,0
33902,RM-B102C,3/12/2014,0,0,0,0,0,0,0
33903,RM-B102C,3/13/2014,0,0,0,0,0,0,0
33904,RM-B102C,3/14/2014,0,0,0,0,0,0,0
33905,RM-B102C,3/15/2014,0,0,0,0,0,0,0
33906,RM-B102C,3/16/2014,0,0,0,0,0,0,0
33907,RM-B102C,3/17/2014,0,0,0,0,0,0,0
33908,RM-B102C,3/18/2014,0,0,0,0,0,0,0
33909,RM-B102C,3/19/2014,0,0,0,0,0,0,0
33910,RM-B102C,3/20/2014,0,0,0,0,0,0,0
33911,RM-B102C,3/21/2014,0,0,0,0,0,0,0
33912,RM-B102C,3/22/2014,0,0,0,0,0,0,0
33913,RM-B102C,3/23/2014,0,0,0,0,0,0,0
33914,RM-B102C,3/24/2014,0,0,0,0,0,0,0
33915,RM-B102C,3/25/2014,0,0,0,0,0,0,0
33916,RM-B102C,3/26/2014,0,0,0,0,0,0,0
33917,RM-B102C,3/27/2014,0,0,0,0,0,0,0
33918,RM-B102C,3/28/2014,0,0,0,0,0,0,0
33919,RM-B102C,3/29/2014,0,0,0,0,0,0,0
33920,RM-B102C,3/30/2014,0,0,0,0,0,0,0
33921,RM-B102C,3/31/2014,0,0,0,0,0,0,0
33922,RM-B102C,4/1/2014,0,0,0,0,0,0,0
33923,RM-B102C,4/2/2014,0,0,0,0,0,0,0
33924,RM-B102C,4/3/2014,0,0,0,0,0,0,0
33925,RM-B102C,4/4/2014,0,0,0,0,0,0,0
33926,RM-B102C,4/5/2014,0,0,0,0,0,0,0
33927,RM-B102C,4/6/2014,0,0,0,0,0,0,0
33928,RM-B102C,4/7/2014,0,0,0,0,0,0,0
33929,RM-B102C,4/8/2014,0,0,0,0,0,0,0
33930,RM-B102C,4/9/2014,0,0,0,0,0,0,0
33931,RM-B102C,4/10/2014,0,0,0,0,0,0,0
33932,RM-B102C,4/11/2014,0,0,0,0,0,0,0
33933,RM-B102C,4/12/2014,0,0,0,0,0,0,0
33934,RM-B102C,4/13/2014,0,0,0,0,0,0,0
33935,RM-B102C,4/14/2014,0,0,0,0,0,0,0
33936,RM-B102C,4/15/2014,0,0,0,0,0,0,0
33937,RM-B102C,4/16/2014,0,0,0,0,0,0,0
33938,RM-B102C,4/17/2014,0,0,0,0,0,0,0
33939,RM-B102C,4/18/2014,0,0,0,0,0,0,0
33940,RM-B102C,4/19/2014,0,0,0,0,0,0,0
33941,RM-B102C,4/20/2014,0,0,0,0,0,0,0
33942,RM-B102C,4/21/2014,0,0,0,0,0,0,0
33943,RM-B102C,4/22/2014,0,0,0,0,0,0,0
33944,RM-B102C,4/23/2014,0,0,0,0,0,0,0
33945,RM-B102C,4/24/2014,0,0,0,0,0,0,0
33946,RM-B102C,4/25/2014,0,0,0,0,0,0,0
33947,RM-B102C,4/26/2014,0,0,0,0,0,0,0
33948,RM-B102C,4/27/2014,0,0,0,0,0,0,0
33949,RM-B102C,4/28/2014,0,0,0,0,0,0,0
33950,RM-B102C,4/29/2014,0,0,0,0,0,0,0
33951,RM-B102C,4/30/2014,0,0,0,0,0,0,0
33952,RM-B102C,5/1/2014,0,0,0,0,0,0,0
33953,RM-B102C,5/2/2014,0,0,0,0,0,0,0
33954,RM-B102C,5/3/2014,0,0,0,0,0,0,0
33955,RM-B102C,5/4/2014,0,0,0,0,0,0,0
33956,RM-B102C,5/5/2014,0,0,0,0,0,0,0
33957,RM-B102C,5/6/2014,0,0,0,0,0,0,0
33958,RM-B102C,5/7/2014,0,0,0,0,0,0,0
33959,RM-B102C,5/8/2014,0,0,0,0,0,0,0
33960,RM-B102C,5/9/2014,0,0,0,0,0,0,0
33961,RM-B102C,5/10/2014,0,0,0,0,0,0,0
33962,RM-B102C,5/11/2014,0,0,0,0,0,0,0
33963,RM-B102C,5/12/2014,0,0,0,0,0,0,0
33964,RM-B102C,5/13/2014,0,0,0,0,0,0,0
33965,RM-B102C,5/14/2014,0,0,0,0,0,0,0
33966,RM-B102C,5/15/2014,0,0,0,0,0,0,0
33967,RM-B102C,5/16/2014,0,0,0,0,0,0,0
33968,RM-B102C,5/17/2014,0,0,0,0,0,0,0
33969,RM-B102C,5/18/2014,0,0,0,0,0,0,0
33970,RM-B102C,5/19/2014,0,0,0,0,0,0,0
33971,RM-B102C,5/20/2014,0,0,0,0,0,0,0
33972,RM-B102C,5/21/2014,0,0,0,0,0,0,0
33973,RM-B102C,5/22/2014,0,0,0,0,0,0,0
33974,RM-B102C,5/23/2014,0,0,0,0,0,0,0
33975,RM-B102C,5/24/2014,0,0,0,0,0,0,0
33976,RM-B102C,5/25/2014,0,0,0,0,0,0,0
33977,RM-B102C,5/26/2014,0,0,0,0,0,0,0
33978,RM-B102C,5/27/2014,0,0,0,0,0,0,0
33979,RM-B102C,5/28/2014,0,0,0,0,0,0,0
33980,RM-B102C,5/29/2014,0,0,0,0,0,0,0
33981,RM-B102C,5/30/2014,0,0,0,0,0,0,0
33982,RM-B102C,5/31/2014,0,0,0,0,0,0,0
33983,RM-B102C,6/1/2014,0,0,0,0,0,0,0
33984,RM-B102C,6/2/2014,0,0,0,0,0,0,0
33985,RM-B102C,6/3/2014,0,0,0,0,0,0,0
33986,RM-B102C,6/4/2014,0,0,0,0,0,0,0
33987,RM-B102C,6/5/2014,0,0,0,0,0,0,0
33988,RM-B102C,6/6/2014,0,0,0,0,0,0,0
33989,RM-B102C,6/7/2014,0,0,0,0,0,0,0
33990,RM-B102C,6/8/2014,0,0,0,0,0,0,0
33991,RM-B102C,6/9/2014,0,0,0,0,0,0,0
33992,RM-B102C,6/10/2014,0,0,0,0,0,0,0
33993,RM-B102C,6/11/2014,0,0,0,0,0,0,0
33994,RM-B102C,6/12/2014,0,0,0,0,0,0,0
33995,RM-B102C,6/13/2014,0,0,0,0,0,0,0
33996,RM-B102C,6/14/2014,0,0,0,0,0,0,0
33997,RM-B102C,6/15/2014,0,0,0,0,0,0,0
33998,RM-B102C,6/16/2014,0,0,0,0,0,0,0
33999,RM-B102C,6/17/2014,0,0,0,0,0,0,0
34000,RM-B102C,6/18/2014,0,0,0,0,0,0,0
34001,RM-B102C,6/19/2014,0,0,0,0,0,0,0
34002,RM-B102C,6/20/2014,0,0,0,0,0,0,0
34003,RM-B102C,6/21/2014,0,0,0,0,0,0,0
34004,RM-B102C,6/22/2014,0,0,0,0,0,0,0
34005,RM-B102C,6/23/2014,0,0,0,0,0,0,0
34006,RM-B102C,6/24/2014,0,0,0,0,0,0,0
34007,RM-B102C,6/25/2014,0,0,0,0,0,0,0
34008,RM-B102C,6/26/2014,0,0,0,0,0,0,0
34009,RM-B102C,6/27/2014,0,0,0,0,0,0,0
34010,RM-B102C,6/28/2014,0,0,0,0,0,0,0
34011,RM-B102C,6/29/2014,0,0,0,0,0,0,0
34012,RM-B102C,6/30/2014,0,0,0,0,0,0,0
34013,RM-B102C,7/1/2014,0,0,0,0,0,0,0
34014,RM-B102C,7/2/2014,0,0,0,0,0,0,0
34015,RM-B102C,7/3/2014,0,0,0,0,0,0,0
34016,RM-B102C,7/4/2014,0,0,0,0,0,0,0
34195,RM-B103,6/28/2013,0,0,0,0,0,0,0
34196,RM-B103,6/29/2013,0,0,0,0,0,0,0
34197,RM-B103,6/30/2013,0,0,0,0,0,0,0
34198,RM-B103,7/1/2013,0,0,0,0,0,0,0
34199,RM-B103,7/2/2013,0,0,0,0,0,0,0
34200,RM-B103,7/3/2013,0,0,0,0,0,0,0
34201,RM-B103,7/4/2013,0,0,0,0,0,0,0
34202,RM-B103,7/5/2013,0,0,0,0,0,0,0
34203,RM-B103,7/6/2013,0,0,0,0,0,0,0
34204,RM-B103,7/7/2013,0,0,0,0,0,0,0
34205,RM-B103,7/8/2013,0,0,0,0,0,0,0
34206,RM-B103,7/9/2013,0,0,0,0,0,0,0
34207,RM-B103,7/10/2013,0,0,0,0,0,0,0
34208,RM-B103,7/11/2013,0,0,0,0,0,0,0
34209,RM-B103,7/12/2013,0,0,0,0,0,0,0
34210,RM-B103,7/13/2013,0,0,0,0,0,0,0
34211,RM-B103,7/14/2013,0,0,0,0,0,0,0
34212,RM-B103,7/15/2013,0,0,0,0,0,0,0
34213,RM-B103,7/17/2013,0,0,0,0,0,0,0
34214,RM-B103,7/18/2013,0,0,0,0,0,0,0
34215,RM-B103,7/19/2013,0,0,0,0,0,0,0
34216,RM-B103,7/20/2013,0,0,0,0,0,0,0
34217,RM-B103,7/21/2013,0,0,0,0,0,0,0
34218,RM-B103,7/22/2013,0,0,0,0,0,0,0
34219,RM-B103,7/23/2013,0,0,0,0,0,0,0
34220,RM-B103,7/24/2013,0,0,0,0,0,0,0
34221,RM-B103,7/25/2013,0,0,0,0,0,0,0
34222,RM-B103,7/26/2013,0,0,0,0,0,0,0
34223,RM-B103,7/27/2013,0,0,0,0,0,0,0
34224,RM-B103,7/28/2013,0,0,0,0,0,0,0
34225,RM-B103,7/29/2013,0,0,0,0,0,0,0
34226,RM-B103,7/30/2013,0,0,0,0,0,0,0
34227,RM-B103,7/31/2013,0,0,0,0,0,0,0
34228,RM-B103,8/1/2013,0,0,0,0,0,0,0
34229,RM-B103,8/2/2013,0,0,0,0,0,0,0
34230,RM-B103,8/3/2013,0,0,0,0,0,0,0
34231,RM-B103,8/4/2013,0,0,0,0,0,0,0
34232,RM-B103,8/5/2013,0,0,0,0,0,0,0
34233,RM-B103,8/6/2013,0,0,0,0,0,0,0
34234,RM-B103,8/7/2013,0,0,0,0,0,0,0
34235,RM-B103,8/8/2013,0,0,0,0,0,0,0
34236,RM-B103,8/9/2013,0,0,0,0,0,0,0
34237,RM-B103,8/10/2013,0,0,0,0,0,0,0
34238,RM-B103,8/11/2013,0,0,0,0,0,0,0
34239,RM-B103,8/12/2013,0,0,0,0,0,0,0
34240,RM-B103,8/13/2013,0,0,0,0,0,0,0
34241,RM-B103,8/14/2013,0,0,0,0,0,0,0
34242,RM-B103,8/15/2013,0,0,0,0,0,0,0
34243,RM-B103,8/16/2013,0,0,0,0,0,0,0
34244,RM-B103,8/17/2013,0,0,0,0,0,0,0
34245,RM-B103,8/18/2013,0,0,0,0,0,0,0
34246,RM-B103,8/19/2013,0,0,0,0,0,0,0
34247,RM-B103,8/20/2013,0,0,0,0,0,0,0
34248,RM-B103,8/21/2013,0,0,0,0,0,0,0
34249,RM-B103,8/22/2013,0,0,0,0,0,0,0
34250,RM-B103,8/27/2013,0,0,0,0,0,0,0
34251,RM-B103,8/28/2013,0,0,0,0,0,0,0
34252,RM-B103,8/29/2013,0,0,0,0,0,0,0
34253,RM-B103,8/30/2013,0,0,0,0,0,0,0
34254,RM-B103,9/4/2013,0,0,0,0,0,0,0
34255,RM-B103,9/5/2013,0,0,0,0,0,0,0
34256,RM-B103,9/6/2013,0,0,0,0,0,0,0
34257,RM-B103,9/7/2013,0,0,0,0,0,0,0
34258,RM-B103,9/9/2013,0,0,0,0,0,0,0
34259,RM-B103,9/10/2013,0,0,0,0,0,0,0
34260,RM-B103,9/11/2013,0,0,0,0,0,0,0
34261,RM-B103,9/12/2013,0,0,0,0,0,0,0
34262,RM-B103,9/13/2013,0,0,0,0,0,0,0
34263,RM-B103,9/14/2013,0,0,0,0,0,0,0
34264,RM-B103,9/15/2013,0,0,0,0,0,0,0
34265,RM-B103,9/16/2013,0,0,0,0,0,0,0
34266,RM-B103,9/17/2013,0,0,0,0,0,0,0
34267,RM-B103,9/18/2013,0,0,0,0,0,0,0
34268,RM-B103,9/19/2013,0,0,0,0,0,0,0
34269,RM-B103,9/20/2013,0,0,0,0,0,0,0
34270,RM-B103,9/21/2013,0,0,0,0,0,0,0
34271,RM-B103,9/22/2013,0,0,0,0,0,0,0
34272,RM-B103,9/23/2013,0,0,0,0,0,0,0
34273,RM-B103,9/24/2013,0,0,0,0,0,0,0
34274,RM-B103,9/25/2013,0,0,0,0,0,0,0
34275,RM-B103,9/26/2013,0,0,0,0,0,0,0
34276,RM-B103,9/27/2013,0,0,0,0,0,0,0
34277,RM-B103,9/28/2013,0,0,0,0,0,0,0
34278,RM-B103,9/29/2013,0,0,0,0,0,0,0
34279,RM-B103,9/30/2013,0,0,0,0,0,0,0
34280,RM-B103,10/1/2013,0,0,0,0,0,0,0
34281,RM-B103,10/2/2013,0,0,0,0,0,0,0
34282,RM-B103,10/3/2013,0,0,0,0,0,0,0
34283,RM-B103,10/4/2013,0,0,0,0,0,0,0
34284,RM-B103,10/5/2013,0,0,0,0,0,0,0
34285,RM-B103,10/6/2013,0,0,0,0,0,0,0
34286,RM-B103,10/7/2013,0,0,0,0,0,0,0
34287,RM-B103,10/8/2013,0,0,0,0,0,0,0
34288,RM-B103,10/9/2013,0,0,0,0,0,0,0
34289,RM-B103,10/10/2013,0,0,0,0,0,0,0
34290,RM-B103,10/11/2013,0,0,0,0,0,0,0
34291,RM-B103,10/12/2013,0,0,0,0,0,0,0
34292,RM-B103,10/13/2013,0,0,0,0,0,0,0
34293,RM-B103,10/14/2013,0,0,0,0,0,0,0
34294,RM-B103,10/15/2013,0,0,0,0,0,0,0
34295,RM-B103,10/16/2013,0,0,0,0,0,0,0
34296,RM-B103,10/17/2013,0,0,0,0,0,0,0
34297,RM-B103,10/18/2013,0,0,0,0,0,0,0
34298,RM-B103,10/19/2013,0,0,0,0,0,0,0
34299,RM-B103,10/20/2013,0,0,0,0,0,0,0
34300,RM-B103,10/21/2013,0,0,0,0,0,0,0
34301,RM-B103,10/22/2013,0,0,0,0,0,0,0
34302,RM-B103,10/23/2013,0,0,0,0,0,0,0
34303,RM-B103,10/24/2013,0,0,0,0,0,0,0
34304,RM-B103,10/25/2013,0,0,0,0,0,0,0
34305,RM-B103,10/26/2013,0,0,0,0,0,0,0
34306,RM-B103,10/27/2013,0,0,0,0,0,0,0
34307,RM-B103,10/28/2013,0,0,0,0,0,0,0
34308,RM-B103,10/29/2013,0,0,0,0,0,0,0
34309,RM-B103,10/30/2013,0,0,0,0,0,0,0
34310,RM-B103,10/31/2013,0,0,0,0,0,0,0
34311,RM-B103,11/1/2013,0,0,0,0,0,0,0
34312,RM-B103,11/2/2013,0,0,0,0,0,0,0
34313,RM-B103,11/3/2013,0,0,0,0,0,0,0
34314,RM-B103,11/4/2013,0,0,0,0,0,0,0
34315,RM-B103,11/5/2013,0,0,0,0,0,0,0
34316,RM-B103,11/6/2013,0,0,0,0,0,0,0
34317,RM-B103,11/7/2013,0,0,0,0,0,0,0
34318,RM-B103,11/8/2013,0,0,0,0,0,0,0
34319,RM-B103,11/9/2013,0,0,0,0,0,0,0
34320,RM-B103,11/10/2013,0,0,0,0,0,0,0
34321,RM-B103,11/11/2013,0,0,0,0,0,0,0
34322,RM-B103,11/12/2013,0,0,0,0,0,0,0
34323,RM-B103,11/13/2013,0,0,0,0,0,0,0
34324,RM-B103,11/14/2013,0,0,0,0,0,0,0
34325,RM-B103,11/15/2013,0,0,0,0,0,0,0
34326,RM-B103,11/19/2013,0,0,0,0,0,0,0
34327,RM-B103,11/20/2013,0,0,0,0,0,0,0
34328,RM-B103,11/21/2013,0,0,0,0,0,0,0
34329,RM-B103,11/22/2013,0,0,0,0,0,0,0
34330,RM-B103,11/23/2013,0,0,0,0,0,0,0
34331,RM-B103,11/24/2013,0,0,0,0,0,0,0
34332,RM-B103,11/25/2013,0,0,0,0,0,0,0
34333,RM-B103,11/26/2013,0,0,0,0,0,0,0
34334,RM-B103,11/27/2013,0,0,0,0,0,0,0
34335,RM-B103,11/28/2013,0,0,0,0,0,0,0
34336,RM-B103,11/29/2013,0,0,0,0,0,0,0
34337,RM-B103,11/30/2013,0,0,0,0,0,0,0
34338,RM-B103,12/1/2013,0,0,0,0,0,0,0
34339,RM-B103,12/2/2013,0,0,0,0,0,0,0
34340,RM-B103,12/3/2013,0,0,0,0,0,0,0
34341,RM-B103,12/4/2013,0,0,0,0,0,0,0
34342,RM-B103,12/5/2013,0,0,0,0,0,0,0
34343,RM-B103,12/6/2013,0,0,0,0,0,0,0
34344,RM-B103,12/7/2013,0,0,0,0,0,0,0
34345,RM-B103,12/8/2013,0,0,0,0,0,0,0
34346,RM-B103,12/9/2013,0,0,0,0,0,0,0
34347,RM-B103,12/10/2013,0,0,0,0,0,0,0
34348,RM-B103,12/11/2013,0,0,0,0,0,0,0
34349,RM-B103,12/12/2013,0,0,0,0,0,0,0
34350,RM-B103,12/13/2013,0,0,0,0,0,0,0
34351,RM-B103,12/14/2013,0,0,0,0,0,0,0
34352,RM-B103,12/15/2013,0,0,0,0,0,0,0
34353,RM-B103,12/16/2013,0,0,0,0,0,0,0
34354,RM-B103,12/17/2013,0,0,0,0,0,0,0
34355,RM-B103,12/18/2013,0,0,0,0,0,0,0
34356,RM-B103,12/19/2013,0,0,0,0,0,0,0
34357,RM-B103,12/20/2013,0,0,0,0,0,0,0
34358,RM-B103,12/21/2013,0,0,0,0,0,0,0
34359,RM-B103,12/22/2013,0,0,0,0,0,0,0
34360,RM-B103,12/23/2013,0,0,0,0,0,0,0
34361,RM-B103,12/24/2013,0,0,0,0,0,0,0
34362,RM-B103,12/25/2013,0,0,0,0,0,0,0
34363,RM-B103,12/26/2013,0,0,0,0,0,0,0
34364,RM-B103,12/27/2013,0,0,0,0,0,0,0
34365,RM-B103,12/28/2013,0,0,0,0,0,0,0
34366,RM-B103,12/29/2013,0,0,0,0,0,0,0
34367,RM-B103,12/30/2013,0,0,0,0,0,0,0
34368,RM-B103,12/31/2013,0,0,0,0,0,0,0
34369,RM-B103,1/1/2014,0,0,0,0,0,0,0
34370,RM-B103,1/2/2014,0,0,0,0,0,0,0
34371,RM-B103,1/3/2014,0,0,0,0,0,0,0
34372,RM-B103,1/4/2014,0,0,0,0,0,0,0
34373,RM-B103,1/5/2014,0,0,0,0,0,0,0
34374,RM-B103,1/6/2014,0,0,0,0,0,0,0
34375,RM-B103,1/7/2014,0,0,0,0,0,0,0
34377,RM-B103,1/9/2014,0,0,0,0,0,0,0
34381,RM-B103,1/13/2014,0,0,0,0,0,0,0
34382,RM-B103,1/14/2014,0,0,0,0,0,0,0
34448,RM-B103,3/21/2014,0,0,0,0,0,0,0
34449,RM-B103,3/22/2014,0,0,0,0,0,0,0
34450,RM-B103,3/23/2014,0,0,0,0,0,0,0
34451,RM-B103,3/24/2014,0,0,0,0,0,0,0
34452,RM-B103,3/25/2014,0,0,0,0,0,0,0
34453,RM-B103,3/26/2014,0,0,0,0,0,0,0
34454,RM-B103,3/27/2014,0,0,0,0,0,0,0
34455,RM-B103,3/28/2014,0,0,0,0,0,0,0
34456,RM-B103,3/29/2014,0,0,0,0,0,0,0
34457,RM-B103,3/30/2014,0,0,0,0,0,0,0
34458,RM-B103,3/31/2014,0,0,0,0,0,0,0
34459,RM-B103,4/1/2014,0,0,0,0,0,0,0
34460,RM-B103,4/2/2014,0,0,0,0,0,0,0
34461,RM-B103,4/3/2014,0,0,0,0,0,0,0
34462,RM-B103,4/4/2014,0,0,0,0,0,0,0
34463,RM-B103,4/5/2014,0,0,0,0,0,0,0
34464,RM-B103,4/6/2014,0,0,0,0,0,0,0
34465,RM-B103,4/7/2014,0,0,0,0,0,0,0
34466,RM-B103,4/8/2014,0,0,0,0,0,0,0
34467,RM-B103,4/9/2014,0,0,0,0,0,0,0
34468,RM-B103,4/10/2014,0,0,0,0,0,0,0
34469,RM-B103,4/11/2014,0,0,0,0,0,0,0
34470,RM-B103,4/12/2014,0,0,0,0,0,0,0
34471,RM-B103,4/13/2014,0,0,0,0,0,0,0
34472,RM-B103,4/14/2014,0,0,0,0,0,0,0
34473,RM-B103,4/15/2014,0,0,0,0,0,0,0
34474,RM-B103,4/16/2014,0,0,0,0,0,0,0
34475,RM-B103,4/17/2014,0,0,0,0,0,0,0
34476,RM-B103,4/18/2014,0,0,0,0,0,0,0
34477,RM-B103,4/19/2014,0,0,0,0,0,0,0
34478,RM-B103,4/20/2014,0,0,0,0,0,0,0
34479,RM-B103,4/21/2014,0,0,0,0,0,0,0
34480,RM-B103,4/22/2014,0,0,0,0,0,0,0
34481,RM-B103,4/23/2014,0,0,0,0,0,0,0
34482,RM-B103,4/24/2014,0,0,0,0,0,0,0
34483,RM-B103,4/25/2014,0,0,0,0,0,0,0
34484,RM-B103,4/26/2014,0,0,0,0,0,0,0
34485,RM-B103,4/27/2014,0,0,0,0,0,0,0
34486,RM-B103,4/28/2014,0,0,0,0,0,0,0
34487,RM-B103,4/29/2014,0,0,0,0,0,0,0
34488,RM-B103,4/30/2014,0,0,0,0,0,0,0
34489,RM-B103,5/1/2014,0,0,0,0,0,0,0
34490,RM-B103,5/2/2014,0,0,0,0,0,0,0
34491,RM-B103,5/3/2014,0,0,0,0,0,0,0
34492,RM-B103,5/4/2014,0,0,0,0,0,0,0
34493,RM-B103,5/5/2014,0,0,0,0,0,0,0
34494,RM-B103,5/7/2014,0,0,0,0,0,0,0
34495,RM-B103,5/8/2014,0,0,0,0,0,0,0
34496,RM-B103,5/9/2014,0,0,0,0,0,0,0
34497,RM-B103,5/10/2014,0,0,0,0,0,0,0
34498,RM-B103,5/11/2014,0,0,0,0,0,0,0
34499,RM-B103,5/12/2014,0,0,0,0,0,0,0
34500,RM-B103,5/13/2014,0,0,0,0,0,0,0
34501,RM-B103,5/14/2014,0,0,0,0,0,0,0
34502,RM-B103,5/15/2014,0,0,0,0,0,0,0
34503,RM-B103,5/16/2014,0,0,0,0,0,0,0
34504,RM-B103,5/17/2014,0,0,0,0,0,0,0
34505,RM-B103,5/18/2014,0,0,0,0,0,0,0
34506,RM-B103,5/19/2014,0,0,0,0,0,0,0
34507,RM-B103,5/20/2014,0,0,0,0,0,0,0
34508,RM-B103,5/21/2014,0,0,0,0,0,0,0
34509,RM-B103,5/22/2014,0,0,0,0,0,0,0
34510,RM-B103,5/23/2014,0,0,0,0,0,0,0
34511,RM-B103,5/24/2014,0,0,0,0,0,0,0
34512,RM-B103,5/25/2014,0,0,0,0,0,0,0
34513,RM-B103,5/26/2014,0,0,0,0,0,0,0
34514,RM-B103,5/27/2014,0,0,0,0,0,0,0
34515,RM-B103,5/28/2014,0,0,0,0,0,0,0
34516,RM-B103,5/29/2014,0,0,0,0,0,0,0
34517,RM-B103,5/30/2014,0,0,0,0,0,0,0
34518,RM-B103,5/31/2014,0,0,0,0,0,0,0
34519,RM-B103,6/1/2014,0,0,0,0,0,0,0
34520,RM-B103,6/2/2014,0,0,0,0,0,0,0
34521,RM-B103,6/3/2014,0,0,0,0,0,0,0
34522,RM-B103,6/4/2014,0,0,0,0,0,0,0
34523,RM-B103,6/5/2014,0,0,0,0,0,0,0
34524,RM-B103,6/6/2014,0,0,0,0,0,0,0
34525,RM-B103,6/7/2014,0,0,0,0,0,0,0
34526,RM-B103,6/8/2014,0,0,0,0,0,0,0
34527,RM-B103,6/9/2014,0,0,0,0,0,0,0
34528,RM-B103,6/10/2014,0,0,0,0,0,0,0
34529,RM-B103,6/11/2014,0,0,0,0,0,0,0
34530,RM-B103,6/12/2014,0,0,0,0,0,0,0
34531,RM-B103,6/13/2014,0,0,0,0,0,0,0
34532,RM-B103,6/14/2014,0,0,0,0,0,0,0
34533,RM-B103,6/15/2014,0,0,0,0,0,0,0
34534,RM-B103,6/16/2014,0,0,0,0,0,0,0
34535,RM-B103,6/17/2014,0,0,0,0,0,0,0
34536,RM-B103,6/18/2014,0,0,0,0,0,0,0
34537,RM-B103,6/19/2014,0,0,0,0,0,0,0
34538,RM-B103,6/20/2014,0,0,0,0,0,0,0
34539,RM-B103,6/21/2014,0,0,0,0,0,0,0
34540,RM-B103,6/22/2014,0,0,0,0,0,0,0
34541,RM-B103,6/23/2014,0,0,0,0,0,0,0
34542,RM-B103,6/24/2014,0,0,0,0,0,0,0
34551,RM-B103,7/3/2014,0,0,0,0,0,0,0
34552,RM-B103,7/4/2014,0,0,0,0,0,0,0
34553,RM-B103,7/5/2014,0,0,0,0,0,0,0
34554,RM-B103,7/6/2014,0,0,0,0,0,0,0
34555,RM-B103,7/7/2014,0,0,0,0,0,0,0
34556,RM-B103,7/8/2014,0,0,0,0,0,0,0
34557,RM-B103,7/9/2014,0,0,0,0,0,0,0
34558,RM-B103,7/10/2014,0,0,0,0,0,0,0
34559,RM-B103,7/11/2014,0,0,0,0,0,0,0
34560,RM-B103,7/12/2014,0,0,0,0,0,0,0
34561,RM-B103,7/13/2014,0,0,0,0,0,0,0
34562,RM-B103,7/14/2014,0,0,0,0,0,0,0
34563,RM-B103,7/15/2014,0,0,0,0,0,0,0
34564,RM-B103,7/16/2014,0,0,0,0,0,0,0
34565,RM-B103,7/17/2014,0,0,0,0,0,0,0
34566,RM-B103,7/18/2014,0,0,0,0,0,0,0
34567,RM-B103,7/19/2014,0,0,0,0,0,0,0
34568,RM-B103,7/20/2014,0,0,0,0,0,0,0
34569,RM-B103,7/21/2014,0,0,0,0,0,0,0
34570,RM-B103,7/22/2014,0,0,0,0,0,0,0
34571,RM-B103,7/23/2014,0,0,0,0,0,0,0
34572,RM-B103,7/24/2014,0,0,0,0,0,0,0
34573,RM-B103,7/25/2014,0,0,0,0,0,0,0
34574,RM-B103,7/26/2014,0,0,0,0,0,0,0
34575,RM-B103,7/27/2014,0,0,0,0,0,0,0
34576,RM-B103,7/28/2014,0,0,0,0,0,0,0
34577,RM-B103,7/29/2014,0,0,0,0,0,0,0
34578,RM-B103,7/30/2014,0,0,0,0,0,0,0
34579,RM-B103,7/31/2014,0,0,0,0,0,0,0
34580,RM-B103,8/1/2014,0,0,0,0,0,0,0
34581,RM-B103,8/2/2014,0,0,0,0,0,0,0
34582,RM-B103,8/3/2014,0,0,0,0,0,0,0
34583,RM-B103,8/4/2014,0,0,0,0,0,0,0
34584,RM-B103,8/5/2014,0,0,0,0,0,0,0
34585,RM-B103,8/6/2014,0,0,0,0,0,0,0
34586,RM-B103,8/7/2014,0,0,0,0,0,0,0
34587,RM-B103,8/8/2014,0,0,0,0,0,0,0
34588,RM-B103,8/9/2014,0,0,0,0,0,0,0
34589,RM-B103,8/10/2014,0,0,0,0,0,0,0
34590,RM-B103,8/11/2014,0,0,0,0,0,0,0
34591,RM-B103,8/12/2014,0,0,0,0,0,0,0
34592,RM-B103,8/13/2014,0,0,0,0,0,0,0
34593,RM-B103,8/14/2014,0,0,0,0,0,0,0
34594,RM-B103,8/15/2014,0,0,0,0,0,0,0
34595,RM-B103,8/16/2014,0,0,0,0,0,0,0
34596,RM-B103,8/17/2014,0,0,0,0,0,0,0
34597,RM-B103,8/18/2014,0,0,0,0,0,0,0
34598,RM-B103,8/19/2014,0,0,0,0,0,0,0
34599,RM-B103,8/20/2014,0,0,0,0,0,0,0
34600,RM-B103,8/21/2014,0,0,0,0,0,0,0
34601,RM-B103,8/22/2014,0,0,0,0,0,0,0
34602,RM-B103,8/23/2014,0,0,0,0,0,0,0
34603,RM-B103,8/24/2014,0,0,0,0,0,0,0
34604,RM-B103,8/25/2014,0,0,0,0,0,0,0
34605,RM-B103,8/26/2014,0,0,0,0,0,0,0
34606,RM-B103,8/27/2014,0,0,0,0,0,0,0
34607,RM-B103,8/28/2014,0,0,0,0,0,0,0
34608,RM-B103,8/29/2014,0,0,0,0,0,0,0
34609,RM-B103,8/30/2014,0,0,0,0,0,0,0
34610,RM-B103,8/31/2014,0,0,0,0,0,0,0
34611,RM-B103,9/1/2014,0,0,0,0,0,0,0
34612,RM-B103,9/2/2014,0,0,0,0,0,0,0
34613,RM-B103,9/3/2014,0,0,0,0,0,0,0
34614,RM-B103,9/4/2014,0,0,0,0,0,0,0
34615,RM-B103,9/5/2014,0,0,0,0,0,0,0
34616,RM-B103,9/6/2014,0,0,0,0,0,0,0
34617,RM-B103,9/7/2014,0,0,0,0,0,0,0
34618,RM-B103,9/8/2014,0,0,0,0,0,0,0
34619,RM-B103,9/9/2014,0,0,0,0,0,0,0
34620,RM-B103,9/10/2014,0,0,0,0,0,0,0
34621,RM-B103,9/11/2014,0,0,0,0,0,0,0
34622,RM-B103,9/12/2014,0,0,0,0,0,0,0
34623,RM-B103,9/13/2014,0,0,0,0,0,0,0
34624,RM-B103,9/14/2014,0,0,0,0,0,0,0
34625,RM-B103,9/15/2014,0,0,0,0,0,0,0
34626,RM-B103,9/16/2014,0,0,0,0,0,0,0
34627,RM-B103,9/17/2014,0,0,0,0,0,0,0
34628,RM-B103,9/18/2014,0,0,0,0,0,0,0
34629,RM-B103,9/19/2014,0,0,0,0,0,0,0
34630,RM-B103,9/20/2014,0,0,0,0,0,0,0
34631,RM-B103,9/21/2014,0,0,0,0,0,0,0
34632,RM-B103,9/22/2014,0,0,0,0,0,0,0
34633,RM-B103,9/23/2014,0,0,0,0,0,0,0
34634,RM-B103,9/24/2014,0,0,0,0,0,0,0
34635,RM-B103,9/25/2014,0,0,0,0,0,0,0
34636,RM-B103,9/28/2014,0,0,0,0,0,0,0
34637,RM-B103,9/29/2014,0,0,0,0,0,0,0
34638,RM-B103,9/30/2014,0,0,0,0,0,0,0
34639,RM-B103,10/1/2014,0,0,0,0,0,0,0
34640,RM-B103,10/2/2014,0,0,0,0,0,0,0
34641,RM-B103,10/3/2014,0,0,0,0,0,0,0
34642,RM-B103,10/4/2014,0,0,0,0,0,0,0
34643,RM-B103,10/5/2014,0,0,0,0,0,0,0
34644,RM-B103,10/6/2014,0,0,0,0,0,0,0
34645,RM-B103,10/7/2014,0,0,0,0,0,0,0
34646,RM-B103,10/8/2014,0,0,0,0,0,0,0
34647,RM-B103,10/9/2014,0,0,0,0,0,0,0
34648,RM-B103,10/10/2014,0,0,0,0,0,0,0
34649,RM-B103,10/11/2014,0,0,0,0,0,0,0
34650,RM-B103,10/12/2014,0,0,0,0,0,0,0
34651,RM-B103,10/13/2014,0,0,0,0,0,0,0
34652,RM-B103,10/14/2014,0,0,0,0,0,0,0
34653,RM-B103,10/15/2014,0,0,0,0,0,0,0
34654,RM-B103,10/16/2014,0,0,0,0,0,0,0
34655,RM-B103,10/17/2014,0,0,0,0,0,0,0
34656,RM-B103,10/18/2014,0,0,0,0,0,0,0
34657,RM-B103,10/19/2014,0,0,0,0,0,0,0
34658,RM-B103,10/20/2014,0,0,0,0,0,0,0
34659,RM-B103,10/26/2014,0,0,0,0,0,0,0
34660,RM-B103,10/27/2014,0,0,0,0,0,0,0
34661,RM-B103,10/28/2014,0,0,0,0,0,0,0
34662,RM-B103,10/29/2014,0,0,0,0,0,0,0
34663,RM-B103,10/30/2014,0,0,0,0,0,0,0
34664,RM-B103,10/31/2014,0,0,0,0,0,0,0
34665,RM-B103,11/1/2014,0,0,0,0,0,0,0
34666,RM-B103,11/2/2014,0,0,0,0,0,0,0
34667,RM-B103,11/3/2014,0,0,0,0,0,0,0
34668,RM-B103,11/4/2014,0,0,0,0,0,0,0
34669,RM-B103,11/5/2014,0,0,0,0,0,0,0
34670,RM-B103,11/6/2014,0,0,0,0,0,0,0
34671,RM-B103,11/7/2014,0,0,0,0,0,0,0
34672,RM-B103,11/8/2014,0,0,0,0,0,0,0
34673,RM-B103,11/9/2014,0,0,0,0,0,0,0
34674,RM-B103,11/10/2014,0,0,0,0,0,0,0
34675,RM-B103,11/11/2014,0,0,0,0,0,0,0
34676,RM-B103,11/12/2014,0,0,0,0,0,0,0
34677,RM-B103,11/13/2014,0,0,0,0,0,0,0
34678,RM-B103,11/14/2014,0,0,0,0,0,0,0
34679,RM-B103,11/15/2014,0,0,0,0,0,0,0
34680,RM-B103,11/16/2014,0,0,0,0,0,0,0
34681,RM-B103,11/17/2014,0,0,0,0,0,0,0
34682,RM-B103,11/18/2014,0,0,0,0,0,0,0
34683,RM-B103,11/19/2014,0,0,0,0,0,0,0
34684,RM-B103,11/20/2014,0,0,0,0,0,0,0
34685,RM-B103,11/21/2014,0,0,0,0,0,0,0
34686,RM-B103,11/22/2014,0,0,0,0,0,0,0
34687,RM-B103,11/23/2014,0,0,0,0,0,0,0
34688,RM-B103,11/24/2014,0,0,0,0,0,0,0
34689,RM-B103,11/25/2014,0,0,0,0,0,0,0
34690,RM-B103,11/26/2014,0,0,0,0,0,0,0
34691,RM-B103,11/27/2014,0,0,0,0,0,0,0
34692,RM-B103,11/28/2014,0,0,0,0,0,0,0
34693,RM-B103,11/29/2014,0,0,0,0,0,0,0
34694,RM-B103,11/30/2014,0,0,0,0,0,0,0
34695,RM-B103,12/1/2014,0,0,0,0,0,0,0
34696,RM-B103,12/2/2014,0,0,0,0,0,0,0
34697,RM-B103,12/3/2014,0,0,0,0,0,0,0
34698,RM-B103,12/4/2014,0,0,0,0,0,0,0
34699,RM-B103,12/5/2014,0,0,0,0,0,0,0
34700,RM-B103,12/6/2014,0,0,0,0,0,0,0
34701,RM-B103,12/7/2014,0,0,0,0,0,0,0
34702,RM-B103,12/8/2014,0,0,0,0,0,0,0
34703,RM-B103,12/9/2014,0,0,0,0,0,0,0
34704,RM-B103,12/10/2014,0,0,0,0,0,0,0
34705,RM-B103,12/11/2014,0,0,0,0,0,0,0
34706,RM-B103,12/12/2014,0,0,0,0,0,0,0
34707,RM-B103,12/13/2014,0,0,0,0,0,0,0
34708,RM-B103,12/14/2014,0,0,0,0,0,0,0
34709,RM-B103,12/15/2014,0,0,0,0,0,0,0
34710,RM-B103,12/16/2014,0,0,0,0,0,0,0
34711,RM-B103,12/17/2014,0,0,0,0,0,0,0
34712,RM-B103,12/18/2014,0,0,0,0,0,0,0
34713,RM-B103,12/19/2014,0,0,0,0,0,0,0
34714,RM-B103,12/20/2014,0,0,0,0,0,0,0
34715,RM-B103,12/21/2014,0,0,0,0,0,0,0
34716,RM-B103,12/22/2014,0,0,0,0,0,0,0
34717,RM-B103,12/23/2014,0,0,0,0,0,0,0
34718,RM-B103,12/24/2014,0,0,0,0,0,0,0
34719,RM-B103,12/25/2014,0,0,0,0,0,0,0
34720,RM-B103,12/26/2014,0,0,0,0,0,0,0
34721,RM-B103,12/27/2014,0,0,0,0,0,0,0
34722,RM-B103,12/28/2014,0,0,0,0,0,0,0
34723,RM-B103,12/29/2014,0,0,0,0,0,0,0
34724,RM-B103,12/30/2014,0,0,0,0,0,0,0
34725,RM-B103,12/31/2014,0,0,0,0,0,0,0
34726,RM-B103,1/1/2015,0,0,0,0,0,0,0
34727,RM-B103,1/2/2015,0,0,0,0,0,0,0
34728,RM-B103,1/3/2015,0,0,0,0,0,0,0
34729,RM-B103,1/4/2015,0,0,0,0,0,0,0
34730,RM-B103,1/5/2015,0,0,0,0,0,0,0
34731,RM-B103,1/6/2015,0,0,0,0,0,0,0
34732,RM-B103,1/7/2015,0,0,0,0,0,0,0
34733,RM-B103,1/8/2015,0,0,0,0,0,0,0
34734,RM-B103,1/9/2015,0,0,0,0,0,0,0
34735,RM-B103,1/10/2015,0,0,0,0,0,0,0
34736,RM-B103,1/11/2015,0,0,0,0,0,0,0
34737,RM-B103,1/12/2015,0,0,0,0,0,0,0
34738,RM-B103,1/13/2015,0,0,0,0,0,0,0
34739,RM-B103,1/14/2015,0,0,0,0,0,0,0
34740,RM-B103,1/15/2015,0,0,0,0,0,0,0
34741,RM-B103,1/16/2015,0,0,0,0,0,0,0
34742,RM-B103,1/17/2015,0,0,0,0,0,0,0
34743,RM-B103,1/18/2015,0,0,0,0,0,0,0
34744,RM-B103,1/19/2015,0,0,0,0,0,0,0
34745,RM-B103,1/20/2015,0,0,0,0,0,0,0
34746,RM-B103,1/21/2015,0,0,0,0,0,0,0
34747,RM-B103,1/22/2015,0,0,0,0,0,0,0
34748,RM-B103,1/23/2015,0,0,0,0,0,0,0
34749,RM-B103,1/24/2015,0,0,0,0,0,0,0
34750,RM-B103,1/25/2015,0,0,0,0,0,0,0
34751,RM-B103,1/26/2015,0,0,0,0,0,0,0
34752,RM-B103,1/27/2015,0,0,0,0,0,0,0
34753,RM-B103,1/28/2015,0,0,0,0,0,0,0
34754,RM-B103,1/29/2015,0,0,0,0,0,0,0
34755,RM-B103,1/30/2015,0,0,0,0,0,0,0
34756,RM-B103,1/31/2015,0,0,0,0,0,0,0
34757,RM-B103,2/1/2015,0,0,0,0,0,0,0
34758,RM-B103,2/2/2015,0,0,0,0,0,0,0
34759,RM-B103,2/3/2015,0,0,0,0,0,0,0
34760,RM-B103,2/4/2015,0,0,0,0,0,0,0
34761,RM-B103,2/5/2015,0,0,0,0,0,0,0
34762,RM-B103,2/6/2015,0,0,0,0,0,0,0
34763,RM-B103,2/7/2015,0,0,0,0,0,0,0
34764,RM-B103,2/8/2015,0,0,0,0,0,0,0
34765,RM-B103,2/9/2015,0,0,0,0,0,0,0
34766,RM-B103,2/10/2015,0,0,0,0,0,0,0
34767,RM-B103,2/11/2015,0,0,0,0,0,0,0
34768,RM-B103,2/12/2015,0,0,0,0,0,0,0
34769,RM-B103,2/13/2015,0,0,0,0,0,0,0
34770,RM-B103,2/14/2015,0,0,0,0,0,0,0
34771,RM-B103,2/15/2015,0,0,0,0,0,0,0
34772,RM-B103,2/16/2015,0,0,0,0,0,0,0
34773,RM-B103,2/17/2015,0,0,0,0,0,0,0
34774,RM-B103,2/18/2015,0,0,0,0,0,0,0
34775,RM-B103,2/19/2015,0,0,0,0,0,0,0
34776,RM-B103,2/20/2015,0,0,0,0,0,0,0
34777,RM-B103,2/21/2015,0,0,0,0,0,0,0
34778,RM-B103,2/22/2015,0,0,0,0,0,0,0
34779,RM-B103,2/23/2015,0,0,0,0,0,0,0
34780,RM-B103,2/24/2015,0,0,0,0,0,0,0
34781,RM-B103,2/25/2015,0,0,0,0,0,0,0
34782,RM-B103,2/26/2015,0,0,0,0,0,0,0
34783,RM-B103,2/27/2015,0,0,0,0,0,0,0
34784,RM-B103,2/28/2015,0,0,0,0,0,0,0
34785,RM-B103,3/1/2015,0,0,0,0,0,0,0
34786,RM-B103,3/2/2015,0,0,0,0,0,0,0
34787,RM-B103,3/3/2015,0,0,0,0,0,0,0
34788,RM-B103,3/4/2015,0,0,0,0,0,0,0
34789,RM-B103,3/5/2015,0,0,0,0,0,0,0
34790,RM-B103,3/6/2015,0,0,0,0,0,0,0
34791,RM-B103,3/7/2015,0,0,0,0,0,0,0
34792,RM-B103,3/8/2015,0,0,0,0,0,0,0
34793,RM-B103,3/9/2015,0,0,0,0,0,0,0
34794,RM-B103,3/10/2015,0,0,0,0,0,0,0
34795,RM-B103,3/11/2015,0,0,0,0,0,0,0
34796,RM-B103,3/12/2015,0,0,0,0,0,0,0
34797,RM-B103,3/13/2015,0,0,0,0,0,0,0
34798,RM-B103,3/14/2015,0,0,0,0,0,0,0
34799,RM-B103,3/15/2015,0,0,0,0,0,0,0
34800,RM-B103,3/16/2015,0,0,0,0,0,0,0
34801,RM-B103,3/17/2015,0,0,0,0,0,0,0
34802,RM-B103,3/18/2015,0,0,0,0,0,0,0
34803,RM-B103,3/19/2015,0,0,0,0,0,0,0
34804,RM-B103,3/20/2015,0,0,0,0,0,0,0
34805,RM-B103,3/21/2015,0,0,0,0,0,0,0
34806,RM-B103,3/22/2015,0,0,0,0,0,0,0
34807,RM-B103,3/23/2015,0,0,0,0,0,0,0
34808,RM-B103,3/24/2015,0,0,0,0,0,0,0
34809,RM-B103,3/25/2015,0,0,0,0,0,0,0
34810,RM-B103,3/26/2015,0,0,0,0,0,0,0
34811,RM-B103,3/27/2015,0,0,0,0,0,0,0
34812,RM-B103,3/28/2015,0,0,0,0,0,0,0
34813,RM-B103,3/29/2015,0,0,0,0,0,0,0
34814,RM-B103,3/30/2015,0,0,0,0,0,0,0
34815,RM-B103,3/31/2015,0,0,0,0,0,0,0
34816,RM-B103,4/1/2015,0,0,0,0,0,0,0
34817,RM-B103,4/2/2015,0,0,0,0,0,0,0
34818,RM-B103,4/3/2015,0,0,0,0,0,0,0
34819,RM-B103,4/4/2015,0,0,0,0,0,0,0
34820,RM-B103,4/5/2015,0,0,0,0,0,0,0
34821,RM-B103,4/6/2015,0,0,0,0,0,0,0
34822,RM-B103,4/7/2015,0,0,0,0,0,0,0
34823,RM-B103,4/8/2015,0,0,0,0,0,0,0
34824,RM-B103,4/9/2015,0,0,0,0,0,0,0
35231,RM-B103A,7/3/2014,0,0,0,0,0,0,0
35232,RM-B103A,7/4/2014,0,0,0,0,0,0,0
35233,RM-B103A,7/5/2014,0,0,0,0,0,0,0
35234,RM-B103A,7/6/2014,0,0,0,0,0,0,0
35235,RM-B103A,7/7/2014,0,0,0,0,0,0,0
35236,RM-B103A,7/8/2014,0,0,0,0,0,0,0
35237,RM-B103A,7/9/2014,0,0,0,0,0,0,0
35238,RM-B103A,7/10/2014,0,0,0,0,0,0,0
35239,RM-B103A,7/11/2014,0,0,0,0,0,0,0
35240,RM-B103A,7/12/2014,0,0,0,0,0,0,0
35241,RM-B103A,7/13/2014,0,0,0,0,0,0,0
35242,RM-B103A,7/14/2014,0,0,0,0,0,0,0
35243,RM-B103A,7/15/2014,0,0,0,0,0,0,0
35244,RM-B103A,7/16/2014,0,0,0,0,0,0,0
35245,RM-B103A,7/17/2014,0,0,0,0,0,0,0
35246,RM-B103A,7/18/2014,0,0,0,0,0,0,0
35247,RM-B103A,7/19/2014,0,0,0,0,0,0,0
35248,RM-B103A,7/20/2014,0,0,0,0,0,0,0
35249,RM-B103A,7/21/2014,0,0,0,0,0,0,0
35250,RM-B103A,7/22/2014,0,0,0,0,0,0,0
35251,RM-B103A,7/23/2014,0,0,0,0,0,0,0
35252,RM-B103A,7/24/2014,0,0,0,0,0,0,0
35253,RM-B103A,7/25/2014,0,0,0,0,0,0,0
35254,RM-B103A,7/26/2014,0,0,0,0,0,0,0
35255,RM-B103A,7/27/2014,0,0,0,0,0,0,0
35256,RM-B103A,7/28/2014,0,0,0,0,0,0,0
35257,RM-B103A,7/29/2014,0,0,0,0,0,0,0
35258,RM-B103A,7/30/2014,0,0,0,0,0,0,0
35259,RM-B103A,7/31/2014,0,0,0,0,0,0,0
35260,RM-B103A,8/1/2014,0,0,0,0,0,0,0
35261,RM-B103A,8/2/2014,0,0,0,0,0,0,0
35262,RM-B103A,8/3/2014,0,0,0,0,0,0,0
35263,RM-B103A,8/4/2014,0,0,0,0,0,0,0
35264,RM-B103A,8/5/2014,0,0,0,0,0,0,0
35265,RM-B103A,8/6/2014,0,0,0,0,0,0,0
35266,RM-B103A,8/7/2014,0,0,0,0,0,0,0
35267,RM-B103A,8/8/2014,0,0,0,0,0,0,0
35268,RM-B103A,8/9/2014,0,0,0,0,0,0,0
35269,RM-B103A,8/10/2014,0,0,0,0,0,0,0
35270,RM-B103A,8/11/2014,0,0,0,0,0,0,0
35271,RM-B103A,8/12/2014,0,0,0,0,0,0,0
35272,RM-B103A,8/13/2014,0,0,0,0,0,0,0
35273,RM-B103A,8/14/2014,0,0,0,0,0,0,0
35274,RM-B103A,8/15/2014,0,0,0,0,0,0,0
35275,RM-B103A,8/16/2014,0,0,0,0,0,0,0
35276,RM-B103A,8/17/2014,0,0,0,0,0,0,0
35277,RM-B103A,8/18/2014,0,0,0,0,0,0,0
35278,RM-B103A,8/19/2014,0,0,0,0,0,0,0
35279,RM-B103A,8/20/2014,0,0,0,0,0,0,0
35280,RM-B103A,8/21/2014,0,0,0,0,0,0,0
35281,RM-B103A,8/22/2014,0,0,0,0,0,0,0
35282,RM-B103A,8/23/2014,0,0,0,0,0,0,0
35283,RM-B103A,8/24/2014,0,0,0,0,0,0,0
35284,RM-B103A,8/25/2014,0,0,0,0,0,0,0
35285,RM-B103A,8/26/2014,0,0,0,0,0,0,0
35286,RM-B103A,8/27/2014,0,0,0,0,0,0,0
35287,RM-B103A,8/28/2014,0,0,0,0,0,0,0
35288,RM-B103A,8/29/2014,0,0,0,0,0,0,0
35289,RM-B103A,8/30/2014,0,0,0,0,0,0,0
35290,RM-B103A,8/31/2014,0,0,0,0,0,0,0
35291,RM-B103A,9/1/2014,0,0,0,0,0,0,0
35292,RM-B103A,9/2/2014,0,0,0,0,0,0,0
35293,RM-B103A,9/3/2014,0,0,0,0,0,0,0
35294,RM-B103A,9/4/2014,0,0,0,0,0,0,0
35295,RM-B103A,9/5/2014,0,0,0,0,0,0,0
35296,RM-B103A,9/6/2014,0,0,0,0,0,0,0
35297,RM-B103A,9/7/2014,0,0,0,0,0,0,0
35298,RM-B103A,9/8/2014,0,0,0,0,0,0,0
35299,RM-B103A,9/9/2014,0,0,0,0,0,0,0
35300,RM-B103A,9/10/2014,0,0,0,0,0,0,0
35301,RM-B103A,9/11/2014,0,0,0,0,0,0,0
35302,RM-B103A,9/12/2014,0,0,0,0,0,0,0
35303,RM-B103A,9/13/2014,0,0,0,0,0,0,0
35304,RM-B103A,9/14/2014,0,0,0,0,0,0,0
35305,RM-B103A,9/15/2014,0,0,0,0,0,0,0
35306,RM-B103A,9/16/2014,0,0,0,0,0,0,0
35307,RM-B103A,9/17/2014,0,0,0,0,0,0,0
35308,RM-B103A,9/18/2014,0,0,0,0,0,0,0
35309,RM-B103A,9/19/2014,0,0,0,0,0,0,0
35310,RM-B103A,9/20/2014,0,0,0,0,0,0,0
35311,RM-B103A,9/21/2014,0,0,0,0,0,0,0
35312,RM-B103A,9/22/2014,0,0,0,0,0,0,0
35313,RM-B103A,9/23/2014,0,0,0,0,0,0,0
35314,RM-B103A,9/24/2014,0,0,0,0,0,0,0
35315,RM-B103A,9/25/2014,0,0,0,0,0,0,0
35316,RM-B103A,9/28/2014,0,0,0,0,0,0,0
35317,RM-B103A,9/29/2014,0,0,0,0,0,0,0
35318,RM-B103A,9/30/2014,0,0,0,0,0,0,0
35319,RM-B103A,10/1/2014,0,0,0,0,0,0,0
35320,RM-B103A,10/2/2014,0,0,0,0,0,0,0
35321,RM-B103A,10/3/2014,0,0,0,0,0,0,0
35322,RM-B103A,10/4/2014,0,0,0,0,0,0,0
35323,RM-B103A,10/5/2014,0,0,0,0,0,0,0
35324,RM-B103A,10/6/2014,0,0,0,0,0,0,0
35325,RM-B103A,10/7/2014,0,0,0,0,0,0,0
35326,RM-B103A,10/8/2014,0,0,0,0,0,0,0
35327,RM-B103A,10/9/2014,0,0,0,0,0,0,0
35328,RM-B103A,10/10/2014,0,0,0,0,0,0,0
35329,RM-B103A,10/11/2014,0,0,0,0,0,0,0
35330,RM-B103A,10/12/2014,0,0,0,0,0,0,0
35331,RM-B103A,10/13/2014,0,0,0,0,0,0,0
35332,RM-B103A,10/14/2014,0,0,0,0,0,0,0
35333,RM-B103A,10/15/2014,0,0,0,0,0,0,0
35334,RM-B103A,10/16/2014,0,0,0,0,0,0,0
35335,RM-B103A,10/17/2014,0,0,0,0,0,0,0
35336,RM-B103A,10/18/2014,0,0,0,0,0,0,0
35337,RM-B103A,10/19/2014,0,0,0,0,0,0,0
35338,RM-B103A,10/20/2014,0,0,0,0,0,0,0
35339,RM-B103A,10/21/2014,0,0,0,0,0,0,0
35340,RM-B103A,10/22/2014,0,0,0,0,0,0,0
35341,RM-B103A,10/23/2014,0,0,0,0,0,0,0
35342,RM-B103A,10/24/2014,0,0,0,0,0,0,0
35343,RM-B103A,10/25/2014,0,0,0,0,0,0,0
35344,RM-B103A,10/26/2014,0,0,0,0,0,0,0
35345,RM-B103A,10/27/2014,0,0,0,0,0,0,0
35346,RM-B103A,10/28/2014,0,0,0,0,0,0,0
35347,RM-B103A,10/29/2014,0,0,0,0,0,0,0
35348,RM-B103A,10/30/2014,0,0,0,0,0,0,0
35349,RM-B103A,10/31/2014,0,0,0,0,0,0,0
35350,RM-B103A,11/1/2014,0,0,0,0,0,0,0
35351,RM-B103A,11/2/2014,0,0,0,0,0,0,0
35352,RM-B103A,11/3/2014,0,0,0,0,0,0,0
35353,RM-B103A,11/4/2014,0,0,0,0,0,0,0
35354,RM-B103A,11/5/2014,0,0,0,0,0,0,0
35355,RM-B103A,11/6/2014,0,0,0,0,0,0,0
35356,RM-B103A,11/7/2014,0,0,0,0,0,0,0
35357,RM-B103A,11/8/2014,0,0,0,0,0,0,0
35358,RM-B103A,11/9/2014,0,0,0,0,0,0,0
35359,RM-B103A,11/10/2014,0,0,0,0,0,0,0
35360,RM-B103A,11/11/2014,0,0,0,0,0,0,0
35361,RM-B103A,11/12/2014,0,0,0,0,0,0,0
35362,RM-B103A,11/13/2014,0,0,0,0,0,0,0
35363,RM-B103A,11/14/2014,0,0,0,0,0,0,0
35364,RM-B103A,11/15/2014,0,0,0,0,0,0,0
35365,RM-B103A,11/16/2014,0,0,0,0,0,0,0
35366,RM-B103A,11/17/2014,0,0,0,0,0,0,0
35367,RM-B103A,11/18/2014,0,0,0,0,0,0,0
35368,RM-B103A,11/19/2014,0,0,0,0,0,0,0
35369,RM-B103A,11/20/2014,0,0,0,0,0,0,0
35370,RM-B103A,11/21/2014,0,0,0,0,0,0,0
35371,RM-B103A,11/22/2014,0,0,0,0,0,0,0
35372,RM-B103A,11/23/2014,0,0,0,0,0,0,0
35373,RM-B103A,11/24/2014,0,0,0,0,0,0,0
35374,RM-B103A,11/25/2014,0,0,0,0,0,0,0
35375,RM-B103A,11/26/2014,0,0,0,0,0,0,0
35376,RM-B103A,11/27/2014,0,0,0,0,0,0,0
35377,RM-B103A,11/28/2014,0,0,0,0,0,0,0
35378,RM-B103A,11/29/2014,0,0,0,0,0,0,0
35379,RM-B103A,11/30/2014,0,0,0,0,0,0,0
35380,RM-B103A,12/1/2014,0,0,0,0,0,0,0
35381,RM-B103A,12/2/2014,0,0,0,0,0,0,0
35382,RM-B103A,12/3/2014,0,0,0,0,0,0,0
35383,RM-B103A,12/4/2014,0,0,0,0,0,0,0
35384,RM-B103A,12/5/2014,0,0,0,0,0,0,0
35385,RM-B103A,12/6/2014,0,0,0,0,0,0,0
35386,RM-B103A,12/7/2014,0,0,0,0,0,0,0
35387,RM-B103A,12/8/2014,0,0,0,0,0,0,0
35388,RM-B103A,12/9/2014,0,0,0,0,0,0,0
35389,RM-B103A,12/10/2014,0,0,0,0,0,0,0
35390,RM-B103A,12/11/2014,0,0,0,0,0,0,0
35391,RM-B103A,12/12/2014,0,0,0,0,0,0,0
35392,RM-B103A,12/13/2014,0,0,0,0,0,0,0
35393,RM-B103A,12/14/2014,0,0,0,0,0,0,0
35394,RM-B103A,12/15/2014,0,0,0,0,0,0,0
35395,RM-B103A,12/16/2014,0,0,0,0,0,0,0
35396,RM-B103A,12/17/2014,0,0,0,0,0,0,0
35397,RM-B103A,12/18/2014,0,0,0,0,0,0,0
35398,RM-B103A,12/19/2014,0,0,0,0,0,0,0
35399,RM-B103A,12/20/2014,0,0,0,0,0,0,0
35400,RM-B103A,12/21/2014,0,0,0,0,0,0,0
35401,RM-B103A,12/22/2014,0,0,0,0,0,0,0
35402,RM-B103A,12/23/2014,0,0,0,0,0,0,0
35403,RM-B103A,12/24/2014,0,0,0,0,0,0,0
35404,RM-B103A,12/25/2014,0,0,0,0,0,0,0
35405,RM-B103A,12/26/2014,0,0,0,0,0,0,0
35406,RM-B103A,12/27/2014,0,0,0,0,0,0,0
35407,RM-B103A,12/28/2014,0,0,0,0,0,0,0
35408,RM-B103A,12/29/2014,0,0,0,0,0,0,0
35409,RM-B103A,12/30/2014,0,0,0,0,0,0,0
35410,RM-B103A,12/31/2014,0,0,0,0,0,0,0
35411,RM-B103A,1/1/2015,0,0,0,0,0,0,0
35412,RM-B103A,1/2/2015,0,0,0,0,0,0,0
35413,RM-B103A,1/3/2015,0,0,0,0,0,0,0
35414,RM-B103A,1/4/2015,0,0,0,0,0,0,0
35415,RM-B103A,1/5/2015,0,0,0,0,0,0,0
35416,RM-B103A,1/6/2015,0,0,0,0,0,0,0
35417,RM-B103A,1/7/2015,0,0,0,0,0,0,0
35418,RM-B103A,1/8/2015,0,0,0,0,0,0,0
35419,RM-B103A,1/9/2015,0,0,0,0,0,0,0
35420,RM-B103A,1/10/2015,0,0,0,0,0,0,0
35421,RM-B103A,1/11/2015,0,0,0,0,0,0,0
35422,RM-B103A,1/12/2015,0,0,0,0,0,0,0
35423,RM-B103A,1/13/2015,0,0,0,0,0,0,0
35424,RM-B103A,1/14/2015,0,0,0,0,0,0,0
35425,RM-B103A,1/15/2015,0,0,0,0,0,0,0
35426,RM-B109,7/1/2013,0,0,0,0,0,0,0
35427,RM-B109,7/2/2013,0,0,0,0,0,0,0
35428,RM-B109,7/3/2013,0,0,0,0,0,0,0
35429,RM-B109,7/4/2013,0,0,0,0,0,0,0
35430,RM-B109,7/5/2013,0,0,0,0,0,0,0
35431,RM-B109,7/6/2013,0,0,0,0,0,0,0
35432,RM-B109,7/7/2013,0,0,0,0,0,0,0
35433,RM-B109,7/8/2013,0,0,0,0,0,0,0
35434,RM-B109,7/9/2013,0,0,0,0,0,0,0
35435,RM-B109,7/10/2013,0,0,0,0,0,0,0
35436,RM-B109,7/11/2013,0,0,0,0,0,0,0
35437,RM-B109,7/12/2013,0,0,0,0,0,0,0
35438,RM-B109,7/13/2013,0,0,0,0,0,0,0
35439,RM-B109,7/14/2013,0,0,0,0,0,0,0
35440,RM-B109,7/15/2013,0,0,0,0,0,0,0
35441,RM-B109,7/17/2013,0,0,0,0,0,0,0
35442,RM-B109,7/18/2013,0,0,0,0,0,0,0
35443,RM-B109,7/19/2013,0,0,0,0,0,0,0
35444,RM-B109,7/20/2013,0,0,0,0,0,0,0
35445,RM-B109,7/21/2013,0,0,0,0,0,0,0
35446,RM-B109,7/22/2013,0,0,0,0,0,0,0
35447,RM-B109,7/23/2013,0,0,0,0,0,0,0
35448,RM-B109,7/24/2013,0,0,0,0,0,0,0
35449,RM-B109,7/25/2013,0,0,0,0,0,0,0
35450,RM-B109,7/26/2013,0,0,0,0,0,0,0
35451,RM-B109,7/27/2013,0,0,0,0,0,0,0
35452,RM-B109,7/28/2013,0,0,0,0,0,0,0
35453,RM-B109,7/29/2013,0,0,0,0,0,0,0
35454,RM-B109,7/30/2013,0,0,0,0,0,0,0
35455,RM-B109,7/31/2013,0,0,0,0,0,0,0
35456,RM-B109,8/1/2013,0,0,0,0,0,0,0
35457,RM-B109,8/2/2013,0,0,0,0,0,0,0
35458,RM-B109,8/3/2013,0,0,0,0,0,0,0
35459,RM-B109,8/4/2013,0,0,0,0,0,0,0
35460,RM-B109,8/5/2013,0,0,0,0,0,0,0
35461,RM-B109,8/6/2013,0,0,0,0,0,0,0
35462,RM-B109,8/7/2013,0,0,0,0,0,0,0
35463,RM-B109,8/8/2013,0,0,0,0,0,0,0
35464,RM-B109,8/9/2013,0,0,0,0,0,0,0
35465,RM-B109,8/10/2013,0,0,0,0,0,0,0
35466,RM-B109,8/11/2013,0,0,0,0,0,0,0
35467,RM-B109,8/12/2013,0,0,0,0,0,0,0
35468,RM-B109,8/13/2013,0,0,0,0,0,0,0
35469,RM-B109,8/14/2013,0,0,0,0,0,0,0
35470,RM-B109,8/15/2013,0,0,0,0,0,0,0
35471,RM-B109,8/16/2013,0,0,0,0,0,0,0
35472,RM-B109,8/17/2013,0,0,0,0,0,0,0
35473,RM-B109,8/18/2013,0,0,0,0,0,0,0
35474,RM-B109,8/19/2013,0,0,0,0,0,0,0
35475,RM-B109,8/20/2013,0,0,0,0,0,0,0
35476,RM-B109,8/21/2013,0,0,0,0,0,0,0
35477,RM-B109,8/22/2013,0,0,0,0,0,0,0
35478,RM-B109,8/27/2013,0,0,0,0,0,0,0
35479,RM-B109,8/28/2013,0,0,0,0,0,0,0
35480,RM-B109,8/29/2013,0,0,0,0,0,0,0
35481,RM-B109,8/30/2013,0,0,0,0,0,0,0
35482,RM-B109,9/4/2013,0,0,0,0,0,0,0
35483,RM-B109,9/5/2013,0,0,0,0,0,0,0
35484,RM-B109,9/6/2013,0,0,0,0,0,0,0
35485,RM-B109,9/7/2013,0,0,0,0,0,0,0
35486,RM-B109,9/9/2013,0,0,0,0,0,0,0
35487,RM-B109,9/10/2013,0,0,0,0,0,0,0
35488,RM-B109,9/11/2013,0,0,0,0,0,0,0
35489,RM-B109,9/12/2013,0,0,0,0,0,0,0
35490,RM-B109,9/13/2013,0,0,0,0,0,0,0
35491,RM-B109,9/14/2013,0,0,0,0,0,0,0
35492,RM-B109,9/15/2013,0,0,0,0,0,0,0
35493,RM-B109,9/16/2013,0,0,0,0,0,0,0
35494,RM-B109,9/17/2013,0,0,0,0,0,0,0
35495,RM-B109,9/18/2013,0,0,0,0,0,0,0
35496,RM-B109,9/19/2013,0,0,0,0,0,0,0
35497,RM-B109,9/20/2013,0,0,0,0,0,0,0
35498,RM-B109,9/21/2013,0,0,0,0,0,0,0
35499,RM-B109,9/22/2013,0,0,0,0,0,0,0
35500,RM-B109,9/23/2013,0,0,0,0,0,0,0
35501,RM-B109,9/24/2013,0,0,0,0,0,0,0
35502,RM-B109,9/25/2013,0,0,0,0,0,0,0
35503,RM-B109,9/26/2013,0,0,0,0,0,0,0
35504,RM-B109,9/27/2013,0,0,0,0,0,0,0
35505,RM-B109,9/28/2013,0,0,0,0,0,0,0
35506,RM-B109,9/29/2013,0,0,0,0,0,0,0
35507,RM-B109,9/30/2013,0,0,0,0,0,0,0
35508,RM-B109,10/1/2013,0,0,0,0,0,0,0
35509,RM-B109,10/2/2013,0,0,0,0,0,0,0
35510,RM-B109,10/3/2013,0,0,0,0,0,0,0
35511,RM-B109,10/4/2013,0,0,0,0,0,0,0
35512,RM-B109,10/5/2013,0,0,0,0,0,0,0
35513,RM-B109,10/6/2013,0,0,0,0,0,0,0
35514,RM-B109,10/7/2013,0,0,0,0,0,0,0
35515,RM-B109,10/8/2013,0,0,0,0,0,0,0
35516,RM-B109,10/9/2013,0,0,0,0,0,0,0
35517,RM-B109,10/10/2013,0,0,0,0,0,0,0
35518,RM-B109,10/11/2013,0,0,0,0,0,0,0
35519,RM-B109,10/12/2013,0,0,0,0,0,0,0
35520,RM-B109,10/13/2013,0,0,0,0,0,0,0
35521,RM-B109,10/14/2013,0,0,0,0,0,0,0
35522,RM-B109,10/15/2013,0,0,0,0,0,0,0
35523,RM-B109,10/16/2013,0,0,0,0,0,0,0
35524,RM-B109,10/17/2013,0,0,0,0,0,0,0
35525,RM-B109,10/18/2013,0,0,0,0,0,0,0
35526,RM-B109,10/19/2013,0,0,0,0,0,0,0
35527,RM-B109,10/20/2013,0,0,0,0,0,0,0
35528,RM-B109,10/21/2013,0,0,0,0,0,0,0
35529,RM-B109,10/22/2013,0,0,0,0,0,0,0
35530,RM-B109,10/23/2013,0,0,0,0,0,0,0
35531,RM-B109,10/24/2013,0,0,0,0,0,0,0
35532,RM-B109,10/25/2013,0,0,0,0,0,0,0
35533,RM-B109,10/26/2013,0,0,0,0,0,0,0
35534,RM-B109,10/27/2013,0,0,0,0,0,0,0
35535,RM-B109,10/28/2013,0,0,0,0,0,0,0
35536,RM-B109,10/29/2013,0,0,0,0,0,0,0
35537,RM-B109,10/30/2013,0,0,0,0,0,0,0
35538,RM-B109,10/31/2013,0,0,0,0,0,0,0
35539,RM-B109,11/1/2013,0,0,0,0,0,0,0
35540,RM-B109,11/2/2013,0,0,0,0,0,0,0
35541,RM-B109,11/3/2013,0,0,0,0,0,0,0
35542,RM-B109,11/4/2013,0,0,0,0,0,0,0
35543,RM-B109,11/5/2013,0,0,0,0,0,0,0
35544,RM-B109,11/6/2013,0,0,0,0,0,0,0
35545,RM-B109,11/7/2013,0,0,0,0,0,0,0
35546,RM-B109,11/8/2013,0,0,0,0,0,0,0
35547,RM-B109,11/9/2013,0,0,0,0,0,0,0
35548,RM-B109,11/10/2013,0,0,0,0,0,0,0
35549,RM-B109,11/11/2013,0,0,0,0,0,0,0
35550,RM-B109,11/12/2013,0,0,0,0,0,0,0
35551,RM-B109,11/13/2013,0,0,0,0,0,0,0
35552,RM-B109,11/14/2013,0,0,0,0,0,0,0
35553,RM-B109,11/15/2013,0,0,0,0,0,0,0
35554,RM-B109,11/19/2013,0,0,0,0,0,0,0
35555,RM-B109,11/20/2013,0,0,0,0,0,0,0
35556,RM-B109,11/21/2013,0,0,0,0,0,0,0
35557,RM-B109,11/22/2013,0,0,0,0,0,0,0
35558,RM-B109,11/23/2013,0,0,0,0,0,0,0
35559,RM-B109,11/24/2013,0,0,0,0,0,0,0
35560,RM-B109,11/25/2013,0,0,0,0,0,0,0
35561,RM-B109,11/26/2013,0,0,0,0,0,0,0
35562,RM-B109,11/27/2013,0,0,0,0,0,0,0
35563,RM-B109,11/28/2013,0,0,0,0,0,0,0
35564,RM-B109,11/29/2013,0,0,0,0,0,0,0
35565,RM-B109,11/30/2013,0,0,0,0,0,0,0
35566,RM-B109,12/1/2013,0,0,0,0,0,0,0
35567,RM-B109,12/2/2013,0,0,0,0,0,0,0
35568,RM-B109,12/3/2013,0,0,0,0,0,0,0
35569,RM-B109,12/4/2013,0,0,0,0,0,0,0
35570,RM-B109,12/5/2013,0,0,0,0,0,0,0
35571,RM-B109,12/6/2013,0,0,0,0,0,0,0
35572,RM-B109,12/7/2013,0,0,0,0,0,0,0
35573,RM-B109,12/8/2013,0,0,0,0,0,0,0
35574,RM-B109,12/9/2013,0,0,0,0,0,0,0
35575,RM-B109,12/10/2013,0,0,0,0,0,0,0
35576,RM-B109,12/11/2013,0,0,0,0,0,0,0
35577,RM-B109,12/12/2013,0,0,0,0,0,0,0
35578,RM-B109,12/13/2013,0,0,0,0,0,0,0
35579,RM-B109,12/14/2013,0,0,0,0,0,0,0
35580,RM-B109,12/15/2013,0,0,0,0,0,0,0
35581,RM-B109,12/16/2013,0,0,0,0,0,0,0
35582,RM-B109,12/17/2013,0,0,0,0,0,0,0
35583,RM-B109,12/18/2013,0,0,0,0,0,0,0
35584,RM-B109,12/19/2013,0,0,0,0,0,0,0
35585,RM-B109,12/20/2013,0,0,0,0,0,0,0
35586,RM-B109,12/21/2013,0,0,0,0,0,0,0
35587,RM-B109,12/22/2013,0,0,0,0,0,0,0
35588,RM-B109,12/23/2013,0,0,0,0,0,0,0
35589,RM-B109,12/24/2013,0,0,0,0,0,0,0
35590,RM-B109,12/25/2013,0,0,0,0,0,0,0
35591,RM-B109,12/26/2013,0,0,0,0,0,0,0
35592,RM-B109,12/27/2013,0,0,0,0,0,0,0
35593,RM-B109,12/28/2013,0,0,0,0,0,0,0
35594,RM-B109,12/29/2013,0,0,0,0,0,0,0
35595,RM-B109,12/30/2013,0,0,0,0,0,0,0
35596,RM-B109,12/31/2013,0,0,0,0,0,0,0
35597,RM-B109,1/1/2014,0,0,0,0,0,0,0
35598,RM-B109,1/2/2014,0,0,0,0,0,0,0
35599,RM-B109,1/3/2014,0,0,0,0,0,0,0
35600,RM-B109,1/4/2014,0,0,0,0,0,0,0
35601,RM-B109,1/5/2014,0,0,0,0,0,0,0
35602,RM-B109,1/6/2014,0,0,0,0,0,0,0
35603,RM-B109,1/7/2014,0,0,0,0,0,0,0
35605,RM-B109,1/9/2014,0,0,0,0,0,0,0
35609,RM-B109,1/13/2014,0,0,0,0,0,0,0
35610,RM-B109,1/14/2014,0,0,0,0,0,0,0
36111,RM-B200B,6/28/2013,0,0,0,0,0,0,0
36112,RM-B200B,6/29/2013,0,0,0,0,0,0,0
36113,RM-B200B,7/1/2013,0,0,0,0,0,0,0
36114,RM-B200B,7/2/2013,0,0,0,0,0,0,0
36115,RM-B200B,7/3/2013,0,0,0,0,0,0,0
36116,RM-B200B,7/4/2013,0,0,0,0,0,0,0
36117,RM-B200B,7/5/2013,0,0,0,0,0,0,0
36118,RM-B200B,7/6/2013,0,0,0,0,0,0,0
36119,RM-B200B,7/7/2013,0,0,0,0,0,0,0
36120,RM-B200B,7/8/2013,0,0,0,0,0,0,0
36121,RM-B200B,7/9/2013,0,0,0,0,0,0,0
36122,RM-B200B,7/10/2013,0,0,0,0,0,0,0
36123,RM-B200B,7/11/2013,0,0,0,0,0,0,0
36124,RM-B200B,7/12/2013,0,0,0,0,0,0,0
36125,RM-B200B,7/13/2013,0,0,0,0,0,0,0
36126,RM-B200B,7/14/2013,0,0,0,0,0,0,0
36127,RM-B200B,7/15/2013,0,0,0,0,0,0,0
36128,RM-B200B,7/17/2013,0,0,0,0,0,0,0
36129,RM-B200B,7/18/2013,0,0,0,0,0,0,0
36130,RM-B200B,7/19/2013,0,0,0,0,0,0,0
36131,RM-B200B,7/20/2013,0,0,0,0,0,0,0
36132,RM-B200B,7/21/2013,0,0,0,0,0,0,0
36133,RM-B200B,7/22/2013,0,0,0,0,0,0,0
36134,RM-B200B,7/23/2013,0,0,0,0,0,0,0
36135,RM-B200B,7/24/2013,0,0,0,0,0,0,0
36136,RM-B200B,7/25/2013,0,0,0,0,0,0,0
36137,RM-B200B,7/26/2013,0,0,0,0,0,0,0
36138,RM-B200B,7/27/2013,0,0,0,0,0,0,0
36139,RM-B200B,7/28/2013,0,0,0,0,0,0,0
36140,RM-B200B,7/29/2013,0,0,0,0,0,0,0
36141,RM-B200B,7/30/2013,0,0,0,0,0,0,0
36142,RM-B200B,7/31/2013,0,0,0,0,0,0,0
36143,RM-B200B,8/1/2013,0,0,0,0,0,0,0
36144,RM-B200B,8/2/2013,0,0,0,0,0,0,0
36145,RM-B200B,8/3/2013,0,0,0,0,0,0,0
36146,RM-B200B,8/4/2013,0,0,0,0,0,0,0
36147,RM-B200B,8/5/2013,0,0,0,0,0,0,0
36148,RM-B200B,8/6/2013,0,0,0,0,0,0,0
36149,RM-B200B,8/7/2013,0,0,0,0,0,0,0
36150,RM-B200B,8/8/2013,0,0,0,0,0,0,0
36151,RM-B200B,8/9/2013,0,0,0,0,0,0,0
36152,RM-B200B,8/10/2013,0,0,0,0,0,0,0
36153,RM-B200B,8/11/2013,0,0,0,0,0,0,0
36154,RM-B200B,8/12/2013,0,0,0,0,0,0,0
36155,RM-B200B,8/13/2013,0,0,0,0,0,0,0
36156,RM-B200B,8/14/2013,0,0,0,0,0,0,0
36157,RM-B200B,8/15/2013,0,0,0,0,0,0,0
36158,RM-B200B,8/16/2013,0,0,0,0,0,0,0
36159,RM-B200B,8/17/2013,0,0,0,0,0,0,0
36160,RM-B200B,8/18/2013,0,0,0,0,0,0,0
36161,RM-B200B,8/19/2013,0,0,0,0,0,0,0
36162,RM-B200B,8/20/2013,0,0,0,0,0,0,0
36163,RM-B200B,8/21/2013,0,0,0,0,0,0,0
36164,RM-B200B,8/22/2013,0,0,0,0,0,0,0
36165,RM-B200B,8/27/2013,0,0,0,0,0,0,0
36580,RM-B200B,10/26/2014,0,0,0,0,0,0,0
36581,RM-B200B,10/27/2014,0,0,0,0,0,0,0
36582,RM-B200B,10/28/2014,0,0,0,0,0,0,0
36583,RM-B200B,10/29/2014,0,0,0,0,0,0,0
36584,RM-B200B,10/30/2014,0,0,0,0,0,0,0
36585,RM-B200B,10/31/2014,0,0,0,0,0,0,0
36586,RM-B200B,11/1/2014,0,0,0,0,0,0,0
36587,RM-B200B,11/2/2014,0,0,0,0,0,0,0
36588,RM-B200B,11/3/2014,0,0,0,0,0,0,0
36589,RM-B200B,11/4/2014,0,0,0,0,0,0,0
36590,RM-B200B,11/5/2014,0,0,0,0,0,0,0
36591,RM-B200B,11/6/2014,0,0,0,0,0,0,0
36592,RM-B200B,11/7/2014,0,0,0,0,0,0,0
36593,RM-B200B,11/8/2014,0,0,0,0,0,0,0
36594,RM-B200B,11/9/2014,0,0,0,0,0,0,0
36595,RM-B200B,11/10/2014,0,0,0,0,0,0,0
36596,RM-B200B,11/11/2014,0,0,0,0,0,0,0
36597,RM-B200B,11/12/2014,0,0,0,0,0,0,0
36598,RM-B200B,11/13/2014,0,0,0,0,0,0,0
36599,RM-B200B,11/14/2014,0,0,0,0,0,0,0
36600,RM-B200B,11/15/2014,0,0,0,0,0,0,0
36601,RM-B200B,11/16/2014,0,0,0,0,0,0,0
36602,RM-B200B,11/17/2014,0,0,0,0,0,0,0
36603,RM-B200B,11/18/2014,0,0,0,0,0,0,0
36604,RM-B200B,11/19/2014,0,0,0,0,0,0,0
36605,RM-B200B,11/20/2014,0,0,0,0,0,0,0
36606,RM-B200B,11/21/2014,0,0,0,0,0,0,0
36607,RM-B200B,11/22/2014,0,0,0,0,0,0,0
36608,RM-B200B,11/23/2014,0,0,0,0,0,0,0
36609,RM-B200B,11/24/2014,0,0,0,0,0,0,0
36610,RM-B200B,11/25/2014,0,0,0,0,0,0,0
36611,RM-B200B,11/26/2014,0,0,0,0,0,0,0
36612,RM-B200B,11/27/2014,0,0,0,0,0,0,0
36613,RM-B200B,11/28/2014,0,0,0,0,0,0,0
36614,RM-B200B,11/29/2014,0,0,0,0,0,0,0
36615,RM-B200B,11/30/2014,0,0,0,0,0,0,0
36616,RM-B200B,12/1/2014,0,0,0,0,0,0,0
36617,RM-B200B,12/2/2014,0,0,0,0,0,0,0
36618,RM-B200B,12/3/2014,0,0,0,0,0,0,0
36619,RM-B200B,12/4/2014,0,0,0,0,0,0,0
36620,RM-B200B,12/5/2014,0,0,0,0,0,0,0
36621,RM-B200B,12/6/2014,0,0,0,0,0,0,0
36622,RM-B200B,12/7/2014,0,0,0,0,0,0,0
36623,RM-B200B,12/8/2014,0,0,0,0,0,0,0
36624,RM-B200B,12/9/2014,0,0,0,0,0,0,0
36625,RM-B200B,12/10/2014,0,0,0,0,0,0,0
36626,RM-B200B,12/11/2014,0,0,0,0,0,0,0
36627,RM-B200B,12/12/2014,0,0,0,0,0,0,0
36628,RM-B200B,12/13/2014,0,0,0,0,0,0,0
36629,RM-B200B,12/14/2014,0,0,0,0,0,0,0
36630,RM-B200B,12/15/2014,0,0,0,0,0,0,0
36631,RM-B200B,12/16/2014,0,0,0,0,0,0,0
36632,RM-B200B,12/17/2014,0,0,0,0,0,0,0
36633,RM-B200B,12/18/2014,0,0,0,0,0,0,0
36634,RM-B200B,12/19/2014,0,0,0,0,0,0,0
36635,RM-B200B,12/24/2014,0,0,0,0,0,0,0
36636,RM-B200B,12/25/2014,0,0,0,0,0,0,0
36637,RM-B200B,12/26/2014,0,0,0,0,0,0,0
36638,RM-B200B,12/27/2014,0,0,0,0,0,0,0
36639,RM-B200B,12/28/2014,0,0,0,0,0,0,0
36640,RM-B200B,12/29/2014,0,0,0,0,0,0,0
36641,RM-B200B,12/30/2014,0,0,0,0,0,0,0
36642,RM-B200B,12/31/2014,0,0,0,0,0,0,0
36643,RM-B200B,1/1/2015,0,0,0,0,0,0,0
36644,RM-B200B,1/2/2015,0,0,0,0,0,0,0
36645,RM-B200B,1/3/2015,0,0,0,0,0,0,0
36646,RM-B200B,1/4/2015,0,0,0,0,0,0,0
36647,RM-B200B,1/5/2015,0,0,0,0,0,0,0
36648,RM-B200B,1/6/2015,0,0,0,0,0,0,0
36649,RM-B200B,1/7/2015,0,0,0,0,0,0,0
36650,RM-B200B,1/8/2015,0,0,0,0,0,0,0
36651,RM-B200B,1/9/2015,0,0,0,0,0,0,0
36652,RM-B200B,1/10/2015,0,0,0,0,0,0,0
36653,RM-B200B,1/11/2015,0,0,0,0,0,0,0
36654,RM-B200B,1/12/2015,0,0,0,0,0,0,0
36655,RM-B200B,1/13/2015,0,0,0,0,0,0,0
36656,RM-B200B,1/14/2015,0,0,0,0,0,0,0
36657,RM-B200B,1/15/2015,0,0,0,0,0,0,0
36658,RM-B200B,1/16/2015,0,0,0,0,0,0,0
36659,RM-B200B,1/17/2015,0,0,0,0,0,0,0
36660,RM-B200B,1/18/2015,0,0,0,0,0,0,0
36661,RM-B200B,1/19/2015,0,0,0,0,0,0,0
36662,RM-B200B,1/20/2015,0,0,0,0,0,0,0
36663,RM-B200B,1/21/2015,0,0,0,0,0,0,0
36664,RM-B200B,1/22/2015,0,0,0,0,0,0,0
36754,RM-B200B,4/22/2015,0,0,0,0,0,0,0
36755,RM-B200B,4/23/2015,0,0,0,0,0,0,0
36756,RM-B200B,4/24/2015,0,0,0,0,0,0,0
36757,RM-B200B,4/25/2015,0,0,0,0,0,0,0
36758,RM-B200B,4/26/2015,0,0,0,0,0,0,0
36759,RM-B200B,4/27/2015,0,0,0,0,0,0,0
36760,RM-B200B,4/28/2015,0,0,0,0,0,0,0
36761,RM-B200B,4/29/2015,0,0,0,0,0,0,0
36762,RM-B200B,4/30/2015,0,0,0,0,0,0,0
36763,RM-B200B,5/1/2015,0,0,0,0,0,0,0
36764,RM-B200B,5/2/2015,0,0,0,0,0,0,0
36765,RM-B200B,5/3/2015,0,0,0,0,0,0,0
36766,RM-B200B,5/4/2015,0,0,0,0,0,0,0
36767,RM-B200B,5/5/2015,0,0,0,0,0,0,0
36768,RM-B200B,5/6/2015,0,0,0,0,0,0,0
36769,RM-B200B,5/7/2015,0,0,0,0,0,0,0
36770,RM-B200B,5/8/2015,0,0,0,0,0,0,0
36771,RM-B200B,5/9/2015,0,0,0,0,0,0,0
36772,RM-B200B,5/10/2015,0,0,0,0,0,0,0
36773,RM-B200B,5/11/2015,0,0,0,0,0,0,0
36774,RM-B200B,5/12/2015,0,0,0,0,0,0,0
36775,RM-B200B,5/13/2015,0,0,0,0,0,0,0
36776,RM-B200B,5/14/2015,0,0,0,0,0,0,0
36777,RM-B200B,5/15/2015,0,0,0,0,0,0,0
36778,RM-B200B,5/16/2015,0,0,0,0,0,0,0
36779,RM-B200B,5/17/2015,0,0,0,0,0,0,0
36780,RM-B200B,5/18/2015,0,0,0,0,0,0,0
36781,RM-B200B,5/19/2015,0,0,0,0,0,0,0
36782,RM-B200B,5/20/2015,0,0,0,0,0,0,0
36783,RM-B200B,5/21/2015,0,0,0,0,0,0,0
36784,RM-B200B,5/22/2015,0,0,0,0,0,0,0
36785,RM-B200B,5/23/2015,0,0,0,0,0,0,0
36786,RM-B200B,5/24/2015,0,0,0,0,0,0,0
36787,RM-B200B,5/25/2015,0,0,0,0,0,0,0
36788,RM-B200B,5/26/2015,0,0,0,0,0,0,0
36789,RM-B200B,5/27/2015,0,0,0,0,0,0,0
36790,RM-B200B,5/28/2015,0,0,0,0,0,0,0
36791,RM-B200B,5/29/2015,0,0,0,0,0,0,0
36792,RM-B200B,5/30/2015,0,0,0,0,0,0,0
36793,RM-B200B,5/31/2015,0,0,0,0,0,0,0
37479,RM-B210,6/28/2013,0,0,0,0,0,0,0
37480,RM-B210,6/29/2013,0,0,0,0,0,0,0
37481,RM-B210,6/30/2013,0,0,0,0,0,0,0
37523,RM-B210,8/12/2013,0,0,0,0,0,0,0
37524,RM-B210,8/13/2013,0,0,0,0,0,0,0
37525,RM-B210,8/14/2013,0,0,0,0,0,0,0
37526,RM-B210,8/15/2013,0,0,0,0,0,0,0
37527,RM-B210,8/16/2013,0,0,0,0,0,0,0
37528,RM-B210,8/17/2013,0,0,0,0,0,0,0
37529,RM-B210,8/18/2013,0,0,0,0,0,0,0
37530,RM-B210,8/19/2013,0,0,0,0,0,0,0
37531,RM-B210,8/20/2013,0,0,0,0,0,0,0
37532,RM-B210,8/21/2013,0,0,0,0,0,0,0
37533,RM-B210,8/22/2013,0,0,0,0,0,0,0
37534,RM-B210,8/27/2013,0,0,0,0,0,0,0
37535,RM-B210,8/28/2013,0,0,0,0,0,0,0
37536,RM-B210,8/29/2013,0,0,0,0,0,0,0
37537,RM-B210,8/30/2013,0,0,0,0,0,0,0
37538,RM-B210,9/4/2013,0,0,0,0,0,0,0
37539,RM-B210,9/5/2013,0,0,0,0,0,0,0
37540,RM-B210,9/6/2013,0,0,0,0,0,0,0
37541,RM-B210,9/7/2013,0,0,0,0,0,0,0
37542,RM-B210,9/9/2013,0,0,0,0,0,0,0
37543,RM-B210,9/10/2013,0,0,0,0,0,0,0
37544,RM-B210,9/11/2013,0,0,0,0,0,0,0
37545,RM-B210,9/12/2013,0,0,0,0,0,0,0
37546,RM-B210,9/13/2013,0,0,0,0,0,0,0
37547,RM-B210,9/14/2013,0,0,0,0,0,0,0
37548,RM-B210,9/15/2013,0,0,0,0,0,0,0
37549,RM-B210,9/16/2013,0,0,0,0,0,0,0
37550,RM-B210,9/17/2013,0,0,0,0,0,0,0
37551,RM-B210,9/18/2013,0,0,0,0,0,0,0
37552,RM-B210,9/19/2013,0,0,0,0,0,0,0
37553,RM-B210,9/20/2013,0,0,0,0,0,0,0
37554,RM-B210,9/21/2013,0,0,0,0,0,0,0
37555,RM-B210,9/22/2013,0,0,0,0,0,0,0
37556,RM-B210,9/23/2013,0,0,0,0,0,0,0
37557,RM-B210,9/24/2013,0,0,0,0,0,0,0
37558,RM-B210,9/25/2013,0,0,0,0,0,0,0
37559,RM-B210,9/26/2013,0,0,0,0,0,0,0
37560,RM-B210,9/27/2013,0,0,0,0,0,0,0
37561,RM-B210,9/28/2013,0,0,0,0,0,0,0
37562,RM-B210,9/29/2013,0,0,0,0,0,0,0
37563,RM-B210,9/30/2013,0,0,0,0,0,0,0
37564,RM-B210,10/1/2013,0,0,0,0,0,0,0
37565,RM-B210,10/2/2013,0,0,0,0,0,0,0
37566,RM-B210,10/3/2013,0,0,0,0,0,0,0
37567,RM-B210,10/4/2013,0,0,0,0,0,0,0
37568,RM-B210,10/5/2013,0,0,0,0,0,0,0
37569,RM-B210,10/6/2013,0,0,0,0,0,0,0
37570,RM-B210,10/7/2013,0,0,0,0,0,0,0
37571,RM-B210,10/8/2013,0,0,0,0,0,0,0
37572,RM-B210,10/9/2013,0,0,0,0,0,0,0
37573,RM-B210,10/10/2013,0,0,0,0,0,0,0
37574,RM-B210,10/11/2013,0,0,0,0,0,0,0
37575,RM-B210,10/12/2013,0,0,0,0,0,0,0
37576,RM-B210,10/13/2013,0,0,0,0,0,0,0
37577,RM-B210,10/14/2013,0,0,0,0,0,0,0
37578,RM-B210,10/15/2013,0,0,0,0,0,0,0
37579,RM-B210,10/16/2013,0,0,0,0,0,0,0
37580,RM-B210,10/17/2013,0,0,0,0,0,0,0
37581,RM-B210,10/18/2013,0,0,0,0,0,0,0
37582,RM-B210,10/19/2013,0,0,0,0,0,0,0
37583,RM-B210,10/20/2013,0,0,0,0,0,0,0
37584,RM-B210,10/21/2013,0,0,0,0,0,0,0
37585,RM-B210,10/22/2013,0,0,0,0,0,0,0
37586,RM-B210,10/23/2013,0,0,0,0,0,0,0
37587,RM-B210,10/24/2013,0,0,0,0,0,0,0
37588,RM-B210,10/25/2013,0,0,0,0,0,0,0
37589,RM-B210,10/26/2013,0,0,0,0,0,0,0
37590,RM-B210,10/27/2013,0,0,0,0,0,0,0
37591,RM-B210,10/28/2013,0,0,0,0,0,0,0
37592,RM-B210,10/29/2013,0,0,0,0,0,0,0
37593,RM-B210,10/30/2013,0,0,0,0,0,0,0
37594,RM-B210,10/31/2013,0,0,0,0,0,0,0
37595,RM-B210,11/1/2013,0,0,0,0,0,0,0
37596,RM-B210,11/2/2013,0,0,0,0,0,0,0
37597,RM-B210,11/3/2013,0,0,0,0,0,0,0
37598,RM-B210,11/4/2013,0,0,0,0,0,0,0
37599,RM-B210,11/5/2013,0,0,0,0,0,0,0
37600,RM-B210,11/6/2013,0,0,0,0,0,0,0
37601,RM-B210,11/7/2013,0,0,0,0,0,0,0
37602,RM-B210,11/8/2013,0,0,0,0,0,0,0
37603,RM-B210,11/9/2013,0,0,0,0,0,0,0
37604,RM-B210,11/10/2013,0,0,0,0,0,0,0
37605,RM-B210,11/11/2013,0,0,0,0,0,0,0
37606,RM-B210,11/12/2013,0,0,0,0,0,0,0
37607,RM-B210,11/13/2013,0,0,0,0,0,0,0
37608,RM-B210,11/14/2013,0,0,0,0,0,0,0
37609,RM-B210,11/15/2013,0,0,0,0,0,0,0
37610,RM-B210,11/19/2013,0,0,0,0,0,0,0
37611,RM-B210,11/20/2013,0,0,0,0,0,0,0
37612,RM-B210,11/21/2013,0,0,0,0,0,0,0
37613,RM-B210,11/22/2013,0,0,0,0,0,0,0
37614,RM-B210,11/23/2013,0,0,0,0,0,0,0
37615,RM-B210,11/24/2013,0,0,0,0,0,0,0
37616,RM-B210,11/25/2013,0,0,0,0,0,0,0
37617,RM-B210,11/26/2013,0,0,0,0,0,0,0
37618,RM-B210,11/27/2013,0,0,0,0,0,0,0
37619,RM-B210,11/28/2013,0,0,0,0,0,0,0
37620,RM-B210,11/29/2013,0,0,0,0,0,0,0
37621,RM-B210,11/30/2013,0,0,0,0,0,0,0
37622,RM-B210,12/1/2013,0,0,0,0,0,0,0
37623,RM-B210,12/2/2013,0,0,0,0,0,0,0
37624,RM-B210,12/3/2013,0,0,0,0,0,0,0
37625,RM-B210,12/4/2013,0,0,0,0,0,0,0
37626,RM-B210,12/5/2013,0,0,0,0,0,0,0
37627,RM-B210,12/6/2013,0,0,0,0,0,0,0
37628,RM-B210,12/7/2013,0,0,0,0,0,0,0
37629,RM-B210,12/8/2013,0,0,0,0,0,0,0
37630,RM-B210,12/9/2013,0,0,0,0,0,0,0
37631,RM-B210,12/10/2013,0,0,0,0,0,0,0
37632,RM-B210,12/11/2013,0,0,0,0,0,0,0
37633,RM-B210,12/12/2013,0,0,0,0,0,0,0
37634,RM-B210,12/13/2013,0,0,0,0,0,0,0
37635,RM-B210,12/14/2013,0,0,0,0,0,0,0
37636,RM-B210,12/15/2013,0,0,0,0,0,0,0
37637,RM-B210,12/16/2013,0,0,0,0,0,0,0
37638,RM-B210,12/17/2013,0,0,0,0,0,0,0
37639,RM-B210,12/18/2013,0,0,0,0,0,0,0
37640,RM-B210,12/19/2013,0,0,0,0,0,0,0
37641,RM-B210,12/20/2013,0,0,0,0,0,0,0
37642,RM-B210,12/21/2013,0,0,0,0,0,0,0
37643,RM-B210,12/22/2013,0,0,0,0,0,0,0
37644,RM-B210,12/23/2013,0,0,0,0,0,0,0
37645,RM-B210,12/24/2013,0,0,0,0,0,0,0
37646,RM-B210,12/25/2013,0,0,0,0,0,0,0
37647,RM-B210,12/26/2013,0,0,0,0,0,0,0
37648,RM-B210,12/27/2013,0,0,0,0,0,0,0
37649,RM-B210,12/28/2013,0,0,0,0,0,0,0
37650,RM-B210,12/29/2013,0,0,0,0,0,0,0
37651,RM-B210,12/30/2013,0,0,0,0,0,0,0
37652,RM-B210,12/31/2013,0,0,0,0,0,0,0
37653,RM-B210,1/1/2014,0,0,0,0,0,0,0
37654,RM-B210,1/2/2014,0,0,0,0,0,0,0
37655,RM-B210,1/3/2014,0,0,0,0,0,0,0
37656,RM-B210,1/4/2014,0,0,0,0,0,0,0
37657,RM-B210,1/5/2014,0,0,0,0,0,0,0
37658,RM-B210,1/6/2014,0,0,0,0,0,0,0
37659,RM-B210,1/7/2014,0,0,0,0,0,0,0
37660,RM-B210,1/8/2014,0,0,0,0,0,0,0
37661,RM-B210,1/9/2014,0,0,0,0,0,0,0
37662,RM-B210,1/10/2014,0,0,0,0,0,0,0
37663,RM-B210,1/11/2014,0,0,0,0,0,0,0
37664,RM-B210,1/12/2014,0,0,0,0,0,0,0
37665,RM-B210,1/13/2014,0,0,0,0,0,0,0
37666,RM-B210,1/14/2014,0,0,0,0,0,0,0
37667,RM-B210,1/15/2014,0,0,0,0,0,0,0
37668,RM-B210,1/16/2014,0,0,0,0,0,0,0
37669,RM-B210,1/17/2014,0,0,0,0,0,0,0
37670,RM-B210,1/18/2014,0,0,0,0,0,0,0
37671,RM-B210,1/19/2014,0,0,0,0,0,0,0
37672,RM-B210,1/20/2014,0,0,0,0,0,0,0
37673,RM-B210,1/21/2014,0,0,0,0,0,0,0
37674,RM-B210,1/22/2014,0,0,0,0,0,0,0
37675,RM-B210,1/23/2014,0,0,0,0,0,0,0
37676,RM-B210,1/24/2014,0,0,0,0,0,0,0
37677,RM-B210,1/25/2014,0,0,0,0,0,0,0
37678,RM-B210,1/26/2014,0,0,0,0,0,0,0
37679,RM-B210,1/27/2014,0,0,0,0,0,0,0
37680,RM-B210,1/28/2014,0,0,0,0,0,0,0
37681,RM-B210,1/29/2014,0,0,0,0,0,0,0
37682,RM-B210,1/30/2014,0,0,0,0,0,0,0
37683,RM-B210,1/31/2014,0,0,0,0,0,0,0
37684,RM-B210,2/1/2014,0,0,0,0,0,0,0
37685,RM-B210,2/2/2014,0,0,0,0,0,0,0
37686,RM-B210,2/3/2014,0,0,0,0,0,0,0
37687,RM-B210,2/4/2014,0,0,0,0,0,0,0
37688,RM-B210,2/5/2014,0,0,0,0,0,0,0
37689,RM-B210,2/6/2014,0,0,0,0,0,0,0
37690,RM-B210,2/7/2014,0,0,0,0,0,0,0
37691,RM-B210,2/8/2014,0,0,0,0,0,0,0
37692,RM-B210,2/9/2014,0,0,0,0,0,0,0
37693,RM-B210,2/10/2014,0,0,0,0,0,0,0
37694,RM-B210,2/11/2014,0,0,0,0,0,0,0
37695,RM-B210,2/12/2014,0,0,0,0,0,0,0
37696,RM-B210,2/13/2014,0,0,0,0,0,0,0
37697,RM-B210,2/14/2014,0,0,0,0,0,0,0
37698,RM-B210,2/15/2014,0,0,0,0,0,0,0
37699,RM-B210,2/16/2014,0,0,0,0,0,0,0
37700,RM-B210,2/17/2014,0,0,0,0,0,0,0
37701,RM-B210,2/18/2014,0,0,0,0,0,0,0
37702,RM-B210,2/19/2014,0,0,0,0,0,0,0
37703,RM-B210,2/20/2014,0,0,0,0,0,0,0
37704,RM-B210,2/21/2014,0,0,0,0,0,0,0
37705,RM-B210,2/22/2014,0,0,0,0,0,0,0
37706,RM-B210,2/23/2014,0,0,0,0,0,0,0
37707,RM-B210,2/24/2014,0,0,0,0,0,0,0
37708,RM-B210,2/25/2014,0,0,0,0,0,0,0
37709,RM-B210,2/26/2014,0,0,0,0,0,0,0
37710,RM-B210,2/27/2014,0,0,0,0,0,0,0
37711,RM-B210,2/28/2014,0,0,0,0,0,0,0
37712,RM-B210,3/1/2014,0,0,0,0,0,0,0
37713,RM-B210,3/2/2014,0,0,0,0,0,0,0
37714,RM-B210,3/3/2014,0,0,0,0,0,0,0
37715,RM-B210,3/4/2014,0,0,0,0,0,0,0
37716,RM-B210,3/5/2014,0,0,0,0,0,0,0
37717,RM-B210,3/6/2014,0,0,0,0,0,0,0
37718,RM-B210,3/7/2014,0,0,0,0,0,0,0
37719,RM-B210,3/8/2014,0,0,0,0,0,0,0
37720,RM-B210,3/9/2014,0,0,0,0,0,0,0
37721,RM-B210,3/10/2014,0,0,0,0,0,0,0
37722,RM-B210,3/11/2014,0,0,0,0,0,0,0
37723,RM-B210,3/12/2014,0,0,0,0,0,0,0
37724,RM-B210,3/13/2014,0,0,0,0,0,0,0
37725,RM-B210,3/14/2014,0,0,0,0,0,0,0
37726,RM-B210,3/15/2014,0,0,0,0,0,0,0
37727,RM-B210,3/16/2014,0,0,0,0,0,0,0
37728,RM-B210,3/17/2014,0,0,0,0,0,0,0
37729,RM-B210,3/18/2014,0,0,0,0,0,0,0
37730,RM-B210,3/19/2014,0,0,0,0,0,0,0
37731,RM-B210,3/20/2014,0,0,0,0,0,0,0
37732,RM-B210,3/21/2014,0,0,0,0,0,0,0
37733,RM-B210,3/22/2014,0,0,0,0,0,0,0
37734,RM-B210,3/23/2014,0,0,0,0,0,0,0
37735,RM-B210,3/24/2014,0,0,0,0,0,0,0
37736,RM-B210,3/25/2014,0,0,0,0,0,0,0
37737,RM-B210,3/26/2014,0,0,0,0,0,0,0
37738,RM-B210,3/27/2014,0,0,0,0,0,0,0
37739,RM-B210,3/28/2014,0,0,0,0,0,0,0
37740,RM-B210,3/29/2014,0,0,0,0,0,0,0
37741,RM-B210,3/30/2014,0,0,0,0,0,0,0
37742,RM-B210,3/31/2014,0,0,0,0,0,0,0
37743,RM-B210,4/1/2014,0,0,0,0,0,0,0
37744,RM-B210,4/2/2014,0,0,0,0,0,0,0
37745,RM-B210,4/3/2014,0,0,0,0,0,0,0
37746,RM-B210,4/4/2014,0,0,0,0,0,0,0
37747,RM-B210,4/5/2014,0,0,0,0,0,0,0
37748,RM-B210,4/6/2014,0,0,0,0,0,0,0
37749,RM-B210,4/7/2014,0,0,0,0,0,0,0
37750,RM-B210,4/8/2014,0,0,0,0,0,0,0
37751,RM-B210,4/9/2014,0,0,0,0,0,0,0
37752,RM-B210,4/10/2014,0,0,0,0,0,0,0
37753,RM-B210,4/11/2014,0,0,0,0,0,0,0
37754,RM-B210,4/12/2014,0,0,0,0,0,0,0
37755,RM-B210,4/13/2014,0,0,0,0,0,0,0
37756,RM-B210,4/14/2014,0,0,0,0,0,0,0
37757,RM-B210,4/15/2014,0,0,0,0,0,0,0
37758,RM-B210,4/16/2014,0,0,0,0,0,0,0
37759,RM-B210,4/17/2014,0,0,0,0,0,0,0
37760,RM-B210,4/18/2014,0,0,0,0,0,0,0
37761,RM-B210,4/19/2014,0,0,0,0,0,0,0
37762,RM-B210,4/20/2014,0,0,0,0,0,0,0
37763,RM-B210,4/21/2014,0,0,0,0,0,0,0
37764,RM-B210,4/22/2014,0,0,0,0,0,0,0
37765,RM-B210,4/23/2014,0,0,0,0,0,0,0
37766,RM-B210,4/24/2014,0,0,0,0,0,0,0
37767,RM-B210,4/25/2014,0,0,0,0,0,0,0
37768,RM-B210,4/26/2014,0,0,0,0,0,0,0
37769,RM-B210,4/27/2014,0,0,0,0,0,0,0
37770,RM-B210,4/28/2014,0,0,0,0,0,0,0
37771,RM-B210,4/29/2014,0,0,0,0,0,0,0
37772,RM-B210,4/30/2014,0,0,0,0,0,0,0
37773,RM-B210,5/1/2014,0,0,0,0,0,0,0
37774,RM-B210,5/2/2014,0,0,0,0,0,0,0
37775,RM-B210,5/3/2014,0,0,0,0,0,0,0
37776,RM-B210,5/4/2014,0,0,0,0,0,0,0
37777,RM-B210,5/5/2014,0,0,0,0,0,0,0
37778,RM-B210,5/6/2014,0,0,0,0,0,0,0
37779,RM-B210,5/7/2014,0,0,0,0,0,0,0
37780,RM-B210,5/8/2014,0,0,0,0,0,0,0
37781,RM-B210,5/9/2014,0,0,0,0,0,0,0
37782,RM-B210,5/10/2014,0,0,0,0,0,0,0
37783,RM-B210,5/11/2014,0,0,0,0,0,0,0
37784,RM-B210,5/12/2014,0,0,0,0,0,0,0
37785,RM-B210,5/13/2014,0,0,0,0,0,0,0
37786,RM-B210,5/14/2014,0,0,0,0,0,0,0
37787,RM-B210,5/15/2014,0,0,0,0,0,0,0
37788,RM-B210,5/16/2014,0,0,0,0,0,0,0
37789,RM-B210,5/17/2014,0,0,0,0,0,0,0
37790,RM-B210,5/18/2014,0,0,0,0,0,0,0
37791,RM-B210,5/19/2014,0,0,0,0,0,0,0
37792,RM-B210,5/20/2014,0,0,0,0,0,0,0
37793,RM-B210,5/21/2014,0,0,0,0,0,0,0
37794,RM-B210,5/22/2014,0,0,0,0,0,0,0
37795,RM-B210,5/23/2014,0,0,0,0,0,0,0
37796,RM-B210,5/24/2014,0,0,0,0,0,0,0
37797,RM-B210,5/25/2014,0,0,0,0,0,0,0
37798,RM-B210,5/26/2014,0,0,0,0,0,0,0
37799,RM-B210,5/27/2014,0,0,0,0,0,0,0
37800,RM-B210,5/28/2014,0,0,0,0,0,0,0
37801,RM-B210,5/29/2014,0,0,0,0,0,0,0
37802,RM-B210,5/30/2014,0,0,0,0,0,0,0
37803,RM-B210,5/31/2014,0,0,0,0,0,0,0
37804,RM-B210,6/1/2014,0,0,0,0,0,0,0
37805,RM-B210,6/2/2014,0,0,0,0,0,0,0
37806,RM-B210,6/3/2014,0,0,0,0,0,0,0
37807,RM-B210,6/4/2014,0,0,0,0,0,0,0
37808,RM-B210,6/5/2014,0,0,0,0,0,0,0
37809,RM-B210,6/6/2014,0,0,0,0,0,0,0
37810,RM-B210,6/7/2014,0,0,0,0,0,0,0
37811,RM-B210,6/8/2014,0,0,0,0,0,0,0
37812,RM-B210,6/9/2014,0,0,0,0,0,0,0
37813,RM-B210,6/10/2014,0,0,0,0,0,0,0
37814,RM-B210,6/11/2014,0,0,0,0,0,0,0
37815,RM-B210,6/12/2014,0,0,0,0,0,0,0
37816,RM-B210,6/13/2014,0,0,0,0,0,0,0
37817,RM-B210,6/14/2014,0,0,0,0,0,0,0
37818,RM-B210,6/15/2014,0,0,0,0,0,0,0
37819,RM-B210,6/16/2014,0,0,0,0,0,0,0
37820,RM-B210,6/17/2014,0,0,0,0,0,0,0
37821,RM-B210,6/18/2014,0,0,0,0,0,0,0
37822,RM-B210,6/19/2014,0,0,0,0,0,0,0
37823,RM-B210,6/20/2014,0,0,0,0,0,0,0
37824,RM-B210,6/21/2014,0,0,0,0,0,0,0
37825,RM-B210,6/22/2014,0,0,0,0,0,0,0
37826,RM-B210,6/23/2014,0,0,0,0,0,0,0
37827,RM-B210,6/24/2014,0,0,0,0,0,0,0
37828,RM-B210,6/25/2014,0,0,0,0,0,0,0
37829,RM-B210,6/26/2014,0,0,0,0,0,0,0
37830,RM-B210,6/27/2014,0,0,0,0,0,0,0
37831,RM-B210,6/28/2014,0,0,0,0,0,0,0
37832,RM-B210,6/29/2014,0,0,0,0,0,0,0
37833,RM-B210,6/30/2014,0,0,0,0,0,0,0
37834,RM-B210,7/1/2014,0,0,0,0,0,0,0
37835,RM-B210,7/2/2014,0,0,0,0,0,0,0
37836,RM-B210,7/3/2014,0,0,0,0,0,0,0
37837,RM-B210,7/4/2014,0,0,0,0,0,0,0
37838,RM-B210,7/5/2014,0,0,0,0,0,0,0
37839,RM-B210,7/6/2014,0,0,0,0,0,0,0
37840,RM-B210,7/7/2014,0,0,0,0,0,0,0
37841,RM-B210,7/8/2014,0,0,0,0,0,0,0
37842,RM-B210,7/9/2014,0,0,0,0,0,0,0
37843,RM-B210,7/10/2014,0,0,0,0,0,0,0
37844,RM-B210,7/11/2014,0,0,0,0,0,0,0
37845,RM-B210,7/12/2014,0,0,0,0,0,0,0
37846,RM-B210,7/13/2014,0,0,0,0,0,0,0
37847,RM-B210,7/14/2014,0,0,0,0,0,0,0
37848,RM-B210,7/15/2014,0,0,0,0,0,0,0
37849,RM-B210,7/16/2014,0,0,0,0,0,0,0
37850,RM-B210,7/17/2014,0,0,0,0,0,0,0
37851,RM-B210,7/18/2014,0,0,0,0,0,0,0
37852,RM-B210,7/19/2014,0,0,0,0,0,0,0
37853,RM-B210,7/20/2014,0,0,0,0,0,0,0
37854,RM-B210,7/21/2014,0,0,0,0,0,0,0
37855,RM-B210,7/22/2014,0,0,0,0,0,0,0
37856,RM-B210,7/23/2014,0,0,0,0,0,0,0
37857,RM-B210,7/24/2014,0,0,0,0,0,0,0
37858,RM-B210,7/25/2014,0,0,0,0,0,0,0
37859,RM-B210,7/26/2014,0,0,0,0,0,0,0
37860,RM-B210,7/27/2014,0,0,0,0,0,0,0
37861,RM-B210,7/28/2014,0,0,0,0,0,0,0
37862,RM-B210,7/29/2014,0,0,0,0,0,0,0
37863,RM-B210,7/30/2014,0,0,0,0,0,0,0
37864,RM-B210,7/31/2014,0,0,0,0,0,0,0
37865,RM-B210,8/1/2014,0,0,0,0,0,0,0
37866,RM-B210,8/2/2014,0,0,0,0,0,0,0
37867,RM-B210,8/3/2014,0,0,0,0,0,0,0
37868,RM-B210,8/4/2014,0,0,0,0,0,0,0
37869,RM-B210,8/5/2014,0,0,0,0,0,0,0
37870,RM-B210,8/6/2014,0,0,0,0,0,0,0
37871,RM-B210,8/7/2014,0,0,0,0,0,0,0
37872,RM-B210,8/8/2014,0,0,0,0,0,0,0
37873,RM-B210,8/9/2014,0,0,0,0,0,0,0
37874,RM-B210,8/10/2014,0,0,0,0,0,0,0
37875,RM-B210,8/11/2014,0,0,0,0,0,0,0
37876,RM-B210,8/12/2014,0,0,0,0,0,0,0
37877,RM-B210,8/13/2014,0,0,0,0,0,0,0
37878,RM-B210,8/14/2014,0,0,0,0,0,0,0
37879,RM-B210,8/15/2014,0,0,0,0,0,0,0
37880,RM-B210,8/16/2014,0,0,0,0,0,0,0
37881,RM-B210,8/17/2014,0,0,0,0,0,0,0
37882,RM-B210,8/18/2014,0,0,0,0,0,0,0
37883,RM-B210,8/19/2014,0,0,0,0,0,0,0
37884,RM-B210,8/20/2014,0,0,0,0,0,0,0
37885,RM-B210,8/21/2014,0,0,0,0,0,0,0
37886,RM-B210,8/22/2014,0,0,0,0,0,0,0
37887,RM-B210,8/23/2014,0,0,0,0,0,0,0
37888,RM-B210,8/24/2014,0,0,0,0,0,0,0
37889,RM-B210,8/25/2014,0,0,0,0,0,0,0
37890,RM-B210,8/26/2014,0,0,0,0,0,0,0
37891,RM-B210,8/27/2014,0,0,0,0,0,0,0
37892,RM-B210,8/28/2014,0,0,0,0,0,0,0
37893,RM-B210,8/29/2014,0,0,0,0,0,0,0
37894,RM-B210,8/30/2014,0,0,0,0,0,0,0
37895,RM-B210,8/31/2014,0,0,0,0,0,0,0
37896,RM-B210,9/1/2014,0,0,0,0,0,0,0
37897,RM-B210,9/2/2014,0,0,0,0,0,0,0
37898,RM-B210,9/3/2014,0,0,0,0,0,0,0
37899,RM-B210,9/4/2014,0,0,0,0,0,0,0
37900,RM-B210,9/5/2014,0,0,0,0,0,0,0
37901,RM-B210,9/6/2014,0,0,0,0,0,0,0
37902,RM-B210,9/7/2014,0,0,0,0,0,0,0
37903,RM-B210,9/8/2014,0,0,0,0,0,0,0
37904,RM-B210,9/9/2014,0,0,0,0,0,0,0
37905,RM-B210,9/10/2014,0,0,0,0,0,0,0
37906,RM-B210,9/11/2014,0,0,0,0,0,0,0
37907,RM-B210,9/12/2014,0,0,0,0,0,0,0
37908,RM-B210,9/13/2014,0,0,0,0,0,0,0
37909,RM-B210,9/14/2014,0,0,0,0,0,0,0
37910,RM-B210,9/15/2014,0,0,0,0,0,0,0
37911,RM-B210,9/16/2014,0,0,0,0,0,0,0
37912,RM-B210,9/17/2014,0,0,0,0,0,0,0
37913,RM-B210,9/18/2014,0,0,0,0,0,0,0
37914,RM-B210,9/19/2014,0,0,0,0,0,0,0
37915,RM-B210,9/20/2014,0,0,0,0,0,0,0
37916,RM-B210,9/21/2014,0,0,0,0,0,0,0
37917,RM-B210,9/22/2014,0,0,0,0,0,0,0
37918,RM-B210,9/23/2014,0,0,0,0,0,0,0
37919,RM-B210,9/24/2014,0,0,0,0,0,0,0
37920,RM-B210,9/25/2014,0,0,0,0,0,0,0
37921,RM-B210,9/28/2014,0,0,0,0,0,0,0
37922,RM-B210,9/29/2014,0,0,0,0,0,0,0
37923,RM-B210,9/30/2014,0,0,0,0,0,0,0
37924,RM-B210,10/1/2014,0,0,0,0,0,0,0
37925,RM-B210,10/2/2014,0,0,0,0,0,0,0
37926,RM-B210,10/3/2014,0,0,0,0,0,0,0
37927,RM-B210,10/4/2014,0,0,0,0,0,0,0
37928,RM-B210,10/5/2014,0,0,0,0,0,0,0
37929,RM-B210,10/6/2014,0,0,0,0,0,0,0
37930,RM-B210,10/7/2014,0,0,0,0,0,0,0
37931,RM-B210,10/8/2014,0,0,0,0,0,0,0
37932,RM-B210,10/9/2014,0,0,0,0,0,0,0
37933,RM-B210,10/10/2014,0,0,0,0,0,0,0
37934,RM-B210,10/11/2014,0,0,0,0,0,0,0
37935,RM-B210,10/12/2014,0,0,0,0,0,0,0
37936,RM-B210,10/13/2014,0,0,0,0,0,0,0
37937,RM-B210,10/14/2014,0,0,0,0,0,0,0
37938,RM-B210,10/15/2014,0,0,0,0,0,0,0
37939,RM-B210,10/16/2014,0,0,0,0,0,0,0
37940,RM-B210,10/17/2014,0,0,0,0,0,0,0
37941,RM-B210,10/18/2014,0,0,0,0,0,0,0
37942,RM-B210,10/19/2014,0,0,0,0,0,0,0
37943,RM-B210,10/20/2014,0,0,0,0,0,0,0
37944,RM-B210,10/21/2014,0,0,0,0,0,0,0
37945,RM-B210,10/22/2014,0,0,0,0,0,0,0
37946,RM-B210,10/23/2014,0,0,0,0,0,0,0
37947,RM-B210,10/24/2014,0,0,0,0,0,0,0
37948,RM-B210,10/25/2014,0,0,0,0,0,0,0
37949,RM-B210,10/26/2014,0,0,0,0,0,0,0
37950,RM-B210,10/27/2014,0,0,0,0,0,0,0
37951,RM-B210,10/28/2014,0,0,0,0,0,0,0
37952,RM-B210,10/29/2014,0,0,0,0,0,0,0
37953,RM-B210,10/30/2014,0,0,0,0,0,0,0
37954,RM-B210,10/31/2014,0,0,0,0,0,0,0
37955,RM-B210,11/1/2014,0,0,0,0,0,0,0
37956,RM-B210,11/2/2014,0,0,0,0,0,0,0
37957,RM-B210,11/3/2014,0,0,0,0,0,0,0
37958,RM-B210,11/4/2014,0,0,0,0,0,0,0
37959,RM-B210,11/5/2014,0,0,0,0,0,0,0
37960,RM-B210,11/6/2014,0,0,0,0,0,0,0
37961,RM-B210,11/7/2014,0,0,0,0,0,0,0
37962,RM-B210,11/8/2014,0,0,0,0,0,0,0
37963,RM-B210,11/9/2014,0,0,0,0,0,0,0
37964,RM-B210,11/10/2014,0,0,0,0,0,0,0
37965,RM-B210,11/11/2014,0,0,0,0,0,0,0
37966,RM-B210,11/12/2014,0,0,0,0,0,0,0
37967,RM-B210,11/13/2014,0,0,0,0,0,0,0
37968,RM-B210,11/14/2014,0,0,0,0,0,0,0
37969,RM-B210,11/15/2014,0,0,0,0,0,0,0
37970,RM-B210,11/16/2014,0,0,0,0,0,0,0
37971,RM-B210,11/17/2014,0,0,0,0,0,0,0
37972,RM-B210,11/18/2014,0,0,0,0,0,0,0
37973,RM-B210,11/19/2014,0,0,0,0,0,0,0
37974,RM-B210,11/20/2014,0,0,0,0,0,0,0
37975,RM-B210,11/21/2014,0,0,0,0,0,0,0
37976,RM-B210,11/22/2014,0,0,0,0,0,0,0
37977,RM-B210,11/23/2014,0,0,0,0,0,0,0
37978,RM-B210,11/24/2014,0,0,0,0,0,0,0
37979,RM-B210,11/25/2014,0,0,0,0,0,0,0
37980,RM-B210,11/26/2014,0,0,0,0,0,0,0
37981,RM-B210,11/27/2014,0,0,0,0,0,0,0
37982,RM-B210,11/28/2014,0,0,0,0,0,0,0
37983,RM-B210,11/29/2014,0,0,0,0,0,0,0
37984,RM-B210,11/30/2014,0,0,0,0,0,0,0
37985,RM-B210,12/1/2014,0,0,0,0,0,0,0
37986,RM-B210,12/2/2014,0,0,0,0,0,0,0
37987,RM-B210,12/3/2014,0,0,0,0,0,0,0
37988,RM-B210,12/4/2014,0,0,0,0,0,0,0
37989,RM-B210,12/5/2014,0,0,0,0,0,0,0
37990,RM-B210,12/6/2014,0,0,0,0,0,0,0
37991,RM-B210,12/7/2014,0,0,0,0,0,0,0
37992,RM-B210,12/8/2014,0,0,0,0,0,0,0
37993,RM-B210,12/9/2014,0,0,0,0,0,0,0
37994,RM-B210,12/10/2014,0,0,0,0,0,0,0
37995,RM-B210,12/11/2014,0,0,0,0,0,0,0
37996,RM-B210,12/12/2014,0,0,0,0,0,0,0
37997,RM-B210,12/13/2014,0,0,0,0,0,0,0
37998,RM-B210,12/14/2014,0,0,0,0,0,0,0
37999,RM-B210,12/15/2014,0,0,0,0,0,0,0
38000,RM-B210,12/16/2014,0,0,0,0,0,0,0
38001,RM-B210,12/17/2014,0,0,0,0,0,0,0
38002,RM-B210,12/18/2014,0,0,0,0,0,0,0
38003,RM-B210,12/19/2014,0,0,0,0,0,0,0
38004,RM-B210,12/20/2014,0,0,0,0,0,0,0
38005,RM-B210,12/21/2014,0,0,0,0,0,0,0
38006,RM-B210,12/22/2014,0,0,0,0,0,0,0
38007,RM-B210,12/23/2014,0,0,0,0,0,0,0
38008,RM-B210,12/24/2014,0,0,0,0,0,0,0
38009,RM-B210,12/25/2014,0,0,0,0,0,0,0
38010,RM-B210,12/26/2014,0,0,0,0,0,0,0
38011,RM-B210,12/27/2014,0,0,0,0,0,0,0
38012,RM-B210,12/28/2014,0,0,0,0,0,0,0
38013,RM-B210,12/29/2014,0,0,0,0,0,0,0
38014,RM-B210,12/30/2014,0,0,0,0,0,0,0
38015,RM-B210,12/31/2014,0,0,0,0,0,0,0
38016,RM-B210,1/1/2015,0,0,0,0,0,0,0
38017,RM-B210,1/2/2015,0,0,0,0,0,0,0
38018,RM-B210,1/3/2015,0,0,0,0,0,0,0
38019,RM-B210,1/4/2015,0,0,0,0,0,0,0
38020,RM-B210,1/5/2015,0,0,0,0,0,0,0
38021,RM-B210,1/6/2015,0,0,0,0,0,0,0
38022,RM-B210,1/7/2015,0,0,0,0,0,0,0
38023,RM-B210,1/8/2015,0,0,0,0,0,0,0
38024,RM-B210,1/9/2015,0,0,0,0,0,0,0
38025,RM-B210,1/10/2015,0,0,0,0,0,0,0
38026,RM-B210,1/11/2015,0,0,0,0,0,0,0
38027,RM-B210,1/12/2015,0,0,0,0,0,0,0
38028,RM-B210,1/13/2015,0,0,0,0,0,0,0
38029,RM-B210,1/14/2015,0,0,0,0,0,0,0
38030,RM-B210,1/15/2015,0,0,0,0,0,0,0
38031,RM-B210,1/16/2015,0,0,0,0,0,0,0
38032,RM-B210,1/17/2015,0,0,0,0,0,0,0
38033,RM-B210,1/18/2015,0,0,0,0,0,0,0
38034,RM-B210,1/19/2015,0,0,0,0,0,0,0
38035,RM-B210,1/20/2015,0,0,0,0,0,0,0
38036,RM-B210,1/21/2015,0,0,0,0,0,0,0
38037,RM-B210,1/22/2015,0,0,0,0,0,0,0
38038,RM-B210,1/23/2015,0,0,0,0,0,0,0
38039,RM-B210,1/24/2015,0,0,0,0,0,0,0
38040,RM-B210,1/25/2015,0,0,0,0,0,0,0
38041,RM-B210,1/26/2015,0,0,0,0,0,0,0
38042,RM-B210,1/27/2015,0,0,0,0,0,0,0
38043,RM-B210,1/28/2015,0,0,0,0,0,0,0
38044,RM-B210,1/29/2015,0,0,0,0,0,0,0
38045,RM-B210,1/30/2015,0,0,0,0,0,0,0
38046,RM-B210,1/31/2015,0,0,0,0,0,0,0
38047,RM-B210,2/1/2015,0,0,0,0,0,0,0
38048,RM-B210,2/2/2015,0,0,0,0,0,0,0
38049,RM-B210,2/3/2015,0,0,0,0,0,0,0
38050,RM-B210,2/4/2015,0,0,0,0,0,0,0
38051,RM-B210,2/5/2015,0,0,0,0,0,0,0
38052,RM-B210,2/6/2015,0,0,0,0,0,0,0
38053,RM-B210,2/7/2015,0,0,0,0,0,0,0
38054,RM-B210,2/8/2015,0,0,0,0,0,0,0
38055,RM-B210,2/9/2015,0,0,0,0,0,0,0
38056,RM-B210,2/10/2015,0,0,0,0,0,0,0
38057,RM-B210,2/11/2015,0,0,0,0,0,0,0
38058,RM-B210,2/12/2015,0,0,0,0,0,0,0
38059,RM-B210,2/13/2015,0,0,0,0,0,0,0
38060,RM-B210,2/14/2015,0,0,0,0,0,0,0
38061,RM-B210,2/15/2015,0,0,0,0,0,0,0
38062,RM-B210,2/16/2015,0,0,0,0,0,0,0
38063,RM-B210,2/17/2015,0,0,0,0,0,0,0
38064,RM-B210,2/18/2015,0,0,0,0,0,0,0
38065,RM-B210,2/19/2015,0,0,0,0,0,0,0
38066,RM-B210,2/20/2015,0,0,0,0,0,0,0
38067,RM-B210,2/21/2015,0,0,0,0,0,0,0
38068,RM-B210,2/22/2015,0,0,0,0,0,0,0
38069,RM-B210,2/23/2015,0,0,0,0,0,0,0
38070,RM-B210,2/24/2015,0,0,0,0,0,0,0
38071,RM-B210,2/25/2015,0,0,0,0,0,0,0
38072,RM-B210,2/26/2015,0,0,0,0,0,0,0
38073,RM-B210,2/27/2015,0,0,0,0,0,0,0
38074,RM-B210,2/28/2015,0,0,0,0,0,0,0
38075,RM-B210,3/1/2015,0,0,0,0,0,0,0
38076,RM-B210,3/2/2015,0,0,0,0,0,0,0
38077,RM-B210,3/3/2015,0,0,0,0,0,0,0
38078,RM-B210,3/4/2015,0,0,0,0,0,0,0
38079,RM-B210,3/5/2015,0,0,0,0,0,0,0
38080,RM-B210,3/6/2015,0,0,0,0,0,0,0
38081,RM-B210,3/7/2015,0,0,0,0,0,0,0
38082,RM-B210,3/8/2015,0,0,0,0,0,0,0
38083,RM-B210,3/9/2015,0,0,0,0,0,0,0
38084,RM-B210,3/10/2015,0,0,0,0,0,0,0
38085,RM-B210,3/11/2015,0,0,0,0,0,0,0
38086,RM-B210,3/12/2015,0,0,0,0,0,0,0
38087,RM-B210,3/13/2015,0,0,0,0,0,0,0
38088,RM-B210,3/14/2015,0,0,0,0,0,0,0
38089,RM-B210,3/15/2015,0,0,0,0,0,0,0
38090,RM-B210,3/16/2015,0,0,0,0,0,0,0
38091,RM-B210,3/17/2015,0,0,0,0,0,0,0
38092,RM-B210,3/18/2015,0,0,0,0,0,0,0
38093,RM-B210,3/19/2015,0,0,0,0,0,0,0
38094,RM-B210,3/20/2015,0,0,0,0,0,0,0
38095,RM-B210,3/21/2015,0,0,0,0,0,0,0
38096,RM-B210,3/22/2015,0,0,0,0,0,0,0
38097,RM-B210,3/23/2015,0,0,0,0,0,0,0
38098,RM-B210,3/24/2015,0,0,0,0,0,0,0
38099,RM-B210,3/25/2015,0,0,0,0,0,0,0
38100,RM-B210,3/26/2015,0,0,0,0,0,0,0
38101,RM-B210,3/27/2015,0,0,0,0,0,0,0
38102,RM-B210,3/28/2015,0,0,0,0,0,0,0
38103,RM-B210,3/29/2015,0,0,0,0,0,0,0
38104,RM-B210,3/30/2015,0,0,0,0,0,0,0
38105,RM-B210,3/31/2015,0,0,0,0,0,0,0
38106,RM-B210,4/1/2015,0,0,0,0,0,0,0
38107,RM-B210,4/2/2015,0,0,0,0,0,0,0
38108,RM-B210,4/3/2015,0,0,0,0,0,0,0
38109,RM-B210,4/4/2015,0,0,0,0,0,0,0
38110,RM-B210,4/5/2015,0,0,0,0,0,0,0
38111,RM-B210,4/6/2015,0,0,0,0,0,0,0
38112,RM-B210,4/7/2015,0,0,0,0,0,0,0
38113,RM-B210,4/8/2015,0,0,0,0,0,0,0
38114,RM-B210,4/9/2015,0,0,0,0,0,0,0
38115,RM-B210,4/10/2015,0,0,0,0,0,0,0
38116,RM-B210,4/11/2015,0,0,0,0,0,0,0
38117,RM-B210,4/12/2015,0,0,0,0,0,0,0
38118,RM-B210,4/13/2015,0,0,0,0,0,0,0
38119,RM-B210,4/14/2015,0,0,0,0,0,0,0
38120,RM-B210,4/15/2015,0,0,0,0,0,0,0
38121,RM-B210,4/16/2015,0,0,0,0,0,0,0
38122,RM-B210,4/17/2015,0,0,0,0,0,0,0
38123,RM-B210,4/18/2015,0,0,0,0,0,0,0
38124,RM-B210,4/19/2015,0,0,0,0,0,0,0
38125,RM-B210,4/20/2015,0,0,0,0,0,0,0
38126,RM-B210,4/21/2015,0,0,0,0,0,0,0
38127,RM-B210,4/22/2015,0,0,0,0,0,0,0
38128,RM-B210,4/23/2015,0,0,0,0,0,0,0
38129,RM-B210,4/24/2015,0,0,0,0,0,0,0
38130,RM-B210,4/25/2015,0,0,0,0,0,0,0
38131,RM-B210,4/26/2015,0,0,0,0,0,0,0
38132,RM-B210,4/27/2015,0,0,0,0,0,0,0
38133,RM-B210,4/28/2015,0,0,0,0,0,0,0
38134,RM-B210,4/29/2015,0,0,0,0,0,0,0
38135,RM-B210,4/30/2015,0,0,0,0,0,0,0
38136,RM-B210,5/1/2015,0,0,0,0,0,0,0
38137,RM-B210,5/2/2015,0,0,0,0,0,0,0
38138,RM-B210,5/3/2015,0,0,0,0,0,0,0
38139,RM-B210,5/4/2015,0,0,0,0,0,0,0
38140,RM-B210,5/5/2015,0,0,0,0,0,0,0
38141,RM-B210,5/6/2015,0,0,0,0,0,0,0
38142,RM-B210,5/7/2015,0,0,0,0,0,0,0
38143,RM-B210,5/8/2015,0,0,0,0,0,0,0
38144,RM-B210,5/9/2015,0,0,0,0,0,0,0
38145,RM-B210,5/10/2015,0,0,0,0,0,0,0
38146,RM-B210,5/11/2015,0,0,0,0,0,0,0
38147,RM-B210,5/12/2015,0,0,0,0,0,0,0
38148,RM-B210,5/13/2015,0,0,0,0,0,0,0
38149,RM-B210,5/14/2015,0,0,0,0,0,0,0
38150,RM-B210,5/15/2015,0,0,0,0,0,0,0
38151,RM-B210,5/16/2015,0,0,0,0,0,0,0
38152,RM-B210,5/17/2015,0,0,0,0,0,0,0
38153,RM-B210,5/18/2015,0,0,0,0,0,0,0
38154,RM-B210,5/19/2015,0,0,0,0,0,0,0
38155,RM-B210,5/20/2015,0,0,0,0,0,0,0
38156,RM-B210,5/21/2015,0,0,0,0,0,0,0
38157,RM-B210,5/22/2015,0,0,0,0,0,0,0
38158,RM-B210,5/23/2015,0,0,0,0,0,0,0
38159,RM-B210,5/24/2015,0,0,0,0,0,0,0
38160,RM-B210,5/25/2015,0,0,0,0,0,0,0
38161,RM-B210,5/26/2015,0,0,0,0,0,0,0
38162,RM-B210,5/27/2015,0,0,0,0,0,0,0
38163,RM-B210,5/28/2015,0,0,0,0,0,0,0
38164,RM-B210,5/29/2015,0,0,0,0,0,0,0
38165,RM-B210,5/30/2015,0,0,0,0,0,0,0
38166,RM-B210,5/31/2015,0,0,0,0,0,0,0
38496,RM-B215,6/5/2014,0,0,0,0,0,0,0
38497,RM-B215,6/6/2014,0,0,0,0,0,0,0
38498,RM-B215,6/7/2014,0,0,0,0,0,0,0
38499,RM-B215,6/8/2014,0,0,0,0,0,0,0
38500,RM-B215,6/9/2014,0,0,0,0,0,0,0
38501,RM-B215,6/10/2014,0,0,0,0,0,0,0
38502,RM-B215,6/11/2014,0,0,0,0,0,0,0
38503,RM-B215,6/12/2014,0,0,0,0,0,0,0
38504,RM-B215,6/13/2014,0,0,0,0,0,0,0
38505,RM-B215,6/14/2014,0,0,0,0,0,0,0
38506,RM-B215,6/15/2014,0,0,0,0,0,0,0
38507,RM-B215,6/16/2014,0,0,0,0,0,0,0
38508,RM-B215,6/17/2014,0,0,0,0,0,0,0
38509,RM-B215,6/18/2014,0,0,0,0,0,0,0
38510,RM-B215,6/19/2014,0,0,0,0,0,0,0
38511,RM-B215,6/20/2014,0,0,0,0,0,0,0
38512,RM-B215,6/21/2014,0,0,0,0,0,0,0
38513,RM-B215,6/22/2014,0,0,0,0,0,0,0
38514,RM-B215,6/23/2014,0,0,0,0,0,0,0
38515,RM-B215,6/24/2014,0,0,0,0,0,0,0
38516,RM-B215,6/25/2014,0,0,0,0,0,0,0
38517,RM-B215,6/26/2014,0,0,0,0,0,0,0
38518,RM-B215,6/27/2014,0,0,0,0,0,0,0
38519,RM-B215,6/28/2014,0,0,0,0,0,0,0
38520,RM-B215,6/29/2014,0,0,0,0,0,0,0
38521,RM-B215,6/30/2014,0,0,0,0,0,0,0
38522,RM-B215,7/1/2014,0,0,0,0,0,0,0
38523,RM-B215,7/2/2014,0,0,0,0,0,0,0
38524,RM-B215,7/3/2014,0,0,0,0,0,0,0
38525,RM-B215,7/4/2014,0,0,0,0,0,0,0
38526,RM-B215,7/5/2014,0,0,0,0,0,0,0
38527,RM-B215,7/6/2014,0,0,0,0,0,0,0
38528,RM-B215,7/7/2014,0,0,0,0,0,0,0
38529,RM-B215,7/8/2014,0,0,0,0,0,0,0
38530,RM-B215,7/9/2014,0,0,0,0,0,0,0
38531,RM-B215,7/10/2014,0,0,0,0,0,0,0
38532,RM-B215,7/11/2014,0,0,0,0,0,0,0
38533,RM-B215,7/12/2014,0,0,0,0,0,0,0
38534,RM-B215,7/13/2014,0,0,0,0,0,0,0
38535,RM-B215,7/14/2014,0,0,0,0,0,0,0
38536,RM-B215,7/15/2014,0,0,0,0,0,0,0
38537,RM-B215,7/16/2014,0,0,0,0,0,0,0
38538,RM-B215,7/17/2014,0,0,0,0,0,0,0
38539,RM-B215,7/18/2014,0,0,0,0,0,0,0
38540,RM-B215,7/19/2014,0,0,0,0,0,0,0
38541,RM-B215,7/20/2014,0,0,0,0,0,0,0
38542,RM-B215,7/21/2014,0,0,0,0,0,0,0
38543,RM-B215,7/22/2014,0,0,0,0,0,0,0
38544,RM-B215,7/23/2014,0,0,0,0,0,0,0
38545,RM-B215,7/24/2014,0,0,0,0,0,0,0
38546,RM-B215,7/25/2014,0,0,0,0,0,0,0
38547,RM-B215,7/26/2014,0,0,0,0,0,0,0
38548,RM-B215,7/27/2014,0,0,0,0,0,0,0
38549,RM-B215,7/28/2014,0,0,0,0,0,0,0
38550,RM-B215,7/29/2014,0,0,0,0,0,0,0
38551,RM-B215,7/30/2014,0,0,0,0,0,0,0
38552,RM-B215,7/31/2014,0,0,0,0,0,0,0
38553,RM-B215,8/1/2014,0,0,0,0,0,0,0
38554,RM-B215,8/2/2014,0,0,0,0,0,0,0
38555,RM-B215,8/3/2014,0,0,0,0,0,0,0
38556,RM-B215,8/4/2014,0,0,0,0,0,0,0
38557,RM-B215,8/5/2014,0,0,0,0,0,0,0
38558,RM-B215,8/6/2014,0,0,0,0,0,0,0
38559,RM-B215,8/7/2014,0,0,0,0,0,0,0
38560,RM-B215,8/8/2014,0,0,0,0,0,0,0
38561,RM-B215,8/9/2014,0,0,0,0,0,0,0
38562,RM-B215,8/10/2014,0,0,0,0,0,0,0
38563,RM-B215,8/11/2014,0,0,0,0,0,0,0
38564,RM-B215,8/12/2014,0,0,0,0,0,0,0
38565,RM-B215,8/13/2014,0,0,0,0,0,0,0
38566,RM-B215,8/14/2014,0,0,0,0,0,0,0
38567,RM-B215,8/15/2014,0,0,0,0,0,0,0
38568,RM-B215,8/16/2014,0,0,0,0,0,0,0
38569,RM-B215,8/17/2014,0,0,0,0,0,0,0
38570,RM-B215,8/18/2014,0,0,0,0,0,0,0
38571,RM-B215,8/19/2014,0,0,0,0,0,0,0
38572,RM-B215,8/20/2014,0,0,0,0,0,0,0
38573,RM-B215,8/21/2014,0,0,0,0,0,0,0
38574,RM-B215,8/22/2014,0,0,0,0,0,0,0
38575,RM-B215,8/23/2014,0,0,0,0,0,0,0
38576,RM-B215,8/24/2014,0,0,0,0,0,0,0
38577,RM-B215,8/25/2014,0,0,0,0,0,0,0
38578,RM-B215,8/26/2014,0,0,0,0,0,0,0
38579,RM-B215,8/27/2014,0,0,0,0,0,0,0
38580,RM-B215,8/28/2014,0,0,0,0,0,0,0
38581,RM-B215,8/29/2014,0,0,0,0,0,0,0
38582,RM-B215,8/30/2014,0,0,0,0,0,0,0
38583,RM-B215,8/31/2014,0,0,0,0,0,0,0
38584,RM-B215,9/1/2014,0,0,0,0,0,0,0
38585,RM-B215,9/2/2014,0,0,0,0,0,0,0
38586,RM-B215,9/3/2014,0,0,0,0,0,0,0
38587,RM-B215,9/4/2014,0,0,0,0,0,0,0
38588,RM-B215,9/5/2014,0,0,0,0,0,0,0
38589,RM-B215,9/6/2014,0,0,0,0,0,0,0
38590,RM-B215,9/7/2014,0,0,0,0,0,0,0
38591,RM-B215,9/8/2014,0,0,0,0,0,0,0
38592,RM-B215,9/9/2014,0,0,0,0,0,0,0
38593,RM-B215,9/10/2014,0,0,0,0,0,0,0
38594,RM-B215,9/11/2014,0,0,0,0,0,0,0
38595,RM-B215,9/12/2014,0,0,0,0,0,0,0
38596,RM-B215,9/13/2014,0,0,0,0,0,0,0
38597,RM-B215,9/14/2014,0,0,0,0,0,0,0
38598,RM-B215,9/15/2014,0,0,0,0,0,0,0
38599,RM-B215,9/16/2014,0,0,0,0,0,0,0
38600,RM-B215,9/17/2014,0,0,0,0,0,0,0
38601,RM-B215,9/18/2014,0,0,0,0,0,0,0
38602,RM-B215,9/19/2014,0,0,0,0,0,0,0
38603,RM-B215,9/20/2014,0,0,0,0,0,0,0
38604,RM-B215,9/21/2014,0,0,0,0,0,0,0
38605,RM-B215,9/22/2014,0,0,0,0,0,0,0
38606,RM-B215,9/23/2014,0,0,0,0,0,0,0
38607,RM-B215,9/24/2014,0,0,0,0,0,0,0
38608,RM-B215,9/25/2014,0,0,0,0,0,0,0
38609,RM-B215,9/28/2014,0,0,0,0,0,0,0
38610,RM-B215,9/29/2014,0,0,0,0,0,0,0
38611,RM-B215,9/30/2014,0,0,0,0,0,0,0
38612,RM-B215,10/1/2014,0,0,0,0,0,0,0
38613,RM-B215,10/2/2014,0,0,0,0,0,0,0
38614,RM-B215,10/3/2014,0,0,0,0,0,0,0
38615,RM-B215,10/4/2014,0,0,0,0,0,0,0
38616,RM-B215,10/5/2014,0,0,0,0,0,0,0
38617,RM-B215,10/6/2014,0,0,0,0,0,0,0
38618,RM-B215,10/7/2014,0,0,0,0,0,0,0
38619,RM-B215,10/8/2014,0,0,0,0,0,0,0
38620,RM-B215,10/9/2014,0,0,0,0,0,0,0
38621,RM-B215,10/10/2014,0,0,0,0,0,0,0
38622,RM-B215,10/11/2014,0,0,0,0,0,0,0
38623,RM-B215,10/12/2014,0,0,0,0,0,0,0
38624,RM-B215,10/13/2014,0,0,0,0,0,0,0
38625,RM-B215,10/14/2014,0,0,0,0,0,0,0
38626,RM-B215,10/15/2014,0,0,0,0,0,0,0
38627,RM-B215,10/16/2014,0,0,0,0,0,0,0
38628,RM-B215,10/17/2014,0,0,0,0,0,0,0
38629,RM-B215,10/18/2014,0,0,0,0,0,0,0
38630,RM-B215,10/19/2014,0,0,0,0,0,0,0
38631,RM-B215,10/20/2014,0,0,0,0,0,0,0
38632,RM-B215,10/21/2014,0,0,0,0,0,0,0
38633,RM-B215,10/22/2014,0,0,0,0,0,0,0
38634,RM-B215,10/23/2014,0,0,0,0,0,0,0
38635,RM-B215,10/24/2014,0,0,0,0,0,0,0
38636,RM-B215,10/25/2014,0,0,0,0,0,0,0
38637,RM-B215,10/26/2014,0,0,0,0,0,0,0
38638,RM-B215,10/27/2014,0,0,0,0,0,0,0
38639,RM-B215,10/28/2014,0,0,0,0,0,0,0
38640,RM-B215,10/29/2014,0,0,0,0,0,0,0
38641,RM-B215,10/30/2014,0,0,0,0,0,0,0
38642,RM-B215,10/31/2014,0,0,0,0,0,0,0
38643,RM-B215,11/1/2014,0,0,0,0,0,0,0
38644,RM-B215,11/2/2014,0,0,0,0,0,0,0
38645,RM-B215,11/3/2014,0,0,0,0,0,0,0
38646,RM-B215,11/4/2014,0,0,0,0,0,0,0
38647,RM-B215,11/5/2014,0,0,0,0,0,0,0
38648,RM-B215,11/6/2014,0,0,0,0,0,0,0
38649,RM-B215,11/7/2014,0,0,0,0,0,0,0
38650,RM-B215,11/8/2014,0,0,0,0,0,0,0
38651,RM-B215,11/9/2014,0,0,0,0,0,0,0
38652,RM-B215,11/10/2014,0,0,0,0,0,0,0
38653,RM-B215,11/11/2014,0,0,0,0,0,0,0
38654,RM-B215,11/12/2014,0,0,0,0,0,0,0
38655,RM-B215,11/13/2014,0,0,0,0,0,0,0
38656,RM-B215,11/14/2014,0,0,0,0,0,0,0
38657,RM-B215,11/15/2014,0,0,0,0,0,0,0
38658,RM-B215,11/16/2014,0,0,0,0,0,0,0
38659,RM-B215,11/17/2014,0,0,0,0,0,0,0
38660,RM-B215,11/18/2014,0,0,0,0,0,0,0
38661,RM-B215,11/19/2014,0,0,0,0,0,0,0
38662,RM-B215,11/20/2014,0,0,0,0,0,0,0
38663,RM-B215,11/21/2014,0,0,0,0,0,0,0
38664,RM-B215,11/22/2014,0,0,0,0,0,0,0
38665,RM-B215,11/23/2014,0,0,0,0,0,0,0
38667,RM-B215,11/25/2014,0,0,0,0,0,0,0
38668,RM-B215,11/26/2014,0,0,0,0,0,0,0
38669,RM-B215,11/27/2014,0,0,0,0,0,0,0
38670,RM-B215,11/28/2014,0,0,0,0,0,0,0
38671,RM-B215,11/29/2014,0,0,0,0,0,0,0
38672,RM-B215,11/30/2014,0,0,0,0,0,0,0
38673,RM-B215,12/1/2014,0,0,0,0,0,0,0
38674,RM-B215,12/2/2014,0,0,0,0,0,0,0
38675,RM-B215,12/3/2014,0,0,0,0,0,0,0
38676,RM-B215,12/4/2014,0,0,0,0,0,0,0
38677,RM-B215,12/5/2014,0,0,0,0,0,0,0
38678,RM-B215,12/6/2014,0,0,0,0,0,0,0
38679,RM-B215,12/7/2014,0,0,0,0,0,0,0
38680,RM-B215,12/8/2014,0,0,0,0,0,0,0
38681,RM-B215,12/9/2014,0,0,0,0,0,0,0
38682,RM-B215,12/10/2014,0,0,0,0,0,0,0
38683,RM-B215,12/11/2014,0,0,0,0,0,0,0
38684,RM-B215,12/12/2014,0,0,0,0,0,0,0
38685,RM-B215,12/13/2014,0,0,0,0,0,0,0
38686,RM-B215,12/14/2014,0,0,0,0,0,0,0
38687,RM-B215,12/15/2014,0,0,0,0,0,0,0
38688,RM-B215,12/16/2014,0,0,0,0,0,0,0
38689,RM-B215,12/17/2014,0,0,0,0,0,0,0
38690,RM-B215,12/18/2014,0,0,0,0,0,0,0
38691,RM-B215,12/19/2014,0,0,0,0,0,0,0
38692,RM-B215,12/20/2014,0,0,0,0,0,0,0
38693,RM-B215,12/21/2014,0,0,0,0,0,0,0
38694,RM-B215,12/22/2014,0,0,0,0,0,0,0
38695,RM-B215,12/23/2014,0,0,0,0,0,0,0
38696,RM-B215,12/24/2014,0,0,0,0,0,0,0
38697,RM-B215,12/25/2014,0,0,0,0,0,0,0
38698,RM-B215,12/26/2014,0,0,0,0,0,0,0
38699,RM-B215,12/27/2014,0,0,0,0,0,0,0
38700,RM-B215,12/28/2014,0,0,0,0,0,0,0
38701,RM-B215,12/29/2014,0,0,0,0,0,0,0
38702,RM-B215,12/30/2014,0,0,0,0,0,0,0
38703,RM-B215,12/31/2014,0,0,0,0,0,0,0
38782,RM-B215,3/20/2015,0,0,0,0,0,0,0
38783,RM-B215,3/21/2015,0,0,0,0,0,0,0
38784,RM-B215,3/22/2015,0,0,0,0,0,0,0
38785,RM-B215,3/23/2015,0,0,0,0,0,0,0
38786,RM-B215,3/24/2015,0,0,0,0,0,0,0
38787,RM-B215,3/25/2015,0,0,0,0,0,0,0
38788,RM-B215,3/26/2015,0,0,0,0,0,0,0
38789,RM-B215,3/27/2015,0,0,0,0,0,0,0
38790,RM-B215,3/28/2015,0,0,0,0,0,0,0
38791,RM-B215,3/29/2015,0,0,0,0,0,0,0
38792,RM-B215,3/30/2015,0,0,0,0,0,0,0
38793,RM-B215,3/31/2015,0,0,0,0,0,0,0
38794,RM-B215,4/1/2015,0,0,0,0,0,0,0
38795,RM-B215,4/2/2015,0,0,0,0,0,0,0
38796,RM-B215,4/3/2015,0,0,0,0,0,0,0
38797,RM-B215,4/4/2015,0,0,0,0,0,0,0
38798,RM-B215,4/5/2015,0,0,0,0,0,0,0
38799,RM-B215,4/6/2015,0,0,0,0,0,0,0
38800,RM-B215,4/7/2015,0,0,0,0,0,0,0
38801,RM-B215,4/8/2015,0,0,0,0,0,0,0
38802,RM-B215,4/9/2015,0,0,0,0,0,0,0
38803,RM-B215,4/10/2015,0,0,0,0,0,0,0
38804,RM-B215,4/11/2015,0,0,0,0,0,0,0
38805,RM-B215,4/12/2015,0,0,0,0,0,0,0
38806,RM-B215,4/13/2015,0,0,0,0,0,0,0
38807,RM-B215,4/14/2015,0,0,0,0,0,0,0
38808,RM-B215,4/15/2015,0,0,0,0,0,0,0
38809,RM-B215,4/16/2015,0,0,0,0,0,0,0
38810,RM-B215,4/17/2015,0,0,0,0,0,0,0
38811,RM-B215,4/18/2015,0,0,0,0,0,0,0
38812,RM-B215,4/19/2015,0,0,0,0,0,0,0
38813,RM-B215,4/20/2015,0,0,0,0,0,0,0
38814,RM-B215,4/21/2015,0,0,0,0,0,0,0
38815,RM-B215,4/22/2015,0,0,0,0,0,0,0
38816,RM-B215,4/23/2015,0,0,0,0,0,0,0
38817,RM-B215,4/24/2015,0,0,0,0,0,0,0
38818,RM-B215,4/25/2015,0,0,0,0,0,0,0
38819,RM-B215,4/26/2015,0,0,0,0,0,0,0
38820,RM-B215,4/27/2015,0,0,0,0,0,0,0
38821,RM-B215,4/28/2015,0,0,0,0,0,0,0
38822,RM-B215,4/29/2015,0,0,0,0,0,0,0
38823,RM-B215,4/30/2015,0,0,0,0,0,0,0
38824,RM-B215,5/1/2015,0,0,0,0,0,0,0
38825,RM-B215,5/2/2015,0,0,0,0,0,0,0
38826,RM-B215,5/3/2015,0,0,0,0,0,0,0
38827,RM-B215,5/4/2015,0,0,0,0,0,0,0
38828,RM-B215,5/5/2015,0,0,0,0,0,0,0
38829,RM-B215,5/6/2015,0,0,0,0,0,0,0
38830,RM-B215,5/7/2015,0,0,0,0,0,0,0
38831,RM-B215,5/8/2015,0,0,0,0,0,0,0
38832,RM-B215,5/9/2015,0,0,0,0,0,0,0
38833,RM-B215,5/10/2015,0,0,0,0,0,0,0
38834,RM-B215,5/11/2015,0,0,0,0,0,0,0
38835,RM-B215,5/12/2015,0,0,0,0,0,0,0
38836,RM-B215,5/13/2015,0,0,0,0,0,0,0
38837,RM-B215,5/14/2015,0,0,0,0,0,0,0
38838,RM-B215,5/15/2015,0,0,0,0,0,0,0
38839,RM-B215,5/16/2015,0,0,0,0,0,0,0
38840,RM-B215,5/17/2015,0,0,0,0,0,0,0
38841,RM-B215,5/18/2015,0,0,0,0,0,0,0
38842,RM-B215,5/19/2015,0,0,0,0,0,0,0
38843,RM-B215,5/20/2015,0,0,0,0,0,0,0
38844,RM-B215,5/21/2015,0,0,0,0,0,0,0
38845,RM-B215,5/22/2015,0,0,0,0,0,0,0
38846,RM-B215,5/23/2015,0,0,0,0,0,0,0
38847,RM-B215,5/24/2015,0,0,0,0,0,0,0
38848,RM-B215,5/25/2015,0,0,0,0,0,0,0
38849,RM-B215,5/26/2015,0,0,0,0,0,0,0
38850,RM-B215,5/27/2015,0,0,0,0,0,0,0
38851,RM-B215,5/28/2015,0,0,0,0,0,0,0
38852,RM-B215,5/29/2015,0,0,0,0,0,0,0
38853,RM-B215,5/30/2015,0,0,0,0,0,0,0
38854,RM-B215,5/31/2015,0,0,0,0,0,0,0
38855,RM-B220,7/1/2013,0,0,0,0,0,0,0
38856,RM-B220,7/2/2013,0,0,0,0,0,0,0
38857,RM-B220,7/3/2013,0,0,0,0,0,0,0
38858,RM-B220,7/4/2013,0,0,0,0,0,0,0
38859,RM-B220,7/5/2013,0,0,0,0,0,0,0
38860,RM-B220,7/6/2013,0,0,0,0,0,0,0
38861,RM-B220,7/7/2013,0,0,0,0,0,0,0
38862,RM-B220,7/8/2013,0,0,0,0,0,0,0
38863,RM-B220,7/9/2013,0,0,0,0,0,0,0
38864,RM-B220,7/10/2013,0,0,0,0,0,0,0
38865,RM-B220,7/11/2013,0,0,0,0,0,0,0
38866,RM-B220,7/12/2013,0,0,0,0,0,0,0
38867,RM-B220,7/13/2013,0,0,0,0,0,0,0
38868,RM-B220,7/14/2013,0,0,0,0,0,0,0
38869,RM-B220,7/15/2013,0,0,0,0,0,0,0
38870,RM-B220,7/17/2013,0,0,0,0,0,0,0
38871,RM-B220,7/18/2013,0,0,0,0,0,0,0
38872,RM-B220,7/19/2013,0,0,0,0,0,0,0
38873,RM-B220,7/20/2013,0,0,0,0,0,0,0
38874,RM-B220,7/21/2013,0,0,0,0,0,0,0
38875,RM-B220,7/22/2013,0,0,0,0,0,0,0
38876,RM-B220,7/23/2013,0,0,0,0,0,0,0
38877,RM-B220,7/24/2013,0,0,0,0,0,0,0
38878,RM-B220,7/25/2013,0,0,0,0,0,0,0
38879,RM-B220,7/26/2013,0,0,0,0,0,0,0
38880,RM-B220,7/27/2013,0,0,0,0,0,0,0
38881,RM-B220,7/28/2013,0,0,0,0,0,0,0
38882,RM-B220,7/29/2013,0,0,0,0,0,0,0
38883,RM-B220,7/30/2013,0,0,0,0,0,0,0
38884,RM-B220,7/31/2013,0,0,0,0,0,0,0
38885,RM-B220,8/1/2013,0,0,0,0,0,0,0
38886,RM-B220,8/2/2013,0,0,0,0,0,0,0
38887,RM-B220,8/3/2013,0,0,0,0,0,0,0
38888,RM-B220,8/4/2013,0,0,0,0,0,0,0
38889,RM-B220,8/5/2013,0,0,0,0,0,0,0
38890,RM-B220,8/6/2013,0,0,0,0,0,0,0
38891,RM-B220,8/7/2013,0,0,0,0,0,0,0
38892,RM-B220,8/8/2013,0,0,0,0,0,0,0
38893,RM-B220,8/9/2013,0,0,0,0,0,0,0
38894,RM-B220,8/10/2013,0,0,0,0,0,0,0
38895,RM-B220,8/11/2013,0,0,0,0,0,0,0
38896,RM-B220,8/12/2013,0,0,0,0,0,0,0
38897,RM-B220,8/13/2013,0,0,0,0,0,0,0
38898,RM-B220,8/14/2013,0,0,0,0,0,0,0
38899,RM-B220,8/15/2013,0,0,0,0,0,0,0
38900,RM-B220,8/16/2013,0,0,0,0,0,0,0
38901,RM-B220,8/17/2013,0,0,0,0,0,0,0
38902,RM-B220,8/18/2013,0,0,0,0,0,0,0
38903,RM-B220,8/19/2013,0,0,0,0,0,0,0
38904,RM-B220,8/20/2013,0,0,0,0,0,0,0
38905,RM-B220,8/21/2013,0,0,0,0,0,0,0
38906,RM-B220,8/22/2013,0,0,0,0,0,0,0
38907,RM-B220,8/27/2013,0,0,0,0,0,0,0
38908,RM-B220,8/28/2013,0,0,0,0,0,0,0
38909,RM-B220,8/29/2013,0,0,0,0,0,0,0
38910,RM-B220,8/30/2013,0,0,0,0,0,0,0
38911,RM-B220,9/4/2013,0,0,0,0,0,0,0
38912,RM-B220,9/5/2013,0,0,0,0,0,0,0
38913,RM-B220,9/6/2013,0,0,0,0,0,0,0
38914,RM-B220,9/7/2013,0,0,0,0,0,0,0
38915,RM-B220,9/9/2013,0,0,0,0,0,0,0
38916,RM-B220,9/10/2013,0,0,0,0,0,0,0
38917,RM-B220,9/11/2013,0,0,0,0,0,0,0
38918,RM-B220,9/12/2013,0,0,0,0,0,0,0
38919,RM-B220,9/13/2013,0,0,0,0,0,0,0
38920,RM-B220,9/14/2013,0,0,0,0,0,0,0
38921,RM-B220,9/15/2013,0,0,0,0,0,0,0
38922,RM-B220,9/16/2013,0,0,0,0,0,0,0
38923,RM-B220,9/17/2013,0,0,0,0,0,0,0
38924,RM-B220,9/18/2013,0,0,0,0,0,0,0
38925,RM-B220,9/19/2013,0,0,0,0,0,0,0
38926,RM-B220,9/20/2013,0,0,0,0,0,0,0
38927,RM-B220,9/21/2013,0,0,0,0,0,0,0
38928,RM-B220,9/22/2013,0,0,0,0,0,0,0
38929,RM-B220,9/23/2013,0,0,0,0,0,0,0
38930,RM-B220,9/24/2013,0,0,0,0,0,0,0
38931,RM-B220,9/25/2013,0,0,0,0,0,0,0
38932,RM-B220,9/26/2013,0,0,0,0,0,0,0
38933,RM-B220,9/27/2013,0,0,0,0,0,0,0
38934,RM-B220,9/28/2013,0,0,0,0,0,0,0
38935,RM-B220,9/29/2013,0,0,0,0,0,0,0
38936,RM-B220,9/30/2013,0,0,0,0,0,0,0
38937,RM-B220,10/1/2013,0,0,0,0,0,0,0
38938,RM-B220,10/2/2013,0,0,0,0,0,0,0
38939,RM-B220,10/3/2013,0,0,0,0,0,0,0
38940,RM-B220,10/4/2013,0,0,0,0,0,0,0
38941,RM-B220,10/5/2013,0,0,0,0,0,0,0
38942,RM-B220,10/6/2013,0,0,0,0,0,0,0
38943,RM-B220,10/7/2013,0,0,0,0,0,0,0
38944,RM-B220,10/8/2013,0,0,0,0,0,0,0
38945,RM-B220,10/9/2013,0,0,0,0,0,0,0
38946,RM-B220,10/10/2013,0,0,0,0,0,0,0
38947,RM-B220,10/11/2013,0,0,0,0,0,0,0
38948,RM-B220,10/12/2013,0,0,0,0,0,0,0
38949,RM-B220,10/13/2013,0,0,0,0,0,0,0
38950,RM-B220,10/14/2013,0,0,0,0,0,0,0
38951,RM-B220,10/15/2013,0,0,0,0,0,0,0
38952,RM-B220,10/16/2013,0,0,0,0,0,0,0
38953,RM-B220,10/17/2013,0,0,0,0,0,0,0
38954,RM-B220,10/18/2013,0,0,0,0,0,0,0
38955,RM-B220,10/19/2013,0,0,0,0,0,0,0
38956,RM-B220,10/20/2013,0,0,0,0,0,0,0
38957,RM-B220,10/21/2013,0,0,0,0,0,0,0
38958,RM-B220,10/22/2013,0,0,0,0,0,0,0
38959,RM-B220,10/23/2013,0,0,0,0,0,0,0
38960,RM-B220,10/24/2013,0,0,0,0,0,0,0
38961,RM-B220,10/25/2013,0,0,0,0,0,0,0
38962,RM-B220,10/26/2013,0,0,0,0,0,0,0
38963,RM-B220,10/27/2013,0,0,0,0,0,0,0
38964,RM-B220,10/28/2013,0,0,0,0,0,0,0
38965,RM-B220,10/29/2013,0,0,0,0,0,0,0
38966,RM-B220,10/30/2013,0,0,0,0,0,0,0
38967,RM-B220,10/31/2013,0,0,0,0,0,0,0
38968,RM-B220,11/1/2013,0,0,0,0,0,0,0
38969,RM-B220,11/2/2013,0,0,0,0,0,0,0
38970,RM-B220,11/3/2013,0,0,0,0,0,0,0
38971,RM-B220,11/4/2013,0,0,0,0,0,0,0
38972,RM-B220,11/5/2013,0,0,0,0,0,0,0
38973,RM-B220,11/6/2013,0,0,0,0,0,0,0
38974,RM-B220,11/7/2013,0,0,0,0,0,0,0
38975,RM-B220,11/8/2013,0,0,0,0,0,0,0
38976,RM-B220,11/9/2013,0,0,0,0,0,0,0
38977,RM-B220,11/10/2013,0,0,0,0,0,0,0
38978,RM-B220,11/11/2013,0,0,0,0,0,0,0
38979,RM-B220,11/12/2013,0,0,0,0,0,0,0
38980,RM-B220,11/13/2013,0,0,0,0,0,0,0
38981,RM-B220,11/14/2013,0,0,0,0,0,0,0
38982,RM-B220,11/15/2013,0,0,0,0,0,0,0
38983,RM-B220,11/19/2013,0,0,0,0,0,0,0
38984,RM-B220,11/20/2013,0,0,0,0,0,0,0
38985,RM-B220,11/21/2013,0,0,0,0,0,0,0
38986,RM-B220,11/22/2013,0,0,0,0,0,0,0
38987,RM-B220,11/23/2013,0,0,0,0,0,0,0
38988,RM-B220,11/24/2013,0,0,0,0,0,0,0
38989,RM-B220,11/25/2013,0,0,0,0,0,0,0
38990,RM-B220,11/26/2013,0,0,0,0,0,0,0
38991,RM-B220,11/27/2013,0,0,0,0,0,0,0
38992,RM-B220,11/28/2013,0,0,0,0,0,0,0
38993,RM-B220,11/29/2013,0,0,0,0,0,0,0
38994,RM-B220,11/30/2013,0,0,0,0,0,0,0
38995,RM-B220,12/1/2013,0,0,0,0,0,0,0
38996,RM-B220,12/2/2013,0,0,0,0,0,0,0
38997,RM-B220,12/3/2013,0,0,0,0,0,0,0
38998,RM-B220,12/4/2013,0,0,0,0,0,0,0
38999,RM-B220,12/5/2013,0,0,0,0,0,0,0
39151,RM-B220,5/6/2014,0,0,0,0,0,0,0
39260,RM-B220,8/23/2014,0,0,0,0,0,0,0
39261,RM-B220,8/24/2014,0,0,0,0,0,0,0
39262,RM-B220,8/25/2014,0,0,0,0,0,0,0
39263,RM-B220,8/26/2014,0,0,0,0,0,0,0
39264,RM-B220,8/27/2014,0,0,0,0,0,0,0
39265,RM-B220,8/28/2014,0,0,0,0,0,0,0
39266,RM-B220,8/29/2014,0,0,0,0,0,0,0
39267,RM-B220,8/30/2014,0,0,0,0,0,0,0
39268,RM-B220,8/31/2014,0,0,0,0,0,0,0
39269,RM-B220,9/1/2014,0,0,0,0,0,0,0
39270,RM-B220,9/2/2014,0,0,0,0,0,0,0
39271,RM-B220,9/3/2014,0,0,0,0,0,0,0
39272,RM-B220,9/4/2014,0,0,0,0,0,0,0
39273,RM-B220,9/5/2014,0,0,0,0,0,0,0
39274,RM-B220,9/6/2014,0,0,0,0,0,0,0
39275,RM-B220,9/7/2014,0,0,0,0,0,0,0
39276,RM-B220,9/8/2014,0,0,0,0,0,0,0
39277,RM-B220,9/9/2014,0,0,0,0,0,0,0
39278,RM-B220,9/10/2014,0,0,0,0,0,0,0
39279,RM-B220,9/11/2014,0,0,0,0,0,0,0
39280,RM-B220,9/12/2014,0,0,0,0,0,0,0
39281,RM-B220,9/13/2014,0,0,0,0,0,0,0
39282,RM-B220,9/14/2014,0,0,0,0,0,0,0
39283,RM-B220,9/15/2014,0,0,0,0,0,0,0
39284,RM-B220,9/16/2014,0,0,0,0,0,0,0
39285,RM-B220,9/17/2014,0,0,0,0,0,0,0
39286,RM-B220,9/18/2014,0,0,0,0,0,0,0
39287,RM-B220,9/19/2014,0,0,0,0,0,0,0
39288,RM-B220,9/20/2014,0,0,0,0,0,0,0
39289,RM-B220,9/21/2014,0,0,0,0,0,0,0
39290,RM-B220,9/22/2014,0,0,0,0,0,0,0
39291,RM-B220,9/23/2014,0,0,0,0,0,0,0
39292,RM-B220,9/24/2014,0,0,0,0,0,0,0
39293,RM-B220,9/25/2014,0,0,0,0,0,0,0
39294,RM-B220,9/28/2014,0,0,0,0,0,0,0
39295,RM-B220,9/29/2014,0,0,0,0,0,0,0
39296,RM-B220,9/30/2014,0,0,0,0,0,0,0
39297,RM-B220,10/1/2014,0,0,0,0,0,0,0
39298,RM-B220,10/2/2014,0,0,0,0,0,0,0
39299,RM-B220,10/3/2014,0,0,0,0,0,0,0
39300,RM-B220,10/4/2014,0,0,0,0,0,0,0
39301,RM-B220,10/5/2014,0,0,0,0,0,0,0
39302,RM-B220,10/6/2014,0,0,0,0,0,0,0
39303,RM-B220,10/7/2014,0,0,0,0,0,0,0
39304,RM-B220,10/8/2014,0,0,0,0,0,0,0
39305,RM-B220,10/9/2014,0,0,0,0,0,0,0
39306,RM-B220,10/10/2014,0,0,0,0,0,0,0
39307,RM-B220,10/11/2014,0,0,0,0,0,0,0
39308,RM-B220,10/12/2014,0,0,0,0,0,0,0
39309,RM-B220,10/13/2014,0,0,0,0,0,0,0
39310,RM-B220,10/14/2014,0,0,0,0,0,0,0
39311,RM-B220,10/15/2014,0,0,0,0,0,0,0
39312,RM-B220,10/16/2014,0,0,0,0,0,0,0
39313,RM-B220,10/17/2014,0,0,0,0,0,0,0
39314,RM-B220,10/18/2014,0,0,0,0,0,0,0
39315,RM-B220,10/19/2014,0,0,0,0,0,0,0
39316,RM-B220,10/20/2014,0,0,0,0,0,0,0
39317,RM-B220,10/21/2014,0,0,0,0,0,0,0
39318,RM-B220,10/22/2014,0,0,0,0,0,0,0
39319,RM-B220,10/23/2014,0,0,0,0,0,0,0
39320,RM-B220,10/24/2014,0,0,0,0,0,0,0
39321,RM-B220,10/25/2014,0,0,0,0,0,0,0
39322,RM-B220,10/26/2014,0,0,0,0,0,0,0
39323,RM-B220,10/27/2014,0,0,0,0,0,0,0
39324,RM-B220,10/28/2014,0,0,0,0,0,0,0
39325,RM-B220,10/29/2014,0,0,0,0,0,0,0
39326,RM-B220,10/30/2014,0,0,0,0,0,0,0
39327,RM-B220,10/31/2014,0,0,0,0,0,0,0
39328,RM-B220,11/1/2014,0,0,0,0,0,0,0
39329,RM-B220,11/2/2014,0,0,0,0,0,0,0
39330,RM-B220,11/3/2014,0,0,0,0,0,0,0
39331,RM-B220,11/4/2014,0,0,0,0,0,0,0
39332,RM-B220,11/5/2014,0,0,0,0,0,0,0
39333,RM-B220,11/6/2014,0,0,0,0,0,0,0
39334,RM-B220,11/7/2014,0,0,0,0,0,0,0
39335,RM-B220,11/8/2014,0,0,0,0,0,0,0
39336,RM-B220,11/9/2014,0,0,0,0,0,0,0
39337,RM-B220,11/10/2014,0,0,0,0,0,0,0
39338,RM-B220,11/11/2014,0,0,0,0,0,0,0
39339,RM-B220,11/12/2014,0,0,0,0,0,0,0
39340,RM-B220,11/13/2014,0,0,0,0,0,0,0
39341,RM-B220,11/14/2014,0,0,0,0,0,0,0
39342,RM-B220,11/15/2014,0,0,0,0,0,0,0
39343,RM-B220,11/16/2014,0,0,0,0,0,0,0
39344,RM-B220,11/17/2014,0,0,0,0,0,0,0
39345,RM-B220,11/18/2014,0,0,0,0,0,0,0
39346,RM-B220,11/19/2014,0,0,0,0,0,0,0
39347,RM-B220,11/20/2014,0,0,0,0,0,0,0
39348,RM-B220,11/21/2014,0,0,0,0,0,0,0
39349,RM-B220,11/22/2014,0,0,0,0,0,0,0
39350,RM-B220,11/23/2014,0,0,0,0,0,0,0
39351,RM-B220,11/24/2014,0,0,0,0,0,0,0
39352,RM-B220,11/25/2014,0,0,0,0,0,0,0
39353,RM-B220,11/26/2014,0,0,0,0,0,0,0
39354,RM-B220,11/27/2014,0,0,0,0,0,0,0
39355,RM-B220,11/28/2014,0,0,0,0,0,0,0
39356,RM-B220,11/29/2014,0,0,0,0,0,0,0
39357,RM-B220,11/30/2014,0,0,0,0,0,0,0
39358,RM-B220,12/1/2014,0,0,0,0,0,0,0
39359,RM-B220,12/2/2014,0,0,0,0,0,0,0
39360,RM-B220,12/3/2014,0,0,0,0,0,0,0
39361,RM-B220,12/4/2014,0,0,0,0,0,0,0
39362,RM-B220,12/5/2014,0,0,0,0,0,0,0
39363,RM-B220,12/6/2014,0,0,0,0,0,0,0
39364,RM-B220,12/7/2014,0,0,0,0,0,0,0
39365,RM-B220,12/8/2014,0,0,0,0,0,0,0
39366,RM-B220,12/9/2014,0,0,0,0,0,0,0
39367,RM-B220,12/10/2014,0,0,0,0,0,0,0
39368,RM-B220,12/11/2014,0,0,0,0,0,0,0
39369,RM-B220,12/12/2014,0,0,0,0,0,0,0
39370,RM-B220,12/13/2014,0,0,0,0,0,0,0
39371,RM-B220,12/14/2014,0,0,0,0,0,0,0
39372,RM-B220,12/15/2014,0,0,0,0,0,0,0
39373,RM-B220,12/16/2014,0,0,0,0,0,0,0
39374,RM-B220,12/17/2014,0,0,0,0,0,0,0
39375,RM-B220,12/18/2014,0,0,0,0,0,0,0
39376,RM-B220,12/19/2014,0,0,0,0,0,0,0
39377,RM-B220,12/20/2014,0,0,0,0,0,0,0
39378,RM-B220,12/21/2014,0,0,0,0,0,0,0
39379,RM-B220,12/22/2014,0,0,0,0,0,0,0
39380,RM-B220,12/23/2014,0,0,0,0,0,0,0
39381,RM-B220,12/24/2014,0,0,0,0,0,0,0
39382,RM-B220,12/25/2014,0,0,0,0,0,0,0
39383,RM-B220,12/26/2014,0,0,0,0,0,0,0
39384,RM-B220,12/27/2014,0,0,0,0,0,0,0
39385,RM-B220,12/28/2014,0,0,0,0,0,0,0
39386,RM-B220,12/29/2014,0,0,0,0,0,0,0
39387,RM-B220,12/30/2014,0,0,0,0,0,0,0
39388,RM-B220,12/31/2014,0,0,0,0,0,0,0
39389,RM-B220,1/1/2015,0,0,0,0,0,0,0
39390,RM-B220,1/2/2015,0,0,0,0,0,0,0
39391,RM-B220,1/3/2015,0,0,0,0,0,0,0
39392,RM-B220,1/4/2015,0,0,0,0,0,0,0
39393,RM-B220,1/5/2015,0,0,0,0,0,0,0
39394,RM-B220,1/6/2015,0,0,0,0,0,0,0
39395,RM-B220,1/7/2015,0,0,0,0,0,0,0
39396,RM-B220,1/8/2015,0,0,0,0,0,0,0
39397,RM-B220,1/9/2015,0,0,0,0,0,0,0
39398,RM-B220,1/10/2015,0,0,0,0,0,0,0
39399,RM-B220,1/11/2015,0,0,0,0,0,0,0
39400,RM-B220,1/12/2015,0,0,0,0,0,0,0
39401,RM-B220,1/13/2015,0,0,0,0,0,0,0
39402,RM-B220,1/14/2015,0,0,0,0,0,0,0
39403,RM-B220,1/15/2015,0,0,0,0,0,0,0
39404,RM-B220,1/16/2015,0,0,0,0,0,0,0
39405,RM-B220,1/17/2015,0,0,0,0,0,0,0
39406,RM-B220,1/18/2015,0,0,0,0,0,0,0
39407,RM-B220,1/19/2015,0,0,0,0,0,0,0
39408,RM-B220,1/20/2015,0,0,0,0,0,0,0
39409,RM-B220,1/21/2015,0,0,0,0,0,0,0
39410,RM-B220,1/22/2015,0,0,0,0,0,0,0
39411,RM-B220,1/23/2015,0,0,0,0,0,0,0
39412,RM-B220,1/24/2015,0,0,0,0,0,0,0
39413,RM-B220,1/25/2015,0,0,0,0,0,0,0
39414,RM-B220,1/26/2015,0,0,0,0,0,0,0
39415,RM-B220,1/27/2015,0,0,0,0,0,0,0
39416,RM-B220,1/28/2015,0,0,0,0,0,0,0
39417,RM-B220,1/29/2015,0,0,0,0,0,0,0
39418,RM-B220,1/30/2015,0,0,0,0,0,0,0
39419,RM-B220,1/31/2015,0,0,0,0,0,0,0
39420,RM-B220,2/1/2015,0,0,0,0,0,0,0
39421,RM-B220,2/2/2015,0,0,0,0,0,0,0
39422,RM-B220,2/3/2015,0,0,0,0,0,0,0
39423,RM-B220,2/4/2015,0,0,0,0,0,0,0
39424,RM-B220,2/5/2015,0,0,0,0,0,0,0
39425,RM-B220,2/6/2015,0,0,0,0,0,0,0
39426,RM-B220,2/7/2015,0,0,0,0,0,0,0
39427,RM-B220,2/8/2015,0,0,0,0,0,0,0
39428,RM-B220,2/9/2015,0,0,0,0,0,0,0
39429,RM-B220,2/10/2015,0,0,0,0,0,0,0
39430,RM-B220,2/11/2015,0,0,0,0,0,0,0
39431,RM-B220,2/12/2015,0,0,0,0,0,0,0
39432,RM-B220,2/13/2015,0,0,0,0,0,0,0
39433,RM-B220,2/14/2015,0,0,0,0,0,0,0
39434,RM-B220,2/15/2015,0,0,0,0,0,0,0
39435,RM-B220,2/16/2015,0,0,0,0,0,0,0
39436,RM-B220,2/17/2015,0,0,0,0,0,0,0
39437,RM-B220,2/18/2015,0,0,0,0,0,0,0
39438,RM-B220,2/19/2015,0,0,0,0,0,0,0
39439,RM-B220,2/20/2015,0,0,0,0,0,0,0
39440,RM-B220,2/21/2015,0,0,0,0,0,0,0
39441,RM-B220,2/22/2015,0,0,0,0,0,0,0
39442,RM-B220,2/23/2015,0,0,0,0,0,0,0
39443,RM-B220,2/24/2015,0,0,0,0,0,0,0
39444,RM-B220,2/25/2015,0,0,0,0,0,0,0
39445,RM-B220,2/26/2015,0,0,0,0,0,0,0
39446,RM-B220,2/27/2015,0,0,0,0,0,0,0
39447,RM-B220,2/28/2015,0,0,0,0,0,0,0
39448,RM-B220,3/1/2015,0,0,0,0,0,0,0
39449,RM-B220,3/2/2015,0,0,0,0,0,0,0
39450,RM-B220,3/3/2015,0,0,0,0,0,0,0
39451,RM-B220,3/4/2015,0,0,0,0,0,0,0
39452,RM-B220,3/5/2015,0,0,0,0,0,0,0
39453,RM-B220,3/6/2015,0,0,0,0,0,0,0
39454,RM-B220,3/7/2015,0,0,0,0,0,0,0
39455,RM-B220,3/8/2015,0,0,0,0,0,0,0
39456,RM-B220,3/9/2015,0,0,0,0,0,0,0
39457,RM-B220,3/10/2015,0,0,0,0,0,0,0
39458,RM-B220,3/11/2015,0,0,0,0,0,0,0
39459,RM-B220,3/12/2015,0,0,0,0,0,0,0
39460,RM-B220,3/13/2015,0,0,0,0,0,0,0
39461,RM-B220,3/14/2015,0,0,0,0,0,0,0
39462,RM-B220,3/15/2015,0,0,0,0,0,0,0
39463,RM-B220,3/16/2015,0,0,0,0,0,0,0
39464,RM-B220,3/17/2015,0,0,0,0,0,0,0
39465,RM-B220,3/18/2015,0,0,0,0,0,0,0
39466,RM-B220,3/19/2015,0,0,0,0,0,0,0
39467,RM-B220,3/20/2015,0,0,0,0,0,0,0
39468,RM-B220,3/21/2015,0,0,0,0,0,0,0
39469,RM-B220,3/22/2015,0,0,0,0,0,0,0
39470,RM-B220,3/23/2015,0,0,0,0,0,0,0
39471,RM-B220,3/24/2015,0,0,0,0,0,0,0
39472,RM-B220,3/25/2015,0,0,0,0,0,0,0
39473,RM-B220,3/26/2015,0,0,0,0,0,0,0
39474,RM-B220,3/27/2015,0,0,0,0,0,0,0
39475,RM-B220,3/28/2015,0,0,0,0,0,0,0
39476,RM-B220,3/29/2015,0,0,0,0,0,0,0
39477,RM-B220,3/30/2015,0,0,0,0,0,0,0
39478,RM-B220,3/31/2015,0,0,0,0,0,0,0
39479,RM-B220,4/1/2015,0,0,0,0,0,0,0
39480,RM-B220,4/2/2015,0,0,0,0,0,0,0
39481,RM-B220,4/3/2015,0,0,0,0,0,0,0
39482,RM-B220,4/4/2015,0,0,0,0,0,0,0
39483,RM-B220,4/5/2015,0,0,0,0,0,0,0
39484,RM-B220,4/6/2015,0,0,0,0,0,0,0
39485,RM-B220,4/7/2015,0,0,0,0,0,0,0
39486,RM-B220,4/8/2015,0,0,0,0,0,0,0
39487,RM-B220,4/9/2015,0,0,0,0,0,0,0
39488,RM-B220,4/10/2015,0,0,0,0,0,0,0
39489,RM-B220,4/11/2015,0,0,0,0,0,0,0
39490,RM-B220,4/12/2015,0,0,0,0,0,0,0
39491,RM-B220,4/13/2015,0,0,0,0,0,0,0
39492,RM-B220,4/14/2015,0,0,0,0,0,0,0
39493,RM-B220,4/15/2015,0,0,0,0,0,0,0
39494,RM-B220,4/16/2015,0,0,0,0,0,0,0
39495,RM-B220,4/17/2015,0,0,0,0,0,0,0
39496,RM-B220,4/18/2015,0,0,0,0,0,0,0
39497,RM-B220,4/19/2015,0,0,0,0,0,0,0
39498,RM-B220,4/20/2015,0,0,0,0,0,0,0
39499,RM-B220,4/21/2015,0,0,0,0,0,0,0
39500,RM-B220,4/22/2015,0,0,0,0,0,0,0
39501,RM-B220,4/23/2015,0,0,0,0,0,0,0
39502,RM-B220,4/24/2015,0,0,0,0,0,0,0
39503,RM-B220,4/25/2015,0,0,0,0,0,0,0
39504,RM-B220,4/26/2015,0,0,0,0,0,0,0
39505,RM-B220,4/27/2015,0,0,0,0,0,0,0
39506,RM-B220,4/28/2015,0,0,0,0,0,0,0
39507,RM-B220,4/29/2015,0,0,0,0,0,0,0
39508,RM-B220,4/30/2015,0,0,0,0,0,0,0
39509,RM-B220,5/1/2015,0,0,0,0,0,0,0
39510,RM-B220,5/2/2015,0,0,0,0,0,0,0
39511,RM-B220,5/3/2015,0,0,0,0,0,0,0
39512,RM-B220,5/4/2015,0,0,0,0,0,0,0
39513,RM-B220,5/5/2015,0,0,0,0,0,0,0
39514,RM-B220,5/6/2015,0,0,0,0,0,0,0
39515,RM-B220,5/7/2015,0,0,0,0,0,0,0
39516,RM-B220,5/8/2015,0,0,0,0,0,0,0
39517,RM-B220,5/9/2015,0,0,0,0,0,0,0
39518,RM-B220,5/10/2015,0,0,0,0,0,0,0
39519,RM-B220,5/11/2015,0,0,0,0,0,0,0
39520,RM-B220,5/12/2015,0,0,0,0,0,0,0
39521,RM-B220,5/13/2015,0,0,0,0,0,0,0
39522,RM-B220,5/14/2015,0,0,0,0,0,0,0
39523,RM-B220,5/15/2015,0,0,0,0,0,0,0
39524,RM-B220,5/16/2015,0,0,0,0,0,0,0
39525,RM-B220,5/17/2015,0,0,0,0,0,0,0
39526,RM-B220,5/18/2015,0,0,0,0,0,0,0
39527,RM-B220,5/19/2015,0,0,0,0,0,0,0
39528,RM-B220,5/20/2015,0,0,0,0,0,0,0
39529,RM-B220,5/21/2015,0,0,0,0,0,0,0
39530,RM-B220,5/22/2015,0,0,0,0,0,0,0
39531,RM-B220,5/23/2015,0,0,0,0,0,0,0
39532,RM-B220,5/24/2015,0,0,0,0,0,0,0
39533,RM-B220,5/25/2015,0,0,0,0,0,0,0
39534,RM-B220,5/26/2015,0,0,0,0,0,0,0
39535,RM-B220,5/27/2015,0,0,0,0,0,0,0
39536,RM-B220,5/28/2015,0,0,0,0,0,0,0
39537,RM-B220,5/29/2015,0,0,0,0,0,0,0
39538,RM-B220,5/30/2015,0,0,0,0,0,0,0
39539,RM-B220,5/31/2015,0,0,0,0,0,0,0
39839,RM-B222,5/6/2014,0,0,0,0,0,0,0
40087,RM-B222,1/11/2015,0,0,0,0,0,0,0
40088,RM-B222,1/12/2015,0,0,0,0,0,0,0
40089,RM-B222,1/13/2015,0,0,0,0,0,0,0
40090,RM-B222,1/14/2015,0,0,0,0,0,0,0
40091,RM-B222,1/15/2015,0,0,0,0,0,0,0
40092,RM-B222,1/16/2015,0,0,0,0,0,0,0
40093,RM-B222,1/17/2015,0,0,0,0,0,0,0
40094,RM-B222,1/18/2015,0,0,0,0,0,0,0
40095,RM-B222,1/19/2015,0,0,0,0,0,0,0
40096,RM-B222,1/20/2015,0,0,0,0,0,0,0
40097,RM-B222,1/21/2015,0,0,0,0,0,0,0
40098,RM-B222,1/22/2015,0,0,0,0,0,0,0
40099,RM-B222,1/23/2015,0,0,0,0,0,0,0
40100,RM-B222,1/24/2015,0,0,0,0,0,0,0
40101,RM-B222,1/25/2015,0,0,0,0,0,0,0
40102,RM-B222,1/26/2015,0,0,0,0,0,0,0
40103,RM-B222,1/27/2015,0,0,0,0,0,0,0
40104,RM-B222,1/28/2015,0,0,0,0,0,0,0
40105,RM-B222,1/29/2015,0,0,0,0,0,0,0
40106,RM-B222,1/30/2015,0,0,0,0,0,0,0
40107,RM-B222,1/31/2015,0,0,0,0,0,0,0
40108,RM-B222,2/1/2015,0,0,0,0,0,0,0
40109,RM-B222,2/2/2015,0,0,0,0,0,0,0
40110,RM-B222,2/3/2015,0,0,0,0,0,0,0
40111,RM-B222,2/4/2015,0,0,0,0,0,0,0
40112,RM-B222,2/5/2015,0,0,0,0,0,0,0
40113,RM-B222,2/6/2015,0,0,0,0,0,0,0
40114,RM-B222,2/7/2015,0,0,0,0,0,0,0
40115,RM-B222,2/8/2015,0,0,0,0,0,0,0
40116,RM-B222,2/9/2015,0,0,0,0,0,0,0
40117,RM-B222,2/10/2015,0,0,0,0,0,0,0
40118,RM-B222,2/11/2015,0,0,0,0,0,0,0
40119,RM-B222,2/12/2015,0,0,0,0,0,0,0
40120,RM-B222,2/13/2015,0,0,0,0,0,0,0
40121,RM-B222,2/14/2015,0,0,0,0,0,0,0
40122,RM-B222,2/15/2015,0,0,0,0,0,0,0
40123,RM-B222,2/16/2015,0,0,0,0,0,0,0
40124,RM-B222,2/17/2015,0,0,0,0,0,0,0
40125,RM-B222,2/18/2015,0,0,0,0,0,0,0
40126,RM-B222,2/19/2015,0,0,0,0,0,0,0
40127,RM-B222,2/20/2015,0,0,0,0,0,0,0
40128,RM-B222,2/21/2015,0,0,0,0,0,0,0
40129,RM-B222,2/22/2015,0,0,0,0,0,0,0
40130,RM-B222,2/23/2015,0,0,0,0,0,0,0
40131,RM-B222,2/24/2015,0,0,0,0,0,0,0
40132,RM-B222,2/25/2015,0,0,0,0,0,0,0
40133,RM-B222,2/26/2015,0,0,0,0,0,0,0
40134,RM-B222,2/27/2015,0,0,0,0,0,0,0
40135,RM-B222,2/28/2015,0,0,0,0,0,0,0
40136,RM-B222,3/1/2015,0,0,0,0,0,0,0
40137,RM-B222,3/2/2015,0,0,0,0,0,0,0
40138,RM-B222,3/3/2015,0,0,0,0,0,0,0
40139,RM-B222,3/4/2015,0,0,0,0,0,0,0
40140,RM-B222,3/5/2015,0,0,0,0,0,0,0
40141,RM-B222,3/6/2015,0,0,0,0,0,0,0
40142,RM-B222,3/7/2015,0,0,0,0,0,0,0
40143,RM-B222,3/8/2015,0,0,0,0,0,0,0
40144,RM-B222,3/9/2015,0,0,0,0,0,0,0
40145,RM-B222,3/10/2015,0,0,0,0,0,0,0
40146,RM-B222,3/11/2015,0,0,0,0,0,0,0
40147,RM-B222,3/12/2015,0,0,0,0,0,0,0
40148,RM-B222,3/13/2015,0,0,0,0,0,0,0
40149,RM-B222,3/14/2015,0,0,0,0,0,0,0
40150,RM-B222,3/15/2015,0,0,0,0,0,0,0
40151,RM-B222,3/16/2015,0,0,0,0,0,0,0
40152,RM-B222,3/17/2015,0,0,0,0,0,0,0
40153,RM-B222,3/18/2015,0,0,0,0,0,0,0
40154,RM-B222,3/19/2015,0,0,0,0,0,0,0
40155,RM-B222,3/20/2015,0,0,0,0,0,0,0
40156,RM-B222,3/21/2015,0,0,0,0,0,0,0
40157,RM-B222,3/22/2015,0,0,0,0,0,0,0
40158,RM-B222,3/23/2015,0,0,0,0,0,0,0
40159,RM-B222,3/24/2015,0,0,0,0,0,0,0
40160,RM-B222,3/25/2015,0,0,0,0,0,0,0
40161,RM-B222,3/26/2015,0,0,0,0,0,0,0
40162,RM-B222,3/27/2015,0,0,0,0,0,0,0
40163,RM-B222,3/28/2015,0,0,0,0,0,0,0
40164,RM-B222,3/29/2015,0,0,0,0,0,0,0
40165,RM-B222,3/30/2015,0,0,0,0,0,0,0
40166,RM-B222,3/31/2015,0,0,0,0,0,0,0
40167,RM-B222,4/1/2015,0,0,0,0,0,0,0
40168,RM-B222,4/2/2015,0,0,0,0,0,0,0
40169,RM-B222,4/3/2015,0,0,0,0,0,0,0
40170,RM-B222,4/4/2015,0,0,0,0,0,0,0
40171,RM-B222,4/5/2015,0,0,0,0,0,0,0
40172,RM-B222,4/6/2015,0,0,0,0,0,0,0
40173,RM-B222,4/7/2015,0,0,0,0,0,0,0
40174,RM-B222,4/8/2015,0,0,0,0,0,0,0
40175,RM-B222,4/9/2015,0,0,0,0,0,0,0
40176,RM-B222,4/10/2015,0,0,0,0,0,0,0
40177,RM-B222,4/11/2015,0,0,0,0,0,0,0
40178,RM-B222,4/12/2015,0,0,0,0,0,0,0
40179,RM-B222,4/13/2015,0,0,0,0,0,0,0
40180,RM-B222,4/14/2015,0,0,0,0,0,0,0
40181,RM-B222,4/15/2015,0,0,0,0,0,0,0
40182,RM-B222,4/16/2015,0,0,0,0,0,0,0
40183,RM-B222,4/17/2015,0,0,0,0,0,0,0
40184,RM-B222,4/18/2015,0,0,0,0,0,0,0
40185,RM-B222,4/19/2015,0,0,0,0,0,0,0
40186,RM-B222,4/20/2015,0,0,0,0,0,0,0
40187,RM-B222,4/21/2015,0,0,0,0,0,0,0
40188,RM-B222,4/22/2015,0,0,0,0,0,0,0
40189,RM-B222,4/23/2015,0,0,0,0,0,0,0
40190,RM-B222,4/24/2015,0,0,0,0,0,0,0
40191,RM-B222,4/25/2015,0,0,0,0,0,0,0
40192,RM-B222,4/26/2015,0,0,0,0,0,0,0
40193,RM-B222,4/27/2015,0,0,0,0,0,0,0
40194,RM-B222,4/28/2015,0,0,0,0,0,0,0
40195,RM-B222,4/29/2015,0,0,0,0,0,0,0
40196,RM-B222,4/30/2015,0,0,0,0,0,0,0
40197,RM-B222,5/1/2015,0,0,0,0,0,0,0
40198,RM-B222,5/2/2015,0,0,0,0,0,0,0
40199,RM-B222,5/3/2015,0,0,0,0,0,0,0
40200,RM-B222,5/4/2015,0,0,0,0,0,0,0
40201,RM-B222,5/5/2015,0,0,0,0,0,0,0
40202,RM-B222,5/6/2015,0,0,0,0,0,0,0
40203,RM-B222,5/7/2015,0,0,0,0,0,0,0
40204,RM-B222,5/8/2015,0,0,0,0,0,0,0
40205,RM-B222,5/9/2015,0,0,0,0,0,0,0
40206,RM-B222,5/10/2015,0,0,0,0,0,0,0
40207,RM-B222,5/11/2015,0,0,0,0,0,0,0
40208,RM-B222,5/12/2015,0,0,0,0,0,0,0
40209,RM-B222,5/13/2015,0,0,0,0,0,0,0
40210,RM-B222,5/14/2015,0,0,0,0,0,0,0
40211,RM-B222,5/15/2015,0,0,0,0,0,0,0
40212,RM-B222,5/16/2015,0,0,0,0,0,0,0
40213,RM-B222,5/17/2015,0,0,0,0,0,0,0
40214,RM-B222,5/18/2015,0,0,0,0,0,0,0
40215,RM-B222,5/19/2015,0,0,0,0,0,0,0
40216,RM-B222,5/20/2015,0,0,0,0,0,0,0
40217,RM-B222,5/21/2015,0,0,0,0,0,0,0
40218,RM-B222,5/22/2015,0,0,0,0,0,0,0
40219,RM-B222,5/23/2015,0,0,0,0,0,0,0
40220,RM-B222,5/24/2015,0,0,0,0,0,0,0
40221,RM-B222,5/25/2015,0,0,0,0,0,0,0
40222,RM-B222,5/26/2015,0,0,0,0,0,0,0
40223,RM-B222,5/27/2015,0,0,0,0,0,0,0
40224,RM-B222,5/28/2015,0,0,0,0,0,0,0
40225,RM-B222,5/29/2015,0,0,0,0,0,0,0
40226,RM-B222,5/30/2015,0,0,0,0,0,0,0
40227,RM-B222,5/31/2015,0,0,0,0,0,0,0
40228,RM-B224,6/28/2013,0,0,0,0,0,0,0
40229,RM-B224,6/29/2013,0,0,0,0,0,0,0
40230,RM-B224,6/30/2013,0,0,0,0,0,0,0
40489,RM-B224,3/29/2014,0,0,0,0,0,0,0
40490,RM-B224,3/30/2014,0,0,0,0,0,0,0
40491,RM-B224,3/31/2014,0,0,0,0,0,0,0
40492,RM-B224,4/1/2014,0,0,0,0,0,0,0
40493,RM-B224,4/2/2014,0,0,0,0,0,0,0
40494,RM-B224,4/3/2014,0,0,0,0,0,0,0
40495,RM-B224,4/4/2014,0,0,0,0,0,0,0
40496,RM-B224,4/5/2014,0,0,0,0,0,0,0
40497,RM-B224,4/6/2014,0,0,0,0,0,0,0
40498,RM-B224,4/7/2014,0,0,0,0,0,0,0
40499,RM-B224,4/8/2014,0,0,0,0,0,0,0
40500,RM-B224,4/9/2014,0,0,0,0,0,0,0
40501,RM-B224,4/10/2014,0,0,0,0,0,0,0
40502,RM-B224,4/11/2014,0,0,0,0,0,0,0
40503,RM-B224,4/12/2014,0,0,0,0,0,0,0
40504,RM-B224,4/13/2014,0,0,0,0,0,0,0
40505,RM-B224,4/14/2014,0,0,0,0,0,0,0
40506,RM-B224,4/15/2014,0,0,0,0,0,0,0
40507,RM-B224,4/16/2014,0,0,0,0,0,0,0
40508,RM-B224,4/17/2014,0,0,0,0,0,0,0
40509,RM-B224,4/18/2014,0,0,0,0,0,0,0
40510,RM-B224,4/19/2014,0,0,0,0,0,0,0
40511,RM-B224,4/20/2014,0,0,0,0,0,0,0
40512,RM-B224,4/21/2014,0,0,0,0,0,0,0
40513,RM-B224,4/22/2014,0,0,0,0,0,0,0
40514,RM-B224,4/23/2014,0,0,0,0,0,0,0
40515,RM-B224,4/24/2014,0,0,0,0,0,0,0
40516,RM-B224,4/25/2014,0,0,0,0,0,0,0
40517,RM-B224,4/26/2014,0,0,0,0,0,0,0
40518,RM-B224,4/27/2014,0,0,0,0,0,0,0
40519,RM-B224,4/28/2014,0,0,0,0,0,0,0
40520,RM-B224,4/29/2014,0,0,0,0,0,0,0
40521,RM-B224,4/30/2014,0,0,0,0,0,0,0
40522,RM-B224,5/1/2014,0,0,0,0,0,0,0
40523,RM-B224,5/2/2014,0,0,0,0,0,0,0
40524,RM-B224,5/3/2014,0,0,0,0,0,0,0
40525,RM-B224,5/4/2014,0,0,0,0,0,0,0
40526,RM-B224,5/5/2014,0,0,0,0,0,0,0
40527,RM-B224,5/6/2014,0,0,0,0,0,0,0
40528,RM-B224,5/7/2014,0,0,0,0,0,0,0
40529,RM-B224,5/8/2014,0,0,0,0,0,0,0
40530,RM-B224,5/9/2014,0,0,0,0,0,0,0
40531,RM-B224,5/10/2014,0,0,0,0,0,0,0
40532,RM-B224,5/11/2014,0,0,0,0,0,0,0
40533,RM-B224,5/12/2014,0,0,0,0,0,0,0
40534,RM-B224,5/13/2014,0,0,0,0,0,0,0
40535,RM-B224,5/14/2014,0,0,0,0,0,0,0
40536,RM-B224,5/15/2014,0,0,0,0,0,0,0
40537,RM-B224,5/16/2014,0,0,0,0,0,0,0
40538,RM-B224,5/17/2014,0,0,0,0,0,0,0
40539,RM-B224,5/18/2014,0,0,0,0,0,0,0
40540,RM-B224,5/19/2014,0,0,0,0,0,0,0
40541,RM-B224,5/20/2014,0,0,0,0,0,0,0
40542,RM-B224,5/21/2014,0,0,0,0,0,0,0
40543,RM-B224,5/22/2014,0,0,0,0,0,0,0
40544,RM-B224,5/23/2014,0,0,0,0,0,0,0
40545,RM-B224,5/24/2014,0,0,0,0,0,0,0
40546,RM-B224,5/25/2014,0,0,0,0,0,0,0
40547,RM-B224,5/26/2014,0,0,0,0,0,0,0
40548,RM-B224,5/27/2014,0,0,0,0,0,0,0
40549,RM-B224,5/28/2014,0,0,0,0,0,0,0
40550,RM-B224,5/29/2014,0,0,0,0,0,0,0
40551,RM-B224,5/30/2014,0,0,0,0,0,0,0
40552,RM-B224,5/31/2014,0,0,0,0,0,0,0
40553,RM-B224,6/1/2014,0,0,0,0,0,0,0
40554,RM-B224,6/2/2014,0,0,0,0,0,0,0
40555,RM-B224,6/3/2014,0,0,0,0,0,0,0
40556,RM-B224,6/4/2014,0,0,0,0,0,0,0
40557,RM-B224,6/5/2014,0,0,0,0,0,0,0
40558,RM-B224,6/6/2014,0,0,0,0,0,0,0
40559,RM-B224,6/7/2014,0,0,0,0,0,0,0
40560,RM-B224,6/8/2014,0,0,0,0,0,0,0
40561,RM-B224,6/9/2014,0,0,0,0,0,0,0
40562,RM-B224,6/10/2014,0,0,0,0,0,0,0
40563,RM-B224,6/11/2014,0,0,0,0,0,0,0
40564,RM-B224,6/12/2014,0,0,0,0,0,0,0
40565,RM-B224,6/13/2014,0,0,0,0,0,0,0
40566,RM-B224,6/14/2014,0,0,0,0,0,0,0
40567,RM-B224,6/15/2014,0,0,0,0,0,0,0
40568,RM-B224,6/16/2014,0,0,0,0,0,0,0
40569,RM-B224,6/17/2014,0,0,0,0,0,0,0
40570,RM-B224,6/18/2014,0,0,0,0,0,0,0
40571,RM-B224,6/19/2014,0,0,0,0,0,0,0
40572,RM-B224,6/20/2014,0,0,0,0,0,0,0
40573,RM-B224,6/21/2014,0,0,0,0,0,0,0
40574,RM-B224,6/22/2014,0,0,0,0,0,0,0
40575,RM-B224,6/23/2014,0,0,0,0,0,0,0
40576,RM-B224,6/24/2014,0,0,0,0,0,0,0
40577,RM-B224,6/25/2014,0,0,0,0,0,0,0
40578,RM-B224,6/26/2014,0,0,0,0,0,0,0
40579,RM-B224,6/27/2014,0,0,0,0,0,0,0
40580,RM-B224,6/28/2014,0,0,0,0,0,0,0
40581,RM-B224,6/29/2014,0,0,0,0,0,0,0
40582,RM-B224,6/30/2014,0,0,0,0,0,0,0
40583,RM-B224,7/1/2014,0,0,0,0,0,0,0
40584,RM-B224,7/2/2014,0,0,0,0,0,0,0
40585,RM-B224,7/3/2014,0,0,0,0,0,0,0
40586,RM-B224,7/4/2014,0,0,0,0,0,0,0
40587,RM-B224,7/5/2014,0,0,0,0,0,0,0
40588,RM-B224,7/6/2014,0,0,0,0,0,0,0
40589,RM-B224,7/7/2014,0,0,0,0,0,0,0
40590,RM-B224,7/8/2014,0,0,0,0,0,0,0
40591,RM-B224,7/9/2014,0,0,0,0,0,0,0
40592,RM-B224,7/10/2014,0,0,0,0,0,0,0
40593,RM-B224,7/11/2014,0,0,0,0,0,0,0
40594,RM-B224,7/12/2014,0,0,0,0,0,0,0
40595,RM-B224,7/13/2014,0,0,0,0,0,0,0
40596,RM-B224,7/14/2014,0,0,0,0,0,0,0
40597,RM-B224,7/15/2014,0,0,0,0,0,0,0
40598,RM-B224,7/16/2014,0,0,0,0,0,0,0
40599,RM-B224,7/17/2014,0,0,0,0,0,0,0
40600,RM-B224,7/18/2014,0,0,0,0,0,0,0
40601,RM-B224,7/19/2014,0,0,0,0,0,0,0
40602,RM-B224,7/20/2014,0,0,0,0,0,0,0
40603,RM-B224,7/21/2014,0,0,0,0,0,0,0
40604,RM-B224,7/22/2014,0,0,0,0,0,0,0
40605,RM-B224,7/23/2014,0,0,0,0,0,0,0
40606,RM-B224,7/24/2014,0,0,0,0,0,0,0
40607,RM-B224,7/25/2014,0,0,0,0,0,0,0
40608,RM-B224,7/26/2014,0,0,0,0,0,0,0
40609,RM-B224,7/27/2014,0,0,0,0,0,0,0
40610,RM-B224,7/28/2014,0,0,0,0,0,0,0
40611,RM-B224,7/29/2014,0,0,0,0,0,0,0
40612,RM-B224,7/30/2014,0,0,0,0,0,0,0
40613,RM-B224,7/31/2014,0,0,0,0,0,0,0
40614,RM-B224,8/1/2014,0,0,0,0,0,0,0
40615,RM-B224,8/2/2014,0,0,0,0,0,0,0
40616,RM-B224,8/3/2014,0,0,0,0,0,0,0
40617,RM-B224,8/4/2014,0,0,0,0,0,0,0
40618,RM-B224,8/5/2014,0,0,0,0,0,0,0
40619,RM-B224,8/6/2014,0,0,0,0,0,0,0
40620,RM-B224,8/7/2014,0,0,0,0,0,0,0
40621,RM-B224,8/8/2014,0,0,0,0,0,0,0
40622,RM-B224,8/9/2014,0,0,0,0,0,0,0
40623,RM-B224,8/10/2014,0,0,0,0,0,0,0
40624,RM-B224,8/11/2014,0,0,0,0,0,0,0
40625,RM-B224,8/12/2014,0,0,0,0,0,0,0
40626,RM-B224,8/13/2014,0,0,0,0,0,0,0
40627,RM-B224,8/14/2014,0,0,0,0,0,0,0
40628,RM-B224,8/15/2014,0,0,0,0,0,0,0
40629,RM-B224,8/16/2014,0,0,0,0,0,0,0
40630,RM-B224,8/17/2014,0,0,0,0,0,0,0
40631,RM-B224,8/18/2014,0,0,0,0,0,0,0
40632,RM-B224,8/19/2014,0,0,0,0,0,0,0
40633,RM-B224,8/20/2014,0,0,0,0,0,0,0
40634,RM-B224,8/21/2014,0,0,0,0,0,0,0
40635,RM-B224,8/22/2014,0,0,0,0,0,0,0
40636,RM-B224,8/23/2014,0,0,0,0,0,0,0
40637,RM-B224,8/24/2014,0,0,0,0,0,0,0
40638,RM-B224,8/25/2014,0,0,0,0,0,0,0
40639,RM-B224,8/26/2014,0,0,0,0,0,0,0
40640,RM-B224,8/27/2014,0,0,0,0,0,0,0
40641,RM-B224,8/28/2014,0,0,0,0,0,0,0
40642,RM-B224,8/29/2014,0,0,0,0,0,0,0
40643,RM-B224,8/30/2014,0,0,0,0,0,0,0
40644,RM-B224,8/31/2014,0,0,0,0,0,0,0
40645,RM-B224,9/1/2014,0,0,0,0,0,0,0
40646,RM-B224,9/2/2014,0,0,0,0,0,0,0
40647,RM-B224,9/3/2014,0,0,0,0,0,0,0
40648,RM-B224,9/4/2014,0,0,0,0,0,0,0
40649,RM-B224,9/5/2014,0,0,0,0,0,0,0
40650,RM-B224,9/6/2014,0,0,0,0,0,0,0
40651,RM-B224,9/7/2014,0,0,0,0,0,0,0
40652,RM-B224,9/8/2014,0,0,0,0,0,0,0
40653,RM-B224,9/9/2014,0,0,0,0,0,0,0
40654,RM-B224,9/10/2014,0,0,0,0,0,0,0
40655,RM-B224,9/11/2014,0,0,0,0,0,0,0
40656,RM-B224,9/12/2014,0,0,0,0,0,0,0
40657,RM-B224,9/13/2014,0,0,0,0,0,0,0
40658,RM-B224,9/14/2014,0,0,0,0,0,0,0
40659,RM-B224,9/15/2014,0,0,0,0,0,0,0
40660,RM-B224,9/16/2014,0,0,0,0,0,0,0
40661,RM-B224,9/17/2014,0,0,0,0,0,0,0
40662,RM-B224,9/18/2014,0,0,0,0,0,0,0
40663,RM-B224,9/19/2014,0,0,0,0,0,0,0
40664,RM-B224,9/20/2014,0,0,0,0,0,0,0
40665,RM-B224,9/21/2014,0,0,0,0,0,0,0
40666,RM-B224,9/22/2014,0,0,0,0,0,0,0
40667,RM-B224,9/23/2014,0,0,0,0,0,0,0
40668,RM-B224,9/24/2014,0,0,0,0,0,0,0
40669,RM-B224,9/25/2014,0,0,0,0,0,0,0
40670,RM-B224,9/28/2014,0,0,0,0,0,0,0
40671,RM-B224,9/29/2014,0,0,0,0,0,0,0
40672,RM-B224,9/30/2014,0,0,0,0,0,0,0
40673,RM-B224,10/1/2014,0,0,0,0,0,0,0
40674,RM-B224,10/2/2014,0,0,0,0,0,0,0
40675,RM-B224,10/3/2014,0,0,0,0,0,0,0
40676,RM-B224,10/4/2014,0,0,0,0,0,0,0
40677,RM-B224,10/5/2014,0,0,0,0,0,0,0
40678,RM-B224,10/6/2014,0,0,0,0,0,0,0
40679,RM-B224,10/7/2014,0,0,0,0,0,0,0
40680,RM-B224,10/8/2014,0,0,0,0,0,0,0
40681,RM-B224,10/9/2014,0,0,0,0,0,0,0
40682,RM-B224,10/10/2014,0,0,0,0,0,0,0
40683,RM-B224,10/11/2014,0,0,0,0,0,0,0
40684,RM-B224,10/12/2014,0,0,0,0,0,0,0
40685,RM-B224,10/13/2014,0,0,0,0,0,0,0
40686,RM-B224,10/14/2014,0,0,0,0,0,0,0
40687,RM-B224,10/15/2014,0,0,0,0,0,0,0
40688,RM-B224,10/16/2014,0,0,0,0,0,0,0
40689,RM-B224,10/17/2014,0,0,0,0,0,0,0
40690,RM-B224,10/18/2014,0,0,0,0,0,0,0
40691,RM-B224,10/19/2014,0,0,0,0,0,0,0
40692,RM-B224,10/20/2014,0,0,0,0,0,0,0
40693,RM-B224,10/21/2014,0,0,0,0,0,0,0
40694,RM-B224,10/22/2014,0,0,0,0,0,0,0
40695,RM-B224,10/23/2014,0,0,0,0,0,0,0
40696,RM-B224,10/24/2014,0,0,0,0,0,0,0
40697,RM-B224,10/25/2014,0,0,0,0,0,0,0
40698,RM-B224,10/26/2014,0,0,0,0,0,0,0
40699,RM-B224,10/27/2014,0,0,0,0,0,0,0
40700,RM-B224,10/28/2014,0,0,0,0,0,0,0
40701,RM-B224,10/29/2014,0,0,0,0,0,0,0
40702,RM-B224,10/30/2014,0,0,0,0,0,0,0
40703,RM-B224,10/31/2014,0,0,0,0,0,0,0
40704,RM-B224,11/1/2014,0,0,0,0,0,0,0
40705,RM-B224,11/2/2014,0,0,0,0,0,0,0
40706,RM-B224,11/3/2014,0,0,0,0,0,0,0
40707,RM-B224,11/4/2014,0,0,0,0,0,0,0
40708,RM-B224,11/5/2014,0,0,0,0,0,0,0
40709,RM-B224,11/6/2014,0,0,0,0,0,0,0
40710,RM-B224,11/7/2014,0,0,0,0,0,0,0
40711,RM-B224,11/8/2014,0,0,0,0,0,0,0
40712,RM-B224,11/9/2014,0,0,0,0,0,0,0
40713,RM-B224,11/10/2014,0,0,0,0,0,0,0
40714,RM-B224,11/11/2014,0,0,0,0,0,0,0
40715,RM-B224,11/12/2014,0,0,0,0,0,0,0
40716,RM-B224,11/13/2014,0,0,0,0,0,0,0
40717,RM-B224,11/14/2014,0,0,0,0,0,0,0
40718,RM-B224,11/15/2014,0,0,0,0,0,0,0
40719,RM-B224,11/16/2014,0,0,0,0,0,0,0
40720,RM-B224,11/17/2014,0,0,0,0,0,0,0
40721,RM-B224,11/18/2014,0,0,0,0,0,0,0
40722,RM-B224,11/19/2014,0,0,0,0,0,0,0
40723,RM-B224,11/20/2014,0,0,0,0,0,0,0
40724,RM-B224,11/21/2014,0,0,0,0,0,0,0
40725,RM-B224,11/22/2014,0,0,0,0,0,0,0
40726,RM-B224,11/23/2014,0,0,0,0,0,0,0
40727,RM-B224,11/24/2014,0,0,0,0,0,0,0
40728,RM-B224,11/25/2014,0,0,0,0,0,0,0
40729,RM-B224,11/26/2014,0,0,0,0,0,0,0
40730,RM-B224,11/27/2014,0,0,0,0,0,0,0
40731,RM-B224,11/28/2014,0,0,0,0,0,0,0
40732,RM-B224,11/29/2014,0,0,0,0,0,0,0
40733,RM-B224,11/30/2014,0,0,0,0,0,0,0
40734,RM-B224,12/1/2014,0,0,0,0,0,0,0
40735,RM-B224,12/2/2014,0,0,0,0,0,0,0
40736,RM-B224,12/3/2014,0,0,0,0,0,0,0
40737,RM-B224,12/4/2014,0,0,0,0,0,0,0
40738,RM-B224,12/5/2014,0,0,0,0,0,0,0
40739,RM-B224,12/6/2014,0,0,0,0,0,0,0
40740,RM-B224,12/7/2014,0,0,0,0,0,0,0
40741,RM-B224,12/8/2014,0,0,0,0,0,0,0
40742,RM-B224,12/9/2014,0,0,0,0,0,0,0
40743,RM-B224,12/10/2014,0,0,0,0,0,0,0
40744,RM-B224,12/11/2014,0,0,0,0,0,0,0
40745,RM-B224,12/12/2014,0,0,0,0,0,0,0
40746,RM-B224,12/13/2014,0,0,0,0,0,0,0
40747,RM-B224,12/14/2014,0,0,0,0,0,0,0
40748,RM-B224,12/15/2014,0,0,0,0,0,0,0
40749,RM-B224,12/16/2014,0,0,0,0,0,0,0
40750,RM-B224,12/17/2014,0,0,0,0,0,0,0
40751,RM-B224,12/18/2014,0,0,0,0,0,0,0
40752,RM-B224,12/19/2014,0,0,0,0,0,0,0
40753,RM-B224,12/20/2014,0,0,0,0,0,0,0
40754,RM-B224,12/21/2014,0,0,0,0,0,0,0
40755,RM-B224,12/22/2014,0,0,0,0,0,0,0
40756,RM-B224,12/23/2014,0,0,0,0,0,0,0
40757,RM-B224,12/24/2014,0,0,0,0,0,0,0
40758,RM-B224,12/25/2014,0,0,0,0,0,0,0
40759,RM-B224,12/26/2014,0,0,0,0,0,0,0
40760,RM-B224,12/27/2014,0,0,0,0,0,0,0
40761,RM-B224,12/28/2014,0,0,0,0,0,0,0
40762,RM-B224,12/29/2014,0,0,0,0,0,0,0
40763,RM-B224,12/30/2014,0,0,0,0,0,0,0
40764,RM-B224,12/31/2014,0,0,0,0,0,0,0
40765,RM-B224,1/1/2015,0,0,0,0,0,0,0
40766,RM-B224,1/2/2015,0,0,0,0,0,0,0
40767,RM-B224,1/3/2015,0,0,0,0,0,0,0
40768,RM-B224,1/4/2015,0,0,0,0,0,0,0
40769,RM-B224,1/5/2015,0,0,0,0,0,0,0
40770,RM-B224,1/6/2015,0,0,0,0,0,0,0
40771,RM-B224,1/7/2015,0,0,0,0,0,0,0
40772,RM-B224,1/8/2015,0,0,0,0,0,0,0
40773,RM-B224,1/9/2015,0,0,0,0,0,0,0
40774,RM-B224,1/10/2015,0,0,0,0,0,0,0
40775,RM-B224,1/11/2015,0,0,0,0,0,0,0
40776,RM-B224,1/12/2015,0,0,0,0,0,0,0
40777,RM-B224,1/13/2015,0,0,0,0,0,0,0
40778,RM-B224,1/14/2015,0,0,0,0,0,0,0
40779,RM-B224,1/15/2015,0,0,0,0,0,0,0
40780,RM-B224,1/16/2015,0,0,0,0,0,0,0
40781,RM-B224,1/17/2015,0,0,0,0,0,0,0
40782,RM-B224,1/18/2015,0,0,0,0,0,0,0
40783,RM-B224,1/19/2015,0,0,0,0,0,0,0
40784,RM-B224,1/20/2015,0,0,0,0,0,0,0
40785,RM-B224,1/21/2015,0,0,0,0,0,0,0
40786,RM-B224,1/22/2015,0,0,0,0,0,0,0
40787,RM-B224,1/23/2015,0,0,0,0,0,0,0
40788,RM-B224,1/24/2015,0,0,0,0,0,0,0
40789,RM-B224,1/25/2015,0,0,0,0,0,0,0
40790,RM-B224,1/26/2015,0,0,0,0,0,0,0
40791,RM-B224,1/27/2015,0,0,0,0,0,0,0
40792,RM-B224,1/28/2015,0,0,0,0,0,0,0
40793,RM-B224,1/29/2015,0,0,0,0,0,0,0
40794,RM-B224,1/30/2015,0,0,0,0,0,0,0
40795,RM-B224,1/31/2015,0,0,0,0,0,0,0
40796,RM-B224,2/1/2015,0,0,0,0,0,0,0
40797,RM-B224,2/2/2015,0,0,0,0,0,0,0
40798,RM-B224,2/3/2015,0,0,0,0,0,0,0
40799,RM-B224,2/4/2015,0,0,0,0,0,0,0
40800,RM-B224,2/5/2015,0,0,0,0,0,0,0
40801,RM-B224,2/6/2015,0,0,0,0,0,0,0
40802,RM-B224,2/7/2015,0,0,0,0,0,0,0
40803,RM-B224,2/8/2015,0,0,0,0,0,0,0
40804,RM-B224,2/9/2015,0,0,0,0,0,0,0
40805,RM-B224,2/10/2015,0,0,0,0,0,0,0
40806,RM-B224,2/11/2015,0,0,0,0,0,0,0
40807,RM-B224,2/12/2015,0,0,0,0,0,0,0
40808,RM-B224,2/13/2015,0,0,0,0,0,0,0
40809,RM-B224,2/14/2015,0,0,0,0,0,0,0
40810,RM-B224,2/15/2015,0,0,0,0,0,0,0
40811,RM-B224,2/16/2015,0,0,0,0,0,0,0
40812,RM-B224,2/17/2015,0,0,0,0,0,0,0
40813,RM-B224,2/18/2015,0,0,0,0,0,0,0
40814,RM-B224,2/19/2015,0,0,0,0,0,0,0
40815,RM-B224,2/20/2015,0,0,0,0,0,0,0
40816,RM-B224,2/21/2015,0,0,0,0,0,0,0
40817,RM-B224,2/22/2015,0,0,0,0,0,0,0
40818,RM-B224,2/23/2015,0,0,0,0,0,0,0
40819,RM-B224,2/24/2015,0,0,0,0,0,0,0
40820,RM-B224,2/25/2015,0,0,0,0,0,0,0
40821,RM-B224,2/26/2015,0,0,0,0,0,0,0
40822,RM-B224,2/27/2015,0,0,0,0,0,0,0
40823,RM-B224,2/28/2015,0,0,0,0,0,0,0
40824,RM-B224,3/1/2015,0,0,0,0,0,0,0
40825,RM-B224,3/2/2015,0,0,0,0,0,0,0
40826,RM-B224,3/3/2015,0,0,0,0,0,0,0
40827,RM-B224,3/4/2015,0,0,0,0,0,0,0
40828,RM-B224,3/5/2015,0,0,0,0,0,0,0
40829,RM-B224,3/6/2015,0,0,0,0,0,0,0
40830,RM-B224,3/7/2015,0,0,0,0,0,0,0
40831,RM-B224,3/8/2015,0,0,0,0,0,0,0
40832,RM-B224,3/9/2015,0,0,0,0,0,0,0
40833,RM-B224,3/10/2015,0,0,0,0,0,0,0
40834,RM-B224,3/11/2015,0,0,0,0,0,0,0
40835,RM-B224,3/12/2015,0,0,0,0,0,0,0
40836,RM-B224,3/13/2015,0,0,0,0,0,0,0
40837,RM-B224,3/14/2015,0,0,0,0,0,0,0
40838,RM-B224,3/15/2015,0,0,0,0,0,0,0
40839,RM-B224,3/16/2015,0,0,0,0,0,0,0
40840,RM-B224,3/17/2015,0,0,0,0,0,0,0
40841,RM-B224,3/18/2015,0,0,0,0,0,0,0
40842,RM-B224,3/19/2015,0,0,0,0,0,0,0
40843,RM-B224,3/20/2015,0,0,0,0,0,0,0
40844,RM-B224,3/21/2015,0,0,0,0,0,0,0
40845,RM-B224,3/22/2015,0,0,0,0,0,0,0
40846,RM-B224,3/23/2015,0,0,0,0,0,0,0
40847,RM-B224,3/24/2015,0,0,0,0,0,0,0
40848,RM-B224,3/25/2015,0,0,0,0,0,0,0
40849,RM-B224,3/26/2015,0,0,0,0,0,0,0
40850,RM-B224,3/27/2015,0,0,0,0,0,0,0
40851,RM-B224,3/28/2015,0,0,0,0,0,0,0
40852,RM-B224,3/29/2015,0,0,0,0,0,0,0
40853,RM-B224,3/30/2015,0,0,0,0,0,0,0
40854,RM-B224,3/31/2015,0,0,0,0,0,0,0
40855,RM-B224,4/1/2015,0,0,0,0,0,0,0
40856,RM-B224,4/2/2015,0,0,0,0,0,0,0
40857,RM-B224,4/3/2015,0,0,0,0,0,0,0
40858,RM-B224,4/4/2015,0,0,0,0,0,0,0
40859,RM-B224,4/5/2015,0,0,0,0,0,0,0
40860,RM-B224,4/6/2015,0,0,0,0,0,0,0
40861,RM-B224,4/7/2015,0,0,0,0,0,0,0
40862,RM-B224,4/8/2015,0,0,0,0,0,0,0
40863,RM-B224,4/9/2015,0,0,0,0,0,0,0
40864,RM-B224,4/10/2015,0,0,0,0,0,0,0
40865,RM-B224,4/11/2015,0,0,0,0,0,0,0
40866,RM-B224,4/12/2015,0,0,0,0,0,0,0
40867,RM-B224,4/13/2015,0,0,0,0,0,0,0
40868,RM-B224,4/14/2015,0,0,0,0,0,0,0
40869,RM-B224,4/15/2015,0,0,0,0,0,0,0
40870,RM-B224,4/16/2015,0,0,0,0,0,0,0
40871,RM-B224,4/17/2015,0,0,0,0,0,0,0
40872,RM-B224,4/18/2015,0,0,0,0,0,0,0
40873,RM-B224,4/19/2015,0,0,0,0,0,0,0
40874,RM-B224,4/20/2015,0,0,0,0,0,0,0
40875,RM-B224,4/21/2015,0,0,0,0,0,0,0
40876,RM-B224,4/22/2015,0,0,0,0,0,0,0
40877,RM-B224,4/23/2015,0,0,0,0,0,0,0
40878,RM-B224,4/24/2015,0,0,0,0,0,0,0
40879,RM-B224,4/25/2015,0,0,0,0,0,0,0
40880,RM-B224,4/26/2015,0,0,0,0,0,0,0
40881,RM-B224,4/27/2015,0,0,0,0,0,0,0
40882,RM-B224,4/28/2015,0,0,0,0,0,0,0
40883,RM-B224,4/29/2015,0,0,0,0,0,0,0
40884,RM-B224,4/30/2015,0,0,0,0,0,0,0
40885,RM-B224,5/1/2015,0,0,0,0,0,0,0
40886,RM-B224,5/2/2015,0,0,0,0,0,0,0
40887,RM-B224,5/3/2015,0,0,0,0,0,0,0
40888,RM-B224,5/4/2015,0,0,0,0,0,0,0
40889,RM-B224,5/5/2015,0,0,0,0,0,0,0
40890,RM-B224,5/6/2015,0,0,0,0,0,0,0
40891,RM-B224,5/7/2015,0,0,0,0,0,0,0
40892,RM-B224,5/8/2015,0,0,0,0,0,0,0
40893,RM-B224,5/9/2015,0,0,0,0,0,0,0
40894,RM-B224,5/10/2015,0,0,0,0,0,0,0
40895,RM-B224,5/11/2015,0,0,0,0,0,0,0
40896,RM-B224,5/12/2015,0,0,0,0,0,0,0
40897,RM-B224,5/13/2015,0,0,0,0,0,0,0
40898,RM-B224,5/14/2015,0,0,0,0,0,0,0
40899,RM-B224,5/15/2015,0,0,0,0,0,0,0
40900,RM-B224,5/16/2015,0,0,0,0,0,0,0
40901,RM-B224,5/17/2015,0,0,0,0,0,0,0
40902,RM-B224,5/18/2015,0,0,0,0,0,0,0
40903,RM-B224,5/19/2015,0,0,0,0,0,0,0
40904,RM-B224,5/20/2015,0,0,0,0,0,0,0
40905,RM-B224,5/21/2015,0,0,0,0,0,0,0
40906,RM-B224,5/22/2015,0,0,0,0,0,0,0
40907,RM-B224,5/23/2015,0,0,0,0,0,0,0
40908,RM-B224,5/24/2015,0,0,0,0,0,0,0
40909,RM-B224,5/25/2015,0,0,0,0,0,0,0
40910,RM-B224,5/26/2015,0,0,0,0,0,0,0
40911,RM-B224,5/27/2015,0,0,0,0,0,0,0
40912,RM-B224,5/28/2015,0,0,0,0,0,0,0
40913,RM-B224,5/29/2015,0,0,0,0,0,0,0
40914,RM-B224,5/30/2015,0,0,0,0,0,0,0
40915,RM-B224,5/31/2015,0,0,0,0,0,0,0
40916,RM-B225,6/28/2013,0,0,0,0,0,0,0
40917,RM-B225,6/29/2013,0,0,0,0,0,0,0
40918,RM-B225,6/30/2013,0,0,0,0,0,0,0
41129,RM-B225,2/9/2014,0,0,0,0,0,0,0
41130,RM-B225,2/10/2014,0,0,0,0,0,0,0
41131,RM-B225,2/11/2014,0,0,0,0,0,0,0
41132,RM-B225,2/12/2014,0,0,0,0,0,0,0
41133,RM-B225,2/13/2014,0,0,0,0,0,0,0
41134,RM-B225,2/14/2014,0,0,0,0,0,0,0
41135,RM-B225,2/15/2014,0,0,0,0,0,0,0
41136,RM-B225,2/16/2014,0,0,0,0,0,0,0
41137,RM-B225,2/17/2014,0,0,0,0,0,0,0
41138,RM-B225,2/18/2014,0,0,0,0,0,0,0
41139,RM-B225,2/19/2014,0,0,0,0,0,0,0
41140,RM-B225,2/20/2014,0,0,0,0,0,0,0
41141,RM-B225,2/21/2014,0,0,0,0,0,0,0
41142,RM-B225,2/22/2014,0,0,0,0,0,0,0
41143,RM-B225,2/23/2014,0,0,0,0,0,0,0
41144,RM-B225,2/24/2014,0,0,0,0,0,0,0
41145,RM-B225,2/25/2014,0,0,0,0,0,0,0
41146,RM-B225,2/26/2014,0,0,0,0,0,0,0
41147,RM-B225,2/27/2014,0,0,0,0,0,0,0
41148,RM-B225,2/28/2014,0,0,0,0,0,0,0
41149,RM-B225,3/1/2014,0,0,0,0,0,0,0
41150,RM-B225,3/2/2014,0,0,0,0,0,0,0
41151,RM-B225,3/3/2014,0,0,0,0,0,0,0
41152,RM-B225,3/4/2014,0,0,0,0,0,0,0
41153,RM-B225,3/5/2014,0,0,0,0,0,0,0
41154,RM-B225,3/6/2014,0,0,0,0,0,0,0
41155,RM-B225,3/7/2014,0,0,0,0,0,0,0
41156,RM-B225,3/8/2014,0,0,0,0,0,0,0
41157,RM-B225,3/9/2014,0,0,0,0,0,0,0
41158,RM-B225,3/10/2014,0,0,0,0,0,0,0
41159,RM-B225,3/11/2014,0,0,0,0,0,0,0
41160,RM-B225,3/12/2014,0,0,0,0,0,0,0
41161,RM-B225,3/13/2014,0,0,0,0,0,0,0
41162,RM-B225,3/14/2014,0,0,0,0,0,0,0
41163,RM-B225,3/15/2014,0,0,0,0,0,0,0
41164,RM-B225,3/16/2014,0,0,0,0,0,0,0
41165,RM-B225,3/17/2014,0,0,0,0,0,0,0
41166,RM-B225,3/18/2014,0,0,0,0,0,0,0
41167,RM-B225,3/19/2014,0,0,0,0,0,0,0
41168,RM-B225,3/20/2014,0,0,0,0,0,0,0
41169,RM-B225,3/21/2014,0,0,0,0,0,0,0
41170,RM-B225,3/22/2014,0,0,0,0,0,0,0
41171,RM-B225,3/23/2014,0,0,0,0,0,0,0
41172,RM-B225,3/24/2014,0,0,0,0,0,0,0
41173,RM-B225,3/25/2014,0,0,0,0,0,0,0
41174,RM-B225,3/26/2014,0,0,0,0,0,0,0
41175,RM-B225,3/27/2014,0,0,0,0,0,0,0
41176,RM-B225,3/28/2014,0,0,0,0,0,0,0
41177,RM-B225,3/29/2014,0,0,0,0,0,0,0
41178,RM-B225,3/30/2014,0,0,0,0,0,0,0
41179,RM-B225,3/31/2014,0,0,0,0,0,0,0
41180,RM-B225,4/1/2014,0,0,0,0,0,0,0
41181,RM-B225,4/2/2014,0,0,0,0,0,0,0
41182,RM-B225,4/3/2014,0,0,0,0,0,0,0
41183,RM-B225,4/4/2014,0,0,0,0,0,0,0
41184,RM-B225,4/5/2014,0,0,0,0,0,0,0
41185,RM-B225,4/6/2014,0,0,0,0,0,0,0
41186,RM-B225,4/7/2014,0,0,0,0,0,0,0
41187,RM-B225,4/8/2014,0,0,0,0,0,0,0
41188,RM-B225,4/9/2014,0,0,0,0,0,0,0
41189,RM-B225,4/10/2014,0,0,0,0,0,0,0
41190,RM-B225,4/11/2014,0,0,0,0,0,0,0
41191,RM-B225,4/12/2014,0,0,0,0,0,0,0
41192,RM-B225,4/13/2014,0,0,0,0,0,0,0
41193,RM-B225,4/14/2014,0,0,0,0,0,0,0
41194,RM-B225,4/15/2014,0,0,0,0,0,0,0
41195,RM-B225,4/16/2014,0,0,0,0,0,0,0
41196,RM-B225,4/17/2014,0,0,0,0,0,0,0
41197,RM-B225,4/18/2014,0,0,0,0,0,0,0
41198,RM-B225,4/19/2014,0,0,0,0,0,0,0
41199,RM-B225,4/20/2014,0,0,0,0,0,0,0
41200,RM-B225,4/21/2014,0,0,0,0,0,0,0
41201,RM-B225,4/22/2014,0,0,0,0,0,0,0
41202,RM-B225,4/23/2014,0,0,0,0,0,0,0
41203,RM-B225,4/24/2014,0,0,0,0,0,0,0
41204,RM-B225,4/25/2014,0,0,0,0,0,0,0
41205,RM-B225,4/26/2014,0,0,0,0,0,0,0
41206,RM-B225,4/27/2014,0,0,0,0,0,0,0
41207,RM-B225,4/28/2014,0,0,0,0,0,0,0
41208,RM-B225,4/29/2014,0,0,0,0,0,0,0
41209,RM-B225,4/30/2014,0,0,0,0,0,0,0
41210,RM-B225,5/1/2014,0,0,0,0,0,0,0
41211,RM-B225,5/2/2014,0,0,0,0,0,0,0
41212,RM-B225,5/3/2014,0,0,0,0,0,0,0
41213,RM-B225,5/4/2014,0,0,0,0,0,0,0
41214,RM-B225,5/5/2014,0,0,0,0,0,0,0
41215,RM-B225,5/6/2014,0,0,0,0,0,0,0
41216,RM-B225,5/7/2014,0,0,0,0,0,0,0
41217,RM-B225,5/8/2014,0,0,0,0,0,0,0
41218,RM-B225,5/9/2014,0,0,0,0,0,0,0
41219,RM-B225,5/10/2014,0,0,0,0,0,0,0
41220,RM-B225,5/11/2014,0,0,0,0,0,0,0
41221,RM-B225,5/12/2014,0,0,0,0,0,0,0
41222,RM-B225,5/13/2014,0,0,0,0,0,0,0
41223,RM-B225,5/14/2014,0,0,0,0,0,0,0
41224,RM-B225,5/15/2014,0,0,0,0,0,0,0
41225,RM-B225,5/16/2014,0,0,0,0,0,0,0
41226,RM-B225,5/17/2014,0,0,0,0,0,0,0
41227,RM-B225,5/18/2014,0,0,0,0,0,0,0
41228,RM-B225,5/19/2014,0,0,0,0,0,0,0
41229,RM-B225,5/20/2014,0,0,0,0,0,0,0
41230,RM-B225,5/21/2014,0,0,0,0,0,0,0
41231,RM-B225,5/22/2014,0,0,0,0,0,0,0
41232,RM-B225,5/23/2014,0,0,0,0,0,0,0
41233,RM-B225,5/24/2014,0,0,0,0,0,0,0
41234,RM-B225,5/25/2014,0,0,0,0,0,0,0
41235,RM-B225,5/26/2014,0,0,0,0,0,0,0
41236,RM-B225,5/27/2014,0,0,0,0,0,0,0
41237,RM-B225,5/28/2014,0,0,0,0,0,0,0
41238,RM-B225,5/29/2014,0,0,0,0,0,0,0
41239,RM-B225,5/30/2014,0,0,0,0,0,0,0
41240,RM-B225,5/31/2014,0,0,0,0,0,0,0
41241,RM-B225,6/1/2014,0,0,0,0,0,0,0
41242,RM-B225,6/2/2014,0,0,0,0,0,0,0
41243,RM-B225,6/3/2014,0,0,0,0,0,0,0
41244,RM-B225,6/4/2014,0,0,0,0,0,0,0
41245,RM-B225,6/5/2014,0,0,0,0,0,0,0
41246,RM-B225,6/6/2014,0,0,0,0,0,0,0
41247,RM-B225,6/7/2014,0,0,0,0,0,0,0
41248,RM-B225,6/8/2014,0,0,0,0,0,0,0
41249,RM-B225,6/9/2014,0,0,0,0,0,0,0
41250,RM-B225,6/10/2014,0,0,0,0,0,0,0
41251,RM-B225,6/11/2014,0,0,0,0,0,0,0
41252,RM-B225,6/12/2014,0,0,0,0,0,0,0
41253,RM-B225,6/13/2014,0,0,0,0,0,0,0
41254,RM-B225,6/14/2014,0,0,0,0,0,0,0
41255,RM-B225,6/15/2014,0,0,0,0,0,0,0
41256,RM-B225,6/16/2014,0,0,0,0,0,0,0
41257,RM-B225,6/17/2014,0,0,0,0,0,0,0
41258,RM-B225,6/18/2014,0,0,0,0,0,0,0
41259,RM-B225,6/19/2014,0,0,0,0,0,0,0
41260,RM-B225,6/20/2014,0,0,0,0,0,0,0
41261,RM-B225,6/21/2014,0,0,0,0,0,0,0
41262,RM-B225,6/22/2014,0,0,0,0,0,0,0
41263,RM-B225,6/23/2014,0,0,0,0,0,0,0
41264,RM-B225,6/24/2014,0,0,0,0,0,0,0
41265,RM-B225,6/25/2014,0,0,0,0,0,0,0
41266,RM-B225,6/26/2014,0,0,0,0,0,0,0
41267,RM-B225,6/27/2014,0,0,0,0,0,0,0
41268,RM-B225,6/28/2014,0,0,0,0,0,0,0
41269,RM-B225,6/29/2014,0,0,0,0,0,0,0
41270,RM-B225,6/30/2014,0,0,0,0,0,0,0
41271,RM-B225,7/1/2014,0,0,0,0,0,0,0
41272,RM-B225,7/2/2014,0,0,0,0,0,0,0
41273,RM-B225,7/3/2014,0,0,0,0,0,0,0
41274,RM-B225,7/4/2014,0,0,0,0,0,0,0
41275,RM-B225,7/5/2014,0,0,0,0,0,0,0
41276,RM-B225,7/6/2014,0,0,0,0,0,0,0
41277,RM-B225,7/7/2014,0,0,0,0,0,0,0
41278,RM-B225,7/8/2014,0,0,0,0,0,0,0
41279,RM-B225,7/9/2014,0,0,0,0,0,0,0
41280,RM-B225,7/10/2014,0,0,0,0,0,0,0
41281,RM-B225,7/11/2014,0,0,0,0,0,0,0
41282,RM-B225,7/12/2014,0,0,0,0,0,0,0
41283,RM-B225,7/13/2014,0,0,0,0,0,0,0
41284,RM-B225,7/14/2014,0,0,0,0,0,0,0
41285,RM-B225,7/15/2014,0,0,0,0,0,0,0
41286,RM-B225,7/16/2014,0,0,0,0,0,0,0
41287,RM-B225,7/17/2014,0,0,0,0,0,0,0
41288,RM-B225,7/18/2014,0,0,0,0,0,0,0
41289,RM-B225,7/19/2014,0,0,0,0,0,0,0
41290,RM-B225,7/20/2014,0,0,0,0,0,0,0
41291,RM-B225,7/21/2014,0,0,0,0,0,0,0
41292,RM-B225,7/22/2014,0,0,0,0,0,0,0
41293,RM-B225,7/23/2014,0,0,0,0,0,0,0
41294,RM-B225,7/24/2014,0,0,0,0,0,0,0
41295,RM-B225,7/25/2014,0,0,0,0,0,0,0
41296,RM-B225,7/26/2014,0,0,0,0,0,0,0
41297,RM-B225,7/27/2014,0,0,0,0,0,0,0
41298,RM-B225,7/28/2014,0,0,0,0,0,0,0
41299,RM-B225,7/29/2014,0,0,0,0,0,0,0
41300,RM-B225,7/30/2014,0,0,0,0,0,0,0
41301,RM-B225,7/31/2014,0,0,0,0,0,0,0
41302,RM-B225,8/1/2014,0,0,0,0,0,0,0
41303,RM-B225,8/2/2014,0,0,0,0,0,0,0
41304,RM-B225,8/3/2014,0,0,0,0,0,0,0
41305,RM-B225,8/4/2014,0,0,0,0,0,0,0
41306,RM-B225,8/5/2014,0,0,0,0,0,0,0
41307,RM-B225,8/6/2014,0,0,0,0,0,0,0
41308,RM-B225,8/7/2014,0,0,0,0,0,0,0
41309,RM-B225,8/8/2014,0,0,0,0,0,0,0
41310,RM-B225,8/9/2014,0,0,0,0,0,0,0
41311,RM-B225,8/10/2014,0,0,0,0,0,0,0
41312,RM-B225,8/11/2014,0,0,0,0,0,0,0
41313,RM-B225,8/12/2014,0,0,0,0,0,0,0
41314,RM-B225,8/13/2014,0,0,0,0,0,0,0
41315,RM-B225,8/14/2014,0,0,0,0,0,0,0
41316,RM-B225,8/15/2014,0,0,0,0,0,0,0
41317,RM-B225,8/16/2014,0,0,0,0,0,0,0
41318,RM-B225,8/17/2014,0,0,0,0,0,0,0
41319,RM-B225,8/18/2014,0,0,0,0,0,0,0
41320,RM-B225,8/19/2014,0,0,0,0,0,0,0
41321,RM-B225,8/20/2014,0,0,0,0,0,0,0
41322,RM-B225,8/21/2014,0,0,0,0,0,0,0
41323,RM-B225,8/22/2014,0,0,0,0,0,0,0
41324,RM-B225,8/23/2014,0,0,0,0,0,0,0
41325,RM-B225,8/24/2014,0,0,0,0,0,0,0
41326,RM-B225,8/25/2014,0,0,0,0,0,0,0
41327,RM-B225,8/26/2014,0,0,0,0,0,0,0
41328,RM-B225,8/27/2014,0,0,0,0,0,0,0
41329,RM-B225,8/28/2014,0,0,0,0,0,0,0
41330,RM-B225,8/29/2014,0,0,0,0,0,0,0
41331,RM-B225,8/30/2014,0,0,0,0,0,0,0
41332,RM-B225,8/31/2014,0,0,0,0,0,0,0
41333,RM-B225,9/1/2014,0,0,0,0,0,0,0
41334,RM-B225,9/2/2014,0,0,0,0,0,0,0
41335,RM-B225,9/3/2014,0,0,0,0,0,0,0
41336,RM-B225,9/4/2014,0,0,0,0,0,0,0
41337,RM-B225,9/5/2014,0,0,0,0,0,0,0
41338,RM-B225,9/6/2014,0,0,0,0,0,0,0
41339,RM-B225,9/7/2014,0,0,0,0,0,0,0
41340,RM-B225,9/8/2014,0,0,0,0,0,0,0
41341,RM-B225,9/9/2014,0,0,0,0,0,0,0
41342,RM-B225,9/10/2014,0,0,0,0,0,0,0
41343,RM-B225,9/11/2014,0,0,0,0,0,0,0
41344,RM-B225,9/12/2014,0,0,0,0,0,0,0
41345,RM-B225,9/13/2014,0,0,0,0,0,0,0
41346,RM-B225,9/14/2014,0,0,0,0,0,0,0
41347,RM-B225,9/15/2014,0,0,0,0,0,0,0
41348,RM-B225,9/16/2014,0,0,0,0,0,0,0
41349,RM-B225,9/17/2014,0,0,0,0,0,0,0
41350,RM-B225,9/18/2014,0,0,0,0,0,0,0
41351,RM-B225,9/19/2014,0,0,0,0,0,0,0
41352,RM-B225,9/20/2014,0,0,0,0,0,0,0
41353,RM-B225,9/21/2014,0,0,0,0,0,0,0
41354,RM-B225,9/22/2014,0,0,0,0,0,0,0
41355,RM-B225,9/23/2014,0,0,0,0,0,0,0
41356,RM-B225,9/24/2014,0,0,0,0,0,0,0
41357,RM-B225,9/25/2014,0,0,0,0,0,0,0
41358,RM-B225,9/28/2014,0,0,0,0,0,0,0
41359,RM-B225,9/29/2014,0,0,0,0,0,0,0
41360,RM-B225,9/30/2014,0,0,0,0,0,0,0
41361,RM-B225,10/1/2014,0,0,0,0,0,0,0
41362,RM-B225,10/2/2014,0,0,0,0,0,0,0
41363,RM-B225,10/3/2014,0,0,0,0,0,0,0
41364,RM-B225,10/4/2014,0,0,0,0,0,0,0
41365,RM-B225,10/5/2014,0,0,0,0,0,0,0
41366,RM-B225,10/6/2014,0,0,0,0,0,0,0
41367,RM-B225,10/7/2014,0,0,0,0,0,0,0
41368,RM-B225,10/8/2014,0,0,0,0,0,0,0
41369,RM-B225,10/9/2014,0,0,0,0,0,0,0
41370,RM-B225,10/10/2014,0,0,0,0,0,0,0
41371,RM-B225,10/11/2014,0,0,0,0,0,0,0
41372,RM-B225,10/12/2014,0,0,0,0,0,0,0
41373,RM-B225,10/13/2014,0,0,0,0,0,0,0
41374,RM-B225,10/14/2014,0,0,0,0,0,0,0
41375,RM-B225,10/15/2014,0,0,0,0,0,0,0
41376,RM-B225,10/16/2014,0,0,0,0,0,0,0
41377,RM-B225,10/17/2014,0,0,0,0,0,0,0
41378,RM-B225,10/18/2014,0,0,0,0,0,0,0
41379,RM-B225,10/19/2014,0,0,0,0,0,0,0
41380,RM-B225,10/20/2014,0,0,0,0,0,0,0
41381,RM-B225,10/21/2014,0,0,0,0,0,0,0
41382,RM-B225,10/22/2014,0,0,0,0,0,0,0
41383,RM-B225,10/23/2014,0,0,0,0,0,0,0
41384,RM-B225,10/24/2014,0,0,0,0,0,0,0
41385,RM-B225,10/25/2014,0,0,0,0,0,0,0
41386,RM-B225,10/26/2014,0,0,0,0,0,0,0
41387,RM-B225,10/27/2014,0,0,0,0,0,0,0
41388,RM-B225,10/28/2014,0,0,0,0,0,0,0
41389,RM-B225,10/29/2014,0,0,0,0,0,0,0
41390,RM-B225,10/30/2014,0,0,0,0,0,0,0
41391,RM-B225,10/31/2014,0,0,0,0,0,0,0
41392,RM-B225,11/1/2014,0,0,0,0,0,0,0
41393,RM-B225,11/2/2014,0,0,0,0,0,0,0
41394,RM-B225,11/3/2014,0,0,0,0,0,0,0
41395,RM-B225,11/4/2014,0,0,0,0,0,0,0
41396,RM-B225,11/5/2014,0,0,0,0,0,0,0
41397,RM-B225,11/6/2014,0,0,0,0,0,0,0
41398,RM-B225,11/7/2014,0,0,0,0,0,0,0
41399,RM-B225,11/8/2014,0,0,0,0,0,0,0
41400,RM-B225,11/9/2014,0,0,0,0,0,0,0
41401,RM-B225,11/10/2014,0,0,0,0,0,0,0
41402,RM-B225,11/11/2014,0,0,0,0,0,0,0
41403,RM-B225,11/12/2014,0,0,0,0,0,0,0
41404,RM-B225,11/13/2014,0,0,0,0,0,0,0
41405,RM-B225,11/14/2014,0,0,0,0,0,0,0
41406,RM-B225,11/15/2014,0,0,0,0,0,0,0
41407,RM-B225,11/16/2014,0,0,0,0,0,0,0
41408,RM-B225,11/17/2014,0,0,0,0,0,0,0
41409,RM-B225,11/18/2014,0,0,0,0,0,0,0
41410,RM-B225,11/19/2014,0,0,0,0,0,0,0
41411,RM-B225,11/20/2014,0,0,0,0,0,0,0
41412,RM-B225,11/21/2014,0,0,0,0,0,0,0
41413,RM-B225,11/22/2014,0,0,0,0,0,0,0
41414,RM-B225,11/23/2014,0,0,0,0,0,0,0
41415,RM-B225,11/24/2014,0,0,0,0,0,0,0
41416,RM-B225,11/25/2014,0,0,0,0,0,0,0
41417,RM-B225,11/26/2014,0,0,0,0,0,0,0
41418,RM-B225,11/27/2014,0,0,0,0,0,0,0
41419,RM-B225,11/28/2014,0,0,0,0,0,0,0
41420,RM-B225,11/29/2014,0,0,0,0,0,0,0
41421,RM-B225,11/30/2014,0,0,0,0,0,0,0
41422,RM-B225,12/1/2014,0,0,0,0,0,0,0
41423,RM-B225,12/2/2014,0,0,0,0,0,0,0
41424,RM-B225,12/3/2014,0,0,0,0,0,0,0
41425,RM-B225,12/4/2014,0,0,0,0,0,0,0
41426,RM-B225,12/5/2014,0,0,0,0,0,0,0
41427,RM-B225,12/6/2014,0,0,0,0,0,0,0
41428,RM-B225,12/7/2014,0,0,0,0,0,0,0
41429,RM-B225,12/8/2014,0,0,0,0,0,0,0
41430,RM-B225,12/9/2014,0,0,0,0,0,0,0
41431,RM-B225,12/10/2014,0,0,0,0,0,0,0
41432,RM-B225,12/11/2014,0,0,0,0,0,0,0
41433,RM-B225,12/12/2014,0,0,0,0,0,0,0
41434,RM-B225,12/13/2014,0,0,0,0,0,0,0
41435,RM-B225,12/14/2014,0,0,0,0,0,0,0
41436,RM-B225,12/15/2014,0,0,0,0,0,0,0
41437,RM-B225,12/16/2014,0,0,0,0,0,0,0
41438,RM-B225,12/17/2014,0,0,0,0,0,0,0
41439,RM-B225,12/18/2014,0,0,0,0,0,0,0
41440,RM-B225,12/19/2014,0,0,0,0,0,0,0
41441,RM-B225,12/20/2014,0,0,0,0,0,0,0
41442,RM-B225,12/21/2014,0,0,0,0,0,0,0
41443,RM-B225,12/22/2014,0,0,0,0,0,0,0
41444,RM-B225,12/23/2014,0,0,0,0,0,0,0
41445,RM-B225,12/24/2014,0,0,0,0,0,0,0
41446,RM-B225,12/25/2014,0,0,0,0,0,0,0
41447,RM-B225,12/26/2014,0,0,0,0,0,0,0
41448,RM-B225,12/27/2014,0,0,0,0,0,0,0
41449,RM-B225,12/28/2014,0,0,0,0,0,0,0
41450,RM-B225,12/29/2014,0,0,0,0,0,0,0
41451,RM-B225,12/30/2014,0,0,0,0,0,0,0
41452,RM-B225,12/31/2014,0,0,0,0,0,0,0
41453,RM-B225,1/1/2015,0,0,0,0,0,0,0
41454,RM-B225,1/2/2015,0,0,0,0,0,0,0
41455,RM-B225,1/3/2015,0,0,0,0,0,0,0
41456,RM-B225,1/4/2015,0,0,0,0,0,0,0
41457,RM-B225,1/5/2015,0,0,0,0,0,0,0
41458,RM-B225,1/6/2015,0,0,0,0,0,0,0
41459,RM-B225,1/7/2015,0,0,0,0,0,0,0
41460,RM-B225,1/8/2015,0,0,0,0,0,0,0
41461,RM-B225,1/9/2015,0,0,0,0,0,0,0
41462,RM-B225,1/10/2015,0,0,0,0,0,0,0
41463,RM-B225,1/11/2015,0,0,0,0,0,0,0
41464,RM-B225,1/12/2015,0,0,0,0,0,0,0
41465,RM-B225,1/13/2015,0,0,0,0,0,0,0
41466,RM-B225,1/14/2015,0,0,0,0,0,0,0
41467,RM-B225,1/15/2015,0,0,0,0,0,0,0
41468,RM-B225,1/16/2015,0,0,0,0,0,0,0
41469,RM-B225,1/17/2015,0,0,0,0,0,0,0
41470,RM-B225,1/18/2015,0,0,0,0,0,0,0
41471,RM-B225,1/19/2015,0,0,0,0,0,0,0
41472,RM-B225,1/20/2015,0,0,0,0,0,0,0
41473,RM-B225,1/21/2015,0,0,0,0,0,0,0
41474,RM-B225,1/22/2015,0,0,0,0,0,0,0
41475,RM-B225,1/23/2015,0,0,0,0,0,0,0
41476,RM-B225,1/24/2015,0,0,0,0,0,0,0
41477,RM-B225,1/25/2015,0,0,0,0,0,0,0
41478,RM-B225,1/26/2015,0,0,0,0,0,0,0
41479,RM-B225,1/27/2015,0,0,0,0,0,0,0
41480,RM-B225,1/28/2015,0,0,0,0,0,0,0
41481,RM-B225,1/29/2015,0,0,0,0,0,0,0
41482,RM-B225,1/30/2015,0,0,0,0,0,0,0
41483,RM-B225,1/31/2015,0,0,0,0,0,0,0
41484,RM-B225,2/1/2015,0,0,0,0,0,0,0
41485,RM-B225,2/2/2015,0,0,0,0,0,0,0
41486,RM-B225,2/3/2015,0,0,0,0,0,0,0
41487,RM-B225,2/4/2015,0,0,0,0,0,0,0
41488,RM-B225,2/5/2015,0,0,0,0,0,0,0
41489,RM-B225,2/6/2015,0,0,0,0,0,0,0
41490,RM-B225,2/7/2015,0,0,0,0,0,0,0
41491,RM-B225,2/8/2015,0,0,0,0,0,0,0
41492,RM-B225,2/9/2015,0,0,0,0,0,0,0
41493,RM-B225,2/10/2015,0,0,0,0,0,0,0
41494,RM-B225,2/11/2015,0,0,0,0,0,0,0
41495,RM-B225,2/12/2015,0,0,0,0,0,0,0
41496,RM-B225,2/13/2015,0,0,0,0,0,0,0
41497,RM-B225,2/14/2015,0,0,0,0,0,0,0
41498,RM-B225,2/15/2015,0,0,0,0,0,0,0
41499,RM-B225,2/16/2015,0,0,0,0,0,0,0
41500,RM-B225,2/17/2015,0,0,0,0,0,0,0
41501,RM-B225,2/18/2015,0,0,0,0,0,0,0
41502,RM-B225,2/19/2015,0,0,0,0,0,0,0
41503,RM-B225,2/20/2015,0,0,0,0,0,0,0
41504,RM-B225,2/21/2015,0,0,0,0,0,0,0
41505,RM-B225,2/22/2015,0,0,0,0,0,0,0
41506,RM-B225,2/23/2015,0,0,0,0,0,0,0
41507,RM-B225,2/24/2015,0,0,0,0,0,0,0
41508,RM-B225,2/25/2015,0,0,0,0,0,0,0
41509,RM-B225,2/26/2015,0,0,0,0,0,0,0
41510,RM-B225,2/27/2015,0,0,0,0,0,0,0
41511,RM-B225,2/28/2015,0,0,0,0,0,0,0
41512,RM-B225,3/1/2015,0,0,0,0,0,0,0
41513,RM-B225,3/2/2015,0,0,0,0,0,0,0
41514,RM-B225,3/3/2015,0,0,0,0,0,0,0
41515,RM-B225,3/4/2015,0,0,0,0,0,0,0
41516,RM-B225,3/5/2015,0,0,0,0,0,0,0
41517,RM-B225,3/6/2015,0,0,0,0,0,0,0
41518,RM-B225,3/7/2015,0,0,0,0,0,0,0
41519,RM-B225,3/8/2015,0,0,0,0,0,0,0
41520,RM-B225,3/9/2015,0,0,0,0,0,0,0
41521,RM-B225,3/10/2015,0,0,0,0,0,0,0
41522,RM-B225,3/11/2015,0,0,0,0,0,0,0
41523,RM-B225,3/12/2015,0,0,0,0,0,0,0
41524,RM-B225,3/13/2015,0,0,0,0,0,0,0
41525,RM-B225,3/14/2015,0,0,0,0,0,0,0
41526,RM-B225,3/15/2015,0,0,0,0,0,0,0
41527,RM-B225,3/16/2015,0,0,0,0,0,0,0
41528,RM-B225,3/17/2015,0,0,0,0,0,0,0
41529,RM-B225,3/18/2015,0,0,0,0,0,0,0
41530,RM-B225,3/19/2015,0,0,0,0,0,0,0
41531,RM-B225,3/20/2015,0,0,0,0,0,0,0
41532,RM-B225,3/21/2015,0,0,0,0,0,0,0
41533,RM-B225,3/22/2015,0,0,0,0,0,0,0
41534,RM-B225,3/23/2015,0,0,0,0,0,0,0
41535,RM-B225,3/24/2015,0,0,0,0,0,0,0
41536,RM-B225,3/25/2015,0,0,0,0,0,0,0
41537,RM-B225,3/26/2015,0,0,0,0,0,0,0
41538,RM-B225,3/27/2015,0,0,0,0,0,0,0
41539,RM-B225,3/28/2015,0,0,0,0,0,0,0
41540,RM-B225,3/29/2015,0,0,0,0,0,0,0
41541,RM-B225,3/30/2015,0,0,0,0,0,0,0
41542,RM-B225,3/31/2015,0,0,0,0,0,0,0
41543,RM-B225,4/1/2015,0,0,0,0,0,0,0
41544,RM-B225,4/2/2015,0,0,0,0,0,0,0
41545,RM-B225,4/3/2015,0,0,0,0,0,0,0
41546,RM-B225,4/4/2015,0,0,0,0,0,0,0
41547,RM-B225,4/5/2015,0,0,0,0,0,0,0
41548,RM-B225,4/6/2015,0,0,0,0,0,0,0
41549,RM-B225,4/7/2015,0,0,0,0,0,0,0
41550,RM-B225,4/8/2015,0,0,0,0,0,0,0
41551,RM-B225,4/9/2015,0,0,0,0,0,0,0
41552,RM-B225,4/10/2015,0,0,0,0,0,0,0
41553,RM-B225,4/11/2015,0,0,0,0,0,0,0
41554,RM-B225,4/12/2015,0,0,0,0,0,0,0
41555,RM-B225,4/13/2015,0,0,0,0,0,0,0
41556,RM-B225,4/14/2015,0,0,0,0,0,0,0
41557,RM-B225,4/15/2015,0,0,0,0,0,0,0
41558,RM-B225,4/16/2015,0,0,0,0,0,0,0
41559,RM-B225,4/17/2015,0,0,0,0,0,0,0
41560,RM-B225,4/18/2015,0,0,0,0,0,0,0
41561,RM-B225,4/19/2015,0,0,0,0,0,0,0
41562,RM-B225,4/20/2015,0,0,0,0,0,0,0
41563,RM-B225,4/21/2015,0,0,0,0,0,0,0
41564,RM-B225,4/22/2015,0,0,0,0,0,0,0
41565,RM-B225,4/23/2015,0,0,0,0,0,0,0
41566,RM-B225,4/24/2015,0,0,0,0,0,0,0
41567,RM-B225,4/25/2015,0,0,0,0,0,0,0
41568,RM-B225,4/26/2015,0,0,0,0,0,0,0
41569,RM-B225,4/27/2015,0,0,0,0,0,0,0
41570,RM-B225,4/28/2015,0,0,0,0,0,0,0
41571,RM-B225,4/29/2015,0,0,0,0,0,0,0
41572,RM-B225,4/30/2015,0,0,0,0,0,0,0
41573,RM-B225,5/1/2015,0,0,0,0,0,0,0
41574,RM-B225,5/2/2015,0,0,0,0,0,0,0
41575,RM-B225,5/3/2015,0,0,0,0,0,0,0
41576,RM-B225,5/4/2015,0,0,0,0,0,0,0
41577,RM-B225,5/5/2015,0,0,0,0,0,0,0
41578,RM-B225,5/6/2015,0,0,0,0,0,0,0
41579,RM-B225,5/7/2015,0,0,0,0,0,0,0
41580,RM-B225,5/8/2015,0,0,0,0,0,0,0
41581,RM-B225,5/9/2015,0,0,0,0,0,0,0
41582,RM-B225,5/10/2015,0,0,0,0,0,0,0
41583,RM-B225,5/11/2015,0,0,0,0,0,0,0
41584,RM-B225,5/12/2015,0,0,0,0,0,0,0
41585,RM-B225,5/13/2015,0,0,0,0,0,0,0
41586,RM-B225,5/14/2015,0,0,0,0,0,0,0
41587,RM-B225,5/15/2015,0,0,0,0,0,0,0
41588,RM-B225,5/16/2015,0,0,0,0,0,0,0
41589,RM-B225,5/17/2015,0,0,0,0,0,0,0
41590,RM-B225,5/18/2015,0,0,0,0,0,0,0
41591,RM-B225,5/19/2015,0,0,0,0,0,0,0
41592,RM-B225,5/20/2015,0,0,0,0,0,0,0
41593,RM-B225,5/21/2015,0,0,0,0,0,0,0
41594,RM-B225,5/22/2015,0,0,0,0,0,0,0
41595,RM-B225,5/23/2015,0,0,0,0,0,0,0
41596,RM-B225,5/24/2015,0,0,0,0,0,0,0
41597,RM-B225,5/25/2015,0,0,0,0,0,0,0
41598,RM-B225,5/26/2015,0,0,0,0,0,0,0
41599,RM-B225,5/27/2015,0,0,0,0,0,0,0
41600,RM-B225,5/28/2015,0,0,0,0,0,0,0
41601,RM-B225,5/29/2015,0,0,0,0,0,0,0
41602,RM-B225,5/30/2015,0,0,0,0,0,0,0
41603,RM-B225,5/31/2015,0,0,0,0,0,0,0
41604,RM-B230,7/1/2013,0,0,0,0,0,0,0
41605,RM-B230,7/2/2013,0,0,0,0,0,0,0
41606,RM-B230,7/3/2013,0,0,0,0,0,0,0
41607,RM-B230,7/4/2013,0,0,0,0,0,0,0
41608,RM-B230,7/5/2013,0,0,0,0,0,0,0
41609,RM-B230,7/6/2013,0,0,0,0,0,0,0
41610,RM-B230,7/7/2013,0,0,0,0,0,0,0
41611,RM-B230,7/8/2013,0,0,0,0,0,0,0
41612,RM-B230,7/9/2013,0,0,0,0,0,0,0
41613,RM-B230,7/10/2013,0,0,0,0,0,0,0
41614,RM-B230,7/11/2013,0,0,0,0,0,0,0
41615,RM-B230,7/12/2013,0,0,0,0,0,0,0
41616,RM-B230,7/13/2013,0,0,0,0,0,0,0
41617,RM-B230,7/14/2013,0,0,0,0,0,0,0
41618,RM-B230,7/15/2013,0,0,0,0,0,0,0
41619,RM-B230,7/17/2013,0,0,0,0,0,0,0
41620,RM-B230,7/18/2013,0,0,0,0,0,0,0
41621,RM-B230,7/19/2013,0,0,0,0,0,0,0
41622,RM-B230,7/20/2013,0,0,0,0,0,0,0
41623,RM-B230,7/21/2013,0,0,0,0,0,0,0
41624,RM-B230,7/22/2013,0,0,0,0,0,0,0
41625,RM-B230,7/23/2013,0,0,0,0,0,0,0
41626,RM-B230,7/24/2013,0,0,0,0,0,0,0
41627,RM-B230,7/25/2013,0,0,0,0,0,0,0
41628,RM-B230,7/26/2013,0,0,0,0,0,0,0
41629,RM-B230,7/27/2013,0,0,0,0,0,0,0
41630,RM-B230,7/28/2013,0,0,0,0,0,0,0
41631,RM-B230,7/29/2013,0,0,0,0,0,0,0
41632,RM-B230,7/30/2013,0,0,0,0,0,0,0
41633,RM-B230,7/31/2013,0,0,0,0,0,0,0
41634,RM-B230,8/1/2013,0,0,0,0,0,0,0
41635,RM-B230,8/2/2013,0,0,0,0,0,0,0
41636,RM-B230,8/3/2013,0,0,0,0,0,0,0
41637,RM-B230,8/4/2013,0,0,0,0,0,0,0
41638,RM-B230,8/5/2013,0,0,0,0,0,0,0
41639,RM-B230,8/6/2013,0,0,0,0,0,0,0
41640,RM-B230,8/7/2013,0,0,0,0,0,0,0
41641,RM-B230,8/8/2013,0,0,0,0,0,0,0
41642,RM-B230,8/9/2013,0,0,0,0,0,0,0
41643,RM-B230,8/10/2013,0,0,0,0,0,0,0
41644,RM-B230,8/11/2013,0,0,0,0,0,0,0
41645,RM-B230,8/12/2013,0,0,0,0,0,0,0
41646,RM-B230,8/13/2013,0,0,0,0,0,0,0
41647,RM-B230,8/14/2013,0,0,0,0,0,0,0
41648,RM-B230,8/15/2013,0,0,0,0,0,0,0
41649,RM-B230,8/16/2013,0,0,0,0,0,0,0
41650,RM-B230,8/17/2013,0,0,0,0,0,0,0
41651,RM-B230,8/18/2013,0,0,0,0,0,0,0
41652,RM-B230,8/19/2013,0,0,0,0,0,0,0
41653,RM-B230,8/20/2013,0,0,0,0,0,0,0
41654,RM-B230,8/21/2013,0,0,0,0,0,0,0
41655,RM-B230,8/22/2013,0,0,0,0,0,0,0
41656,RM-B230,8/27/2013,0,0,0,0,0,0,0
41657,RM-B230,8/28/2013,0,0,0,0,0,0,0
41658,RM-B230,8/29/2013,0,0,0,0,0,0,0
41659,RM-B230,8/30/2013,0,0,0,0,0,0,0
41660,RM-B230,9/4/2013,0,0,0,0,0,0,0
41661,RM-B230,9/5/2013,0,0,0,0,0,0,0
41662,RM-B230,9/6/2013,0,0,0,0,0,0,0
41663,RM-B230,9/7/2013,0,0,0,0,0,0,0
41664,RM-B230,9/9/2013,0,0,0,0,0,0,0
41665,RM-B230,9/10/2013,0,0,0,0,0,0,0
41666,RM-B230,9/11/2013,0,0,0,0,0,0,0
41667,RM-B230,9/12/2013,0,0,0,0,0,0,0
41668,RM-B230,9/13/2013,0,0,0,0,0,0,0
41669,RM-B230,9/14/2013,0,0,0,0,0,0,0
41670,RM-B230,9/15/2013,0,0,0,0,0,0,0
41671,RM-B230,9/16/2013,0,0,0,0,0,0,0
41672,RM-B230,9/17/2013,0,0,0,0,0,0,0
41673,RM-B230,9/18/2013,0,0,0,0,0,0,0
41674,RM-B230,9/19/2013,0,0,0,0,0,0,0
41675,RM-B230,9/20/2013,0,0,0,0,0,0,0
41676,RM-B230,9/21/2013,0,0,0,0,0,0,0
41677,RM-B230,9/22/2013,0,0,0,0,0,0,0
41678,RM-B230,9/23/2013,0,0,0,0,0,0,0
41679,RM-B230,9/24/2013,0,0,0,0,0,0,0
41680,RM-B230,9/25/2013,0,0,0,0,0,0,0
41681,RM-B230,9/26/2013,0,0,0,0,0,0,0
41682,RM-B230,9/27/2013,0,0,0,0,0,0,0
41683,RM-B230,9/28/2013,0,0,0,0,0,0,0
41684,RM-B230,9/29/2013,0,0,0,0,0,0,0
41685,RM-B230,9/30/2013,0,0,0,0,0,0,0
41686,RM-B230,10/1/2013,0,0,0,0,0,0,0
41687,RM-B230,10/2/2013,0,0,0,0,0,0,0
41688,RM-B230,10/3/2013,0,0,0,0,0,0,0
41689,RM-B230,10/4/2013,0,0,0,0,0,0,0
41690,RM-B230,10/5/2013,0,0,0,0,0,0,0
41691,RM-B230,10/6/2013,0,0,0,0,0,0,0
41692,RM-B230,10/7/2013,0,0,0,0,0,0,0
41693,RM-B230,10/8/2013,0,0,0,0,0,0,0
41694,RM-B230,10/9/2013,0,0,0,0,0,0,0
41695,RM-B230,10/10/2013,0,0,0,0,0,0,0
41696,RM-B230,10/11/2013,0,0,0,0,0,0,0
41697,RM-B230,10/12/2013,0,0,0,0,0,0,0
41698,RM-B230,10/13/2013,0,0,0,0,0,0,0
41699,RM-B230,10/14/2013,0,0,0,0,0,0,0
41700,RM-B230,10/15/2013,0,0,0,0,0,0,0
41701,RM-B230,10/16/2013,0,0,0,0,0,0,0
41702,RM-B230,10/17/2013,0,0,0,0,0,0,0
41703,RM-B230,10/18/2013,0,0,0,0,0,0,0
41704,RM-B230,10/19/2013,0,0,0,0,0,0,0
41705,RM-B230,10/20/2013,0,0,0,0,0,0,0
41706,RM-B230,10/21/2013,0,0,0,0,0,0,0
41707,RM-B230,10/22/2013,0,0,0,0,0,0,0
41708,RM-B230,10/23/2013,0,0,0,0,0,0,0
41709,RM-B230,10/24/2013,0,0,0,0,0,0,0
41710,RM-B230,10/25/2013,0,0,0,0,0,0,0
41711,RM-B230,10/26/2013,0,0,0,0,0,0,0
41712,RM-B230,10/27/2013,0,0,0,0,0,0,0
41713,RM-B230,10/28/2013,0,0,0,0,0,0,0
41714,RM-B230,10/29/2013,0,0,0,0,0,0,0
41715,RM-B230,10/30/2013,0,0,0,0,0,0,0
41716,RM-B230,10/31/2013,0,0,0,0,0,0,0
41717,RM-B230,11/1/2013,0,0,0,0,0,0,0
41718,RM-B230,11/2/2013,0,0,0,0,0,0,0
41719,RM-B230,11/3/2013,0,0,0,0,0,0,0
41720,RM-B230,11/4/2013,0,0,0,0,0,0,0
41721,RM-B230,11/5/2013,0,0,0,0,0,0,0
41722,RM-B230,11/6/2013,0,0,0,0,0,0,0
41723,RM-B230,11/7/2013,0,0,0,0,0,0,0
41724,RM-B230,11/8/2013,0,0,0,0,0,0,0
41725,RM-B230,11/9/2013,0,0,0,0,0,0,0
41726,RM-B230,11/10/2013,0,0,0,0,0,0,0
41727,RM-B230,11/11/2013,0,0,0,0,0,0,0
41728,RM-B230,11/12/2013,0,0,0,0,0,0,0
41729,RM-B230,11/13/2013,0,0,0,0,0,0,0
41730,RM-B230,11/14/2013,0,0,0,0,0,0,0
41731,RM-B230,11/15/2013,0,0,0,0,0,0,0
41732,RM-B230,11/19/2013,0,0,0,0,0,0,0
41733,RM-B230,11/20/2013,0,0,0,0,0,0,0
41734,RM-B230,11/21/2013,0,0,0,0,0,0,0
41735,RM-B230,11/22/2013,0,0,0,0,0,0,0
41736,RM-B230,11/23/2013,0,0,0,0,0,0,0
41737,RM-B230,11/24/2013,0,0,0,0,0,0,0
41738,RM-B230,11/25/2013,0,0,0,0,0,0,0
41739,RM-B230,11/26/2013,0,0,0,0,0,0,0
41740,RM-B230,11/27/2013,0,0,0,0,0,0,0
41741,RM-B230,11/28/2013,0,0,0,0,0,0,0
41742,RM-B230,11/29/2013,0,0,0,0,0,0,0
41743,RM-B230,11/30/2013,0,0,0,0,0,0,0
41744,RM-B230,12/1/2013,0,0,0,0,0,0,0
41745,RM-B230,12/2/2013,0,0,0,0,0,0,0
41746,RM-B230,12/3/2013,0,0,0,0,0,0,0
41747,RM-B230,12/4/2013,0,0,0,0,0,0,0
41748,RM-B230,12/5/2013,0,0,0,0,0,0,0
41749,RM-B230,12/6/2013,0,0,0,0,0,0,0
41750,RM-B230,12/7/2013,0,0,0,0,0,0,0
41751,RM-B230,12/8/2013,0,0,0,0,0,0,0
41752,RM-B230,12/9/2013,0,0,0,0,0,0,0
41753,RM-B230,12/10/2013,0,0,0,0,0,0,0
41754,RM-B230,12/11/2013,0,0,0,0,0,0,0
41755,RM-B230,12/12/2013,0,0,0,0,0,0,0
41756,RM-B230,12/13/2013,0,0,0,0,0,0,0
41757,RM-B230,12/14/2013,0,0,0,0,0,0,0
41758,RM-B230,12/15/2013,0,0,0,0,0,0,0
41759,RM-B230,12/16/2013,0,0,0,0,0,0,0
41760,RM-B230,12/17/2013,0,0,0,0,0,0,0
41761,RM-B230,12/18/2013,0,0,0,0,0,0,0
41762,RM-B230,12/19/2013,0,0,0,0,0,0,0
41763,RM-B230,12/20/2013,0,0,0,0,0,0,0
41764,RM-B230,12/21/2013,0,0,0,0,0,0,0
41765,RM-B230,12/22/2013,0,0,0,0,0,0,0
41766,RM-B230,12/23/2013,0,0,0,0,0,0,0
42058,RM-B230,10/13/2014,0,0,0,0,0,0,0
42059,RM-B230,10/14/2014,0,0,0,0,0,0,0
42060,RM-B230,10/15/2014,0,0,0,0,0,0,0
42061,RM-B230,10/16/2014,0,0,0,0,0,0,0
42062,RM-B230,10/17/2014,0,0,0,0,0,0,0
42063,RM-B230,10/18/2014,0,0,0,0,0,0,0
42064,RM-B230,10/19/2014,0,0,0,0,0,0,0
42065,RM-B230,10/20/2014,0,0,0,0,0,0,0
42066,RM-B230,10/21/2014,0,0,0,0,0,0,0
42067,RM-B230,10/22/2014,0,0,0,0,0,0,0
42068,RM-B230,10/23/2014,0,0,0,0,0,0,0
42069,RM-B230,10/24/2014,0,0,0,0,0,0,0
42070,RM-B230,10/25/2014,0,0,0,0,0,0,0
42071,RM-B230,10/26/2014,0,0,0,0,0,0,0
42072,RM-B230,10/27/2014,0,0,0,0,0,0,0
42073,RM-B230,10/28/2014,0,0,0,0,0,0,0
42074,RM-B230,10/29/2014,0,0,0,0,0,0,0
42075,RM-B230,10/30/2014,0,0,0,0,0,0,0
42076,RM-B230,10/31/2014,0,0,0,0,0,0,0
42077,RM-B230,11/1/2014,0,0,0,0,0,0,0
42078,RM-B230,11/2/2014,0,0,0,0,0,0,0
42079,RM-B230,11/3/2014,0,0,0,0,0,0,0
42080,RM-B230,11/4/2014,0,0,0,0,0,0,0
42081,RM-B230,11/5/2014,0,0,0,0,0,0,0
42082,RM-B230,11/6/2014,0,0,0,0,0,0,0
42083,RM-B230,11/7/2014,0,0,0,0,0,0,0
42084,RM-B230,11/8/2014,0,0,0,0,0,0,0
42085,RM-B230,11/9/2014,0,0,0,0,0,0,0
42086,RM-B230,11/10/2014,0,0,0,0,0,0,0
42087,RM-B230,11/11/2014,0,0,0,0,0,0,0
42088,RM-B230,11/12/2014,0,0,0,0,0,0,0
42089,RM-B230,11/13/2014,0,0,0,0,0,0,0
42090,RM-B230,11/14/2014,0,0,0,0,0,0,0
42091,RM-B230,11/15/2014,0,0,0,0,0,0,0
42092,RM-B230,11/16/2014,0,0,0,0,0,0,0
42093,RM-B230,11/17/2014,0,0,0,0,0,0,0
42094,RM-B230,11/18/2014,0,0,0,0,0,0,0
42095,RM-B230,11/19/2014,0,0,0,0,0,0,0
42096,RM-B230,11/20/2014,0,0,0,0,0,0,0
42097,RM-B230,11/21/2014,0,0,0,0,0,0,0
42098,RM-B230,11/22/2014,0,0,0,0,0,0,0
42099,RM-B230,11/23/2014,0,0,0,0,0,0,0
42100,RM-B230,11/24/2014,0,0,0,0,0,0,0
42101,RM-B230,11/25/2014,0,0,0,0,0,0,0
42102,RM-B230,11/26/2014,0,0,0,0,0,0,0
42103,RM-B230,11/27/2014,0,0,0,0,0,0,0
42104,RM-B230,11/28/2014,0,0,0,0,0,0,0
42105,RM-B230,11/29/2014,0,0,0,0,0,0,0
42106,RM-B230,11/30/2014,0,0,0,0,0,0,0
42107,RM-B230,12/1/2014,0,0,0,0,0,0,0
42108,RM-B230,12/2/2014,0,0,0,0,0,0,0
42109,RM-B230,12/3/2014,0,0,0,0,0,0,0
42110,RM-B230,12/4/2014,0,0,0,0,0,0,0
42111,RM-B230,12/5/2014,0,0,0,0,0,0,0
42112,RM-B230,12/6/2014,0,0,0,0,0,0,0
42113,RM-B230,12/7/2014,0,0,0,0,0,0,0
42114,RM-B230,12/8/2014,0,0,0,0,0,0,0
42115,RM-B230,12/9/2014,0,0,0,0,0,0,0
42116,RM-B230,12/10/2014,0,0,0,0,0,0,0
42117,RM-B230,12/11/2014,0,0,0,0,0,0,0
42118,RM-B230,12/12/2014,0,0,0,0,0,0,0
42119,RM-B230,12/13/2014,0,0,0,0,0,0,0
42120,RM-B230,12/14/2014,0,0,0,0,0,0,0
42121,RM-B230,12/15/2014,0,0,0,0,0,0,0
42122,RM-B230,12/16/2014,0,0,0,0,0,0,0
42123,RM-B230,12/17/2014,0,0,0,0,0,0,0
42124,RM-B230,12/18/2014,0,0,0,0,0,0,0
42125,RM-B230,12/19/2014,0,0,0,0,0,0,0
42126,RM-B230,12/20/2014,0,0,0,0,0,0,0
42127,RM-B230,12/21/2014,0,0,0,0,0,0,0
42128,RM-B230,12/22/2014,0,0,0,0,0,0,0
42129,RM-B230,12/23/2014,0,0,0,0,0,0,0
42130,RM-B230,12/24/2014,0,0,0,0,0,0,0
42131,RM-B230,12/25/2014,0,0,0,0,0,0,0
42132,RM-B230,12/26/2014,0,0,0,0,0,0,0
42133,RM-B230,12/27/2014,0,0,0,0,0,0,0
42134,RM-B230,12/28/2014,0,0,0,0,0,0,0
42135,RM-B230,12/29/2014,0,0,0,0,0,0,0
42136,RM-B230,12/30/2014,0,0,0,0,0,0,0
42137,RM-B230,12/31/2014,0,0,0,0,0,0,0
42138,RM-B230,1/1/2015,0,0,0,0,0,0,0
42139,RM-B230,1/2/2015,0,0,0,0,0,0,0
42140,RM-B230,1/3/2015,0,0,0,0,0,0,0
42141,RM-B230,1/4/2015,0,0,0,0,0,0,0
42142,RM-B230,1/5/2015,0,0,0,0,0,0,0
42143,RM-B230,1/6/2015,0,0,0,0,0,0,0
42144,RM-B230,1/7/2015,0,0,0,0,0,0,0
42145,RM-B230,1/8/2015,0,0,0,0,0,0,0
42146,RM-B230,1/9/2015,0,0,0,0,0,0,0
42147,RM-B230,1/10/2015,0,0,0,0,0,0,0
42148,RM-B230,1/11/2015,0,0,0,0,0,0,0
42149,RM-B230,1/12/2015,0,0,0,0,0,0,0
42150,RM-B230,1/13/2015,0,0,0,0,0,0,0
42151,RM-B230,1/14/2015,0,0,0,0,0,0,0
42152,RM-B230,1/15/2015,0,0,0,0,0,0,0
42153,RM-B230,1/16/2015,0,0,0,0,0,0,0
42154,RM-B230,1/17/2015,0,0,0,0,0,0,0
42155,RM-B230,1/18/2015,0,0,0,0,0,0,0
42156,RM-B230,1/19/2015,0,0,0,0,0,0,0
42157,RM-B230,1/20/2015,0,0,0,0,0,0,0
42158,RM-B230,1/21/2015,0,0,0,0,0,0,0
42159,RM-B230,1/22/2015,0,0,0,0,0,0,0
42160,RM-B230,1/23/2015,0,0,0,0,0,0,0
42161,RM-B230,1/24/2015,0,0,0,0,0,0,0
42162,RM-B230,1/25/2015,0,0,0,0,0,0,0
42163,RM-B230,1/26/2015,0,0,0,0,0,0,0
42164,RM-B230,1/27/2015,0,0,0,0,0,0,0
42165,RM-B230,1/28/2015,0,0,0,0,0,0,0
42166,RM-B230,1/29/2015,0,0,0,0,0,0,0
42167,RM-B230,1/30/2015,0,0,0,0,0,0,0
42168,RM-B230,1/31/2015,0,0,0,0,0,0,0
42169,RM-B230,2/1/2015,0,0,0,0,0,0,0
42170,RM-B230,2/2/2015,0,0,0,0,0,0,0
42171,RM-B230,2/3/2015,0,0,0,0,0,0,0
42172,RM-B230,2/4/2015,0,0,0,0,0,0,0
42173,RM-B230,2/5/2015,0,0,0,0,0,0,0
42174,RM-B230,2/6/2015,0,0,0,0,0,0,0
42175,RM-B230,2/7/2015,0,0,0,0,0,0,0
42176,RM-B230,2/8/2015,0,0,0,0,0,0,0
42177,RM-B230,2/9/2015,0,0,0,0,0,0,0
42178,RM-B230,2/10/2015,0,0,0,0,0,0,0
42179,RM-B230,2/11/2015,0,0,0,0,0,0,0
42180,RM-B230,2/12/2015,0,0,0,0,0,0,0
42181,RM-B230,2/13/2015,0,0,0,0,0,0,0
42182,RM-B230,2/14/2015,0,0,0,0,0,0,0
42183,RM-B230,2/15/2015,0,0,0,0,0,0,0
42184,RM-B230,2/16/2015,0,0,0,0,0,0,0
42185,RM-B230,2/17/2015,0,0,0,0,0,0,0
42186,RM-B230,2/18/2015,0,0,0,0,0,0,0
42187,RM-B230,2/19/2015,0,0,0,0,0,0,0
42188,RM-B230,2/20/2015,0,0,0,0,0,0,0
42189,RM-B230,2/21/2015,0,0,0,0,0,0,0
42190,RM-B230,2/22/2015,0,0,0,0,0,0,0
42191,RM-B230,2/23/2015,0,0,0,0,0,0,0
42192,RM-B230,2/24/2015,0,0,0,0,0,0,0
42193,RM-B230,2/25/2015,0,0,0,0,0,0,0
42194,RM-B230,2/26/2015,0,0,0,0,0,0,0
42195,RM-B230,2/27/2015,0,0,0,0,0,0,0
42196,RM-B230,2/28/2015,0,0,0,0,0,0,0
42197,RM-B230,3/1/2015,0,0,0,0,0,0,0
42198,RM-B230,3/2/2015,0,0,0,0,0,0,0
42199,RM-B230,3/3/2015,0,0,0,0,0,0,0
42200,RM-B230,3/4/2015,0,0,0,0,0,0,0
42201,RM-B230,3/5/2015,0,0,0,0,0,0,0
42202,RM-B230,3/6/2015,0,0,0,0,0,0,0
42203,RM-B230,3/7/2015,0,0,0,0,0,0,0
42204,RM-B230,3/8/2015,0,0,0,0,0,0,0
42205,RM-B230,3/9/2015,0,0,0,0,0,0,0
42206,RM-B230,3/10/2015,0,0,0,0,0,0,0
42207,RM-B230,3/11/2015,0,0,0,0,0,0,0
42208,RM-B230,3/12/2015,0,0,0,0,0,0,0
42209,RM-B230,3/13/2015,0,0,0,0,0,0,0
42210,RM-B230,3/14/2015,0,0,0,0,0,0,0
42211,RM-B230,3/15/2015,0,0,0,0,0,0,0
42212,RM-B230,3/16/2015,0,0,0,0,0,0,0
42213,RM-B230,3/17/2015,0,0,0,0,0,0,0
42214,RM-B230,3/18/2015,0,0,0,0,0,0,0
42215,RM-B230,3/19/2015,0,0,0,0,0,0,0
42216,RM-B230,3/20/2015,0,0,0,0,0,0,0
42217,RM-B230,3/21/2015,0,0,0,0,0,0,0
42218,RM-B230,3/22/2015,0,0,0,0,0,0,0
42219,RM-B230,3/23/2015,0,0,0,0,0,0,0
42220,RM-B230,3/24/2015,0,0,0,0,0,0,0
42221,RM-B230,3/25/2015,0,0,0,0,0,0,0
42222,RM-B230,3/26/2015,0,0,0,0,0,0,0
42223,RM-B230,3/27/2015,0,0,0,0,0,0,0
42224,RM-B230,3/28/2015,0,0,0,0,0,0,0
42225,RM-B230,3/29/2015,0,0,0,0,0,0,0
42226,RM-B230,3/30/2015,0,0,0,0,0,0,0
42227,RM-B230,3/31/2015,0,0,0,0,0,0,0
42228,RM-B230,4/1/2015,0,0,0,0,0,0,0
42229,RM-B230,4/2/2015,0,0,0,0,0,0,0
42230,RM-B230,4/3/2015,0,0,0,0,0,0,0
42231,RM-B230,4/4/2015,0,0,0,0,0,0,0
42232,RM-B230,4/5/2015,0,0,0,0,0,0,0
42233,RM-B230,4/6/2015,0,0,0,0,0,0,0
42234,RM-B230,4/7/2015,0,0,0,0,0,0,0
42235,RM-B230,4/8/2015,0,0,0,0,0,0,0
42236,RM-B230,4/9/2015,0,0,0,0,0,0,0
42237,RM-B230,4/10/2015,0,0,0,0,0,0,0
42238,RM-B230,4/11/2015,0,0,0,0,0,0,0
42239,RM-B230,4/12/2015,0,0,0,0,0,0,0
42240,RM-B230,4/13/2015,0,0,0,0,0,0,0
42241,RM-B230,4/14/2015,0,0,0,0,0,0,0
42242,RM-B230,4/15/2015,0,0,0,0,0,0,0
42243,RM-B230,4/16/2015,0,0,0,0,0,0,0
42244,RM-B230,4/17/2015,0,0,0,0,0,0,0
42245,RM-B230,4/18/2015,0,0,0,0,0,0,0
42246,RM-B230,4/19/2015,0,0,0,0,0,0,0
42247,RM-B230,4/20/2015,0,0,0,0,0,0,0
42248,RM-B230,4/21/2015,0,0,0,0,0,0,0
42249,RM-B230,4/22/2015,0,0,0,0,0,0,0
42250,RM-B230,4/23/2015,0,0,0,0,0,0,0
42251,RM-B230,4/24/2015,0,0,0,0,0,0,0
42252,RM-B230,4/25/2015,0,0,0,0,0,0,0
42253,RM-B230,4/26/2015,0,0,0,0,0,0,0
42254,RM-B230,4/27/2015,0,0,0,0,0,0,0
42255,RM-B230,4/28/2015,0,0,0,0,0,0,0
42256,RM-B230,4/29/2015,0,0,0,0,0,0,0
42257,RM-B230,4/30/2015,0,0,0,0,0,0,0
42258,RM-B230,5/1/2015,0,0,0,0,0,0,0
42259,RM-B230,5/2/2015,0,0,0,0,0,0,0
42260,RM-B230,5/3/2015,0,0,0,0,0,0,0
42261,RM-B230,5/4/2015,0,0,0,0,0,0,0
42262,RM-B230,5/5/2015,0,0,0,0,0,0,0
42263,RM-B230,5/6/2015,0,0,0,0,0,0,0
42264,RM-B230,5/7/2015,0,0,0,0,0,0,0
42265,RM-B230,5/8/2015,0,0,0,0,0,0,0
42266,RM-B230,5/9/2015,0,0,0,0,0,0,0
42267,RM-B230,5/10/2015,0,0,0,0,0,0,0
42268,RM-B230,5/11/2015,0,0,0,0,0,0,0
42269,RM-B230,5/12/2015,0,0,0,0,0,0,0
42270,RM-B230,5/13/2015,0,0,0,0,0,0,0
42271,RM-B230,5/14/2015,0,0,0,0,0,0,0
42272,RM-B230,5/15/2015,0,0,0,0,0,0,0
42273,RM-B230,5/16/2015,0,0,0,0,0,0,0
42274,RM-B230,5/17/2015,0,0,0,0,0,0,0
42275,RM-B230,5/18/2015,0,0,0,0,0,0,0
42276,RM-B230,5/19/2015,0,0,0,0,0,0,0
42277,RM-B230,5/20/2015,0,0,0,0,0,0,0
42278,RM-B230,5/21/2015,0,0,0,0,0,0,0
42279,RM-B230,5/22/2015,0,0,0,0,0,0,0
42280,RM-B230,5/23/2015,0,0,0,0,0,0,0
42281,RM-B230,5/24/2015,0,0,0,0,0,0,0
42282,RM-B230,5/25/2015,0,0,0,0,0,0,0
42283,RM-B230,5/26/2015,0,0,0,0,0,0,0
42284,RM-B230,5/27/2015,0,0,0,0,0,0,0
42285,RM-B230,5/28/2015,0,0,0,0,0,0,0
42286,RM-B230,5/29/2015,0,0,0,0,0,0,0
42287,RM-B230,5/30/2015,0,0,0,0,0,0,0
42288,RM-B230,5/31/2015,0,0,0,0,0,0,0
42547,RM-B230A,3/29/2014,0,0,0,0,0,0,0
42548,RM-B230A,3/30/2014,0,0,0,0,0,0,0
42549,RM-B230A,3/31/2014,0,0,0,0,0,0,0
42550,RM-B230A,4/1/2014,0,0,0,0,0,0,0
42551,RM-B230A,4/2/2014,0,0,0,0,0,0,0
42552,RM-B230A,4/3/2014,0,0,0,0,0,0,0
42553,RM-B230A,4/4/2014,0,0,0,0,0,0,0
42554,RM-B230A,4/5/2014,0,0,0,0,0,0,0
42555,RM-B230A,4/6/2014,0,0,0,0,0,0,0
42556,RM-B230A,4/7/2014,0,0,0,0,0,0,0
42557,RM-B230A,4/8/2014,0,0,0,0,0,0,0
42558,RM-B230A,4/9/2014,0,0,0,0,0,0,0
42559,RM-B230A,4/10/2014,0,0,0,0,0,0,0
42560,RM-B230A,4/11/2014,0,0,0,0,0,0,0
42561,RM-B230A,4/12/2014,0,0,0,0,0,0,0
42562,RM-B230A,4/13/2014,0,0,0,0,0,0,0
42563,RM-B230A,4/14/2014,0,0,0,0,0,0,0
42564,RM-B230A,4/15/2014,0,0,0,0,0,0,0
42565,RM-B230A,4/16/2014,0,0,0,0,0,0,0
42566,RM-B230A,4/17/2014,0,0,0,0,0,0,0
42567,RM-B230A,4/18/2014,0,0,0,0,0,0,0
42568,RM-B230A,4/19/2014,0,0,0,0,0,0,0
42569,RM-B230A,4/20/2014,0,0,0,0,0,0,0
42570,RM-B230A,4/21/2014,0,0,0,0,0,0,0
42571,RM-B230A,4/22/2014,0,0,0,0,0,0,0
42572,RM-B230A,4/23/2014,0,0,0,0,0,0,0
42573,RM-B230A,4/24/2014,0,0,0,0,0,0,0
42574,RM-B230A,4/25/2014,0,0,0,0,0,0,0
42575,RM-B230A,4/26/2014,0,0,0,0,0,0,0
42576,RM-B230A,4/27/2014,0,0,0,0,0,0,0
42577,RM-B230A,4/28/2014,0,0,0,0,0,0,0
42578,RM-B230A,4/29/2014,0,0,0,0,0,0,0
42579,RM-B230A,4/30/2014,0,0,0,0,0,0,0
42580,RM-B230A,5/1/2014,0,0,0,0,0,0,0
42581,RM-B230A,5/2/2014,0,0,0,0,0,0,0
42582,RM-B230A,5/3/2014,0,0,0,0,0,0,0
42583,RM-B230A,5/4/2014,0,0,0,0,0,0,0
42584,RM-B230A,5/5/2014,0,0,0,0,0,0,0
42585,RM-B230A,5/6/2014,0,0,0,0,0,0,0
42586,RM-B230A,5/7/2014,0,0,0,0,0,0,0
42587,RM-B230A,5/8/2014,0,0,0,0,0,0,0
42588,RM-B230A,5/9/2014,0,0,0,0,0,0,0
42589,RM-B230A,5/10/2014,0,0,0,0,0,0,0
42590,RM-B230A,5/11/2014,0,0,0,0,0,0,0
42591,RM-B230A,5/12/2014,0,0,0,0,0,0,0
42592,RM-B230A,5/13/2014,0,0,0,0,0,0,0
42593,RM-B230A,5/14/2014,0,0,0,0,0,0,0
42594,RM-B230A,5/15/2014,0,0,0,0,0,0,0
42595,RM-B230A,5/16/2014,0,0,0,0,0,0,0
42596,RM-B230A,5/17/2014,0,0,0,0,0,0,0
42597,RM-B230A,5/18/2014,0,0,0,0,0,0,0
42598,RM-B230A,5/19/2014,0,0,0,0,0,0,0
42599,RM-B230A,5/20/2014,0,0,0,0,0,0,0
42600,RM-B230A,5/21/2014,0,0,0,0,0,0,0
42601,RM-B230A,5/22/2014,0,0,0,0,0,0,0
42602,RM-B230A,5/23/2014,0,0,0,0,0,0,0
42603,RM-B230A,5/24/2014,0,0,0,0,0,0,0
42604,RM-B230A,5/25/2014,0,0,0,0,0,0,0
42605,RM-B230A,5/26/2014,0,0,0,0,0,0,0
42606,RM-B230A,5/27/2014,0,0,0,0,0,0,0
42607,RM-B230A,5/28/2014,0,0,0,0,0,0,0
42608,RM-B230A,5/29/2014,0,0,0,0,0,0,0
42609,RM-B230A,5/30/2014,0,0,0,0,0,0,0
42610,RM-B230A,5/31/2014,0,0,0,0,0,0,0
42611,RM-B230A,6/1/2014,0,0,0,0,0,0,0
42612,RM-B230A,6/2/2014,0,0,0,0,0,0,0
42613,RM-B230A,6/3/2014,0,0,0,0,0,0,0
42614,RM-B230A,6/4/2014,0,0,0,0,0,0,0
42615,RM-B230A,6/5/2014,0,0,0,0,0,0,0
42616,RM-B230A,6/6/2014,0,0,0,0,0,0,0
42617,RM-B230A,6/7/2014,0,0,0,0,0,0,0
42618,RM-B230A,6/8/2014,0,0,0,0,0,0,0
42619,RM-B230A,6/9/2014,0,0,0,0,0,0,0
42620,RM-B230A,6/10/2014,0,0,0,0,0,0,0
42621,RM-B230A,6/11/2014,0,0,0,0,0,0,0
42622,RM-B230A,6/12/2014,0,0,0,0,0,0,0
42623,RM-B230A,6/13/2014,0,0,0,0,0,0,0
42624,RM-B230A,6/14/2014,0,0,0,0,0,0,0
42625,RM-B230A,6/15/2014,0,0,0,0,0,0,0
42626,RM-B230A,6/16/2014,0,0,0,0,0,0,0
42627,RM-B230A,6/17/2014,0,0,0,0,0,0,0
42628,RM-B230A,6/18/2014,0,0,0,0,0,0,0
42629,RM-B230A,6/19/2014,0,0,0,0,0,0,0
42630,RM-B230A,6/20/2014,0,0,0,0,0,0,0
42631,RM-B230A,6/21/2014,0,0,0,0,0,0,0
42632,RM-B230A,6/22/2014,0,0,0,0,0,0,0
42633,RM-B230A,6/23/2014,0,0,0,0,0,0,0
42634,RM-B230A,6/24/2014,0,0,0,0,0,0,0
42635,RM-B230A,6/25/2014,0,0,0,0,0,0,0
42636,RM-B230A,6/26/2014,0,0,0,0,0,0,0
42637,RM-B230A,6/27/2014,0,0,0,0,0,0,0
42638,RM-B230A,6/28/2014,0,0,0,0,0,0,0
42639,RM-B230A,6/29/2014,0,0,0,0,0,0,0
42640,RM-B230A,6/30/2014,0,0,0,0,0,0,0
42641,RM-B230A,7/1/2014,0,0,0,0,0,0,0
42642,RM-B230A,7/2/2014,0,0,0,0,0,0,0
42643,RM-B230A,7/3/2014,0,0,0,0,0,0,0
42644,RM-B230A,7/4/2014,0,0,0,0,0,0,0
42645,RM-B230A,7/5/2014,0,0,0,0,0,0,0
42646,RM-B230A,7/6/2014,0,0,0,0,0,0,0
42647,RM-B230A,7/7/2014,0,0,0,0,0,0,0
42648,RM-B230A,7/8/2014,0,0,0,0,0,0,0
42649,RM-B230A,7/9/2014,0,0,0,0,0,0,0
42650,RM-B230A,7/10/2014,0,0,0,0,0,0,0
42651,RM-B230A,7/11/2014,0,0,0,0,0,0,0
42652,RM-B230A,7/12/2014,0,0,0,0,0,0,0
42653,RM-B230A,7/13/2014,0,0,0,0,0,0,0
42654,RM-B230A,7/14/2014,0,0,0,0,0,0,0
42655,RM-B230A,7/15/2014,0,0,0,0,0,0,0
42656,RM-B230A,7/16/2014,0,0,0,0,0,0,0
42657,RM-B230A,7/17/2014,0,0,0,0,0,0,0
42658,RM-B230A,7/18/2014,0,0,0,0,0,0,0
42659,RM-B230A,7/19/2014,0,0,0,0,0,0,0
42660,RM-B230A,7/20/2014,0,0,0,0,0,0,0
42661,RM-B230A,7/21/2014,0,0,0,0,0,0,0
42662,RM-B230A,7/22/2014,0,0,0,0,0,0,0
42663,RM-B230A,7/23/2014,0,0,0,0,0,0,0
42664,RM-B230A,7/24/2014,0,0,0,0,0,0,0
42665,RM-B230A,7/25/2014,0,0,0,0,0,0,0
42666,RM-B230A,7/26/2014,0,0,0,0,0,0,0
42667,RM-B230A,7/27/2014,0,0,0,0,0,0,0
42668,RM-B230A,7/28/2014,0,0,0,0,0,0,0
42669,RM-B230A,7/29/2014,0,0,0,0,0,0,0
42670,RM-B230A,7/30/2014,0,0,0,0,0,0,0
42671,RM-B230A,7/31/2014,0,0,0,0,0,0,0
42672,RM-B230A,8/1/2014,0,0,0,0,0,0,0
42673,RM-B230A,8/2/2014,0,0,0,0,0,0,0
42674,RM-B230A,8/3/2014,0,0,0,0,0,0,0
42675,RM-B230A,8/4/2014,0,0,0,0,0,0,0
42676,RM-B230A,8/5/2014,0,0,0,0,0,0,0
42677,RM-B230A,8/6/2014,0,0,0,0,0,0,0
42678,RM-B230A,8/7/2014,0,0,0,0,0,0,0
42679,RM-B230A,8/8/2014,0,0,0,0,0,0,0
42680,RM-B230A,8/9/2014,0,0,0,0,0,0,0
42681,RM-B230A,8/10/2014,0,0,0,0,0,0,0
42682,RM-B230A,8/11/2014,0,0,0,0,0,0,0
42683,RM-B230A,8/12/2014,0,0,0,0,0,0,0
42684,RM-B230A,8/13/2014,0,0,0,0,0,0,0
42685,RM-B230A,8/14/2014,0,0,0,0,0,0,0
42686,RM-B230A,8/15/2014,0,0,0,0,0,0,0
42687,RM-B230A,8/16/2014,0,0,0,0,0,0,0
42688,RM-B230A,8/17/2014,0,0,0,0,0,0,0
42689,RM-B230A,8/18/2014,0,0,0,0,0,0,0
42690,RM-B230A,8/19/2014,0,0,0,0,0,0,0
42691,RM-B230A,8/20/2014,0,0,0,0,0,0,0
42692,RM-B230A,8/21/2014,0,0,0,0,0,0,0
42693,RM-B230A,8/22/2014,0,0,0,0,0,0,0
42694,RM-B230A,8/23/2014,0,0,0,0,0,0,0
42695,RM-B230A,8/24/2014,0,0,0,0,0,0,0
42696,RM-B230A,8/25/2014,0,0,0,0,0,0,0
42697,RM-B230A,8/26/2014,0,0,0,0,0,0,0
42698,RM-B230A,8/27/2014,0,0,0,0,0,0,0
42699,RM-B230A,8/28/2014,0,0,0,0,0,0,0
42700,RM-B230A,8/29/2014,0,0,0,0,0,0,0
42701,RM-B230A,8/30/2014,0,0,0,0,0,0,0
42702,RM-B230A,8/31/2014,0,0,0,0,0,0,0
42703,RM-B230A,9/1/2014,0,0,0,0,0,0,0
42704,RM-B230A,9/2/2014,0,0,0,0,0,0,0
42705,RM-B230A,9/3/2014,0,0,0,0,0,0,0
42706,RM-B230A,9/4/2014,0,0,0,0,0,0,0
42707,RM-B230A,9/5/2014,0,0,0,0,0,0,0
42708,RM-B230A,9/6/2014,0,0,0,0,0,0,0
42709,RM-B230A,9/7/2014,0,0,0,0,0,0,0
42710,RM-B230A,9/8/2014,0,0,0,0,0,0,0
42711,RM-B230A,9/9/2014,0,0,0,0,0,0,0
42712,RM-B230A,9/10/2014,0,0,0,0,0,0,0
42713,RM-B230A,9/11/2014,0,0,0,0,0,0,0
42714,RM-B230A,9/12/2014,0,0,0,0,0,0,0
42715,RM-B230A,9/13/2014,0,0,0,0,0,0,0
42716,RM-B230A,9/14/2014,0,0,0,0,0,0,0
42717,RM-B230A,9/15/2014,0,0,0,0,0,0,0
42718,RM-B230A,9/16/2014,0,0,0,0,0,0,0
42719,RM-B230A,9/17/2014,0,0,0,0,0,0,0
42720,RM-B230A,9/18/2014,0,0,0,0,0,0,0
42721,RM-B230A,9/19/2014,0,0,0,0,0,0,0
42722,RM-B230A,9/20/2014,0,0,0,0,0,0,0
42723,RM-B230A,9/21/2014,0,0,0,0,0,0,0
42724,RM-B230A,9/22/2014,0,0,0,0,0,0,0
42725,RM-B230A,9/23/2014,0,0,0,0,0,0,0
42726,RM-B230A,9/24/2014,0,0,0,0,0,0,0
42727,RM-B230A,9/25/2014,0,0,0,0,0,0,0
42728,RM-B230A,9/28/2014,0,0,0,0,0,0,0
42729,RM-B230A,9/29/2014,0,0,0,0,0,0,0
42730,RM-B230A,9/30/2014,0,0,0,0,0,0,0
42731,RM-B230A,10/1/2014,0,0,0,0,0,0,0
42732,RM-B230A,10/2/2014,0,0,0,0,0,0,0
42733,RM-B230A,10/3/2014,0,0,0,0,0,0,0
42734,RM-B230A,10/4/2014,0,0,0,0,0,0,0
42735,RM-B230A,10/5/2014,0,0,0,0,0,0,0
42736,RM-B230A,10/6/2014,0,0,0,0,0,0,0
42737,RM-B230A,10/7/2014,0,0,0,0,0,0,0
42738,RM-B230A,10/8/2014,0,0,0,0,0,0,0
42739,RM-B230A,10/9/2014,0,0,0,0,0,0,0
42740,RM-B230A,10/10/2014,0,0,0,0,0,0,0
42741,RM-B230A,10/11/2014,0,0,0,0,0,0,0
42742,RM-B230A,10/12/2014,0,0,0,0,0,0,0
42743,RM-B230A,10/13/2014,0,0,0,0,0,0,0
42744,RM-B230A,10/14/2014,0,0,0,0,0,0,0
42745,RM-B230A,10/15/2014,0,0,0,0,0,0,0
42746,RM-B230A,10/16/2014,0,0,0,0,0,0,0
42747,RM-B230A,10/17/2014,0,0,0,0,0,0,0
42748,RM-B230A,10/18/2014,0,0,0,0,0,0,0
42749,RM-B230A,10/19/2014,0,0,0,0,0,0,0
42750,RM-B230A,10/20/2014,0,0,0,0,0,0,0
42751,RM-B230A,10/21/2014,0,0,0,0,0,0,0
42752,RM-B230A,10/22/2014,0,0,0,0,0,0,0
42753,RM-B230A,10/23/2014,0,0,0,0,0,0,0
42754,RM-B230A,10/24/2014,0,0,0,0,0,0,0
42755,RM-B230A,10/25/2014,0,0,0,0,0,0,0
42756,RM-B230A,10/26/2014,0,0,0,0,0,0,0
42757,RM-B230A,10/27/2014,0,0,0,0,0,0,0
42758,RM-B230A,10/28/2014,0,0,0,0,0,0,0
42759,RM-B230A,10/29/2014,0,0,0,0,0,0,0
42760,RM-B230A,10/30/2014,0,0,0,0,0,0,0
42761,RM-B230A,10/31/2014,0,0,0,0,0,0,0
42762,RM-B230A,11/1/2014,0,0,0,0,0,0,0
42763,RM-B230A,11/2/2014,0,0,0,0,0,0,0
42764,RM-B230A,11/3/2014,0,0,0,0,0,0,0
42765,RM-B230A,11/4/2014,0,0,0,0,0,0,0
42766,RM-B230A,11/5/2014,0,0,0,0,0,0,0
42767,RM-B230A,11/6/2014,0,0,0,0,0,0,0
42768,RM-B230A,11/7/2014,0,0,0,0,0,0,0
42769,RM-B230A,11/8/2014,0,0,0,0,0,0,0
42770,RM-B230A,11/9/2014,0,0,0,0,0,0,0
42771,RM-B230A,11/10/2014,0,0,0,0,0,0,0
42772,RM-B230A,11/11/2014,0,0,0,0,0,0,0
42773,RM-B230A,11/12/2014,0,0,0,0,0,0,0
42774,RM-B230A,11/13/2014,0,0,0,0,0,0,0
42775,RM-B230A,11/14/2014,0,0,0,0,0,0,0
42776,RM-B230A,11/15/2014,0,0,0,0,0,0,0
42777,RM-B230A,11/16/2014,0,0,0,0,0,0,0
42778,RM-B230A,11/17/2014,0,0,0,0,0,0,0
42779,RM-B230A,11/18/2014,0,0,0,0,0,0,0
42780,RM-B230A,11/19/2014,0,0,0,0,0,0,0
42781,RM-B230A,11/20/2014,0,0,0,0,0,0,0
42782,RM-B230A,11/21/2014,0,0,0,0,0,0,0
42783,RM-B230A,11/22/2014,0,0,0,0,0,0,0
42784,RM-B230A,11/23/2014,0,0,0,0,0,0,0
42785,RM-B230A,11/24/2014,0,0,0,0,0,0,0
42786,RM-B230A,11/25/2014,0,0,0,0,0,0,0
42787,RM-B230A,11/26/2014,0,0,0,0,0,0,0
42788,RM-B230A,11/27/2014,0,0,0,0,0,0,0
42789,RM-B230A,11/28/2014,0,0,0,0,0,0,0
42790,RM-B230A,11/29/2014,0,0,0,0,0,0,0
42791,RM-B230A,11/30/2014,0,0,0,0,0,0,0
42792,RM-B230A,12/1/2014,0,0,0,0,0,0,0
42793,RM-B230A,12/2/2014,0,0,0,0,0,0,0
42794,RM-B230A,12/3/2014,0,0,0,0,0,0,0
42795,RM-B230A,12/4/2014,0,0,0,0,0,0,0
42796,RM-B230A,12/5/2014,0,0,0,0,0,0,0
42797,RM-B230A,12/6/2014,0,0,0,0,0,0,0
42798,RM-B230A,12/7/2014,0,0,0,0,0,0,0
42799,RM-B230A,12/8/2014,0,0,0,0,0,0,0
42800,RM-B230A,12/9/2014,0,0,0,0,0,0,0
42801,RM-B230A,12/10/2014,0,0,0,0,0,0,0
42802,RM-B230A,12/11/2014,0,0,0,0,0,0,0
42803,RM-B230A,12/12/2014,0,0,0,0,0,0,0
42804,RM-B230A,12/13/2014,0,0,0,0,0,0,0
42805,RM-B230A,12/14/2014,0,0,0,0,0,0,0
42806,RM-B230A,12/15/2014,0,0,0,0,0,0,0
42807,RM-B230A,12/16/2014,0,0,0,0,0,0,0
42808,RM-B230A,12/17/2014,0,0,0,0,0,0,0
42809,RM-B230A,12/18/2014,0,0,0,0,0,0,0
42810,RM-B230A,12/19/2014,0,0,0,0,0,0,0
42811,RM-B230A,12/20/2014,0,0,0,0,0,0,0
42812,RM-B230A,12/21/2014,0,0,0,0,0,0,0
42813,RM-B230A,12/22/2014,0,0,0,0,0,0,0
42814,RM-B230A,12/23/2014,0,0,0,0,0,0,0
42815,RM-B230A,12/24/2014,0,0,0,0,0,0,0
42816,RM-B230A,12/25/2014,0,0,0,0,0,0,0
42817,RM-B230A,12/26/2014,0,0,0,0,0,0,0
42818,RM-B230A,12/27/2014,0,0,0,0,0,0,0
42819,RM-B230A,12/28/2014,0,0,0,0,0,0,0
42820,RM-B230A,12/29/2014,0,0,0,0,0,0,0
42821,RM-B230A,12/30/2014,0,0,0,0,0,0,0
42822,RM-B230A,12/31/2014,0,0,0,0,0,0,0
42823,RM-B230A,1/1/2015,0,0,0,0,0,0,0
42824,RM-B230A,1/2/2015,0,0,0,0,0,0,0
42825,RM-B230A,1/3/2015,0,0,0,0,0,0,0
42826,RM-B230A,1/4/2015,0,0,0,0,0,0,0
42827,RM-B230A,1/5/2015,0,0,0,0,0,0,0
42828,RM-B230A,1/6/2015,0,0,0,0,0,0,0
42829,RM-B230A,1/7/2015,0,0,0,0,0,0,0
42830,RM-B230A,1/8/2015,0,0,0,0,0,0,0
42831,RM-B230A,1/9/2015,0,0,0,0,0,0,0
42832,RM-B230A,1/10/2015,0,0,0,0,0,0,0
42833,RM-B230A,1/11/2015,0,0,0,0,0,0,0
42834,RM-B230A,1/12/2015,0,0,0,0,0,0,0
42835,RM-B230A,1/13/2015,0,0,0,0,0,0,0
42836,RM-B230A,1/14/2015,0,0,0,0,0,0,0
42837,RM-B230A,1/15/2015,0,0,0,0,0,0,0
42838,RM-B230A,1/16/2015,0,0,0,0,0,0,0
42839,RM-B230A,1/17/2015,0,0,0,0,0,0,0
42840,RM-B230A,1/18/2015,0,0,0,0,0,0,0
42841,RM-B230A,1/19/2015,0,0,0,0,0,0,0
42842,RM-B230A,1/20/2015,0,0,0,0,0,0,0
42843,RM-B230A,1/21/2015,0,0,0,0,0,0,0
42844,RM-B230A,1/22/2015,0,0,0,0,0,0,0
42845,RM-B230A,1/23/2015,0,0,0,0,0,0,0
42846,RM-B230A,1/24/2015,0,0,0,0,0,0,0
42847,RM-B230A,1/25/2015,0,0,0,0,0,0,0
42848,RM-B230A,1/26/2015,0,0,0,0,0,0,0
42849,RM-B230A,1/27/2015,0,0,0,0,0,0,0
42850,RM-B230A,1/28/2015,0,0,0,0,0,0,0
42851,RM-B230A,1/29/2015,0,0,0,0,0,0,0
42852,RM-B230A,1/30/2015,0,0,0,0,0,0,0
42853,RM-B230A,1/31/2015,0,0,0,0,0,0,0
42854,RM-B230A,2/1/2015,0,0,0,0,0,0,0
42855,RM-B230A,2/2/2015,0,0,0,0,0,0,0
42856,RM-B230A,2/3/2015,0,0,0,0,0,0,0
42857,RM-B230A,2/4/2015,0,0,0,0,0,0,0
42858,RM-B230A,2/5/2015,0,0,0,0,0,0,0
42859,RM-B230A,2/6/2015,0,0,0,0,0,0,0
42860,RM-B230A,2/7/2015,0,0,0,0,0,0,0
42861,RM-B230A,2/8/2015,0,0,0,0,0,0,0
42862,RM-B230A,2/9/2015,0,0,0,0,0,0,0
42863,RM-B230A,2/10/2015,0,0,0,0,0,0,0
42864,RM-B230A,2/11/2015,0,0,0,0,0,0,0
42865,RM-B230A,2/12/2015,0,0,0,0,0,0,0
42866,RM-B230A,2/13/2015,0,0,0,0,0,0,0
42867,RM-B230A,2/14/2015,0,0,0,0,0,0,0
42868,RM-B230A,2/15/2015,0,0,0,0,0,0,0
42869,RM-B230A,2/16/2015,0,0,0,0,0,0,0
42870,RM-B230A,2/17/2015,0,0,0,0,0,0,0
42871,RM-B230A,2/18/2015,0,0,0,0,0,0,0
42872,RM-B230A,2/19/2015,0,0,0,0,0,0,0
42873,RM-B230A,2/20/2015,0,0,0,0,0,0,0
42874,RM-B230A,2/21/2015,0,0,0,0,0,0,0
42875,RM-B230A,2/22/2015,0,0,0,0,0,0,0
42876,RM-B230A,2/23/2015,0,0,0,0,0,0,0
42877,RM-B230A,2/24/2015,0,0,0,0,0,0,0
42878,RM-B230A,2/25/2015,0,0,0,0,0,0,0
42879,RM-B230A,2/26/2015,0,0,0,0,0,0,0
42880,RM-B230A,2/27/2015,0,0,0,0,0,0,0
42881,RM-B230A,2/28/2015,0,0,0,0,0,0,0
42882,RM-B230A,3/1/2015,0,0,0,0,0,0,0
42883,RM-B230A,3/2/2015,0,0,0,0,0,0,0
42884,RM-B230A,3/3/2015,0,0,0,0,0,0,0
42885,RM-B230A,3/4/2015,0,0,0,0,0,0,0
42886,RM-B230A,3/5/2015,0,0,0,0,0,0,0
42887,RM-B230A,3/6/2015,0,0,0,0,0,0,0
42888,RM-B230A,3/7/2015,0,0,0,0,0,0,0
42889,RM-B230A,3/8/2015,0,0,0,0,0,0,0
42890,RM-B230A,3/9/2015,0,0,0,0,0,0,0
42891,RM-B230A,3/10/2015,0,0,0,0,0,0,0
42892,RM-B230A,3/11/2015,0,0,0,0,0,0,0
42893,RM-B230A,3/12/2015,0,0,0,0,0,0,0
42894,RM-B230A,3/13/2015,0,0,0,0,0,0,0
42895,RM-B230A,3/14/2015,0,0,0,0,0,0,0
42896,RM-B230A,3/15/2015,0,0,0,0,0,0,0
42897,RM-B230A,3/16/2015,0,0,0,0,0,0,0
42898,RM-B230A,3/17/2015,0,0,0,0,0,0,0
42899,RM-B230A,3/18/2015,0,0,0,0,0,0,0
42900,RM-B230A,3/19/2015,0,0,0,0,0,0,0
42901,RM-B230A,3/20/2015,0,0,0,0,0,0,0
42902,RM-B230A,3/21/2015,0,0,0,0,0,0,0
42903,RM-B230A,3/22/2015,0,0,0,0,0,0,0
42904,RM-B230A,3/23/2015,0,0,0,0,0,0,0
42905,RM-B230A,3/24/2015,0,0,0,0,0,0,0
42906,RM-B230A,3/25/2015,0,0,0,0,0,0,0
42907,RM-B230A,3/26/2015,0,0,0,0,0,0,0
42908,RM-B230A,3/27/2015,0,0,0,0,0,0,0
42909,RM-B230A,3/28/2015,0,0,0,0,0,0,0
42910,RM-B230A,3/29/2015,0,0,0,0,0,0,0
42911,RM-B230A,3/30/2015,0,0,0,0,0,0,0
42912,RM-B230A,3/31/2015,0,0,0,0,0,0,0
42913,RM-B230A,4/1/2015,0,0,0,0,0,0,0
42914,RM-B230A,4/2/2015,0,0,0,0,0,0,0
42915,RM-B230A,4/3/2015,0,0,0,0,0,0,0
42916,RM-B230A,4/4/2015,0,0,0,0,0,0,0
42917,RM-B230A,4/5/2015,0,0,0,0,0,0,0
42918,RM-B230A,4/6/2015,0,0,0,0,0,0,0
42919,RM-B230A,4/7/2015,0,0,0,0,0,0,0
42920,RM-B230A,4/8/2015,0,0,0,0,0,0,0
42921,RM-B230A,4/9/2015,0,0,0,0,0,0,0
42922,RM-B230A,4/10/2015,0,0,0,0,0,0,0
42923,RM-B230A,4/11/2015,0,0,0,0,0,0,0
42924,RM-B230A,4/12/2015,0,0,0,0,0,0,0
42925,RM-B230A,4/13/2015,0,0,0,0,0,0,0
42926,RM-B230A,4/14/2015,0,0,0,0,0,0,0
42927,RM-B230A,4/15/2015,0,0,0,0,0,0,0
42928,RM-B230A,4/16/2015,0,0,0,0,0,0,0
42929,RM-B230A,4/17/2015,0,0,0,0,0,0,0
42930,RM-B230A,4/18/2015,0,0,0,0,0,0,0
42931,RM-B230A,4/19/2015,0,0,0,0,0,0,0
42932,RM-B230A,4/20/2015,0,0,0,0,0,0,0
42933,RM-B230A,4/21/2015,0,0,0,0,0,0,0
42934,RM-B230A,4/22/2015,0,0,0,0,0,0,0
42935,RM-B230A,4/23/2015,0,0,0,0,0,0,0
42936,RM-B230A,4/24/2015,0,0,0,0,0,0,0
42937,RM-B230A,4/25/2015,0,0,0,0,0,0,0
42938,RM-B230A,4/26/2015,0,0,0,0,0,0,0
42939,RM-B230A,4/27/2015,0,0,0,0,0,0,0
42940,RM-B230A,4/28/2015,0,0,0,0,0,0,0
42941,RM-B230A,4/29/2015,0,0,0,0,0,0,0
42942,RM-B230A,4/30/2015,0,0,0,0,0,0,0
42943,RM-B230A,5/27/2015,0,0,0,0,0,0,0
42944,RM-B230A,5/28/2015,0,0,0,0,0,0,0
42945,RM-B230A,5/29/2015,0,0,0,0,0,0,0
42946,RM-B230A,5/30/2015,0,0,0,0,0,0,0
42947,RM-B230A,5/31/2015,0,0,0,0,0,0,0
42948,RM-B240,6/28/2013,0,0,0,0,0,0,0
42949,RM-B240,6/29/2013,0,0,0,0,0,0,0
42950,RM-B240,6/30/2013,0,0,0,0,0,0,0
42951,RM-B240,7/1/2013,0,0,0,0,0,0,0
42952,RM-B240,7/2/2013,0,0,0,0,0,0,0
42953,RM-B240,7/3/2013,0,0,0,0,0,0,0
42954,RM-B240,7/4/2013,0,0,0,0,0,0,0
42955,RM-B240,7/5/2013,0,0,0,0,0,0,0
42956,RM-B240,7/6/2013,0,0,0,0,0,0,0
42957,RM-B240,7/7/2013,0,0,0,0,0,0,0
42958,RM-B240,7/8/2013,0,0,0,0,0,0,0
42959,RM-B240,7/9/2013,0,0,0,0,0,0,0
42960,RM-B240,7/10/2013,0,0,0,0,0,0,0
42961,RM-B240,7/11/2013,0,0,0,0,0,0,0
42962,RM-B240,7/12/2013,0,0,0,0,0,0,0
42963,RM-B240,7/13/2013,0,0,0,0,0,0,0
42964,RM-B240,7/14/2013,0,0,0,0,0,0,0
42965,RM-B240,7/15/2013,0,0,0,0,0,0,0
42966,RM-B240,7/17/2013,0,0,0,0,0,0,0
42967,RM-B240,7/18/2013,0,0,0,0,0,0,0
42968,RM-B240,7/19/2013,0,0,0,0,0,0,0
42969,RM-B240,7/20/2013,0,0,0,0,0,0,0
42970,RM-B240,7/21/2013,0,0,0,0,0,0,0
42971,RM-B240,7/22/2013,0,0,0,0,0,0,0
42972,RM-B240,7/23/2013,0,0,0,0,0,0,0
42973,RM-B240,7/24/2013,0,0,0,0,0,0,0
42974,RM-B240,7/25/2013,0,0,0,0,0,0,0
42975,RM-B240,7/26/2013,0,0,0,0,0,0,0
42976,RM-B240,7/27/2013,0,0,0,0,0,0,0
42977,RM-B240,7/28/2013,0,0,0,0,0,0,0
42978,RM-B240,7/29/2013,0,0,0,0,0,0,0
42979,RM-B240,7/30/2013,0,0,0,0,0,0,0
42980,RM-B240,7/31/2013,0,0,0,0,0,0,0
42981,RM-B240,8/1/2013,0,0,0,0,0,0,0
42982,RM-B240,8/2/2013,0,0,0,0,0,0,0
42983,RM-B240,11/19/2013,0,0,0,0,0,0,0
42984,RM-B240,11/20/2013,0,0,0,0,0,0,0
42985,RM-B240,11/21/2013,0,0,0,0,0,0,0
42986,RM-B240,11/22/2013,0,0,0,0,0,0,0
42987,RM-B240,11/23/2013,0,0,0,0,0,0,0
42988,RM-B240,11/24/2013,0,0,0,0,0,0,0
42989,RM-B240,11/25/2013,0,0,0,0,0,0,0
42990,RM-B240,11/26/2013,0,0,0,0,0,0,0
42991,RM-B240,11/27/2013,0,0,0,0,0,0,0
42992,RM-B240,11/28/2013,0,0,0,0,0,0,0
42993,RM-B240,11/29/2013,0,0,0,0,0,0,0
42994,RM-B240,11/30/2013,0,0,0,0,0,0,0
42995,RM-B240,12/1/2013,0,0,0,0,0,0,0
42996,RM-B240,12/2/2013,0,0,0,0,0,0,0
42997,RM-B240,12/3/2013,0,0,0,0,0,0,0
42998,RM-B240,12/4/2013,0,0,0,0,0,0,0
42999,RM-B240,12/5/2013,0,0,0,0,0,0,0
43000,RM-B240,12/6/2013,0,0,0,0,0,0,0
43001,RM-B240,12/7/2013,0,0,0,0,0,0,0
43002,RM-B240,12/8/2013,0,0,0,0,0,0,0
43003,RM-B240,12/9/2013,0,0,0,0,0,0,0
43004,RM-B240,12/10/2013,0,0,0,0,0,0,0
43005,RM-B240,12/11/2013,0,0,0,0,0,0,0
43006,RM-B240,12/12/2013,0,0,0,0,0,0,0
43007,RM-B240,12/13/2013,0,0,0,0,0,0,0
43008,RM-B240,12/14/2013,0,0,0,0,0,0,0
43009,RM-B240,12/15/2013,0,0,0,0,0,0,0
43010,RM-B240,12/16/2013,0,0,0,0,0,0,0
43011,RM-B240,12/17/2013,0,0,0,0,0,0,0
43012,RM-B240,12/18/2013,0,0,0,0,0,0,0
43013,RM-B240,12/19/2013,0,0,0,0,0,0,0
43014,RM-B240,12/20/2013,0,0,0,0,0,0,0
43015,RM-B240,12/21/2013,0,0,0,0,0,0,0
43016,RM-B240,12/22/2013,0,0,0,0,0,0,0
43017,RM-B240,12/23/2013,0,0,0,0,0,0,0
43018,RM-B240,12/24/2013,0,0,0,0,0,0,0
43019,RM-B240,12/25/2013,0,0,0,0,0,0,0
43020,RM-B240,12/26/2013,0,0,0,0,0,0,0
43021,RM-B240,12/27/2013,0,0,0,0,0,0,0
43022,RM-B240,12/28/2013,0,0,0,0,0,0,0
43023,RM-B240,12/29/2013,0,0,0,0,0,0,0
43024,RM-B240,12/30/2013,0,0,0,0,0,0,0
43025,RM-B240,12/31/2013,0,0,0,0,0,0,0
43026,RM-B240,1/1/2014,0,0,0,0,0,0,0
43027,RM-B240,1/2/2014,0,0,0,0,0,0,0
43028,RM-B240,1/3/2014,0,0,0,0,0,0,0
43029,RM-B240,1/4/2014,0,0,0,0,0,0,0
43030,RM-B240,1/5/2014,0,0,0,0,0,0,0
43031,RM-B240,1/6/2014,0,0,0,0,0,0,0
43032,RM-B240,1/7/2014,0,0,0,0,0,0,0
43033,RM-B240,1/8/2014,0,0,0,0,0,0,0
43034,RM-B240,1/9/2014,0,0,0,0,0,0,0
43035,RM-B240,1/10/2014,0,0,0,0,0,0,0
43036,RM-B240,1/11/2014,0,0,0,0,0,0,0
43037,RM-B240,1/12/2014,0,0,0,0,0,0,0
43038,RM-B240,1/13/2014,0,0,0,0,0,0,0
43039,RM-B240,1/14/2014,0,0,0,0,0,0,0
43040,RM-B240,1/15/2014,0,0,0,0,0,0,0
43041,RM-B240,1/16/2014,0,0,0,0,0,0,0
43042,RM-B240,1/17/2014,0,0,0,0,0,0,0
43043,RM-B240,1/18/2014,0,0,0,0,0,0,0
43044,RM-B240,1/19/2014,0,0,0,0,0,0,0
43045,RM-B240,1/20/2014,0,0,0,0,0,0,0
43046,RM-B240,1/21/2014,0,0,0,0,0,0,0
43047,RM-B240,1/22/2014,0,0,0,0,0,0,0
43048,RM-B240,1/23/2014,0,0,0,0,0,0,0
43049,RM-B240,1/24/2014,0,0,0,0,0,0,0
43050,RM-B240,1/25/2014,0,0,0,0,0,0,0
43051,RM-B240,1/26/2014,0,0,0,0,0,0,0
43052,RM-B240,1/27/2014,0,0,0,0,0,0,0
43053,RM-B240,1/28/2014,0,0,0,0,0,0,0
43054,RM-B240,1/29/2014,0,0,0,0,0,0,0
43055,RM-B240,1/30/2014,0,0,0,0,0,0,0
43056,RM-B240,1/31/2014,0,0,0,0,0,0,0
43057,RM-B240,2/1/2014,0,0,0,0,0,0,0
43058,RM-B240,2/2/2014,0,0,0,0,0,0,0
43059,RM-B240,2/3/2014,0,0,0,0,0,0,0
43060,RM-B240,2/4/2014,0,0,0,0,0,0,0
43061,RM-B240,2/5/2014,0,0,0,0,0,0,0
43062,RM-B240,2/6/2014,0,0,0,0,0,0,0
43063,RM-B240,2/7/2014,0,0,0,0,0,0,0
43064,RM-B240,2/8/2014,0,0,0,0,0,0,0
43065,RM-B240,2/9/2014,0,0,0,0,0,0,0
43066,RM-B240,2/10/2014,0,0,0,0,0,0,0
43067,RM-B240,2/11/2014,0,0,0,0,0,0,0
43068,RM-B240,2/12/2014,0,0,0,0,0,0,0
43069,RM-B240,2/13/2014,0,0,0,0,0,0,0
43070,RM-B240,2/14/2014,0,0,0,0,0,0,0
43071,RM-B240,2/15/2014,0,0,0,0,0,0,0
43618,RM-B240A,9/27/2013,0,0,0,0,0,0,0
43619,RM-B240A,9/28/2013,0,0,0,0,0,0,0
43620,RM-B240A,9/29/2013,0,0,0,0,0,0,0
43621,RM-B240A,9/30/2013,0,0,0,0,0,0,0
43622,RM-B240A,10/1/2013,0,0,0,0,0,0,0
43623,RM-B240A,10/2/2013,0,0,0,0,0,0,0
43624,RM-B240A,10/3/2013,0,0,0,0,0,0,0
43625,RM-B240A,10/4/2013,0,0,0,0,0,0,0
43626,RM-B240A,10/5/2013,0,0,0,0,0,0,0
43627,RM-B240A,10/6/2013,0,0,0,0,0,0,0
43628,RM-B240A,10/7/2013,0,0,0,0,0,0,0
43629,RM-B240A,10/8/2013,0,0,0,0,0,0,0
43630,RM-B240A,10/9/2013,0,0,0,0,0,0,0
43631,RM-B240A,10/10/2013,0,0,0,0,0,0,0
43632,RM-B240A,10/11/2013,0,0,0,0,0,0,0
43633,RM-B240A,10/12/2013,0,0,0,0,0,0,0
43634,RM-B240A,10/13/2013,0,0,0,0,0,0,0
43635,RM-B240A,10/14/2013,0,0,0,0,0,0,0
43636,RM-B240A,10/15/2013,0,0,0,0,0,0,0
43637,RM-B240A,10/16/2013,0,0,0,0,0,0,0
43638,RM-B240A,10/17/2013,0,0,0,0,0,0,0
43639,RM-B240A,10/18/2013,0,0,0,0,0,0,0
43640,RM-B240A,10/19/2013,0,0,0,0,0,0,0
43641,RM-B240A,10/20/2013,0,0,0,0,0,0,0
43642,RM-B240A,10/21/2013,0,0,0,0,0,0,0
43643,RM-B240A,10/22/2013,0,0,0,0,0,0,0
43644,RM-B240A,10/23/2013,0,0,0,0,0,0,0
43645,RM-B240A,10/24/2013,0,0,0,0,0,0,0
43646,RM-B240A,10/25/2013,0,0,0,0,0,0,0
43647,RM-B240A,10/26/2013,0,0,0,0,0,0,0
43648,RM-B240A,10/27/2013,0,0,0,0,0,0,0
43649,RM-B240A,10/28/2013,0,0,0,0,0,0,0
43650,RM-B240A,10/29/2013,0,0,0,0,0,0,0
43651,RM-B240A,10/30/2013,0,0,0,0,0,0,0
43652,RM-B240A,10/31/2013,0,0,0,0,0,0,0
43653,RM-B240A,11/1/2013,0,0,0,0,0,0,0
43654,RM-B240A,11/2/2013,0,0,0,0,0,0,0
43655,RM-B240A,11/3/2013,0,0,0,0,0,0,0
43656,RM-B240A,11/4/2013,0,0,0,0,0,0,0
43657,RM-B240A,11/5/2013,0,0,0,0,0,0,0
43658,RM-B240A,11/6/2013,0,0,0,0,0,0,0
43659,RM-B240A,11/7/2013,0,0,0,0,0,0,0
43660,RM-B240A,11/8/2013,0,0,0,0,0,0,0
43661,RM-B240A,11/9/2013,0,0,0,0,0,0,0
43662,RM-B240A,11/10/2013,0,0,0,0,0,0,0
43663,RM-B240A,11/11/2013,0,0,0,0,0,0,0
43664,RM-B240A,11/12/2013,0,0,0,0,0,0,0
43665,RM-B240A,11/13/2013,0,0,0,0,0,0,0
43666,RM-B240A,11/14/2013,0,0,0,0,0,0,0
43667,RM-B240A,11/15/2013,0,0,0,0,0,0,0
43668,RM-B240A,11/19/2013,0,0,0,0,0,0,0
43669,RM-B240A,11/20/2013,0,0,0,0,0,0,0
43670,RM-B240A,11/21/2013,0,0,0,0,0,0,0
43671,RM-B240A,11/22/2013,0,0,0,0,0,0,0
43672,RM-B240A,11/23/2013,0,0,0,0,0,0,0
43673,RM-B240A,11/24/2013,0,0,0,0,0,0,0
43674,RM-B240A,11/25/2013,0,0,0,0,0,0,0
43675,RM-B240A,11/26/2013,0,0,0,0,0,0,0
43676,RM-B240A,11/27/2013,0,0,0,0,0,0,0
43677,RM-B240A,11/28/2013,0,0,0,0,0,0,0
43678,RM-B240A,11/29/2013,0,0,0,0,0,0,0
43679,RM-B240A,11/30/2013,0,0,0,0,0,0,0
43680,RM-B240A,12/1/2013,0,0,0,0,0,0,0
43681,RM-B240A,12/2/2013,0,0,0,0,0,0,0
43682,RM-B240A,12/3/2013,0,0,0,0,0,0,0
43683,RM-B240A,12/4/2013,0,0,0,0,0,0,0
43684,RM-B240A,12/5/2013,0,0,0,0,0,0,0
43685,RM-B240A,12/6/2013,0,0,0,0,0,0,0
43686,RM-B240A,12/7/2013,0,0,0,0,0,0,0
43687,RM-B240A,12/8/2013,0,0,0,0,0,0,0
43688,RM-B240A,12/9/2013,0,0,0,0,0,0,0
43689,RM-B240A,12/10/2013,0,0,0,0,0,0,0
43690,RM-B240A,12/11/2013,0,0,0,0,0,0,0
43691,RM-B240A,12/12/2013,0,0,0,0,0,0,0
43692,RM-B240A,12/13/2013,0,0,0,0,0,0,0
43693,RM-B240A,12/14/2013,0,0,0,0,0,0,0
43694,RM-B240A,12/15/2013,0,0,0,0,0,0,0
43695,RM-B240A,12/16/2013,0,0,0,0,0,0,0
43696,RM-B240A,12/17/2013,0,0,0,0,0,0,0
43697,RM-B240A,12/18/2013,0,0,0,0,0,0,0
43698,RM-B240A,12/19/2013,0,0,0,0,0,0,0
43699,RM-B240A,12/20/2013,0,0,0,0,0,0,0
43700,RM-B240A,12/21/2013,0,0,0,0,0,0,0
43701,RM-B240A,12/22/2013,0,0,0,0,0,0,0
43702,RM-B240A,12/23/2013,0,0,0,0,0,0,0
43703,RM-B240A,12/24/2013,0,0,0,0,0,0,0
43704,RM-B240A,12/25/2013,0,0,0,0,0,0,0
43705,RM-B240A,12/26/2013,0,0,0,0,0,0,0
43706,RM-B240A,12/27/2013,0,0,0,0,0,0,0
43707,RM-B240A,12/28/2013,0,0,0,0,0,0,0
43708,RM-B240A,12/29/2013,0,0,0,0,0,0,0
43709,RM-B240A,12/30/2013,0,0,0,0,0,0,0
43710,RM-B240A,12/31/2013,0,0,0,0,0,0,0
43711,RM-B240A,1/1/2014,0,0,0,0,0,0,0
43712,RM-B240A,1/2/2014,0,0,0,0,0,0,0
43713,RM-B240A,1/3/2014,0,0,0,0,0,0,0
43714,RM-B240A,1/4/2014,0,0,0,0,0,0,0
43715,RM-B240A,1/5/2014,0,0,0,0,0,0,0
43716,RM-B240A,1/6/2014,0,0,0,0,0,0,0
43717,RM-B240A,1/7/2014,0,0,0,0,0,0,0
43719,RM-B240A,1/9/2014,0,0,0,0,0,0,0
43723,RM-B240A,1/13/2014,0,0,0,0,0,0,0
43724,RM-B240A,1/14/2014,0,0,0,0,0,0,0
44624,RM-B250,11/2/2014,0,0,0,0,0,0,0
44625,RM-B250,11/3/2014,0,0,0,0,0,0,0
44626,RM-B250,11/4/2014,0,0,0,0,0,0,0
44627,RM-B250,11/5/2014,0,0,0,0,0,0,0
44628,RM-B250,11/6/2014,0,0,0,0,0,0,0
44629,RM-B250,11/7/2014,0,0,0,0,0,0,0
44630,RM-B250,11/8/2014,0,0,0,0,0,0,0
44631,RM-B250,11/9/2014,0,0,0,0,0,0,0
44632,RM-B250,11/10/2014,0,0,0,0,0,0,0
44633,RM-B250,11/11/2014,0,0,0,0,0,0,0
44634,RM-B250,11/12/2014,0,0,0,0,0,0,0
44635,RM-B250,11/13/2014,0,0,0,0,0,0,0
44636,RM-B250,11/14/2014,0,0,0,0,0,0,0
44637,RM-B250,11/15/2014,0,0,0,0,0,0,0
44638,RM-B250,11/16/2014,0,0,0,0,0,0,0
44639,RM-B250,11/17/2014,0,0,0,0,0,0,0
44640,RM-B250,11/18/2014,0,0,0,0,0,0,0
44641,RM-B250,11/19/2014,0,0,0,0,0,0,0
44642,RM-B250,11/20/2014,0,0,0,0,0,0,0
44643,RM-B250,11/21/2014,0,0,0,0,0,0,0
44644,RM-B250,11/22/2014,0,0,0,0,0,0,0
44645,RM-B250,11/23/2014,0,0,0,0,0,0,0
44646,RM-B250,11/24/2014,0,0,0,0,0,0,0
44647,RM-B250,11/25/2014,0,0,0,0,0,0,0
44648,RM-B250,11/26/2014,0,0,0,0,0,0,0
44649,RM-B250,11/27/2014,0,0,0,0,0,0,0
44650,RM-B250,11/28/2014,0,0,0,0,0,0,0
44651,RM-B250,11/29/2014,0,0,0,0,0,0,0
44652,RM-B250,11/30/2014,0,0,0,0,0,0,0
44653,RM-B250,12/1/2014,0,0,0,0,0,0,0
44654,RM-B250,12/2/2014,0,0,0,0,0,0,0
44655,RM-B250,12/3/2014,0,0,0,0,0,0,0
44656,RM-B250,12/4/2014,0,0,0,0,0,0,0
44657,RM-B250,12/5/2014,0,0,0,0,0,0,0
44658,RM-B250,12/6/2014,0,0,0,0,0,0,0
44659,RM-B250,12/7/2014,0,0,0,0,0,0,0
44660,RM-B250,12/8/2014,0,0,0,0,0,0,0
44661,RM-B250,12/9/2014,0,0,0,0,0,0,0
44662,RM-B250,12/10/2014,0,0,0,0,0,0,0
44663,RM-B250,12/11/2014,0,0,0,0,0,0,0
44664,RM-B250,12/12/2014,0,0,0,0,0,0,0
44665,RM-B250,12/13/2014,0,0,0,0,0,0,0
44666,RM-B250,12/14/2014,0,0,0,0,0,0,0
44667,RM-B250,12/15/2014,0,0,0,0,0,0,0
44668,RM-B250,12/16/2014,0,0,0,0,0,0,0
44669,RM-B250,12/17/2014,0,0,0,0,0,0,0
44670,RM-B250,12/18/2014,0,0,0,0,0,0,0
44671,RM-B250,12/19/2014,0,0,0,0,0,0,0
44672,RM-B250,12/20/2014,0,0,0,0,0,0,0
44673,RM-B250,12/21/2014,0,0,0,0,0,0,0
44674,RM-B250,12/22/2014,0,0,0,0,0,0,0
44675,RM-B250,12/23/2014,0,0,0,0,0,0,0
44676,RM-B250,12/24/2014,0,0,0,0,0,0,0
44677,RM-B250,12/25/2014,0,0,0,0,0,0,0
44678,RM-B250,12/26/2014,0,0,0,0,0,0,0
44679,RM-B250,12/27/2014,0,0,0,0,0,0,0
44680,RM-B250,12/28/2014,0,0,0,0,0,0,0
44681,RM-B250,12/29/2014,0,0,0,0,0,0,0
44682,RM-B250,12/30/2014,0,0,0,0,0,0,0
44683,RM-B250,12/31/2014,0,0,0,0,0,0,0
44684,RM-B250,1/1/2015,0,0,0,0,0,0,0
44685,RM-B250,1/2/2015,0,0,0,0,0,0,0
44686,RM-B250,1/3/2015,0,0,0,0,0,0,0
44687,RM-B250,1/4/2015,0,0,0,0,0,0,0
44688,RM-B250,1/5/2015,0,0,0,0,0,0,0
44689,RM-B250,1/6/2015,0,0,0,0,0,0,0
44690,RM-B250,1/7/2015,0,0,0,0,0,0,0
44691,RM-B250,1/8/2015,0,0,0,0,0,0,0
44692,RM-B250,1/9/2015,0,0,0,0,0,0,0
44693,RM-B250,1/10/2015,0,0,0,0,0,0,0
44694,RM-B250,1/11/2015,0,0,0,0,0,0,0
44695,RM-B250,1/12/2015,0,0,0,0,0,0,0
44696,RM-B250,1/13/2015,0,0,0,0,0,0,0
44697,RM-B250,1/14/2015,0,0,0,0,0,0,0
44698,RM-B250,1/15/2015,0,0,0,0,0,0,0
44699,RM-B250,1/16/2015,0,0,0,0,0,0,0
44700,RM-B250,1/17/2015,0,0,0,0,0,0,0
44701,RM-B250,1/18/2015,0,0,0,0,0,0,0
44702,RM-B250,1/19/2015,0,0,0,0,0,0,0
44703,RM-B250,1/20/2015,0,0,0,0,0,0,0
44704,RM-B250,1/21/2015,0,0,0,0,0,0,0
44705,RM-B250,1/22/2015,0,0,0,0,0,0,0
44706,RM-B250,1/23/2015,0,0,0,0,0,0,0
44707,RM-B250,1/24/2015,0,0,0,0,0,0,0
44708,RM-B250,1/25/2015,0,0,0,0,0,0,0
44709,RM-B250,1/26/2015,0,0,0,0,0,0,0
44710,RM-B250,1/27/2015,0,0,0,0,0,0,0
44711,RM-B250,1/28/2015,0,0,0,0,0,0,0
44712,RM-B250,1/29/2015,0,0,0,0,0,0,0
44713,RM-B250,1/30/2015,0,0,0,0,0,0,0
44714,RM-B250,1/31/2015,0,0,0,0,0,0,0
44715,RM-B250,2/1/2015,0,0,0,0,0,0,0
44716,RM-B250,2/2/2015,0,0,0,0,0,0,0
44717,RM-B250,2/3/2015,0,0,0,0,0,0,0
44718,RM-B250,2/4/2015,0,0,0,0,0,0,0
44719,RM-B250,2/5/2015,0,0,0,0,0,0,0
44720,RM-B250,2/6/2015,0,0,0,0,0,0,0
44721,RM-B250,2/7/2015,0,0,0,0,0,0,0
44722,RM-B250,2/8/2015,0,0,0,0,0,0,0
44723,RM-B250,2/9/2015,0,0,0,0,0,0,0
44724,RM-B250,2/10/2015,0,0,0,0,0,0,0
44725,RM-B250,2/11/2015,0,0,0,0,0,0,0
44726,RM-B250,2/12/2015,0,0,0,0,0,0,0
44727,RM-B250,2/13/2015,0,0,0,0,0,0,0
44728,RM-B250,2/14/2015,0,0,0,0,0,0,0
44729,RM-B250,2/15/2015,0,0,0,0,0,0,0
44730,RM-B250,2/16/2015,0,0,0,0,0,0,0
44731,RM-B250,2/17/2015,0,0,0,0,0,0,0
44732,RM-B250,2/18/2015,0,0,0,0,0,0,0
44733,RM-B250,2/19/2015,0,0,0,0,0,0,0
44734,RM-B250,2/20/2015,0,0,0,0,0,0,0
44735,RM-B250,2/21/2015,0,0,0,0,0,0,0
44736,RM-B250,2/22/2015,0,0,0,0,0,0,0
44737,RM-B250,2/23/2015,0,0,0,0,0,0,0
44738,RM-B250,2/24/2015,0,0,0,0,0,0,0
44739,RM-B250,2/25/2015,0,0,0,0,0,0,0
44740,RM-B250,2/26/2015,0,0,0,0,0,0,0
44741,RM-B250,2/27/2015,0,0,0,0,0,0,0
44742,RM-B250,2/28/2015,0,0,0,0,0,0,0
44743,RM-B250,3/1/2015,0,0,0,0,0,0,0
44744,RM-B250,3/2/2015,0,0,0,0,0,0,0
44745,RM-B250,3/3/2015,0,0,0,0,0,0,0
44746,RM-B250,3/4/2015,0,0,0,0,0,0,0
44747,RM-B250,3/5/2015,0,0,0,0,0,0,0
44748,RM-B250,3/6/2015,0,0,0,0,0,0,0
44749,RM-B250,3/7/2015,0,0,0,0,0,0,0
44750,RM-B250,3/8/2015,0,0,0,0,0,0,0
44751,RM-B250,3/9/2015,0,0,0,0,0,0,0
44752,RM-B250,3/10/2015,0,0,0,0,0,0,0
44753,RM-B250,3/11/2015,0,0,0,0,0,0,0
44754,RM-B250,3/12/2015,0,0,0,0,0,0,0
44755,RM-B250,3/13/2015,0,0,0,0,0,0,0
44756,RM-B250,3/14/2015,0,0,0,0,0,0,0
44757,RM-B250,3/15/2015,0,0,0,0,0,0,0
44758,RM-B250,3/16/2015,0,0,0,0,0,0,0
44759,RM-B250,3/17/2015,0,0,0,0,0,0,0
44760,RM-B250,3/18/2015,0,0,0,0,0,0,0
44761,RM-B250,3/19/2015,0,0,0,0,0,0,0
44762,RM-B250,3/20/2015,0,0,0,0,0,0,0
44763,RM-B250,3/21/2015,0,0,0,0,0,0,0
44764,RM-B250,3/22/2015,0,0,0,0,0,0,0
44765,RM-B250,3/23/2015,0,0,0,0,0,0,0
44766,RM-B250,3/24/2015,0,0,0,0,0,0,0
44767,RM-B250,3/25/2015,0,0,0,0,0,0,0
44768,RM-B250,3/26/2015,0,0,0,0,0,0,0
44769,RM-B250,3/27/2015,0,0,0,0,0,0,0
44770,RM-B250,3/28/2015,0,0,0,0,0,0,0
44771,RM-B250,3/29/2015,0,0,0,0,0,0,0
44772,RM-B250,3/30/2015,0,0,0,0,0,0,0
44773,RM-B250,3/31/2015,0,0,0,0,0,0,0
44774,RM-B250,4/1/2015,0,0,0,0,0,0,0
44775,RM-B250,4/2/2015,0,0,0,0,0,0,0
44776,RM-B250,4/3/2015,0,0,0,0,0,0,0
44777,RM-B250,4/4/2015,0,0,0,0,0,0,0
44778,RM-B250,4/5/2015,0,0,0,0,0,0,0
44779,RM-B250,4/6/2015,0,0,0,0,0,0,0
44780,RM-B250,4/7/2015,0,0,0,0,0,0,0
44781,RM-B250,4/8/2015,0,0,0,0,0,0,0
44782,RM-B250,4/9/2015,0,0,0,0,0,0,0
44783,RM-B250,4/10/2015,0,0,0,0,0,0,0
44784,RM-B250,4/11/2015,0,0,0,0,0,0,0
44785,RM-B250,4/12/2015,0,0,0,0,0,0,0
44786,RM-B250,4/13/2015,0,0,0,0,0,0,0
44787,RM-B250,4/14/2015,0,0,0,0,0,0,0
44788,RM-B250,4/15/2015,0,0,0,0,0,0,0
44789,RM-B250,4/16/2015,0,0,0,0,0,0,0
44790,RM-B250,4/17/2015,0,0,0,0,0,0,0
44791,RM-B250,4/18/2015,0,0,0,0,0,0,0
44792,RM-B250,4/19/2015,0,0,0,0,0,0,0
44793,RM-B250,4/20/2015,0,0,0,0,0,0,0
44794,RM-B250,4/21/2015,0,0,0,0,0,0,0
44795,RM-B250,4/22/2015,0,0,0,0,0,0,0
44796,RM-B250,4/23/2015,0,0,0,0,0,0,0
44797,RM-B250,4/24/2015,0,0,0,0,0,0,0
44798,RM-B250,4/25/2015,0,0,0,0,0,0,0
44799,RM-B250,4/26/2015,0,0,0,0,0,0,0
44800,RM-B250,4/27/2015,0,0,0,0,0,0,0
44801,RM-B250,4/28/2015,0,0,0,0,0,0,0
44802,RM-B250,4/29/2015,0,0,0,0,0,0,0
44803,RM-B250,4/30/2015,0,0,0,0,0,0,0
44804,RM-B250,5/1/2015,0,0,0,0,0,0,0
44805,RM-B250,5/2/2015,0,0,0,0,0,0,0
44806,RM-B250,5/3/2015,0,0,0,0,0,0,0
44807,RM-B250,5/4/2015,0,0,0,0,0,0,0
44808,RM-B250,5/5/2015,0,0,0,0,0,0,0
44809,RM-B250,5/6/2015,0,0,0,0,0,0,0
44810,RM-B250,5/7/2015,0,0,0,0,0,0,0
44811,RM-B250,5/8/2015,0,0,0,0,0,0,0
44812,RM-B250,5/9/2015,0,0,0,0,0,0,0
44813,RM-B250,5/10/2015,0,0,0,0,0,0,0
44814,RM-B250,5/11/2015,0,0,0,0,0,0,0
44815,RM-B250,5/12/2015,0,0,0,0,0,0,0
44816,RM-B250,5/13/2015,0,0,0,0,0,0,0
44817,RM-B250,5/14/2015,0,0,0,0,0,0,0
44818,RM-B250,5/15/2015,0,0,0,0,0,0,0
44819,RM-B250,5/16/2015,0,0,0,0,0,0,0
44820,RM-B250,5/17/2015,0,0,0,0,0,0,0
44821,RM-B250,5/18/2015,0,0,0,0,0,0,0
44822,RM-B250,5/19/2015,0,0,0,0,0,0,0
44823,RM-B250,5/20/2015,0,0,0,0,0,0,0
44824,RM-B250,5/21/2015,0,0,0,0,0,0,0
44825,RM-B250,5/22/2015,0,0,0,0,0,0,0
44826,RM-B250,5/23/2015,0,0,0,0,0,0,0
44827,RM-B250,5/24/2015,0,0,0,0,0,0,0
44828,RM-B250,5/25/2015,0,0,0,0,0,0,0
44829,RM-B250,5/26/2015,0,0,0,0,0,0,0
44830,RM-B250,5/27/2015,0,0,0,0,0,0,0
44831,RM-B250,5/28/2015,0,0,0,0,0,0,0
44832,RM-B250,5/29/2015,0,0,0,0,0,0,0
44833,RM-B250,5/30/2015,0,0,0,0,0,0,0
44834,RM-B250,5/31/2015,0,0,0,0,0,0,0
44835,RM-B250A,7/1/2013,0,0,0,0,0,0,0
44836,RM-B250A,7/2/2013,0,0,0,0,0,0,0
44837,RM-B250A,7/3/2013,0,0,0,0,0,0,0
44838,RM-B250A,7/4/2013,0,0,0,0,0,0,0
44839,RM-B250A,7/5/2013,0,0,0,0,0,0,0
44840,RM-B250A,7/6/2013,0,0,0,0,0,0,0
44841,RM-B250A,7/7/2013,0,0,0,0,0,0,0
44842,RM-B250A,7/8/2013,0,0,0,0,0,0,0
44843,RM-B250A,7/9/2013,0,0,0,0,0,0,0
44844,RM-B250A,7/10/2013,0,0,0,0,0,0,0
44845,RM-B250A,7/11/2013,0,0,0,0,0,0,0
44846,RM-B250A,7/12/2013,0,0,0,0,0,0,0
44847,RM-B250A,7/13/2013,0,0,0,0,0,0,0
44848,RM-B250A,7/14/2013,0,0,0,0,0,0,0
44849,RM-B250A,7/15/2013,0,0,0,0,0,0,0
44850,RM-B250A,7/17/2013,0,0,0,0,0,0,0
44851,RM-B250A,7/18/2013,0,0,0,0,0,0,0
44852,RM-B250A,7/19/2013,0,0,0,0,0,0,0
44853,RM-B250A,7/20/2013,0,0,0,0,0,0,0
44854,RM-B250A,7/21/2013,0,0,0,0,0,0,0
44855,RM-B250A,7/22/2013,0,0,0,0,0,0,0
44856,RM-B250A,7/23/2013,0,0,0,0,0,0,0
44857,RM-B250A,7/24/2013,0,0,0,0,0,0,0
44858,RM-B250A,7/25/2013,0,0,0,0,0,0,0
44859,RM-B250A,7/26/2013,0,0,0,0,0,0,0
44860,RM-B250A,7/27/2013,0,0,0,0,0,0,0
44861,RM-B250A,7/28/2013,0,0,0,0,0,0,0
44862,RM-B250A,7/29/2013,0,0,0,0,0,0,0
44863,RM-B250A,7/30/2013,0,0,0,0,0,0,0
44864,RM-B250A,7/31/2013,0,0,0,0,0,0,0
44865,RM-B250A,8/1/2013,0,0,0,0,0,0,0
44866,RM-B250A,8/2/2013,0,0,0,0,0,0,0
44867,RM-B250A,8/3/2013,0,0,0,0,0,0,0
44868,RM-B250A,8/4/2013,0,0,0,0,0,0,0
44869,RM-B250A,8/5/2013,0,0,0,0,0,0,0
44870,RM-B250A,8/6/2013,0,0,0,0,0,0,0
44871,RM-B250A,8/7/2013,0,0,0,0,0,0,0
44872,RM-B250A,8/8/2013,0,0,0,0,0,0,0
44873,RM-B250A,8/9/2013,0,0,0,0,0,0,0
44874,RM-B250A,8/10/2013,0,0,0,0,0,0,0
44875,RM-B250A,8/11/2013,0,0,0,0,0,0,0
44876,RM-B250A,8/12/2013,0,0,0,0,0,0,0
44877,RM-B250A,8/13/2013,0,0,0,0,0,0,0
44878,RM-B250A,8/14/2013,0,0,0,0,0,0,0
44879,RM-B250A,8/15/2013,0,0,0,0,0,0,0
44880,RM-B250A,8/16/2013,0,0,0,0,0,0,0
44881,RM-B250A,8/17/2013,0,0,0,0,0,0,0
44882,RM-B250A,8/18/2013,0,0,0,0,0,0,0
44883,RM-B250A,8/19/2013,0,0,0,0,0,0,0
44884,RM-B250A,8/20/2013,0,0,0,0,0,0,0
44885,RM-B250A,8/21/2013,0,0,0,0,0,0,0
44886,RM-B250A,8/22/2013,0,0,0,0,0,0,0
44887,RM-B250A,8/27/2013,0,0,0,0,0,0,0
44888,RM-B250A,8/28/2013,0,0,0,0,0,0,0
44889,RM-B250A,8/29/2013,0,0,0,0,0,0,0
44890,RM-B250A,8/30/2013,0,0,0,0,0,0,0
44891,RM-B250A,9/4/2013,0,0,0,0,0,0,0
44892,RM-B250A,9/5/2013,0,0,0,0,0,0,0
44893,RM-B250A,9/6/2013,0,0,0,0,0,0,0
44894,RM-B250A,9/7/2013,0,0,0,0,0,0,0
44895,RM-B250A,9/9/2013,0,0,0,0,0,0,0
44896,RM-B250A,9/10/2013,0,0,0,0,0,0,0
44897,RM-B250A,9/11/2013,0,0,0,0,0,0,0
44898,RM-B250A,9/12/2013,0,0,0,0,0,0,0
44899,RM-B250A,9/13/2013,0,0,0,0,0,0,0
44900,RM-B250A,9/14/2013,0,0,0,0,0,0,0
44901,RM-B250A,9/15/2013,0,0,0,0,0,0,0
44902,RM-B250A,9/16/2013,0,0,0,0,0,0,0
44903,RM-B250A,9/17/2013,0,0,0,0,0,0,0
44904,RM-B250A,9/18/2013,0,0,0,0,0,0,0
44905,RM-B250A,9/19/2013,0,0,0,0,0,0,0
44906,RM-B250A,9/20/2013,0,0,0,0,0,0,0
44907,RM-B250A,9/21/2013,0,0,0,0,0,0,0
44908,RM-B250A,9/22/2013,0,0,0,0,0,0,0
44909,RM-B250A,9/23/2013,0,0,0,0,0,0,0
44910,RM-B250A,9/24/2013,0,0,0,0,0,0,0
44911,RM-B250A,9/25/2013,0,0,0,0,0,0,0
44912,RM-B250A,9/26/2013,0,0,0,0,0,0,0
44913,RM-B250A,9/27/2013,0,0,0,0,0,0,0
44914,RM-B250A,9/28/2013,0,0,0,0,0,0,0
44915,RM-B250A,9/29/2013,0,0,0,0,0,0,0
44916,RM-B250A,9/30/2013,0,0,0,0,0,0,0
44917,RM-B250A,10/1/2013,0,0,0,0,0,0,0
44918,RM-B250A,10/2/2013,0,0,0,0,0,0,0
44919,RM-B250A,10/3/2013,0,0,0,0,0,0,0
44920,RM-B250A,10/4/2013,0,0,0,0,0,0,0
44921,RM-B250A,10/5/2013,0,0,0,0,0,0,0
44922,RM-B250A,10/6/2013,0,0,0,0,0,0,0
44923,RM-B250A,10/7/2013,0,0,0,0,0,0,0
44924,RM-B250A,10/8/2013,0,0,0,0,0,0,0
44925,RM-B250A,10/9/2013,0,0,0,0,0,0,0
44926,RM-B250A,10/10/2013,0,0,0,0,0,0,0
44927,RM-B250A,10/11/2013,0,0,0,0,0,0,0
44928,RM-B250A,10/12/2013,0,0,0,0,0,0,0
44929,RM-B250A,10/13/2013,0,0,0,0,0,0,0
44930,RM-B250A,10/14/2013,0,0,0,0,0,0,0
44931,RM-B250A,10/15/2013,0,0,0,0,0,0,0
44932,RM-B250A,10/16/2013,0,0,0,0,0,0,0
44933,RM-B250A,10/17/2013,0,0,0,0,0,0,0
44934,RM-B250A,10/18/2013,0,0,0,0,0,0,0
44935,RM-B250A,10/19/2013,0,0,0,0,0,0,0
44936,RM-B250A,10/20/2013,0,0,0,0,0,0,0
44937,RM-B250A,10/21/2013,0,0,0,0,0,0,0
44938,RM-B250A,10/22/2013,0,0,0,0,0,0,0
44939,RM-B250A,10/23/2013,0,0,0,0,0,0,0
44940,RM-B250A,10/24/2013,0,0,0,0,0,0,0
44941,RM-B250A,10/25/2013,0,0,0,0,0,0,0
44942,RM-B250A,10/26/2013,0,0,0,0,0,0,0
44943,RM-B250A,10/27/2013,0,0,0,0,0,0,0
44944,RM-B250A,10/28/2013,0,0,0,0,0,0,0
44945,RM-B250A,10/29/2013,0,0,0,0,0,0,0
44946,RM-B250A,10/30/2013,0,0,0,0,0,0,0
44947,RM-B250A,10/31/2013,0,0,0,0,0,0,0
44948,RM-B250A,11/1/2013,0,0,0,0,0,0,0
44949,RM-B250A,11/2/2013,0,0,0,0,0,0,0
44950,RM-B250A,11/3/2013,0,0,0,0,0,0,0
44951,RM-B250A,11/4/2013,0,0,0,0,0,0,0
44952,RM-B250A,11/5/2013,0,0,0,0,0,0,0
44953,RM-B250A,11/6/2013,0,0,0,0,0,0,0
44954,RM-B250A,11/7/2013,0,0,0,0,0,0,0
44955,RM-B250A,11/8/2013,0,0,0,0,0,0,0
44956,RM-B250A,11/9/2013,0,0,0,0,0,0,0
44957,RM-B250A,11/10/2013,0,0,0,0,0,0,0
44958,RM-B250A,11/11/2013,0,0,0,0,0,0,0
44959,RM-B250A,11/12/2013,0,0,0,0,0,0,0
44960,RM-B250A,11/13/2013,0,0,0,0,0,0,0
44961,RM-B250A,11/14/2013,0,0,0,0,0,0,0
44962,RM-B250A,11/15/2013,0,0,0,0,0,0,0
44963,RM-B250A,11/19/2013,0,0,0,0,0,0,0
44964,RM-B250A,11/20/2013,0,0,0,0,0,0,0
44965,RM-B250A,11/21/2013,0,0,0,0,0,0,0
44966,RM-B250A,11/22/2013,0,0,0,0,0,0,0
44967,RM-B250A,11/23/2013,0,0,0,0,0,0,0
44968,RM-B250A,11/24/2013,0,0,0,0,0,0,0
44969,RM-B250A,11/25/2013,0,0,0,0,0,0,0
44970,RM-B250A,11/26/2013,0,0,0,0,0,0,0
44971,RM-B250A,11/27/2013,0,0,0,0,0,0,0
44972,RM-B250A,11/28/2013,0,0,0,0,0,0,0
44973,RM-B250A,11/29/2013,0,0,0,0,0,0,0
44974,RM-B250A,11/30/2013,0,0,0,0,0,0,0
44975,RM-B250A,12/1/2013,0,0,0,0,0,0,0
44976,RM-B250A,12/2/2013,0,0,0,0,0,0,0
44977,RM-B250A,12/3/2013,0,0,0,0,0,0,0
44978,RM-B250A,12/4/2013,0,0,0,0,0,0,0
44979,RM-B250A,12/5/2013,0,0,0,0,0,0,0
44980,RM-B250A,12/6/2013,0,0,0,0,0,0,0
44981,RM-B250A,12/7/2013,0,0,0,0,0,0,0
44982,RM-B250A,12/8/2013,0,0,0,0,0,0,0
44983,RM-B250A,12/9/2013,0,0,0,0,0,0,0
44984,RM-B250A,12/10/2013,0,0,0,0,0,0,0
44985,RM-B250A,12/11/2013,0,0,0,0,0,0,0
44986,RM-B250A,12/12/2013,0,0,0,0,0,0,0
44987,RM-B250A,12/13/2013,0,0,0,0,0,0,0
44988,RM-B250A,12/14/2013,0,0,0,0,0,0,0
44989,RM-B250A,12/15/2013,0,0,0,0,0,0,0
44990,RM-B250A,12/16/2013,0,0,0,0,0,0,0
44991,RM-B250A,12/17/2013,0,0,0,0,0,0,0
44992,RM-B250A,12/18/2013,0,0,0,0,0,0,0
44993,RM-B250A,12/19/2013,0,0,0,0,0,0,0
44994,RM-B250A,12/20/2013,0,0,0,0,0,0,0
44995,RM-B250A,12/21/2013,0,0,0,0,0,0,0
44996,RM-B250A,12/22/2013,0,0,0,0,0,0,0
44997,RM-B250A,12/23/2013,0,0,0,0,0,0,0
44998,RM-B250A,12/24/2013,0,0,0,0,0,0,0
44999,RM-B250A,12/25/2013,0,0,0,0,0,0,0
45000,RM-B250A,12/26/2013,0,0,0,0,0,0,0
45001,RM-B250A,12/27/2013,0,0,0,0,0,0,0
45002,RM-B250A,12/28/2013,0,0,0,0,0,0,0
45003,RM-B250A,12/29/2013,0,0,0,0,0,0,0
45004,RM-B250A,12/30/2013,0,0,0,0,0,0,0
45005,RM-B250A,12/31/2013,0,0,0,0,0,0,0
45006,RM-B250A,1/1/2014,0,0,0,0,0,0,0
45007,RM-B250A,1/2/2014,0,0,0,0,0,0,0
45008,RM-B250A,1/3/2014,0,0,0,0,0,0,0
45009,RM-B250A,1/4/2014,0,0,0,0,0,0,0
45010,RM-B250A,1/5/2014,0,0,0,0,0,0,0
45011,RM-B250A,1/6/2014,0,0,0,0,0,0,0
45012,RM-B250A,1/7/2014,0,0,0,0,0,0,0
45013,RM-B250A,1/8/2014,0,0,0,0,0,0,0
45014,RM-B250A,1/9/2014,0,0,0,0,0,0,0
45015,RM-B250A,1/10/2014,0,0,0,0,0,0,0
45016,RM-B250A,1/11/2014,0,0,0,0,0,0,0
45017,RM-B250A,1/12/2014,0,0,0,0,0,0,0
45018,RM-B250A,1/13/2014,0,0,0,0,0,0,0
45019,RM-B250A,1/14/2014,0,0,0,0,0,0,0
45020,RM-B250A,1/15/2014,0,0,0,0,0,0,0
45021,RM-B250A,1/16/2014,0,0,0,0,0,0,0
45022,RM-B250A,1/17/2014,0,0,0,0,0,0,0
45023,RM-B250A,1/18/2014,0,0,0,0,0,0,0
45024,RM-B250A,1/19/2014,0,0,0,0,0,0,0
45025,RM-B250A,1/20/2014,0,0,0,0,0,0,0
45026,RM-B250A,1/21/2014,0,0,0,0,0,0,0
45027,RM-B250A,1/22/2014,0,0,0,0,0,0,0
45028,RM-B250A,1/23/2014,0,0,0,0,0,0,0
45029,RM-B250A,1/24/2014,0,0,0,0,0,0,0
45030,RM-B250A,1/25/2014,0,0,0,0,0,0,0
45031,RM-B250A,1/26/2014,0,0,0,0,0,0,0
45032,RM-B250A,1/27/2014,0,0,0,0,0,0,0
45033,RM-B250A,1/28/2014,0,0,0,0,0,0,0
45034,RM-B250A,1/29/2014,0,0,0,0,0,0,0
45035,RM-B250A,1/30/2014,0,0,0,0,0,0,0
45036,RM-B250A,1/31/2014,0,0,0,0,0,0,0
45037,RM-B250A,2/1/2014,0,0,0,0,0,0,0
45038,RM-B250A,2/2/2014,0,0,0,0,0,0,0
45039,RM-B250A,2/3/2014,0,0,0,0,0,0,0
45040,RM-B250A,2/4/2014,0,0,0,0,0,0,0
45041,RM-B250A,2/5/2014,0,0,0,0,0,0,0
45042,RM-B250A,2/6/2014,0,0,0,0,0,0,0
45043,RM-B250A,2/7/2014,0,0,0,0,0,0,0
45044,RM-B250A,2/8/2014,0,0,0,0,0,0,0
45519,RM-B260,7/1/2013,0,0,0,0,0,0,0
45520,RM-B260,7/2/2013,0,0,0,0,0,0,0
45521,RM-B260,7/3/2013,0,0,0,0,0,0,0
45522,RM-B260,7/4/2013,0,0,0,0,0,0,0
45523,RM-B260,7/5/2013,0,0,0,0,0,0,0
45524,RM-B260,7/6/2013,0,0,0,0,0,0,0
45525,RM-B260,7/7/2013,0,0,0,0,0,0,0
45526,RM-B260,7/8/2013,0,0,0,0,0,0,0
45527,RM-B260,7/9/2013,0,0,0,0,0,0,0
45528,RM-B260,7/10/2013,0,0,0,0,0,0,0
45529,RM-B260,7/11/2013,0,0,0,0,0,0,0
45530,RM-B260,7/12/2013,0,0,0,0,0,0,0
45531,RM-B260,7/13/2013,0,0,0,0,0,0,0
45532,RM-B260,7/14/2013,0,0,0,0,0,0,0
45533,RM-B260,7/15/2013,0,0,0,0,0,0,0
45534,RM-B260,7/17/2013,0,0,0,0,0,0,0
45535,RM-B260,7/18/2013,0,0,0,0,0,0,0
45536,RM-B260,7/19/2013,0,0,0,0,0,0,0
45537,RM-B260,7/20/2013,0,0,0,0,0,0,0
45538,RM-B260,7/21/2013,0,0,0,0,0,0,0
45539,RM-B260,7/22/2013,0,0,0,0,0,0,0
45540,RM-B260,7/23/2013,0,0,0,0,0,0,0
45541,RM-B260,7/24/2013,0,0,0,0,0,0,0
45542,RM-B260,7/25/2013,0,0,0,0,0,0,0
45543,RM-B260,7/26/2013,0,0,0,0,0,0,0
45544,RM-B260,7/27/2013,0,0,0,0,0,0,0
45545,RM-B260,7/28/2013,0,0,0,0,0,0,0
45546,RM-B260,7/29/2013,0,0,0,0,0,0,0
45547,RM-B260,7/30/2013,0,0,0,0,0,0,0
45548,RM-B260,7/31/2013,0,0,0,0,0,0,0
45549,RM-B260,8/1/2013,0,0,0,0,0,0,0
45550,RM-B260,8/2/2013,0,0,0,0,0,0,0
45551,RM-B260,8/3/2013,0,0,0,0,0,0,0
45552,RM-B260,8/4/2013,0,0,0,0,0,0,0
45553,RM-B260,8/5/2013,0,0,0,0,0,0,0
45554,RM-B260,8/6/2013,0,0,0,0,0,0,0
45555,RM-B260,8/7/2013,0,0,0,0,0,0,0
45556,RM-B260,8/8/2013,0,0,0,0,0,0,0
45557,RM-B260,8/9/2013,0,0,0,0,0,0,0
45558,RM-B260,8/10/2013,0,0,0,0,0,0,0
45559,RM-B260,8/11/2013,0,0,0,0,0,0,0
45560,RM-B260,8/12/2013,0,0,0,0,0,0,0
45561,RM-B260,8/13/2013,0,0,0,0,0,0,0
45562,RM-B260,8/14/2013,0,0,0,0,0,0,0
45563,RM-B260,8/15/2013,0,0,0,0,0,0,0
45564,RM-B260,8/16/2013,0,0,0,0,0,0,0
45565,RM-B260,8/17/2013,0,0,0,0,0,0,0
45566,RM-B260,8/18/2013,0,0,0,0,0,0,0
45567,RM-B260,8/19/2013,0,0,0,0,0,0,0
45568,RM-B260,8/20/2013,0,0,0,0,0,0,0
45569,RM-B260,8/21/2013,0,0,0,0,0,0,0
45570,RM-B260,8/22/2013,0,0,0,0,0,0,0
45571,RM-B260,8/27/2013,0,0,0,0,0,0,0
45572,RM-B260,8/28/2013,0,0,0,0,0,0,0
45573,RM-B260,8/29/2013,0,0,0,0,0,0,0
45574,RM-B260,8/30/2013,0,0,0,0,0,0,0
45575,RM-B260,9/4/2013,0,0,0,0,0,0,0
45576,RM-B260,9/5/2013,0,0,0,0,0,0,0
45577,RM-B260,9/6/2013,0,0,0,0,0,0,0
45578,RM-B260,9/7/2013,0,0,0,0,0,0,0
45579,RM-B260,9/9/2013,0,0,0,0,0,0,0
45580,RM-B260,9/10/2013,0,0,0,0,0,0,0
45581,RM-B260,9/11/2013,0,0,0,0,0,0,0
45582,RM-B260,9/12/2013,0,0,0,0,0,0,0
45583,RM-B260,9/13/2013,0,0,0,0,0,0,0
45584,RM-B260,9/14/2013,0,0,0,0,0,0,0
45585,RM-B260,9/15/2013,0,0,0,0,0,0,0
45586,RM-B260,9/16/2013,0,0,0,0,0,0,0
45587,RM-B260,9/17/2013,0,0,0,0,0,0,0
45588,RM-B260,9/18/2013,0,0,0,0,0,0,0
45589,RM-B260,9/19/2013,0,0,0,0,0,0,0
45590,RM-B260,9/20/2013,0,0,0,0,0,0,0
45591,RM-B260,9/21/2013,0,0,0,0,0,0,0
45592,RM-B260,9/22/2013,0,0,0,0,0,0,0
45593,RM-B260,9/23/2013,0,0,0,0,0,0,0
45594,RM-B260,9/24/2013,0,0,0,0,0,0,0
45595,RM-B260,9/25/2013,0,0,0,0,0,0,0
45596,RM-B260,9/26/2013,0,0,0,0,0,0,0
45597,RM-B260,9/27/2013,0,0,0,0,0,0,0
45598,RM-B260,9/28/2013,0,0,0,0,0,0,0
45599,RM-B260,9/29/2013,0,0,0,0,0,0,0
45600,RM-B260,9/30/2013,0,0,0,0,0,0,0
45601,RM-B260,10/1/2013,0,0,0,0,0,0,0
45602,RM-B260,10/2/2013,0,0,0,0,0,0,0
45603,RM-B260,10/3/2013,0,0,0,0,0,0,0
45604,RM-B260,10/4/2013,0,0,0,0,0,0,0
45605,RM-B260,10/5/2013,0,0,0,0,0,0,0
45606,RM-B260,10/6/2013,0,0,0,0,0,0,0
45607,RM-B260,10/7/2013,0,0,0,0,0,0,0
45608,RM-B260,10/8/2013,0,0,0,0,0,0,0
45609,RM-B260,10/9/2013,0,0,0,0,0,0,0
45610,RM-B260,10/10/2013,0,0,0,0,0,0,0
45611,RM-B260,10/11/2013,0,0,0,0,0,0,0
45612,RM-B260,10/12/2013,0,0,0,0,0,0,0
45613,RM-B260,10/13/2013,0,0,0,0,0,0,0
45614,RM-B260,10/14/2013,0,0,0,0,0,0,0
45615,RM-B260,10/15/2013,0,0,0,0,0,0,0
45616,RM-B260,10/16/2013,0,0,0,0,0,0,0
45617,RM-B260,10/17/2013,0,0,0,0,0,0,0
45618,RM-B260,10/18/2013,0,0,0,0,0,0,0
45619,RM-B260,10/19/2013,0,0,0,0,0,0,0
45620,RM-B260,10/20/2013,0,0,0,0,0,0,0
45621,RM-B260,10/21/2013,0,0,0,0,0,0,0
45622,RM-B260,10/22/2013,0,0,0,0,0,0,0
45623,RM-B260,10/23/2013,0,0,0,0,0,0,0
45624,RM-B260,10/24/2013,0,0,0,0,0,0,0
45625,RM-B260,10/25/2013,0,0,0,0,0,0,0
45626,RM-B260,10/26/2013,0,0,0,0,0,0,0
45627,RM-B260,10/27/2013,0,0,0,0,0,0,0
45628,RM-B260,10/28/2013,0,0,0,0,0,0,0
45629,RM-B260,10/29/2013,0,0,0,0,0,0,0
45630,RM-B260,10/30/2013,0,0,0,0,0,0,0
45631,RM-B260,10/31/2013,0,0,0,0,0,0,0
45632,RM-B260,11/1/2013,0,0,0,0,0,0,0
45633,RM-B260,11/2/2013,0,0,0,0,0,0,0
45634,RM-B260,11/3/2013,0,0,0,0,0,0,0
45635,RM-B260,11/4/2013,0,0,0,0,0,0,0
45636,RM-B260,11/5/2013,0,0,0,0,0,0,0
45637,RM-B260,11/6/2013,0,0,0,0,0,0,0
45638,RM-B260,11/7/2013,0,0,0,0,0,0,0
45639,RM-B260,11/8/2013,0,0,0,0,0,0,0
45640,RM-B260,11/9/2013,0,0,0,0,0,0,0
45641,RM-B260,11/10/2013,0,0,0,0,0,0,0
45642,RM-B260,11/11/2013,0,0,0,0,0,0,0
45643,RM-B260,11/12/2013,0,0,0,0,0,0,0
45644,RM-B260,11/13/2013,0,0,0,0,0,0,0
45645,RM-B260,11/14/2013,0,0,0,0,0,0,0
45646,RM-B260,11/15/2013,0,0,0,0,0,0,0
45647,RM-B260,11/19/2013,0,0,0,0,0,0,0
45648,RM-B260,11/20/2013,0,0,0,0,0,0,0
45649,RM-B260,11/21/2013,0,0,0,0,0,0,0
45650,RM-B260,11/22/2013,0,0,0,0,0,0,0
45651,RM-B260,11/23/2013,0,0,0,0,0,0,0
45652,RM-B260,11/24/2013,0,0,0,0,0,0,0
45653,RM-B260,11/25/2013,0,0,0,0,0,0,0
45654,RM-B260,11/26/2013,0,0,0,0,0,0,0
45655,RM-B260,11/27/2013,0,0,0,0,0,0,0
45656,RM-B260,11/28/2013,0,0,0,0,0,0,0
45657,RM-B260,11/29/2013,0,0,0,0,0,0,0
45658,RM-B260,11/30/2013,0,0,0,0,0,0,0
45659,RM-B260,12/1/2013,0,0,0,0,0,0,0
45660,RM-B260,12/2/2013,0,0,0,0,0,0,0
45661,RM-B260,12/3/2013,0,0,0,0,0,0,0
45662,RM-B260,12/4/2013,0,0,0,0,0,0,0
45663,RM-B260,12/5/2013,0,0,0,0,0,0,0
45664,RM-B260,12/6/2013,0,0,0,0,0,0,0
45665,RM-B260,12/7/2013,0,0,0,0,0,0,0
45666,RM-B260,12/8/2013,0,0,0,0,0,0,0
45667,RM-B260,12/9/2013,0,0,0,0,0,0,0
45668,RM-B260,12/10/2013,0,0,0,0,0,0,0
45669,RM-B260,12/11/2013,0,0,0,0,0,0,0
45670,RM-B260,12/12/2013,0,0,0,0,0,0,0
45671,RM-B260,12/13/2013,0,0,0,0,0,0,0
45672,RM-B260,12/14/2013,0,0,0,0,0,0,0
45673,RM-B260,12/15/2013,0,0,0,0,0,0,0
45674,RM-B260,12/16/2013,0,0,0,0,0,0,0
45675,RM-B260,12/17/2013,0,0,0,0,0,0,0
45676,RM-B260,12/18/2013,0,0,0,0,0,0,0
45677,RM-B260,12/19/2013,0,0,0,0,0,0,0
45678,RM-B260,12/20/2013,0,0,0,0,0,0,0
45679,RM-B260,12/21/2013,0,0,0,0,0,0,0
45680,RM-B260,12/22/2013,0,0,0,0,0,0,0
45681,RM-B260,12/23/2013,0,0,0,0,0,0,0
45682,RM-B260,12/24/2013,0,0,0,0,0,0,0
45683,RM-B260,12/25/2013,0,0,0,0,0,0,0
45684,RM-B260,12/26/2013,0,0,0,0,0,0,0
45685,RM-B260,12/27/2013,0,0,0,0,0,0,0
45686,RM-B260,12/28/2013,0,0,0,0,0,0,0
45687,RM-B260,12/29/2013,0,0,0,0,0,0,0
45688,RM-B260,12/30/2013,0,0,0,0,0,0,0
45689,RM-B260,12/31/2013,0,0,0,0,0,0,0
45690,RM-B260,1/1/2014,0,0,0,0,0,0,0
45691,RM-B260,1/2/2014,0,0,0,0,0,0,0
45692,RM-B260,1/3/2014,0,0,0,0,0,0,0
45693,RM-B260,1/4/2014,0,0,0,0,0,0,0
45694,RM-B260,1/5/2014,0,0,0,0,0,0,0
45695,RM-B260,1/6/2014,0,0,0,0,0,0,0
45696,RM-B260,1/7/2014,0,0,0,0,0,0,0
45698,RM-B260,1/9/2014,0,0,0,0,0,0,0
45702,RM-B260,1/13/2014,0,0,0,0,0,0,0
45703,RM-B260,1/14/2014,0,0,0,0,0,0,0
46204,RM-B260A,7/1/2013,0,0,0,0,0,0,0
46205,RM-B260A,7/2/2013,0,0,0,0,0,0,0
46206,RM-B260A,7/3/2013,0,0,0,0,0,0,0
46207,RM-B260A,7/4/2013,0,0,0,0,0,0,0
46208,RM-B260A,7/5/2013,0,0,0,0,0,0,0
46209,RM-B260A,7/6/2013,0,0,0,0,0,0,0
46210,RM-B260A,7/7/2013,0,0,0,0,0,0,0
46211,RM-B260A,7/8/2013,0,0,0,0,0,0,0
46212,RM-B260A,7/9/2013,0,0,0,0,0,0,0
46213,RM-B260A,7/10/2013,0,0,0,0,0,0,0
46214,RM-B260A,7/11/2013,0,0,0,0,0,0,0
46215,RM-B260A,7/12/2013,0,0,0,0,0,0,0
46216,RM-B260A,7/13/2013,0,0,0,0,0,0,0
46217,RM-B260A,7/14/2013,0,0,0,0,0,0,0
46218,RM-B260A,7/15/2013,0,0,0,0,0,0,0
46219,RM-B260A,7/17/2013,0,0,0,0,0,0,0
46220,RM-B260A,7/18/2013,0,0,0,0,0,0,0
46221,RM-B260A,7/19/2013,0,0,0,0,0,0,0
46222,RM-B260A,7/20/2013,0,0,0,0,0,0,0
46223,RM-B260A,7/21/2013,0,0,0,0,0,0,0
46224,RM-B260A,7/22/2013,0,0,0,0,0,0,0
46225,RM-B260A,7/23/2013,0,0,0,0,0,0,0
46226,RM-B260A,7/24/2013,0,0,0,0,0,0,0
46227,RM-B260A,7/25/2013,0,0,0,0,0,0,0
46228,RM-B260A,7/26/2013,0,0,0,0,0,0,0
46229,RM-B260A,7/27/2013,0,0,0,0,0,0,0
46230,RM-B260A,7/28/2013,0,0,0,0,0,0,0
46231,RM-B260A,7/29/2013,0,0,0,0,0,0,0
46232,RM-B260A,7/30/2013,0,0,0,0,0,0,0
46233,RM-B260A,7/31/2013,0,0,0,0,0,0,0
46234,RM-B260A,8/1/2013,0,0,0,0,0,0,0
46235,RM-B260A,8/2/2013,0,0,0,0,0,0,0
46236,RM-B260A,8/3/2013,0,0,0,0,0,0,0
46237,RM-B260A,8/4/2013,0,0,0,0,0,0,0
46238,RM-B260A,8/5/2013,0,0,0,0,0,0,0
46239,RM-B260A,8/6/2013,0,0,0,0,0,0,0
46240,RM-B260A,8/7/2013,0,0,0,0,0,0,0
46241,RM-B260A,8/8/2013,0,0,0,0,0,0,0
46242,RM-B260A,8/9/2013,0,0,0,0,0,0,0
46243,RM-B260A,8/10/2013,0,0,0,0,0,0,0
46244,RM-B260A,8/11/2013,0,0,0,0,0,0,0
46245,RM-B260A,8/12/2013,0,0,0,0,0,0,0
46246,RM-B260A,8/13/2013,0,0,0,0,0,0,0
46247,RM-B260A,8/14/2013,0,0,0,0,0,0,0
46248,RM-B260A,8/15/2013,0,0,0,0,0,0,0
46249,RM-B260A,8/16/2013,0,0,0,0,0,0,0
46250,RM-B260A,8/17/2013,0,0,0,0,0,0,0
46251,RM-B260A,8/18/2013,0,0,0,0,0,0,0
46252,RM-B260A,8/19/2013,0,0,0,0,0,0,0
46253,RM-B260A,8/20/2013,0,0,0,0,0,0,0
46254,RM-B260A,8/21/2013,0,0,0,0,0,0,0
46255,RM-B260A,8/22/2013,0,0,0,0,0,0,0
46256,RM-B260A,8/27/2013,0,0,0,0,0,0,0
46257,RM-B260A,8/28/2013,0,0,0,0,0,0,0
46258,RM-B260A,8/29/2013,0,0,0,0,0,0,0
46259,RM-B260A,8/30/2013,0,0,0,0,0,0,0
46260,RM-B260A,9/4/2013,0,0,0,0,0,0,0
46261,RM-B260A,9/5/2013,0,0,0,0,0,0,0
46262,RM-B260A,9/6/2013,0,0,0,0,0,0,0
46263,RM-B260A,9/7/2013,0,0,0,0,0,0,0
46264,RM-B260A,9/9/2013,0,0,0,0,0,0,0
46265,RM-B260A,9/10/2013,0,0,0,0,0,0,0
46266,RM-B260A,9/11/2013,0,0,0,0,0,0,0
46267,RM-B260A,9/12/2013,0,0,0,0,0,0,0
46268,RM-B260A,9/13/2013,0,0,0,0,0,0,0
46269,RM-B260A,9/14/2013,0,0,0,0,0,0,0
46270,RM-B260A,9/15/2013,0,0,0,0,0,0,0
46271,RM-B260A,9/16/2013,0,0,0,0,0,0,0
46272,RM-B260A,9/17/2013,0,0,0,0,0,0,0
46273,RM-B260A,9/18/2013,0,0,0,0,0,0,0
46274,RM-B260A,9/19/2013,0,0,0,0,0,0,0
46275,RM-B260A,9/20/2013,0,0,0,0,0,0,0
46276,RM-B260A,9/21/2013,0,0,0,0,0,0,0
46277,RM-B260A,9/22/2013,0,0,0,0,0,0,0
46278,RM-B260A,9/23/2013,0,0,0,0,0,0,0
46279,RM-B260A,9/24/2013,0,0,0,0,0,0,0
46280,RM-B260A,9/25/2013,0,0,0,0,0,0,0
46281,RM-B260A,9/26/2013,0,0,0,0,0,0,0
46282,RM-B260A,9/27/2013,0,0,0,0,0,0,0
46283,RM-B260A,9/28/2013,0,0,0,0,0,0,0
46284,RM-B260A,9/29/2013,0,0,0,0,0,0,0
46285,RM-B260A,9/30/2013,0,0,0,0,0,0,0
46286,RM-B260A,10/1/2013,0,0,0,0,0,0,0
46287,RM-B260A,10/2/2013,0,0,0,0,0,0,0
46288,RM-B260A,10/3/2013,0,0,0,0,0,0,0
46289,RM-B260A,10/4/2013,0,0,0,0,0,0,0
46290,RM-B260A,10/5/2013,0,0,0,0,0,0,0
46291,RM-B260A,10/6/2013,0,0,0,0,0,0,0
46292,RM-B260A,10/7/2013,0,0,0,0,0,0,0
46293,RM-B260A,10/8/2013,0,0,0,0,0,0,0
46294,RM-B260A,10/9/2013,0,0,0,0,0,0,0
46295,RM-B260A,10/10/2013,0,0,0,0,0,0,0
46296,RM-B260A,10/11/2013,0,0,0,0,0,0,0
46297,RM-B260A,10/12/2013,0,0,0,0,0,0,0
46298,RM-B260A,10/13/2013,0,0,0,0,0,0,0
46299,RM-B260A,10/14/2013,0,0,0,0,0,0,0
46300,RM-B260A,10/15/2013,0,0,0,0,0,0,0
46301,RM-B260A,10/16/2013,0,0,0,0,0,0,0
46302,RM-B260A,10/17/2013,0,0,0,0,0,0,0
46303,RM-B260A,10/18/2013,0,0,0,0,0,0,0
46304,RM-B260A,10/19/2013,0,0,0,0,0,0,0
46305,RM-B260A,10/20/2013,0,0,0,0,0,0,0
46306,RM-B260A,10/21/2013,0,0,0,0,0,0,0
46307,RM-B260A,10/22/2013,0,0,0,0,0,0,0
46308,RM-B260A,10/23/2013,0,0,0,0,0,0,0
46309,RM-B260A,10/24/2013,0,0,0,0,0,0,0
46310,RM-B260A,10/25/2013,0,0,0,0,0,0,0
46311,RM-B260A,10/26/2013,0,0,0,0,0,0,0
46312,RM-B260A,10/27/2013,0,0,0,0,0,0,0
46313,RM-B260A,10/28/2013,0,0,0,0,0,0,0
46314,RM-B260A,10/29/2013,0,0,0,0,0,0,0
46315,RM-B260A,10/30/2013,0,0,0,0,0,0,0
46316,RM-B260A,10/31/2013,0,0,0,0,0,0,0
46317,RM-B260A,11/1/2013,0,0,0,0,0,0,0
46318,RM-B260A,11/2/2013,0,0,0,0,0,0,0
46319,RM-B260A,11/3/2013,0,0,0,0,0,0,0
46320,RM-B260A,11/4/2013,0,0,0,0,0,0,0
46321,RM-B260A,11/5/2013,0,0,0,0,0,0,0
46322,RM-B260A,11/6/2013,0,0,0,0,0,0,0
46323,RM-B260A,11/7/2013,0,0,0,0,0,0,0
46324,RM-B260A,11/8/2013,0,0,0,0,0,0,0
46325,RM-B260A,11/9/2013,0,0,0,0,0,0,0
46326,RM-B260A,11/10/2013,0,0,0,0,0,0,0
46327,RM-B260A,11/11/2013,0,0,0,0,0,0,0
46328,RM-B260A,11/12/2013,0,0,0,0,0,0,0
46329,RM-B260A,11/13/2013,0,0,0,0,0,0,0
46330,RM-B260A,11/14/2013,0,0,0,0,0,0,0
46331,RM-B260A,11/15/2013,0,0,0,0,0,0,0
46332,RM-B260A,11/19/2013,0,0,0,0,0,0,0
46333,RM-B260A,11/20/2013,0,0,0,0,0,0,0
46334,RM-B260A,11/21/2013,0,0,0,0,0,0,0
46335,RM-B260A,11/22/2013,0,0,0,0,0,0,0
46336,RM-B260A,11/23/2013,0,0,0,0,0,0,0
46337,RM-B260A,11/24/2013,0,0,0,0,0,0,0
46338,RM-B260A,11/25/2013,0,0,0,0,0,0,0
46339,RM-B260A,11/26/2013,0,0,0,0,0,0,0
46340,RM-B260A,11/27/2013,0,0,0,0,0,0,0
46341,RM-B260A,11/28/2013,0,0,0,0,0,0,0
46342,RM-B260A,11/29/2013,0,0,0,0,0,0,0
46343,RM-B260A,11/30/2013,0,0,0,0,0,0,0
46344,RM-B260A,12/1/2013,0,0,0,0,0,0,0
46345,RM-B260A,12/2/2013,0,0,0,0,0,0,0
46346,RM-B260A,12/3/2013,0,0,0,0,0,0,0
46347,RM-B260A,12/4/2013,0,0,0,0,0,0,0
46348,RM-B260A,12/5/2013,0,0,0,0,0,0,0
46349,RM-B260A,12/6/2013,0,0,0,0,0,0,0
46350,RM-B260A,12/7/2013,0,0,0,0,0,0,0
46351,RM-B260A,12/8/2013,0,0,0,0,0,0,0
46352,RM-B260A,12/9/2013,0,0,0,0,0,0,0
46353,RM-B260A,12/10/2013,0,0,0,0,0,0,0
46354,RM-B260A,12/11/2013,0,0,0,0,0,0,0
46355,RM-B260A,12/12/2013,0,0,0,0,0,0,0
46356,RM-B260A,12/13/2013,0,0,0,0,0,0,0
46357,RM-B260A,12/14/2013,0,0,0,0,0,0,0
46358,RM-B260A,12/15/2013,0,0,0,0,0,0,0
46359,RM-B260A,12/16/2013,0,0,0,0,0,0,0
46360,RM-B260A,12/17/2013,0,0,0,0,0,0,0
46361,RM-B260A,12/18/2013,0,0,0,0,0,0,0
46362,RM-B260A,12/19/2013,0,0,0,0,0,0,0
46363,RM-B260A,12/20/2013,0,0,0,0,0,0,0
46364,RM-B260A,12/21/2013,0,0,0,0,0,0,0
46365,RM-B260A,12/22/2013,0,0,0,0,0,0,0
46366,RM-B260A,12/23/2013,0,0,0,0,0,0,0
46367,RM-B260A,12/24/2013,0,0,0,0,0,0,0
46368,RM-B260A,12/25/2013,0,0,0,0,0,0,0
46369,RM-B260A,12/26/2013,0,0,0,0,0,0,0
46370,RM-B260A,12/27/2013,0,0,0,0,0,0,0
46371,RM-B260A,12/28/2013,0,0,0,0,0,0,0
46372,RM-B260A,12/29/2013,0,0,0,0,0,0,0
46373,RM-B260A,12/30/2013,0,0,0,0,0,0,0
46374,RM-B260A,12/31/2013,0,0,0,0,0,0,0
46375,RM-B260A,1/1/2014,0,0,0,0,0,0,0
46376,RM-B260A,1/2/2014,0,0,0,0,0,0,0
46377,RM-B260A,1/3/2014,0,0,0,0,0,0,0
46378,RM-B260A,1/4/2014,0,0,0,0,0,0,0
46379,RM-B260A,1/5/2014,0,0,0,0,0,0,0
46380,RM-B260A,1/6/2014,0,0,0,0,0,0,0
46381,RM-B260A,1/7/2014,0,0,0,0,0,0,0
46382,RM-B260A,1/8/2014,0,0,0,0,0,0,0
46383,RM-B260A,1/9/2014,0,0,0,0,0,0,0
46384,RM-B260A,1/10/2014,0,0,0,0,0,0,0
46385,RM-B260A,1/11/2014,0,0,0,0,0,0,0
46386,RM-B260A,1/12/2014,0,0,0,0,0,0,0
46387,RM-B260A,1/13/2014,0,0,0,0,0,0,0
46388,RM-B260A,1/14/2014,0,0,0,0,0,0,0
46389,RM-B260A,1/15/2014,0,0,0,0,0,0,0
46390,RM-B260A,1/16/2014,0,0,0,0,0,0,0
46391,RM-B260A,1/17/2014,0,0,0,0,0,0,0
46392,RM-B260A,1/18/2014,0,0,0,0,0,0,0
46393,RM-B260A,1/19/2014,0,0,0,0,0,0,0
46394,RM-B260A,1/20/2014,0,0,0,0,0,0,0
46395,RM-B260A,1/21/2014,0,0,0,0,0,0,0
46396,RM-B260A,1/22/2014,0,0,0,0,0,0,0
46397,RM-B260A,1/23/2014,0,0,0,0,0,0,0
46398,RM-B260A,1/24/2014,0,0,0,0,0,0,0
46399,RM-B260A,1/25/2014,0,0,0,0,0,0,0
46400,RM-B260A,1/26/2014,0,0,0,0,0,0,0
46401,RM-B260A,1/27/2014,0,0,0,0,0,0,0
46402,RM-B260A,1/28/2014,0,0,0,0,0,0,0
46403,RM-B260A,1/29/2014,0,0,0,0,0,0,0
46404,RM-B260A,1/30/2014,0,0,0,0,0,0,0
46405,RM-B260A,1/31/2014,0,0,0,0,0,0,0
46406,RM-B260A,2/1/2014,0,0,0,0,0,0,0
46407,RM-B260A,2/2/2014,0,0,0,0,0,0,0
46408,RM-B260A,2/3/2014,0,0,0,0,0,0,0
46409,RM-B260A,2/4/2014,0,0,0,0,0,0,0
46410,RM-B260A,2/5/2014,0,0,0,0,0,0,0
46411,RM-B260A,2/6/2014,0,0,0,0,0,0,0
46412,RM-B260A,2/7/2014,0,0,0,0,0,0,0
46413,RM-B260A,2/8/2014,0,0,0,0,0,0,0
46414,RM-B260A,2/9/2014,0,0,0,0,0,0,0
46415,RM-B260A,2/10/2014,0,0,0,0,0,0,0
46416,RM-B260A,2/11/2014,0,0,0,0,0,0,0
46417,RM-B260A,2/12/2014,0,0,0,0,0,0,0
46418,RM-B260A,2/13/2014,0,0,0,0,0,0,0
46419,RM-B260A,2/14/2014,0,0,0,0,0,0,0
46420,RM-B260A,2/15/2014,0,0,0,0,0,0,0
46421,RM-B260A,2/16/2014,0,0,0,0,0,0,0
46422,RM-B260A,2/17/2014,0,0,0,0,0,0,0
46423,RM-B260A,2/18/2014,0,0,0,0,0,0,0
46424,RM-B260A,2/19/2014,0,0,0,0,0,0,0
46425,RM-B260A,2/20/2014,0,0,0,0,0,0,0
46426,RM-B260A,2/21/2014,0,0,0,0,0,0,0
46427,RM-B260A,2/22/2014,0,0,0,0,0,0,0
46428,RM-B260A,2/23/2014,0,0,0,0,0,0,0
46429,RM-B260A,2/24/2014,0,0,0,0,0,0,0
46430,RM-B260A,2/25/2014,0,0,0,0,0,0,0
46431,RM-B260A,2/26/2014,0,0,0,0,0,0,0
46432,RM-B260A,2/27/2014,0,0,0,0,0,0,0
46433,RM-B260A,2/28/2014,0,0,0,0,0,0,0
46434,RM-B260A,3/1/2014,0,0,0,0,0,0,0
46435,RM-B260A,3/2/2014,0,0,0,0,0,0,0
46436,RM-B260A,3/3/2014,0,0,0,0,0,0,0
46437,RM-B260A,3/4/2014,0,0,0,0,0,0,0
46438,RM-B260A,3/5/2014,0,0,0,0,0,0,0
46439,RM-B260A,3/6/2014,0,0,0,0,0,0,0
46440,RM-B260A,3/7/2014,0,0,0,0,0,0,0
46441,RM-B260A,3/8/2014,0,0,0,0,0,0,0
46442,RM-B260A,3/9/2014,0,0,0,0,0,0,0
46443,RM-B260A,3/10/2014,0,0,0,0,0,0,0
46444,RM-B260A,3/11/2014,0,0,0,0,0,0,0
46445,RM-B260A,3/12/2014,0,0,0,0,0,0,0
46446,RM-B260A,3/13/2014,0,0,0,0,0,0,0
46447,RM-B260A,3/14/2014,0,0,0,0,0,0,0
46448,RM-B260A,3/15/2014,0,0,0,0,0,0,0
46449,RM-B260A,3/16/2014,0,0,0,0,0,0,0
46450,RM-B260A,3/17/2014,0,0,0,0,0,0,0
46451,RM-B260A,3/18/2014,0,0,0,0,0,0,0
46452,RM-B260A,3/19/2014,0,0,0,0,0,0,0
46453,RM-B260A,3/20/2014,0,0,0,0,0,0,0
46454,RM-B260A,3/21/2014,0,0,0,0,0,0,0
46455,RM-B260A,3/22/2014,0,0,0,0,0,0,0
46456,RM-B260A,3/23/2014,0,0,0,0,0,0,0
46457,RM-B260A,3/24/2014,0,0,0,0,0,0,0
46458,RM-B260A,3/25/2014,0,0,0,0,0,0,0
46459,RM-B260A,3/26/2014,0,0,0,0,0,0,0
46460,RM-B260A,3/27/2014,0,0,0,0,0,0,0
46461,RM-B260A,3/28/2014,0,0,0,0,0,0,0
46462,RM-B260A,3/29/2014,0,0,0,0,0,0,0
46463,RM-B260A,3/30/2014,0,0,0,0,0,0,0
46464,RM-B260A,3/31/2014,0,0,0,0,0,0,0
46465,RM-B260A,4/1/2014,0,0,0,0,0,0,0
46466,RM-B260A,4/2/2014,0,0,0,0,0,0,0
46467,RM-B260A,4/3/2014,0,0,0,0,0,0,0
46468,RM-B260A,4/4/2014,0,0,0,0,0,0,0
46469,RM-B260A,4/5/2014,0,0,0,0,0,0,0
46470,RM-B260A,4/6/2014,0,0,0,0,0,0,0
46471,RM-B260A,4/7/2014,0,0,0,0,0,0,0
46472,RM-B260A,4/8/2014,0,0,0,0,0,0,0
46473,RM-B260A,4/9/2014,0,0,0,0,0,0,0
46474,RM-B260A,4/10/2014,0,0,0,0,0,0,0
46475,RM-B260A,4/11/2014,0,0,0,0,0,0,0
46476,RM-B260A,4/12/2014,0,0,0,0,0,0,0
46477,RM-B260A,4/13/2014,0,0,0,0,0,0,0
46478,RM-B260A,4/14/2014,0,0,0,0,0,0,0
46479,RM-B260A,4/15/2014,0,0,0,0,0,0,0
46480,RM-B260A,4/16/2014,0,0,0,0,0,0,0
46481,RM-B260A,4/17/2014,0,0,0,0,0,0,0
46482,RM-B260A,4/18/2014,0,0,0,0,0,0,0
46483,RM-B260A,4/19/2014,0,0,0,0,0,0,0
46484,RM-B260A,4/20/2014,0,0,0,0,0,0,0
46485,RM-B260A,4/21/2014,0,0,0,0,0,0,0
46486,RM-B260A,4/22/2014,0,0,0,0,0,0,0
46487,RM-B260A,4/23/2014,0,0,0,0,0,0,0
46488,RM-B260A,4/24/2014,0,0,0,0,0,0,0
46489,RM-B260A,4/25/2014,0,0,0,0,0,0,0
46490,RM-B260A,4/26/2014,0,0,0,0,0,0,0
46491,RM-B260A,4/27/2014,0,0,0,0,0,0,0
46492,RM-B260A,4/28/2014,0,0,0,0,0,0,0
46493,RM-B260A,4/29/2014,0,0,0,0,0,0,0
46494,RM-B260A,4/30/2014,0,0,0,0,0,0,0
46495,RM-B260A,5/1/2014,0,0,0,0,0,0,0
46496,RM-B260A,5/2/2014,0,0,0,0,0,0,0
46497,RM-B260A,5/3/2014,0,0,0,0,0,0,0
46498,RM-B260A,5/4/2014,0,0,0,0,0,0,0
46499,RM-B260A,5/5/2014,0,0,0,0,0,0,0
46500,RM-B260A,5/6/2014,0,0,0,0,0,0,0
46501,RM-B260A,5/7/2014,0,0,0,0,0,0,0
46502,RM-B260A,5/8/2014,0,0,0,0,0,0,0
46503,RM-B260A,5/9/2014,0,0,0,0,0,0,0
46504,RM-B260A,5/10/2014,0,0,0,0,0,0,0
46505,RM-B260A,5/11/2014,0,0,0,0,0,0,0
46506,RM-B260A,5/12/2014,0,0,0,0,0,0,0
46507,RM-B260A,5/13/2014,0,0,0,0,0,0,0
46508,RM-B260A,5/14/2014,0,0,0,0,0,0,0
46509,RM-B260A,5/15/2014,0,0,0,0,0,0,0
46510,RM-B260A,5/16/2014,0,0,0,0,0,0,0
46511,RM-B260A,5/17/2014,0,0,0,0,0,0,0
46512,RM-B260A,5/18/2014,0,0,0,0,0,0,0
46513,RM-B260A,5/19/2014,0,0,0,0,0,0,0
46514,RM-B260A,5/20/2014,0,0,0,0,0,0,0
46515,RM-B260A,5/21/2014,0,0,0,0,0,0,0
46516,RM-B260A,5/22/2014,0,0,0,0,0,0,0
46517,RM-B260A,5/23/2014,0,0,0,0,0,0,0
46518,RM-B260A,5/24/2014,0,0,0,0,0,0,0
46519,RM-B260A,5/25/2014,0,0,0,0,0,0,0
46520,RM-B260A,5/26/2014,0,0,0,0,0,0,0
46521,RM-B260A,5/27/2014,0,0,0,0,0,0,0
46522,RM-B260A,5/28/2014,0,0,0,0,0,0,0
46523,RM-B260A,5/29/2014,0,0,0,0,0,0,0
46524,RM-B260A,5/30/2014,0,0,0,0,0,0,0
46525,RM-B260A,5/31/2014,0,0,0,0,0,0,0
46526,RM-B260A,6/1/2014,0,0,0,0,0,0,0
46527,RM-B260A,6/2/2014,0,0,0,0,0,0,0
46528,RM-B260A,6/3/2014,0,0,0,0,0,0,0
46529,RM-B260A,6/4/2014,0,0,0,0,0,0,0
46530,RM-B260A,6/5/2014,0,0,0,0,0,0,0
46531,RM-B260A,6/6/2014,0,0,0,0,0,0,0
46532,RM-B260A,6/7/2014,0,0,0,0,0,0,0
46533,RM-B260A,6/8/2014,0,0,0,0,0,0,0
46534,RM-B260A,6/9/2014,0,0,0,0,0,0,0
46535,RM-B260A,6/10/2014,0,0,0,0,0,0,0
46536,RM-B260A,6/11/2014,0,0,0,0,0,0,0
46537,RM-B260A,6/12/2014,0,0,0,0,0,0,0
46538,RM-B260A,6/13/2014,0,0,0,0,0,0,0
46539,RM-B260A,6/14/2014,0,0,0,0,0,0,0
46540,RM-B260A,6/15/2014,0,0,0,0,0,0,0
46541,RM-B260A,6/16/2014,0,0,0,0,0,0,0
46542,RM-B260A,6/17/2014,0,0,0,0,0,0,0
46543,RM-B260A,6/18/2014,0,0,0,0,0,0,0
46544,RM-B260A,6/19/2014,0,0,0,0,0,0,0
46545,RM-B260A,6/20/2014,0,0,0,0,0,0,0
46546,RM-B260A,6/21/2014,0,0,0,0,0,0,0
46547,RM-B260A,6/22/2014,0,0,0,0,0,0,0
46548,RM-B260A,6/23/2014,0,0,0,0,0,0,0
46549,RM-B260A,6/24/2014,0,0,0,0,0,0,0
46550,RM-B260A,6/25/2014,0,0,0,0,0,0,0
46551,RM-B260A,6/26/2014,0,0,0,0,0,0,0
46552,RM-B260A,6/27/2014,0,0,0,0,0,0,0
46553,RM-B260A,6/28/2014,0,0,0,0,0,0,0
46554,RM-B260A,6/29/2014,0,0,0,0,0,0,0
46555,RM-B260A,6/30/2014,0,0,0,0,0,0,0
46556,RM-B260A,7/1/2014,0,0,0,0,0,0,0
46557,RM-B260A,7/2/2014,0,0,0,0,0,0,0
46558,RM-B260A,7/3/2014,0,0,0,0,0,0,0
46559,RM-B260A,7/4/2014,0,0,0,0,0,0,0
46560,RM-B260A,7/5/2014,0,0,0,0,0,0,0
46561,RM-B260A,7/6/2014,0,0,0,0,0,0,0
46562,RM-B260A,7/7/2014,0,0,0,0,0,0,0
46563,RM-B260A,7/8/2014,0,0,0,0,0,0,0
46564,RM-B260A,7/9/2014,0,0,0,0,0,0,0
46565,RM-B260A,7/10/2014,0,0,0,0,0,0,0
46566,RM-B260A,7/11/2014,0,0,0,0,0,0,0
46567,RM-B260A,7/12/2014,0,0,0,0,0,0,0
46568,RM-B260A,7/13/2014,0,0,0,0,0,0,0
46569,RM-B260A,7/14/2014,0,0,0,0,0,0,0
46570,RM-B260A,7/15/2014,0,0,0,0,0,0,0
46571,RM-B260A,7/16/2014,0,0,0,0,0,0,0
46572,RM-B260A,7/17/2014,0,0,0,0,0,0,0
46573,RM-B260A,7/18/2014,0,0,0,0,0,0,0
46574,RM-B260A,7/19/2014,0,0,0,0,0,0,0
46575,RM-B260A,7/20/2014,0,0,0,0,0,0,0
46576,RM-B260A,7/21/2014,0,0,0,0,0,0,0
46577,RM-B260A,7/22/2014,0,0,0,0,0,0,0
46578,RM-B260A,7/23/2014,0,0,0,0,0,0,0
46579,RM-B260A,7/24/2014,0,0,0,0,0,0,0
46580,RM-B260A,7/25/2014,0,0,0,0,0,0,0
46581,RM-B260A,7/26/2014,0,0,0,0,0,0,0
46582,RM-B260A,7/27/2014,0,0,0,0,0,0,0
46583,RM-B260A,7/28/2014,0,0,0,0,0,0,0
46584,RM-B260A,7/29/2014,0,0,0,0,0,0,0
46585,RM-B260A,7/30/2014,0,0,0,0,0,0,0
46586,RM-B260A,7/31/2014,0,0,0,0,0,0,0
46587,RM-B260A,8/1/2014,0,0,0,0,0,0,0
46588,RM-B260A,8/2/2014,0,0,0,0,0,0,0
46589,RM-B260A,8/3/2014,0,0,0,0,0,0,0
46590,RM-B260A,8/4/2014,0,0,0,0,0,0,0
46591,RM-B260A,8/5/2014,0,0,0,0,0,0,0
46592,RM-B260A,8/6/2014,0,0,0,0,0,0,0
46593,RM-B260A,8/7/2014,0,0,0,0,0,0,0
46594,RM-B260A,8/8/2014,0,0,0,0,0,0,0
46595,RM-B260A,8/9/2014,0,0,0,0,0,0,0
46596,RM-B260A,8/10/2014,0,0,0,0,0,0,0
46597,RM-B260A,8/11/2014,0,0,0,0,0,0,0
46598,RM-B260A,8/12/2014,0,0,0,0,0,0,0
46599,RM-B260A,8/13/2014,0,0,0,0,0,0,0
46600,RM-B260A,8/14/2014,0,0,0,0,0,0,0
46601,RM-B260A,8/15/2014,0,0,0,0,0,0,0
46602,RM-B260A,8/16/2014,0,0,0,0,0,0,0
46603,RM-B260A,8/17/2014,0,0,0,0,0,0,0
46604,RM-B260A,8/18/2014,0,0,0,0,0,0,0
46605,RM-B260A,8/19/2014,0,0,0,0,0,0,0
46606,RM-B260A,8/20/2014,0,0,0,0,0,0,0
46607,RM-B260A,8/21/2014,0,0,0,0,0,0,0
46608,RM-B260A,8/22/2014,0,0,0,0,0,0,0
46609,RM-B260A,8/23/2014,0,0,0,0,0,0,0
46610,RM-B260A,8/24/2014,0,0,0,0,0,0,0
46611,RM-B260A,8/25/2014,0,0,0,0,0,0,0
46612,RM-B260A,8/26/2014,0,0,0,0,0,0,0
46613,RM-B260A,8/27/2014,0,0,0,0,0,0,0
46614,RM-B260A,8/28/2014,0,0,0,0,0,0,0
46615,RM-B260A,8/29/2014,0,0,0,0,0,0,0
46616,RM-B260A,8/30/2014,0,0,0,0,0,0,0
46617,RM-B260A,8/31/2014,0,0,0,0,0,0,0
46618,RM-B260A,9/1/2014,0,0,0,0,0,0,0
46619,RM-B260A,9/2/2014,0,0,0,0,0,0,0
46620,RM-B260A,9/3/2014,0,0,0,0,0,0,0
46621,RM-B260A,9/4/2014,0,0,0,0,0,0,0
46622,RM-B260A,9/5/2014,0,0,0,0,0,0,0
46623,RM-B260A,9/6/2014,0,0,0,0,0,0,0
46624,RM-B260A,9/7/2014,0,0,0,0,0,0,0
46625,RM-B260A,9/8/2014,0,0,0,0,0,0,0
46626,RM-B260A,9/9/2014,0,0,0,0,0,0,0
46627,RM-B260A,9/10/2014,0,0,0,0,0,0,0
46628,RM-B260A,9/11/2014,0,0,0,0,0,0,0
46629,RM-B260A,9/12/2014,0,0,0,0,0,0,0
46630,RM-B260A,9/13/2014,0,0,0,0,0,0,0
46631,RM-B260A,9/14/2014,0,0,0,0,0,0,0
46632,RM-B260A,9/15/2014,0,0,0,0,0,0,0
46633,RM-B260A,9/16/2014,0,0,0,0,0,0,0
46634,RM-B260A,9/17/2014,0,0,0,0,0,0,0
46635,RM-B260A,9/18/2014,0,0,0,0,0,0,0
46636,RM-B260A,9/19/2014,0,0,0,0,0,0,0
46637,RM-B260A,9/20/2014,0,0,0,0,0,0,0
46638,RM-B260A,9/21/2014,0,0,0,0,0,0,0
46639,RM-B260A,9/22/2014,0,0,0,0,0,0,0
46640,RM-B260A,9/23/2014,0,0,0,0,0,0,0
46641,RM-B260A,9/24/2014,0,0,0,0,0,0,0
46642,RM-B260A,9/25/2014,0,0,0,0,0,0,0
46643,RM-B260A,9/28/2014,0,0,0,0,0,0,0
46644,RM-B260A,9/29/2014,0,0,0,0,0,0,0
46645,RM-B260A,9/30/2014,0,0,0,0,0,0,0
46646,RM-B260A,10/1/2014,0,0,0,0,0,0,0
46647,RM-B260A,10/2/2014,0,0,0,0,0,0,0
46648,RM-B260A,10/3/2014,0,0,0,0,0,0,0
46649,RM-B260A,10/4/2014,0,0,0,0,0,0,0
46650,RM-B260A,10/5/2014,0,0,0,0,0,0,0
46651,RM-B260A,10/6/2014,0,0,0,0,0,0,0
46652,RM-B260A,10/7/2014,0,0,0,0,0,0,0
46653,RM-B260A,10/8/2014,0,0,0,0,0,0,0
46654,RM-B260A,10/9/2014,0,0,0,0,0,0,0
46655,RM-B260A,10/10/2014,0,0,0,0,0,0,0
46656,RM-B260A,10/11/2014,0,0,0,0,0,0,0
46657,RM-B260A,10/12/2014,0,0,0,0,0,0,0
46658,RM-B260A,10/13/2014,0,0,0,0,0,0,0
46659,RM-B260A,10/14/2014,0,0,0,0,0,0,0
46660,RM-B260A,10/15/2014,0,0,0,0,0,0,0
46661,RM-B260A,10/16/2014,0,0,0,0,0,0,0
46662,RM-B260A,10/17/2014,0,0,0,0,0,0,0
46663,RM-B260A,10/18/2014,0,0,0,0,0,0,0
46664,RM-B260A,10/19/2014,0,0,0,0,0,0,0
46665,RM-B260A,10/20/2014,0,0,0,0,0,0,0
46666,RM-B260A,10/21/2014,0,0,0,0,0,0,0
46667,RM-B260A,10/22/2014,0,0,0,0,0,0,0
46668,RM-B260A,10/23/2014,0,0,0,0,0,0,0
46669,RM-B260A,10/24/2014,0,0,0,0,0,0,0
46670,RM-B260A,10/25/2014,0,0,0,0,0,0,0
46671,RM-B260A,10/26/2014,0,0,0,0,0,0,0
46672,RM-B260A,10/27/2014,0,0,0,0,0,0,0
46673,RM-B260A,10/28/2014,0,0,0,0,0,0,0
46674,RM-B260A,10/29/2014,0,0,0,0,0,0,0
46675,RM-B260A,10/30/2014,0,0,0,0,0,0,0
46676,RM-B260A,10/31/2014,0,0,0,0,0,0,0
46677,RM-B260A,11/1/2014,0,0,0,0,0,0,0
46678,RM-B260A,11/2/2014,0,0,0,0,0,0,0
46679,RM-B260A,11/3/2014,0,0,0,0,0,0,0
46680,RM-B260A,11/4/2014,0,0,0,0,0,0,0
46681,RM-B260A,11/5/2014,0,0,0,0,0,0,0
46682,RM-B260A,11/6/2014,0,0,0,0,0,0,0
46683,RM-B260A,11/7/2014,0,0,0,0,0,0,0
46684,RM-B260A,11/8/2014,0,0,0,0,0,0,0
46685,RM-B260A,11/9/2014,0,0,0,0,0,0,0
46686,RM-B260A,11/10/2014,0,0,0,0,0,0,0
46687,RM-B260A,11/11/2014,0,0,0,0,0,0,0
46688,RM-B260A,11/12/2014,0,0,0,0,0,0,0
46689,RM-B260A,11/13/2014,0,0,0,0,0,0,0
46690,RM-B260A,11/14/2014,0,0,0,0,0,0,0
46691,RM-B260A,11/15/2014,0,0,0,0,0,0,0
46692,RM-B260A,11/16/2014,0,0,0,0,0,0,0
46693,RM-B260A,11/17/2014,0,0,0,0,0,0,0
46694,RM-B260A,11/18/2014,0,0,0,0,0,0,0
46695,RM-B260A,11/19/2014,0,0,0,0,0,0,0
46696,RM-B260A,11/20/2014,0,0,0,0,0,0,0
46697,RM-B260A,11/21/2014,0,0,0,0,0,0,0
46698,RM-B260A,11/22/2014,0,0,0,0,0,0,0
46699,RM-B260A,11/23/2014,0,0,0,0,0,0,0
46700,RM-B260A,11/24/2014,0,0,0,0,0,0,0
46701,RM-B260A,11/25/2014,0,0,0,0,0,0,0
46702,RM-B260A,11/26/2014,0,0,0,0,0,0,0
46703,RM-B260A,11/27/2014,0,0,0,0,0,0,0
46704,RM-B260A,11/28/2014,0,0,0,0,0,0,0
46705,RM-B260A,11/29/2014,0,0,0,0,0,0,0
46706,RM-B260A,11/30/2014,0,0,0,0,0,0,0
46707,RM-B260A,12/1/2014,0,0,0,0,0,0,0
46708,RM-B260A,12/2/2014,0,0,0,0,0,0,0
46709,RM-B260A,12/3/2014,0,0,0,0,0,0,0
46710,RM-B260A,12/4/2014,0,0,0,0,0,0,0
46711,RM-B260A,12/5/2014,0,0,0,0,0,0,0
46712,RM-B260A,12/6/2014,0,0,0,0,0,0,0
46713,RM-B260A,12/7/2014,0,0,0,0,0,0,0
46714,RM-B260A,12/8/2014,0,0,0,0,0,0,0
46715,RM-B260A,12/9/2014,0,0,0,0,0,0,0
46716,RM-B260A,12/10/2014,0,0,0,0,0,0,0
46717,RM-B260A,12/11/2014,0,0,0,0,0,0,0
46718,RM-B260A,12/12/2014,0,0,0,0,0,0,0
46719,RM-B260A,12/13/2014,0,0,0,0,0,0,0
46720,RM-B260A,12/14/2014,0,0,0,0,0,0,0
46721,RM-B260A,12/15/2014,0,0,0,0,0,0,0
46722,RM-B260A,12/16/2014,0,0,0,0,0,0,0
46723,RM-B260A,12/17/2014,0,0,0,0,0,0,0
46724,RM-B260A,12/18/2014,0,0,0,0,0,0,0
46725,RM-B260A,12/19/2014,0,0,0,0,0,0,0
46726,RM-B260A,12/20/2014,0,0,0,0,0,0,0
46727,RM-B260A,12/21/2014,0,0,0,0,0,0,0
46728,RM-B260A,12/22/2014,0,0,0,0,0,0,0
46729,RM-B260A,12/23/2014,0,0,0,0,0,0,0
46730,RM-B260A,12/24/2014,0,0,0,0,0,0,0
46731,RM-B260A,12/25/2014,0,0,0,0,0,0,0
46732,RM-B260A,12/26/2014,0,0,0,0,0,0,0
46733,RM-B260A,12/27/2014,0,0,0,0,0,0,0
46734,RM-B260A,12/28/2014,0,0,0,0,0,0,0
46735,RM-B260A,12/29/2014,0,0,0,0,0,0,0
46736,RM-B260A,12/30/2014,0,0,0,0,0,0,0
46737,RM-B260A,12/31/2014,0,0,0,0,0,0,0
46738,RM-B260A,1/1/2015,0,0,0,0,0,0,0
46739,RM-B260A,1/2/2015,0,0,0,0,0,0,0
46740,RM-B260A,1/3/2015,0,0,0,0,0,0,0
46741,RM-B260A,1/4/2015,0,0,0,0,0,0,0
46742,RM-B260A,1/5/2015,0,0,0,0,0,0,0
46743,RM-B260A,1/6/2015,0,0,0,0,0,0,0
46744,RM-B260A,1/7/2015,0,0,0,0,0,0,0
46745,RM-B260A,1/8/2015,0,0,0,0,0,0,0
46746,RM-B260A,1/9/2015,0,0,0,0,0,0,0
46747,RM-B260A,1/10/2015,0,0,0,0,0,0,0
46748,RM-B260A,1/11/2015,0,0,0,0,0,0,0
46749,RM-B260A,1/12/2015,0,0,0,0,0,0,0
46750,RM-B260A,1/13/2015,0,0,0,0,0,0,0
46751,RM-B260A,1/14/2015,0,0,0,0,0,0,0
46752,RM-B260A,1/15/2015,0,0,0,0,0,0,0
46753,RM-B260A,1/16/2015,0,0,0,0,0,0,0
46754,RM-B260A,1/17/2015,0,0,0,0,0,0,0
46755,RM-B260A,1/18/2015,0,0,0,0,0,0,0
46756,RM-B260A,1/19/2015,0,0,0,0,0,0,0
46757,RM-B260A,1/20/2015,0,0,0,0,0,0,0
46758,RM-B260A,1/21/2015,0,0,0,0,0,0,0
46759,RM-B260A,1/22/2015,0,0,0,0,0,0,0
46760,RM-B260A,1/23/2015,0,0,0,0,0,0,0
46761,RM-B260A,1/24/2015,0,0,0,0,0,0,0
46762,RM-B260A,1/25/2015,0,0,0,0,0,0,0
46763,RM-B260A,1/26/2015,0,0,0,0,0,0,0
46764,RM-B260A,1/27/2015,0,0,0,0,0,0,0
46765,RM-B260A,1/28/2015,0,0,0,0,0,0,0
46766,RM-B260A,1/29/2015,0,0,0,0,0,0,0
46767,RM-B260A,1/30/2015,0,0,0,0,0,0,0
46768,RM-B260A,1/31/2015,0,0,0,0,0,0,0
46769,RM-B260A,2/1/2015,0,0,0,0,0,0,0
46770,RM-B260A,2/2/2015,0,0,0,0,0,0,0
46771,RM-B260A,2/3/2015,0,0,0,0,0,0,0
46772,RM-B260A,2/4/2015,0,0,0,0,0,0,0
46773,RM-B260A,2/5/2015,0,0,0,0,0,0,0
46774,RM-B260A,2/6/2015,0,0,0,0,0,0,0
46775,RM-B260A,2/7/2015,0,0,0,0,0,0,0
46776,RM-B260A,2/8/2015,0,0,0,0,0,0,0
46777,RM-B260A,2/9/2015,0,0,0,0,0,0,0
46778,RM-B260A,2/10/2015,0,0,0,0,0,0,0
46779,RM-B260A,2/11/2015,0,0,0,0,0,0,0
46780,RM-B260A,2/12/2015,0,0,0,0,0,0,0
46781,RM-B260A,2/13/2015,0,0,0,0,0,0,0
46782,RM-B260A,2/14/2015,0,0,0,0,0,0,0
46783,RM-B260A,2/15/2015,0,0,0,0,0,0,0
46784,RM-B260A,2/16/2015,0,0,0,0,0,0,0
46785,RM-B260A,2/17/2015,0,0,0,0,0,0,0
46786,RM-B260A,2/18/2015,0,0,0,0,0,0,0
46787,RM-B260A,2/19/2015,0,0,0,0,0,0,0
46788,RM-B260A,2/20/2015,0,0,0,0,0,0,0
46789,RM-B260A,2/21/2015,0,0,0,0,0,0,0
46790,RM-B260A,2/22/2015,0,0,0,0,0,0,0
46791,RM-B260A,2/23/2015,0,0,0,0,0,0,0
46792,RM-B260A,2/24/2015,0,0,0,0,0,0,0
46793,RM-B260A,2/25/2015,0,0,0,0,0,0,0
46794,RM-B260A,2/26/2015,0,0,0,0,0,0,0
46795,RM-B260A,2/27/2015,0,0,0,0,0,0,0
46796,RM-B260A,2/28/2015,0,0,0,0,0,0,0
46797,RM-B260A,3/1/2015,0,0,0,0,0,0,0
46798,RM-B260A,3/2/2015,0,0,0,0,0,0,0
46799,RM-B260A,3/3/2015,0,0,0,0,0,0,0
46800,RM-B260A,3/4/2015,0,0,0,0,0,0,0
46801,RM-B260A,3/5/2015,0,0,0,0,0,0,0
46802,RM-B260A,3/6/2015,0,0,0,0,0,0,0
46803,RM-B260A,3/7/2015,0,0,0,0,0,0,0
46804,RM-B260A,3/8/2015,0,0,0,0,0,0,0
46805,RM-B260A,3/9/2015,0,0,0,0,0,0,0
46806,RM-B260A,3/10/2015,0,0,0,0,0,0,0
46807,RM-B260A,3/11/2015,0,0,0,0,0,0,0
46808,RM-B260A,3/12/2015,0,0,0,0,0,0,0
46809,RM-B260A,3/13/2015,0,0,0,0,0,0,0
46810,RM-B260A,3/14/2015,0,0,0,0,0,0,0
46811,RM-B260A,3/15/2015,0,0,0,0,0,0,0
46812,RM-B260A,3/16/2015,0,0,0,0,0,0,0
46813,RM-B260A,3/17/2015,0,0,0,0,0,0,0
46814,RM-B260A,3/18/2015,0,0,0,0,0,0,0
46815,RM-B260A,3/19/2015,0,0,0,0,0,0,0
46816,RM-B260A,3/20/2015,0,0,0,0,0,0,0
46817,RM-B260A,3/21/2015,0,0,0,0,0,0,0
46818,RM-B260A,3/22/2015,0,0,0,0,0,0,0
46819,RM-B260A,3/23/2015,0,0,0,0,0,0,0
46820,RM-B260A,3/24/2015,0,0,0,0,0,0,0
46821,RM-B260A,3/25/2015,0,0,0,0,0,0,0
46822,RM-B260A,3/26/2015,0,0,0,0,0,0,0
46823,RM-B260A,3/27/2015,0,0,0,0,0,0,0
46824,RM-B260A,3/28/2015,0,0,0,0,0,0,0
46825,RM-B260A,3/29/2015,0,0,0,0,0,0,0
46826,RM-B260A,3/30/2015,0,0,0,0,0,0,0
46827,RM-B260A,3/31/2015,0,0,0,0,0,0,0
46828,RM-B260A,4/1/2015,0,0,0,0,0,0,0
46829,RM-B260A,4/2/2015,0,0,0,0,0,0,0
46830,RM-B260A,4/3/2015,0,0,0,0,0,0,0
46831,RM-B260A,4/4/2015,0,0,0,0,0,0,0
46832,RM-B260A,4/5/2015,0,0,0,0,0,0,0
46833,RM-B260A,4/6/2015,0,0,0,0,0,0,0
46834,RM-B260A,4/7/2015,0,0,0,0,0,0,0
46835,RM-B260A,4/8/2015,0,0,0,0,0,0,0
46836,RM-B260A,4/9/2015,0,0,0,0,0,0,0
46837,RM-B260A,4/10/2015,0,0,0,0,0,0,0
46838,RM-B260A,4/11/2015,0,0,0,0,0,0,0
46839,RM-B260A,4/12/2015,0,0,0,0,0,0,0
46840,RM-B260A,4/13/2015,0,0,0,0,0,0,0
46841,RM-B260A,4/14/2015,0,0,0,0,0,0,0
46842,RM-B260A,4/15/2015,0,0,0,0,0,0,0
46843,RM-B260A,4/16/2015,0,0,0,0,0,0,0
46844,RM-B260A,4/17/2015,0,0,0,0,0,0,0
46845,RM-B260A,4/18/2015,0,0,0,0,0,0,0
46846,RM-B260A,4/19/2015,0,0,0,0,0,0,0
46847,RM-B260A,4/20/2015,0,0,0,0,0,0,0
46848,RM-B260A,4/21/2015,0,0,0,0,0,0,0
46849,RM-B260A,4/22/2015,0,0,0,0,0,0,0
46850,RM-B260A,4/23/2015,0,0,0,0,0,0,0
46851,RM-B260A,4/24/2015,0,0,0,0,0,0,0
46852,RM-B260A,4/25/2015,0,0,0,0,0,0,0
46853,RM-B260A,4/26/2015,0,0,0,0,0,0,0
46854,RM-B260A,4/27/2015,0,0,0,0,0,0,0
46855,RM-B260A,4/28/2015,0,0,0,0,0,0,0
46856,RM-B260A,4/29/2015,0,0,0,0,0,0,0
46857,RM-B260A,4/30/2015,0,0,0,0,0,0,0
46858,RM-B260A,5/1/2015,0,0,0,0,0,0,0
46859,RM-B260A,5/2/2015,0,0,0,0,0,0,0
46860,RM-B260A,5/3/2015,0,0,0,0,0,0,0
46861,RM-B260A,5/4/2015,0,0,0,0,0,0,0
46862,RM-B260A,5/5/2015,0,0,0,0,0,0,0
46863,RM-B260A,5/6/2015,0,0,0,0,0,0,0
46864,RM-B260A,5/7/2015,0,0,0,0,0,0,0
46865,RM-B260A,5/8/2015,0,0,0,0,0,0,0
46866,RM-B260A,5/9/2015,0,0,0,0,0,0,0
46867,RM-B260A,5/10/2015,0,0,0,0,0,0,0
46868,RM-B260A,5/11/2015,0,0,0,0,0,0,0
46869,RM-B260A,5/12/2015,0,0,0,0,0,0,0
46870,RM-B260A,5/13/2015,0,0,0,0,0,0,0
46871,RM-B260A,5/14/2015,0,0,0,0,0,0,0
46872,RM-B260A,5/15/2015,0,0,0,0,0,0,0
46873,RM-B260A,5/16/2015,0,0,0,0,0,0,0
46874,RM-B260A,5/17/2015,0,0,0,0,0,0,0
46875,RM-B260A,5/18/2015,0,0,0,0,0,0,0
46876,RM-B260A,5/19/2015,0,0,0,0,0,0,0
46877,RM-B260A,5/20/2015,0,0,0,0,0,0,0
46878,RM-B260A,5/21/2015,0,0,0,0,0,0,0
46879,RM-B260A,5/22/2015,0,0,0,0,0,0,0
46880,RM-B260A,5/23/2015,0,0,0,0,0,0,0
46881,RM-B260A,5/24/2015,0,0,0,0,0,0,0
46882,RM-B260A,5/25/2015,0,0,0,0,0,0,0
46883,RM-B260A,5/26/2015,0,0,0,0,0,0,0
46884,RM-B260A,5/27/2015,0,0,0,0,0,0,0
46885,RM-B260A,5/28/2015,0,0,0,0,0,0,0
46886,RM-B260A,5/29/2015,0,0,0,0,0,0,0
46887,RM-B260A,5/30/2015,0,0,0,0,0,0,0
46888,RM-B260A,5/31/2015,0,0,0,0,0,0,0
47015,RM-B270,11/14/2013,0,0,0,0,0,0,0
47016,RM-B270,11/15/2013,0,0,0,0,0,0,0
47017,RM-B270,11/19/2013,0,0,0,0,0,0,0
47018,RM-B270,11/20/2013,0,0,0,0,0,0,0
47019,RM-B270,11/21/2013,0,0,0,0,0,0,0
47020,RM-B270,11/22/2013,0,0,0,0,0,0,0
47021,RM-B270,11/23/2013,0,0,0,0,0,0,0
47022,RM-B270,11/24/2013,0,0,0,0,0,0,0
47023,RM-B270,11/25/2013,0,0,0,0,0,0,0
47024,RM-B270,11/26/2013,0,0,0,0,0,0,0
47025,RM-B270,11/27/2013,0,0,0,0,0,0,0
47026,RM-B270,11/28/2013,0,0,0,0,0,0,0
47027,RM-B270,11/29/2013,0,0,0,0,0,0,0
47028,RM-B270,11/30/2013,0,0,0,0,0,0,0
47029,RM-B270,12/1/2013,0,0,0,0,0,0,0
47030,RM-B270,12/2/2013,0,0,0,0,0,0,0
47031,RM-B270,12/3/2013,0,0,0,0,0,0,0
47032,RM-B270,12/4/2013,0,0,0,0,0,0,0
47033,RM-B270,12/5/2013,0,0,0,0,0,0,0
47034,RM-B270,12/6/2013,0,0,0,0,0,0,0
47035,RM-B270,12/7/2013,0,0,0,0,0,0,0
47036,RM-B270,12/8/2013,0,0,0,0,0,0,0
47037,RM-B270,12/9/2013,0,0,0,0,0,0,0
47038,RM-B270,12/10/2013,0,0,0,0,0,0,0
47039,RM-B270,12/11/2013,0,0,0,0,0,0,0
47040,RM-B270,12/12/2013,0,0,0,0,0,0,0
47041,RM-B270,12/13/2013,0,0,0,0,0,0,0
47042,RM-B270,12/14/2013,0,0,0,0,0,0,0
47043,RM-B270,12/15/2013,0,0,0,0,0,0,0
47044,RM-B270,12/16/2013,0,0,0,0,0,0,0
47045,RM-B270,12/17/2013,0,0,0,0,0,0,0
47046,RM-B270,12/18/2013,0,0,0,0,0,0,0
47047,RM-B270,12/19/2013,0,0,0,0,0,0,0
47048,RM-B270,12/20/2013,0,0,0,0,0,0,0
47049,RM-B270,12/21/2013,0,0,0,0,0,0,0
47050,RM-B270,12/22/2013,0,0,0,0,0,0,0
47051,RM-B270,12/23/2013,0,0,0,0,0,0,0
47052,RM-B270,12/24/2013,0,0,0,0,0,0,0
47053,RM-B270,12/25/2013,0,0,0,0,0,0,0
47054,RM-B270,12/26/2013,0,0,0,0,0,0,0
47055,RM-B270,12/27/2013,0,0,0,0,0,0,0
47056,RM-B270,12/28/2013,0,0,0,0,0,0,0
47057,RM-B270,12/29/2013,0,0,0,0,0,0,0
47058,RM-B270,12/30/2013,0,0,0,0,0,0,0
47059,RM-B270,12/31/2013,0,0,0,0,0,0,0
47060,RM-B270,1/1/2014,0,0,0,0,0,0,0
47061,RM-B270,1/2/2014,0,0,0,0,0,0,0
47062,RM-B270,1/3/2014,0,0,0,0,0,0,0
47063,RM-B270,1/4/2014,0,0,0,0,0,0,0
47064,RM-B270,1/5/2014,0,0,0,0,0,0,0
47065,RM-B270,1/6/2014,0,0,0,0,0,0,0
47066,RM-B270,1/7/2014,0,0,0,0,0,0,0
47067,RM-B270,1/8/2014,0,0,0,0,0,0,0
47068,RM-B270,1/9/2014,0,0,0,0,0,0,0
47069,RM-B270,1/10/2014,0,0,0,0,0,0,0
47070,RM-B270,1/11/2014,0,0,0,0,0,0,0
47071,RM-B270,1/12/2014,0,0,0,0,0,0,0
47072,RM-B270,1/13/2014,0,0,0,0,0,0,0
47073,RM-B270,1/14/2014,0,0,0,0,0,0,0
47074,RM-B270,1/15/2014,0,0,0,0,0,0,0
47075,RM-B270,1/16/2014,0,0,0,0,0,0,0
47076,RM-B270,1/17/2014,0,0,0,0,0,0,0
47077,RM-B270,1/18/2014,0,0,0,0,0,0,0
47078,RM-B270,1/19/2014,0,0,0,0,0,0,0
47079,RM-B270,1/20/2014,0,0,0,0,0,0,0
47080,RM-B270,1/21/2014,0,0,0,0,0,0,0
47081,RM-B270,1/22/2014,0,0,0,0,0,0,0
47082,RM-B270,1/23/2014,0,0,0,0,0,0,0
47083,RM-B270,1/24/2014,0,0,0,0,0,0,0
47084,RM-B270,1/25/2014,0,0,0,0,0,0,0
47085,RM-B270,1/26/2014,0,0,0,0,0,0,0
47086,RM-B270,1/27/2014,0,0,0,0,0,0,0
47087,RM-B270,1/28/2014,0,0,0,0,0,0,0
47088,RM-B270,1/29/2014,0,0,0,0,0,0,0
47089,RM-B270,1/30/2014,0,0,0,0,0,0,0
47090,RM-B270,1/31/2014,0,0,0,0,0,0,0
47091,RM-B270,2/1/2014,0,0,0,0,0,0,0
47092,RM-B270,2/2/2014,0,0,0,0,0,0,0
47093,RM-B270,2/3/2014,0,0,0,0,0,0,0
47094,RM-B270,2/4/2014,0,0,0,0,0,0,0
47095,RM-B270,2/5/2014,0,0,0,0,0,0,0
47096,RM-B270,2/6/2014,0,0,0,0,0,0,0
47097,RM-B270,2/7/2014,0,0,0,0,0,0,0
47098,RM-B270,2/8/2014,0,0,0,0,0,0,0
47099,RM-B270,2/9/2014,0,0,0,0,0,0,0
47100,RM-B270,2/10/2014,0,0,0,0,0,0,0
47101,RM-B270,2/11/2014,0,0,0,0,0,0,0
47102,RM-B270,2/12/2014,0,0,0,0,0,0,0
47103,RM-B270,2/13/2014,0,0,0,0,0,0,0
47104,RM-B270,2/14/2014,0,0,0,0,0,0,0
47105,RM-B270,2/15/2014,0,0,0,0,0,0,0
47106,RM-B270,2/16/2014,0,0,0,0,0,0,0
47107,RM-B270,2/17/2014,0,0,0,0,0,0,0
47108,RM-B270,2/18/2014,0,0,0,0,0,0,0
47109,RM-B270,2/19/2014,0,0,0,0,0,0,0
47110,RM-B270,2/20/2014,0,0,0,0,0,0,0
47111,RM-B270,2/21/2014,0,0,0,0,0,0,0
47112,RM-B270,2/22/2014,0,0,0,0,0,0,0
47113,RM-B270,2/23/2014,0,0,0,0,0,0,0
47114,RM-B270,2/24/2014,0,0,0,0,0,0,0
47115,RM-B270,2/25/2014,0,0,0,0,0,0,0
47116,RM-B270,2/26/2014,0,0,0,0,0,0,0
47117,RM-B270,2/27/2014,0,0,0,0,0,0,0
47118,RM-B270,2/28/2014,0,0,0,0,0,0,0
47119,RM-B270,3/1/2014,0,0,0,0,0,0,0
47120,RM-B270,3/2/2014,0,0,0,0,0,0,0
47121,RM-B270,3/3/2014,0,0,0,0,0,0,0
47122,RM-B270,3/4/2014,0,0,0,0,0,0,0
47123,RM-B270,3/5/2014,0,0,0,0,0,0,0
47124,RM-B270,3/6/2014,0,0,0,0,0,0,0
47125,RM-B270,3/7/2014,0,0,0,0,0,0,0
47126,RM-B270,3/8/2014,0,0,0,0,0,0,0
47127,RM-B270,3/9/2014,0,0,0,0,0,0,0
47128,RM-B270,3/10/2014,0,0,0,0,0,0,0
47129,RM-B270,3/11/2014,0,0,0,0,0,0,0
47130,RM-B270,3/12/2014,0,0,0,0,0,0,0
47131,RM-B270,3/13/2014,0,0,0,0,0,0,0
47132,RM-B270,3/14/2014,0,0,0,0,0,0,0
47133,RM-B270,3/15/2014,0,0,0,0,0,0,0
47134,RM-B270,3/16/2014,0,0,0,0,0,0,0
47135,RM-B270,3/17/2014,0,0,0,0,0,0,0
47136,RM-B270,3/18/2014,0,0,0,0,0,0,0
47137,RM-B270,3/19/2014,0,0,0,0,0,0,0
47138,RM-B270,3/20/2014,0,0,0,0,0,0,0
47139,RM-B270,3/21/2014,0,0,0,0,0,0,0
47140,RM-B270,3/22/2014,0,0,0,0,0,0,0
47141,RM-B270,3/23/2014,0,0,0,0,0,0,0
47142,RM-B270,3/24/2014,0,0,0,0,0,0,0
47143,RM-B270,3/25/2014,0,0,0,0,0,0,0
47144,RM-B270,3/26/2014,0,0,0,0,0,0,0
47145,RM-B270,3/27/2014,0,0,0,0,0,0,0
47146,RM-B270,3/28/2014,0,0,0,0,0,0,0
47147,RM-B270,3/29/2014,0,0,0,0,0,0,0
47148,RM-B270,3/30/2014,0,0,0,0,0,0,0
47149,RM-B270,3/31/2014,0,0,0,0,0,0,0
47150,RM-B270,4/1/2014,0,0,0,0,0,0,0
47151,RM-B270,4/2/2014,0,0,0,0,0,0,0
47152,RM-B270,4/3/2014,0,0,0,0,0,0,0
47153,RM-B270,4/4/2014,0,0,0,0,0,0,0
47154,RM-B270,4/5/2014,0,0,0,0,0,0,0
47155,RM-B270,4/6/2014,0,0,0,0,0,0,0
47156,RM-B270,4/7/2014,0,0,0,0,0,0,0
47157,RM-B270,4/8/2014,0,0,0,0,0,0,0
47158,RM-B270,4/9/2014,0,0,0,0,0,0,0
47159,RM-B270,4/10/2014,0,0,0,0,0,0,0
47160,RM-B270,4/11/2014,0,0,0,0,0,0,0
47161,RM-B270,4/12/2014,0,0,0,0,0,0,0
47162,RM-B270,4/13/2014,0,0,0,0,0,0,0
47163,RM-B270,4/14/2014,0,0,0,0,0,0,0
47164,RM-B270,4/15/2014,0,0,0,0,0,0,0
47165,RM-B270,4/16/2014,0,0,0,0,0,0,0
47166,RM-B270,4/17/2014,0,0,0,0,0,0,0
47243,RM-B270,7/3/2014,0,0,0,0,0,0,0
47244,RM-B270,7/4/2014,0,0,0,0,0,0,0
47245,RM-B270,7/5/2014,0,0,0,0,0,0,0
47246,RM-B270,7/6/2014,0,0,0,0,0,0,0
47247,RM-B270,7/7/2014,0,0,0,0,0,0,0
47248,RM-B270,7/8/2014,0,0,0,0,0,0,0
47249,RM-B270,7/9/2014,0,0,0,0,0,0,0
47250,RM-B270,7/10/2014,0,0,0,0,0,0,0
47251,RM-B270,7/11/2014,0,0,0,0,0,0,0
47252,RM-B270,7/12/2014,0,0,0,0,0,0,0
47253,RM-B270,7/13/2014,0,0,0,0,0,0,0
47254,RM-B270,7/14/2014,0,0,0,0,0,0,0
47255,RM-B270,7/15/2014,0,0,0,0,0,0,0
47256,RM-B270,7/16/2014,0,0,0,0,0,0,0
47257,RM-B270,7/17/2014,0,0,0,0,0,0,0
47258,RM-B270,7/18/2014,0,0,0,0,0,0,0
47259,RM-B270,7/19/2014,0,0,0,0,0,0,0
47260,RM-B270,7/20/2014,0,0,0,0,0,0,0
47261,RM-B270,7/21/2014,0,0,0,0,0,0,0
47262,RM-B270,7/22/2014,0,0,0,0,0,0,0
47263,RM-B270,7/23/2014,0,0,0,0,0,0,0
47264,RM-B270,7/24/2014,0,0,0,0,0,0,0
47265,RM-B270,7/25/2014,0,0,0,0,0,0,0
47266,RM-B270,7/26/2014,0,0,0,0,0,0,0
47267,RM-B270,7/27/2014,0,0,0,0,0,0,0
47268,RM-B270,7/28/2014,0,0,0,0,0,0,0
47269,RM-B270,7/29/2014,0,0,0,0,0,0,0
47270,RM-B270,7/30/2014,0,0,0,0,0,0,0
47271,RM-B270,7/31/2014,0,0,0,0,0,0,0
47272,RM-B270,8/1/2014,0,0,0,0,0,0,0
47273,RM-B270,8/2/2014,0,0,0,0,0,0,0
47274,RM-B270,8/3/2014,0,0,0,0,0,0,0
47275,RM-B270,8/4/2014,0,0,0,0,0,0,0
47276,RM-B270,8/5/2014,0,0,0,0,0,0,0
47277,RM-B270,8/6/2014,0,0,0,0,0,0,0
47278,RM-B270,8/7/2014,0,0,0,0,0,0,0
47279,RM-B270,8/8/2014,0,0,0,0,0,0,0
47280,RM-B270,8/9/2014,0,0,0,0,0,0,0
47281,RM-B270,8/10/2014,0,0,0,0,0,0,0
47282,RM-B270,8/11/2014,0,0,0,0,0,0,0
47283,RM-B270,8/12/2014,0,0,0,0,0,0,0
47284,RM-B270,8/13/2014,0,0,0,0,0,0,0
47285,RM-B270,8/14/2014,0,0,0,0,0,0,0
47286,RM-B270,8/15/2014,0,0,0,0,0,0,0
47287,RM-B270,8/16/2014,0,0,0,0,0,0,0
47288,RM-B270,8/17/2014,0,0,0,0,0,0,0
47289,RM-B270,8/18/2014,0,0,0,0,0,0,0
47290,RM-B270,8/19/2014,0,0,0,0,0,0,0
47291,RM-B270,8/20/2014,0,0,0,0,0,0,0
47292,RM-B270,8/21/2014,0,0,0,0,0,0,0
47293,RM-B270,8/22/2014,0,0,0,0,0,0,0
47294,RM-B270,8/23/2014,0,0,0,0,0,0,0
47295,RM-B270,8/24/2014,0,0,0,0,0,0,0
47296,RM-B270,8/25/2014,0,0,0,0,0,0,0
47297,RM-B270,8/26/2014,0,0,0,0,0,0,0
47298,RM-B270,8/27/2014,0,0,0,0,0,0,0
47299,RM-B270,8/28/2014,0,0,0,0,0,0,0
47300,RM-B270,8/29/2014,0,0,0,0,0,0,0
47301,RM-B270,8/30/2014,0,0,0,0,0,0,0
47302,RM-B270,8/31/2014,0,0,0,0,0,0,0
47303,RM-B270,9/1/2014,0,0,0,0,0,0,0
47304,RM-B270,9/2/2014,0,0,0,0,0,0,0
47305,RM-B270,9/3/2014,0,0,0,0,0,0,0
47306,RM-B270,9/4/2014,0,0,0,0,0,0,0
47307,RM-B270,9/5/2014,0,0,0,0,0,0,0
47308,RM-B270,9/6/2014,0,0,0,0,0,0,0
47309,RM-B270,9/7/2014,0,0,0,0,0,0,0
47310,RM-B270,9/8/2014,0,0,0,0,0,0,0
47311,RM-B270,9/9/2014,0,0,0,0,0,0,0
47312,RM-B270,9/10/2014,0,0,0,0,0,0,0
47313,RM-B270,9/11/2014,0,0,0,0,0,0,0
47314,RM-B270,9/12/2014,0,0,0,0,0,0,0
47315,RM-B270,9/13/2014,0,0,0,0,0,0,0
47316,RM-B270,9/14/2014,0,0,0,0,0,0,0
47317,RM-B270,9/15/2014,0,0,0,0,0,0,0
47318,RM-B270,9/16/2014,0,0,0,0,0,0,0
47319,RM-B270,9/17/2014,0,0,0,0,0,0,0
47320,RM-B270,9/18/2014,0,0,0,0,0,0,0
47321,RM-B270,9/19/2014,0,0,0,0,0,0,0
47322,RM-B270,9/20/2014,0,0,0,0,0,0,0
47323,RM-B270,9/21/2014,0,0,0,0,0,0,0
47324,RM-B270,9/22/2014,0,0,0,0,0,0,0
47325,RM-B270,9/23/2014,0,0,0,0,0,0,0
47326,RM-B270,9/24/2014,0,0,0,0,0,0,0
47327,RM-B270,9/25/2014,0,0,0,0,0,0,0
47328,RM-B270,9/28/2014,0,0,0,0,0,0,0
47329,RM-B270,9/29/2014,0,0,0,0,0,0,0
47330,RM-B270,9/30/2014,0,0,0,0,0,0,0
47331,RM-B270,10/1/2014,0,0,0,0,0,0,0
47332,RM-B270,10/2/2014,0,0,0,0,0,0,0
47333,RM-B270,10/3/2014,0,0,0,0,0,0,0
47334,RM-B270,10/4/2014,0,0,0,0,0,0,0
47335,RM-B270,10/5/2014,0,0,0,0,0,0,0
47336,RM-B270,10/6/2014,0,0,0,0,0,0,0
47337,RM-B270,10/7/2014,0,0,0,0,0,0,0
47338,RM-B270,10/8/2014,0,0,0,0,0,0,0
47339,RM-B270,10/9/2014,0,0,0,0,0,0,0
47340,RM-B270,10/10/2014,0,0,0,0,0,0,0
47341,RM-B270,10/11/2014,0,0,0,0,0,0,0
47342,RM-B270,10/12/2014,0,0,0,0,0,0,0
47343,RM-B270,10/13/2014,0,0,0,0,0,0,0
47344,RM-B270,10/14/2014,0,0,0,0,0,0,0
47345,RM-B270,10/15/2014,0,0,0,0,0,0,0
47346,RM-B270,11/5/2014,0,0,0,0,0,0,0
47347,RM-B270,11/6/2014,0,0,0,0,0,0,0
47348,RM-B270,11/7/2014,0,0,0,0,0,0,0
47349,RM-B270,11/8/2014,0,0,0,0,0,0,0
47350,RM-B270,11/9/2014,0,0,0,0,0,0,0
47351,RM-B270,11/10/2014,0,0,0,0,0,0,0
47352,RM-B270,11/11/2014,0,0,0,0,0,0,0
47353,RM-B270,11/12/2014,0,0,0,0,0,0,0
47354,RM-B270,11/13/2014,0,0,0,0,0,0,0
47355,RM-B270,11/14/2014,0,0,0,0,0,0,0
47356,RM-B270,11/15/2014,0,0,0,0,0,0,0
47357,RM-B270,11/16/2014,0,0,0,0,0,0,0
47358,RM-B270,11/17/2014,0,0,0,0,0,0,0
47359,RM-B270,11/18/2014,0,0,0,0,0,0,0
47360,RM-B270,11/19/2014,0,0,0,0,0,0,0
47361,RM-B270,11/20/2014,0,0,0,0,0,0,0
47362,RM-B270,11/21/2014,0,0,0,0,0,0,0
47363,RM-B270,11/22/2014,0,0,0,0,0,0,0
47364,RM-B270,11/23/2014,0,0,0,0,0,0,0
47365,RM-B270,11/24/2014,0,0,0,0,0,0,0
47366,RM-B270,11/25/2014,0,0,0,0,0,0,0
47367,RM-B270,11/26/2014,0,0,0,0,0,0,0
47368,RM-B270,11/27/2014,0,0,0,0,0,0,0
47369,RM-B270,11/28/2014,0,0,0,0,0,0,0
47370,RM-B270,11/29/2014,0,0,0,0,0,0,0
47371,RM-B270,11/30/2014,0,0,0,0,0,0,0
47372,RM-B270,12/1/2014,0,0,0,0,0,0,0
47373,RM-B270,12/2/2014,0,0,0,0,0,0,0
47374,RM-B270,12/3/2014,0,0,0,0,0,0,0
47375,RM-B270,12/4/2014,0,0,0,0,0,0,0
47376,RM-B270,12/5/2014,0,0,0,0,0,0,0
47377,RM-B270,12/6/2014,0,0,0,0,0,0,0
47378,RM-B270,12/7/2014,0,0,0,0,0,0,0
47379,RM-B270,12/8/2014,0,0,0,0,0,0,0
47380,RM-B270,12/9/2014,0,0,0,0,0,0,0
47381,RM-B270,12/10/2014,0,0,0,0,0,0,0
47382,RM-B270,12/11/2014,0,0,0,0,0,0,0
47383,RM-B270,12/12/2014,0,0,0,0,0,0,0
47384,RM-B270,12/13/2014,0,0,0,0,0,0,0
47385,RM-B270,12/14/2014,0,0,0,0,0,0,0
47386,RM-B270,12/15/2014,0,0,0,0,0,0,0
47387,RM-B270,12/16/2014,0,0,0,0,0,0,0
47388,RM-B270,12/17/2014,0,0,0,0,0,0,0
47389,RM-B270,12/18/2014,0,0,0,0,0,0,0
47390,RM-B270,12/19/2014,0,0,0,0,0,0,0
47391,RM-B270,12/20/2014,0,0,0,0,0,0,0
47392,RM-B270,12/21/2014,0,0,0,0,0,0,0
47393,RM-B270,12/22/2014,0,0,0,0,0,0,0
47394,RM-B270,12/23/2014,0,0,0,0,0,0,0
47395,RM-B270,12/24/2014,0,0,0,0,0,0,0
47396,RM-B270,12/25/2014,0,0,0,0,0,0,0
47397,RM-B270,12/26/2014,0,0,0,0,0,0,0
47398,RM-B270,12/27/2014,0,0,0,0,0,0,0
47399,RM-B270,12/28/2014,0,0,0,0,0,0,0
47400,RM-B270,12/29/2014,0,0,0,0,0,0,0
47401,RM-B270,12/30/2014,0,0,0,0,0,0,0
47402,RM-B270,12/31/2014,0,0,0,0,0,0,0
47403,RM-B270,1/1/2015,0,0,0,0,0,0,0
47404,RM-B270,1/2/2015,0,0,0,0,0,0,0
47405,RM-B270,1/3/2015,0,0,0,0,0,0,0
47406,RM-B270,1/4/2015,0,0,0,0,0,0,0
47407,RM-B270,1/5/2015,0,0,0,0,0,0,0
47408,RM-B270,1/6/2015,0,0,0,0,0,0,0
47409,RM-B270,1/7/2015,0,0,0,0,0,0,0
47410,RM-B270,1/8/2015,0,0,0,0,0,0,0
47411,RM-B270,1/9/2015,0,0,0,0,0,0,0
47412,RM-B270,1/10/2015,0,0,0,0,0,0,0
47413,RM-B270,1/11/2015,0,0,0,0,0,0,0
47414,RM-B270,1/12/2015,0,0,0,0,0,0,0
47415,RM-B270,1/13/2015,0,0,0,0,0,0,0
47416,RM-B270,1/14/2015,0,0,0,0,0,0,0
47417,RM-B270,1/15/2015,0,0,0,0,0,0,0
47418,RM-B270,1/16/2015,0,0,0,0,0,0,0
47419,RM-B270,1/17/2015,0,0,0,0,0,0,0
47420,RM-B270,1/18/2015,0,0,0,0,0,0,0
47421,RM-B270,1/19/2015,0,0,0,0,0,0,0
47422,RM-B270,1/20/2015,0,0,0,0,0,0,0
47423,RM-B270,1/21/2015,0,0,0,0,0,0,0
47424,RM-B270,1/22/2015,0,0,0,0,0,0,0
47425,RM-B270,1/23/2015,0,0,0,0,0,0,0
47426,RM-B270,1/24/2015,0,0,0,0,0,0,0
47427,RM-B270,1/25/2015,0,0,0,0,0,0,0
47428,RM-B270,1/26/2015,0,0,0,0,0,0,0
47429,RM-B270,1/27/2015,0,0,0,0,0,0,0
47430,RM-B270,1/28/2015,0,0,0,0,0,0,0
47431,RM-B270,1/29/2015,0,0,0,0,0,0,0
47432,RM-B270,1/30/2015,0,0,0,0,0,0,0
47433,RM-B270,1/31/2015,0,0,0,0,0,0,0
47434,RM-B270,2/1/2015,0,0,0,0,0,0,0
47435,RM-B270,2/2/2015,0,0,0,0,0,0,0
47436,RM-B270,2/3/2015,0,0,0,0,0,0,0
47437,RM-B270,2/4/2015,0,0,0,0,0,0,0
47438,RM-B270,2/5/2015,0,0,0,0,0,0,0
47439,RM-B270,2/6/2015,0,0,0,0,0,0,0
47440,RM-B270,2/7/2015,0,0,0,0,0,0,0
47441,RM-B270,2/8/2015,0,0,0,0,0,0,0
47442,RM-B270,2/9/2015,0,0,0,0,0,0,0
47443,RM-B270,2/10/2015,0,0,0,0,0,0,0
47444,RM-B270,2/11/2015,0,0,0,0,0,0,0
47445,RM-B270,2/12/2015,0,0,0,0,0,0,0
47446,RM-B270,2/13/2015,0,0,0,0,0,0,0
47447,RM-B270,2/14/2015,0,0,0,0,0,0,0
47448,RM-B270,2/15/2015,0,0,0,0,0,0,0
47449,RM-B270,2/16/2015,0,0,0,0,0,0,0
47450,RM-B270,2/17/2015,0,0,0,0,0,0,0
47451,RM-B270,2/18/2015,0,0,0,0,0,0,0
47452,RM-B270,2/19/2015,0,0,0,0,0,0,0
47453,RM-B270,2/20/2015,0,0,0,0,0,0,0
47454,RM-B270,2/21/2015,0,0,0,0,0,0,0
47455,RM-B270,2/22/2015,0,0,0,0,0,0,0
47456,RM-B270,2/23/2015,0,0,0,0,0,0,0
47457,RM-B270,2/24/2015,0,0,0,0,0,0,0
47458,RM-B270,2/25/2015,0,0,0,0,0,0,0
47459,RM-B270,2/26/2015,0,0,0,0,0,0,0
47460,RM-B270,2/27/2015,0,0,0,0,0,0,0
47461,RM-B270,2/28/2015,0,0,0,0,0,0,0
47462,RM-B270,3/1/2015,0,0,0,0,0,0,0
47463,RM-B270,3/2/2015,0,0,0,0,0,0,0
47464,RM-B270,3/3/2015,0,0,0,0,0,0,0
47465,RM-B270,3/4/2015,0,0,0,0,0,0,0
47466,RM-B270,3/5/2015,0,0,0,0,0,0,0
47467,RM-B270,3/6/2015,0,0,0,0,0,0,0
47468,RM-B270,3/7/2015,0,0,0,0,0,0,0
47469,RM-B270,3/8/2015,0,0,0,0,0,0,0
47470,RM-B270,3/9/2015,0,0,0,0,0,0,0
47471,RM-B270,3/10/2015,0,0,0,0,0,0,0
47472,RM-B270,3/11/2015,0,0,0,0,0,0,0
47473,RM-B270,3/12/2015,0,0,0,0,0,0,0
47474,RM-B270,3/13/2015,0,0,0,0,0,0,0
47475,RM-B270,3/14/2015,0,0,0,0,0,0,0
47476,RM-B270,3/15/2015,0,0,0,0,0,0,0
47477,RM-B270,3/16/2015,0,0,0,0,0,0,0
47478,RM-B270,3/17/2015,0,0,0,0,0,0,0
47479,RM-B270,3/18/2015,0,0,0,0,0,0,0
47480,RM-B270,3/19/2015,0,0,0,0,0,0,0
47481,RM-B270,3/20/2015,0,0,0,0,0,0,0
47482,RM-B270,3/21/2015,0,0,0,0,0,0,0
47483,RM-B270,3/22/2015,0,0,0,0,0,0,0
47484,RM-B270,3/23/2015,0,0,0,0,0,0,0
47485,RM-B270,3/24/2015,0,0,0,0,0,0,0
47486,RM-B270,3/25/2015,0,0,0,0,0,0,0
47487,RM-B270,3/26/2015,0,0,0,0,0,0,0
47488,RM-B270,3/27/2015,0,0,0,0,0,0,0
47489,RM-B270,3/28/2015,0,0,0,0,0,0,0
47490,RM-B270,3/29/2015,0,0,0,0,0,0,0
47491,RM-B270,3/30/2015,0,0,0,0,0,0,0
47492,RM-B270,3/31/2015,0,0,0,0,0,0,0
47493,RM-B270,4/1/2015,0,0,0,0,0,0,0
47494,RM-B270,4/2/2015,0,0,0,0,0,0,0
47495,RM-B270,4/3/2015,0,0,0,0,0,0,0
47496,RM-B270,4/4/2015,0,0,0,0,0,0,0
47497,RM-B270,4/5/2015,0,0,0,0,0,0,0
47498,RM-B270,4/6/2015,0,0,0,0,0,0,0
47499,RM-B270,4/7/2015,0,0,0,0,0,0,0
47500,RM-B270,4/8/2015,0,0,0,0,0,0,0
47501,RM-B270,4/9/2015,0,0,0,0,0,0,0
47502,RM-B270,4/10/2015,0,0,0,0,0,0,0
47503,RM-B270,4/11/2015,0,0,0,0,0,0,0
47504,RM-B270,4/12/2015,0,0,0,0,0,0,0
47505,RM-B270,4/13/2015,0,0,0,0,0,0,0
47506,RM-B270,4/14/2015,0,0,0,0,0,0,0
47507,RM-B270,4/15/2015,0,0,0,0,0,0,0
47508,RM-B270,4/16/2015,0,0,0,0,0,0,0
47509,RM-B270,4/17/2015,0,0,0,0,0,0,0
47510,RM-B270,4/18/2015,0,0,0,0,0,0,0
47511,RM-B270,4/19/2015,0,0,0,0,0,0,0
47512,RM-B270,4/20/2015,0,0,0,0,0,0,0
47513,RM-B270,4/21/2015,0,0,0,0,0,0,0
47514,RM-B270,4/22/2015,0,0,0,0,0,0,0
47515,RM-B270,4/23/2015,0,0,0,0,0,0,0
47516,RM-B270,4/24/2015,0,0,0,0,0,0,0
47517,RM-B270,4/25/2015,0,0,0,0,0,0,0
47518,RM-B270,4/26/2015,0,0,0,0,0,0,0
47519,RM-B270,4/27/2015,0,0,0,0,0,0,0
47520,RM-B270,4/28/2015,0,0,0,0,0,0,0
47521,RM-B270,4/29/2015,0,0,0,0,0,0,0
47522,RM-B270,4/30/2015,0,0,0,0,0,0,0
47523,RM-B270,5/1/2015,0,0,0,0,0,0,0
47524,RM-B270,5/2/2015,0,0,0,0,0,0,0
47525,RM-B270,5/3/2015,0,0,0,0,0,0,0
47526,RM-B270,5/4/2015,0,0,0,0,0,0,0
47527,RM-B270,5/5/2015,0,0,0,0,0,0,0
47528,RM-B270,5/6/2015,0,0,0,0,0,0,0
47529,RM-B270,5/7/2015,0,0,0,0,0,0,0
47530,RM-B270,5/8/2015,0,0,0,0,0,0,0
47531,RM-B270,5/9/2015,0,0,0,0,0,0,0
47532,RM-B270,5/10/2015,0,0,0,0,0,0,0
47533,RM-B270,5/11/2015,0,0,0,0,0,0,0
47534,RM-B270,5/12/2015,0,0,0,0,0,0,0
47535,RM-B270,5/13/2015,0,0,0,0,0,0,0
47536,RM-B270,5/14/2015,0,0,0,0,0,0,0
47537,RM-B270,5/15/2015,0,0,0,0,0,0,0
47538,RM-B270,5/16/2015,0,0,0,0,0,0,0
47539,RM-B270,5/17/2015,0,0,0,0,0,0,0
47540,RM-B270,5/18/2015,0,0,0,0,0,0,0
47541,RM-B270,5/19/2015,0,0,0,0,0,0,0
47542,RM-B270,5/20/2015,0,0,0,0,0,0,0
47543,RM-B270,5/21/2015,0,0,0,0,0,0,0
47544,RM-B270,5/22/2015,0,0,0,0,0,0,0
47545,RM-B270,5/23/2015,0,0,0,0,0,0,0
47546,RM-B270,5/24/2015,0,0,0,0,0,0,0
47547,RM-B270,5/25/2015,0,0,0,0,0,0,0
47548,RM-B270,5/26/2015,0,0,0,0,0,0,0
47549,RM-B270,5/27/2015,0,0,0,0,0,0,0
47550,RM-B270,5/28/2015,0,0,0,0,0,0,0
47551,RM-B270,5/29/2015,0,0,0,0,0,0,0
47552,RM-B270,5/30/2015,0,0,0,0,0,0,0
47553,RM-B270,5/31/2015,0,0,0,0,0,0,0
47554,RM-B275,6/28/2013,0,0,0,0,0,0,0
47555,RM-B275,6/29/2013,0,0,0,0,0,0,0
47556,RM-B275,6/30/2013,0,0,0,0,0,0,0
47815,RM-B275,3/29/2014,0,0,0,0,0,0,0
47816,RM-B275,3/30/2014,0,0,0,0,0,0,0
47817,RM-B275,3/31/2014,0,0,0,0,0,0,0
47818,RM-B275,4/1/2014,0,0,0,0,0,0,0
47819,RM-B275,4/2/2014,0,0,0,0,0,0,0
47820,RM-B275,4/3/2014,0,0,0,0,0,0,0
47821,RM-B275,4/4/2014,0,0,0,0,0,0,0
47822,RM-B275,4/5/2014,0,0,0,0,0,0,0
47823,RM-B275,4/6/2014,0,0,0,0,0,0,0
47824,RM-B275,4/7/2014,0,0,0,0,0,0,0
47825,RM-B275,4/8/2014,0,0,0,0,0,0,0
47826,RM-B275,4/9/2014,0,0,0,0,0,0,0
47827,RM-B275,4/10/2014,0,0,0,0,0,0,0
47828,RM-B275,4/11/2014,0,0,0,0,0,0,0
47829,RM-B275,4/12/2014,0,0,0,0,0,0,0
47830,RM-B275,4/13/2014,0,0,0,0,0,0,0
47831,RM-B275,4/14/2014,0,0,0,0,0,0,0
47832,RM-B275,4/15/2014,0,0,0,0,0,0,0
47833,RM-B275,4/16/2014,0,0,0,0,0,0,0
47834,RM-B275,4/17/2014,0,0,0,0,0,0,0
47835,RM-B275,4/18/2014,0,0,0,0,0,0,0
47836,RM-B275,4/19/2014,0,0,0,0,0,0,0
47837,RM-B275,4/20/2014,0,0,0,0,0,0,0
47838,RM-B275,4/21/2014,0,0,0,0,0,0,0
47839,RM-B275,4/22/2014,0,0,0,0,0,0,0
47840,RM-B275,4/23/2014,0,0,0,0,0,0,0
47841,RM-B275,4/24/2014,0,0,0,0,0,0,0
47842,RM-B275,4/25/2014,0,0,0,0,0,0,0
47843,RM-B275,4/26/2014,0,0,0,0,0,0,0
47844,RM-B275,4/27/2014,0,0,0,0,0,0,0
47845,RM-B275,4/28/2014,0,0,0,0,0,0,0
47846,RM-B275,4/29/2014,0,0,0,0,0,0,0
47847,RM-B275,4/30/2014,0,0,0,0,0,0,0
47848,RM-B275,5/1/2014,0,0,0,0,0,0,0
47849,RM-B275,5/2/2014,0,0,0,0,0,0,0
47850,RM-B275,5/3/2014,0,0,0,0,0,0,0
47851,RM-B275,5/4/2014,0,0,0,0,0,0,0
47852,RM-B275,5/5/2014,0,0,0,0,0,0,0
47853,RM-B275,5/6/2014,0,0,0,0,0,0,0
47854,RM-B275,5/7/2014,0,0,0,0,0,0,0
47855,RM-B275,5/8/2014,0,0,0,0,0,0,0
47856,RM-B275,5/9/2014,0,0,0,0,0,0,0
47857,RM-B275,5/10/2014,0,0,0,0,0,0,0
47858,RM-B275,5/11/2014,0,0,0,0,0,0,0
47859,RM-B275,5/12/2014,0,0,0,0,0,0,0
47860,RM-B275,5/13/2014,0,0,0,0,0,0,0
47861,RM-B275,5/14/2014,0,0,0,0,0,0,0
47862,RM-B275,5/15/2014,0,0,0,0,0,0,0
47863,RM-B275,5/16/2014,0,0,0,0,0,0,0
47864,RM-B275,5/17/2014,0,0,0,0,0,0,0
47865,RM-B275,5/18/2014,0,0,0,0,0,0,0
47866,RM-B275,5/19/2014,0,0,0,0,0,0,0
47867,RM-B275,5/20/2014,0,0,0,0,0,0,0
47868,RM-B275,5/21/2014,0,0,0,0,0,0,0
47869,RM-B275,5/22/2014,0,0,0,0,0,0,0
47870,RM-B275,5/23/2014,0,0,0,0,0,0,0
47871,RM-B275,5/24/2014,0,0,0,0,0,0,0
47872,RM-B275,5/25/2014,0,0,0,0,0,0,0
47873,RM-B275,5/26/2014,0,0,0,0,0,0,0
47874,RM-B275,5/27/2014,0,0,0,0,0,0,0
47875,RM-B275,5/28/2014,0,0,0,0,0,0,0
47876,RM-B275,5/29/2014,0,0,0,0,0,0,0
47877,RM-B275,5/30/2014,0,0,0,0,0,0,0
47878,RM-B275,5/31/2014,0,0,0,0,0,0,0
47879,RM-B275,6/1/2014,0,0,0,0,0,0,0
47880,RM-B275,6/2/2014,0,0,0,0,0,0,0
47881,RM-B275,6/3/2014,0,0,0,0,0,0,0
47882,RM-B275,6/4/2014,0,0,0,0,0,0,0
47883,RM-B275,6/5/2014,0,0,0,0,0,0,0
47884,RM-B275,6/6/2014,0,0,0,0,0,0,0
47885,RM-B275,6/7/2014,0,0,0,0,0,0,0
47886,RM-B275,6/8/2014,0,0,0,0,0,0,0
47887,RM-B275,6/9/2014,0,0,0,0,0,0,0
47888,RM-B275,6/10/2014,0,0,0,0,0,0,0
47889,RM-B275,6/11/2014,0,0,0,0,0,0,0
47890,RM-B275,6/12/2014,0,0,0,0,0,0,0
47891,RM-B275,6/13/2014,0,0,0,0,0,0,0
47892,RM-B275,6/14/2014,0,0,0,0,0,0,0
47893,RM-B275,6/15/2014,0,0,0,0,0,0,0
47894,RM-B275,6/16/2014,0,0,0,0,0,0,0
47895,RM-B275,6/17/2014,0,0,0,0,0,0,0
47896,RM-B275,6/18/2014,0,0,0,0,0,0,0
47897,RM-B275,6/19/2014,0,0,0,0,0,0,0
47898,RM-B275,6/20/2014,0,0,0,0,0,0,0
47899,RM-B275,6/21/2014,0,0,0,0,0,0,0
47900,RM-B275,6/22/2014,0,0,0,0,0,0,0
47901,RM-B275,6/23/2014,0,0,0,0,0,0,0
47902,RM-B275,6/24/2014,0,0,0,0,0,0,0
47903,RM-B275,6/25/2014,0,0,0,0,0,0,0
47904,RM-B275,6/26/2014,0,0,0,0,0,0,0
47905,RM-B275,6/27/2014,0,0,0,0,0,0,0
47906,RM-B275,6/28/2014,0,0,0,0,0,0,0
47907,RM-B275,6/29/2014,0,0,0,0,0,0,0
47908,RM-B275,6/30/2014,0,0,0,0,0,0,0
47909,RM-B275,7/1/2014,0,0,0,0,0,0,0
47910,RM-B275,7/2/2014,0,0,0,0,0,0,0
47911,RM-B275,7/3/2014,0,0,0,0,0,0,0
47912,RM-B275,7/4/2014,0,0,0,0,0,0,0
47913,RM-B275,7/5/2014,0,0,0,0,0,0,0
47914,RM-B275,7/6/2014,0,0,0,0,0,0,0
47915,RM-B275,7/7/2014,0,0,0,0,0,0,0
47916,RM-B275,7/8/2014,0,0,0,0,0,0,0
47917,RM-B275,7/9/2014,0,0,0,0,0,0,0
47918,RM-B275,7/10/2014,0,0,0,0,0,0,0
47919,RM-B275,7/11/2014,0,0,0,0,0,0,0
47920,RM-B275,7/12/2014,0,0,0,0,0,0,0
47921,RM-B275,7/13/2014,0,0,0,0,0,0,0
47922,RM-B275,7/14/2014,0,0,0,0,0,0,0
47923,RM-B275,7/15/2014,0,0,0,0,0,0,0
47924,RM-B275,7/16/2014,0,0,0,0,0,0,0
47925,RM-B275,7/17/2014,0,0,0,0,0,0,0
47926,RM-B275,7/18/2014,0,0,0,0,0,0,0
47927,RM-B275,7/19/2014,0,0,0,0,0,0,0
47928,RM-B275,7/20/2014,0,0,0,0,0,0,0
47929,RM-B275,7/21/2014,0,0,0,0,0,0,0
47930,RM-B275,7/22/2014,0,0,0,0,0,0,0
47931,RM-B275,7/23/2014,0,0,0,0,0,0,0
47932,RM-B275,7/24/2014,0,0,0,0,0,0,0
47933,RM-B275,7/25/2014,0,0,0,0,0,0,0
47934,RM-B275,7/26/2014,0,0,0,0,0,0,0
47935,RM-B275,7/27/2014,0,0,0,0,0,0,0
47936,RM-B275,7/28/2014,0,0,0,0,0,0,0
47937,RM-B275,7/29/2014,0,0,0,0,0,0,0
47938,RM-B275,7/30/2014,0,0,0,0,0,0,0
47939,RM-B275,7/31/2014,0,0,0,0,0,0,0
47940,RM-B275,8/1/2014,0,0,0,0,0,0,0
47941,RM-B275,8/2/2014,0,0,0,0,0,0,0
47942,RM-B275,8/3/2014,0,0,0,0,0,0,0
47943,RM-B275,8/4/2014,0,0,0,0,0,0,0
47944,RM-B275,8/5/2014,0,0,0,0,0,0,0
47945,RM-B275,8/6/2014,0,0,0,0,0,0,0
47946,RM-B275,8/7/2014,0,0,0,0,0,0,0
47947,RM-B275,8/8/2014,0,0,0,0,0,0,0
47948,RM-B275,8/9/2014,0,0,0,0,0,0,0
47949,RM-B275,8/10/2014,0,0,0,0,0,0,0
47950,RM-B275,8/11/2014,0,0,0,0,0,0,0
47951,RM-B275,8/12/2014,0,0,0,0,0,0,0
47952,RM-B275,8/13/2014,0,0,0,0,0,0,0
47953,RM-B275,8/14/2014,0,0,0,0,0,0,0
47954,RM-B275,8/15/2014,0,0,0,0,0,0,0
47955,RM-B275,8/16/2014,0,0,0,0,0,0,0
47956,RM-B275,8/17/2014,0,0,0,0,0,0,0
47957,RM-B275,8/18/2014,0,0,0,0,0,0,0
47958,RM-B275,8/19/2014,0,0,0,0,0,0,0
47959,RM-B275,8/20/2014,0,0,0,0,0,0,0
47960,RM-B275,8/21/2014,0,0,0,0,0,0,0
47961,RM-B275,8/22/2014,0,0,0,0,0,0,0
47962,RM-B275,8/23/2014,0,0,0,0,0,0,0
47963,RM-B275,8/24/2014,0,0,0,0,0,0,0
47964,RM-B275,8/25/2014,0,0,0,0,0,0,0
47965,RM-B275,8/26/2014,0,0,0,0,0,0,0
47966,RM-B275,8/27/2014,0,0,0,0,0,0,0
47967,RM-B275,8/28/2014,0,0,0,0,0,0,0
47968,RM-B275,8/29/2014,0,0,0,0,0,0,0
47969,RM-B275,8/30/2014,0,0,0,0,0,0,0
47970,RM-B275,8/31/2014,0,0,0,0,0,0,0
47971,RM-B275,9/1/2014,0,0,0,0,0,0,0
47972,RM-B275,9/2/2014,0,0,0,0,0,0,0
47973,RM-B275,9/3/2014,0,0,0,0,0,0,0
47974,RM-B275,9/4/2014,0,0,0,0,0,0,0
47975,RM-B275,9/5/2014,0,0,0,0,0,0,0
47976,RM-B275,9/6/2014,0,0,0,0,0,0,0
47977,RM-B275,9/7/2014,0,0,0,0,0,0,0
47978,RM-B275,9/8/2014,0,0,0,0,0,0,0
47979,RM-B275,9/9/2014,0,0,0,0,0,0,0
47980,RM-B275,9/10/2014,0,0,0,0,0,0,0
47981,RM-B275,9/11/2014,0,0,0,0,0,0,0
47982,RM-B275,9/12/2014,0,0,0,0,0,0,0
47983,RM-B275,9/13/2014,0,0,0,0,0,0,0
47984,RM-B275,9/14/2014,0,0,0,0,0,0,0
47985,RM-B275,9/15/2014,0,0,0,0,0,0,0
47986,RM-B275,9/16/2014,0,0,0,0,0,0,0
47987,RM-B275,9/17/2014,0,0,0,0,0,0,0
47988,RM-B275,9/18/2014,0,0,0,0,0,0,0
47989,RM-B275,9/19/2014,0,0,0,0,0,0,0
47990,RM-B275,9/20/2014,0,0,0,0,0,0,0
47991,RM-B275,9/21/2014,0,0,0,0,0,0,0
47992,RM-B275,9/22/2014,0,0,0,0,0,0,0
47993,RM-B275,9/23/2014,0,0,0,0,0,0,0
47994,RM-B275,9/24/2014,0,0,0,0,0,0,0
47995,RM-B275,9/25/2014,0,0,0,0,0,0,0
47996,RM-B275,9/28/2014,0,0,0,0,0,0,0
47997,RM-B275,9/29/2014,0,0,0,0,0,0,0
47998,RM-B275,9/30/2014,0,0,0,0,0,0,0
47999,RM-B275,10/1/2014,0,0,0,0,0,0,0
48000,RM-B275,10/2/2014,0,0,0,0,0,0,0
48001,RM-B275,10/3/2014,0,0,0,0,0,0,0
48002,RM-B275,10/4/2014,0,0,0,0,0,0,0
48003,RM-B275,10/5/2014,0,0,0,0,0,0,0
48004,RM-B275,10/6/2014,0,0,0,0,0,0,0
48005,RM-B275,10/7/2014,0,0,0,0,0,0,0
48006,RM-B275,10/8/2014,0,0,0,0,0,0,0
48007,RM-B275,10/9/2014,0,0,0,0,0,0,0
48008,RM-B275,10/10/2014,0,0,0,0,0,0,0
48009,RM-B275,10/11/2014,0,0,0,0,0,0,0
48010,RM-B275,10/12/2014,0,0,0,0,0,0,0
48011,RM-B275,10/13/2014,0,0,0,0,0,0,0
48012,RM-B275,10/14/2014,0,0,0,0,0,0,0
48013,RM-B275,10/15/2014,0,0,0,0,0,0,0
48014,RM-B275,10/16/2014,0,0,0,0,0,0,0
48015,RM-B275,10/17/2014,0,0,0,0,0,0,0
48016,RM-B275,10/18/2014,0,0,0,0,0,0,0
48017,RM-B275,10/19/2014,0,0,0,0,0,0,0
48018,RM-B275,10/20/2014,0,0,0,0,0,0,0
48019,RM-B275,10/21/2014,0,0,0,0,0,0,0
48020,RM-B275,10/22/2014,0,0,0,0,0,0,0
48021,RM-B275,10/23/2014,0,0,0,0,0,0,0
48022,RM-B275,10/24/2014,0,0,0,0,0,0,0
48023,RM-B275,10/25/2014,0,0,0,0,0,0,0
48024,RM-B275,10/26/2014,0,0,0,0,0,0,0
48025,RM-B275,10/27/2014,0,0,0,0,0,0,0
48026,RM-B275,10/28/2014,0,0,0,0,0,0,0
48027,RM-B275,10/29/2014,0,0,0,0,0,0,0
48028,RM-B275,10/30/2014,0,0,0,0,0,0,0
48029,RM-B275,10/31/2014,0,0,0,0,0,0,0
48030,RM-B275,11/1/2014,0,0,0,0,0,0,0
48031,RM-B275,11/2/2014,0,0,0,0,0,0,0
48032,RM-B275,11/3/2014,0,0,0,0,0,0,0
48033,RM-B275,11/4/2014,0,0,0,0,0,0,0
48034,RM-B275,11/5/2014,0,0,0,0,0,0,0
48035,RM-B275,11/6/2014,0,0,0,0,0,0,0
48036,RM-B275,11/7/2014,0,0,0,0,0,0,0
48037,RM-B275,11/8/2014,0,0,0,0,0,0,0
48038,RM-B275,11/9/2014,0,0,0,0,0,0,0
48039,RM-B275,11/10/2014,0,0,0,0,0,0,0
48040,RM-B275,11/11/2014,0,0,0,0,0,0,0
48041,RM-B275,11/12/2014,0,0,0,0,0,0,0
48042,RM-B275,11/13/2014,0,0,0,0,0,0,0
48043,RM-B275,11/14/2014,0,0,0,0,0,0,0
48044,RM-B275,11/15/2014,0,0,0,0,0,0,0
48045,RM-B275,11/16/2014,0,0,0,0,0,0,0
48046,RM-B275,11/17/2014,0,0,0,0,0,0,0
48047,RM-B275,11/18/2014,0,0,0,0,0,0,0
48048,RM-B275,11/19/2014,0,0,0,0,0,0,0
48049,RM-B275,11/20/2014,0,0,0,0,0,0,0
48050,RM-B275,11/21/2014,0,0,0,0,0,0,0
